0 Name Name Name foreign unspecified unspecified unspecified unspecified unspecified  	O	null
1 : : : punctuation unspecified unspecified unspecified unspecified unspecified  	O	null
2 אוורבוך אוורבוך אוורבוך properName unspecified unspecified unspecified unspecified unspecified  	I_PERS	null
3 אורפז אורפז אורפז properName unspecified unspecified unspecified unspecified unspecified  	I_PERS	null
4 , , , punctuation unspecified unspecified unspecified unspecified unspecified  	O	null
5 יצחק יצחק יצחק properName unspecified unspecified unspecified unspecified unspecified  	I_PERS	null
6 Birth Birth Birth foreign unspecified unspecified unspecified unspecified unspecified  	O	null
7 Year Year Year foreign unspecified unspecified unspecified unspecified unspecified  	O	null
8 : : : punctuation unspecified unspecified unspecified unspecified unspecified  	O	null
9 ###NUMBER### ###NUMBER### ###NUMBER### numeral unspecified unspecified unspecified unspecified unspecified  	I_DATE	null
10 Birth Birth Birth foreign unspecified unspecified unspecified unspecified unspecified  	O	null
11 Place Place Place foreign unspecified unspecified unspecified unspecified unspecified  	O	null
12 : : : punctuation unspecified unspecified unspecified unspecified unspecified  	O	null
13 עיירה עיירה עיירה noun feminine singular absolute unspecified unspecified  	O	null
14 זינקו זינקו זינקוב noun masculine singular absolute unspecified unspecified  
14 י י זינקוב possessive masculine-and-feminine singular unspecified 1 unspecified 0 	O	null
15 , , , punctuation unspecified unspecified unspecified unspecified unspecified  	O	null
16 אוקראינה אוקראינה אוקראינה properName unspecified unspecified unspecified unspecified unspecified  	I_LOC	null
17 Occupation Occupation Occupation foreign unspecified unspecified unspecified unspecified unspecified  	O	null
18 : : : punctuation unspecified unspecified unspecified unspecified unspecified  	O	null
19 סופר סופר סופר noun masculine singular absolute unspecified unspecified  	O	null
20 , , , punctuation unspecified unspecified unspecified unspecified unspecified  	O	null
21 מסאי מסאי מסאי noun masculine singular absolute unspecified unspecified  	O	null
22 ו ו ומשורר conjunction unspecified unspecified unspecified unspecified unspecified 0 
22 משורר משורר ומשורר noun masculine singular absolute unspecified unspecified  	O	null
23 Entry Entry Entry foreign unspecified unspecified unspecified unspecified unspecified  	O	null
24 writer writer writer foreign unspecified unspecified unspecified unspecified unspecified  	O	null
25 : : : punctuation unspecified unspecified unspecified unspecified unspecified  	O	null
26 חיים חיים חיים noun masculine plural absolute unspecified unspecified  	O	null
27 נגיד נגיד נגיד properName unspecified unspecified unspecified unspecified unspecified  	I_PERS	null
28 ו ו ונינה conjunction unspecified unspecified unspecified unspecified unspecified 0 
28 נינה נינה ונינה properName unspecified unspecified unspecified unspecified unspecified  	I_PERS	null
29 פינטו פינטו פינטו properName unspecified unspecified unspecified unspecified unspecified  	I_PERS	null
30 - - - properName unspecified unspecified unspecified unspecified unspecified  	I_PERS	null
31 אבקסיס אבקסיס אבקסיס properName unspecified unspecified unspecified unspecified unspecified  	I_PERS	null
32 Entry Entry Entry foreign unspecified unspecified unspecified unspecified unspecified  	O	null
33 Value Value Value foreign unspecified unspecified unspecified unspecified unspecified  	O	null
34 : : : punctuation unspecified unspecified unspecified unspecified unspecified  	O	null
35 נולד נולד נולד verb masculine singular unspecified 3 past  	O	null
36 ב ב בעיירה preposition unspecified unspecified unspecified unspecified unspecified 0 
36 ה ה בעיירה definiteArticle unspecified unspecified unspecified unspecified unspecified 0 
36 העיירה עיירה בעיירה noun feminine singular absolute unspecified unspecified  	O	null
37 זינקו זינקו זינקוב noun masculine singular absolute unspecified unspecified  
37 י י זינקוב possessive masculine-and-feminine singular unspecified 1 unspecified 0 	O	null
38 , , , punctuation unspecified unspecified unspecified unspecified unspecified  	O	null
39 אוקראינה אוקראינה אוקראינה properName unspecified unspecified unspecified unspecified unspecified  	I_LOC	null
40 . . . punctuation unspecified unspecified unspecified unspecified unspecified  	O	null

0 נמלט נמלט נמלט verb masculine singular unspecified 3 past  	O	null
1 עם עם עם preposition unspecified unspecified unspecified unspecified unspecified  	O	null
2 הורי הורה הוריו noun masculine plural absolute unspecified unspecified  
2 ו ו הוריו possessive masculine singular unspecified 3 unspecified 0 	O	null
3 מ מ מאימת preposition unspecified unspecified unspecified unspecified unspecified 0 
3 אימת אימה מאימת noun feminine singular construct unspecified unspecified  	O	null
4 ה ה השלטון definiteArticle unspecified unspecified unspecified unspecified unspecified 0 
4 השלטון שלטון השלטון noun masculine singular absolute unspecified unspecified  	O	null
5 ה ה הקומוניסטי definiteArticle unspecified unspecified unspecified unspecified unspecified 0 
5 הקומוניסטי קומוניסטי הקומוניסטי adjective masculine singular absolute unspecified unspecified  	O	null
6 ל ל לבית preposition unspecified unspecified unspecified unspecified unspecified 0 
6 בית בית לבית noun masculine singular construct unspecified unspecified  	O	null
7 סב סב סבו noun masculine singular absolute unspecified unspecified  
7 ו ו סבו possessive masculine singular unspecified 3 unspecified 0 	O	null
8 בליפקאן בליפקאן בליפקאן properName unspecified unspecified unspecified unspecified unspecified  	I_LOC	null
9 , , , punctuation unspecified unspecified unspecified unspecified unspecified  	O	null
10 ב ב בסרביה preposition unspecified unspecified unspecified unspecified unspecified 0 
10 סרביה סרביה בסרביה properName unspecified unspecified unspecified unspecified unspecified  	I_LOC	null
11 . . . punctuation unspecified unspecified unspecified unspecified unspecified  	O	null

0 בשל בשל בשל preposition unspecified unspecified unspecified unspecified unspecified  	O	null
1 מחלה מחלה מחלה noun feminine singular absolute unspecified unspecified  	O	null
2 נאלץ נאלץ נאלץ verb masculine singular unspecified any beinoni  	O	null
3 לוותר ויתר לוותר verb unspecified unspecified unspecified unspecified infinitive  	O	null
4 על על על preposition unspecified unspecified unspecified unspecified unspecified  	O	null
5 לימודים לימוד לימודים noun masculine plural absolute unspecified unspecified  	O	null
6 ב ב בבית preposition unspecified unspecified unspecified unspecified unspecified 0 
6 בית בית בבית noun masculine singular construct unspecified unspecified  	O	null
7 ספר ספר ספר noun masculine singular absolute unspecified unspecified  	O	null
8 ו ו ורכש conjunction unspecified unspecified unspecified unspecified unspecified 0 
8 רכש רכש ורכש verb masculine singular unspecified 3 past  	O	null
9 את את את at-preposition unspecified unspecified unspecified unspecified unspecified  	O	null
10 השכלת השכלה השכלתו noun feminine singular absolute unspecified unspecified  
10 ו ו השכלתו possessive masculine singular unspecified 3 unspecified 0 	O	null
11 בעיקר בעיקר בעיקר adverb unspecified unspecified unspecified unspecified unspecified  	O	null
12 ב ב בכוחות preposition unspecified unspecified unspecified unspecified unspecified 0 
12 ה ה בכוחות definiteArticle unspecified unspecified unspecified unspecified unspecified 0 
12 הכוחות כוח בכוחות noun masculine plural absolute unspecified unspecified  	O	null
13 עצמו עצמו עצמו pronoun unspecified unspecified unspecified unspecified unspecified  
13 ו ו עצמו pronomial masculine singular unspecified 3 unspecified 0 	O	null
14 ו ו ובעזרת conjunction unspecified unspecified unspecified unspecified unspecified 0 
14 בעזרת בעזרת ובעזרת preposition unspecified unspecified unspecified unspecified unspecified  	O	null
15 מורה מורה מורה noun masculine singular absolute unspecified unspecified  	O	null
16 פרטי פרטי פרטי adjective masculine singular absolute unspecified unspecified  	O	null
17 ש ש שלימד relativizer/subordinatingConjunction unspecified unspecified unspecified unspecified unspecified 0 
17 לימד לימד שלימד verb masculine singular unspecified 3 past  	O	null
18 את את אותו at-preposition unspecified unspecified unspecified unspecified unspecified  
18 ו ו אותו pronomial masculine singular unspecified 3 unspecified 0 	O	null
19 ספרות ספרות ספרות noun feminine singular absolute unspecified unspecified  	O	null
20 עברית עברי עברית adjective feminine singular absolute unspecified unspecified  	O	null
21 , , , punctuation unspecified unspecified unspecified unspecified unspecified  	O	null
22 נביאים נביא נביאים noun masculine plural absolute unspecified unspecified  	O	null
23 אחרונים אחרון אחרונים adjective masculine plural absolute unspecified unspecified  	O	null
24 ו ו וגמרא conjunction unspecified unspecified unspecified unspecified unspecified 0 
24 גמרא גמרא וגמרא noun feminine singular absolute unspecified unspecified  	O	null
25 . . . punctuation unspecified unspecified unspecified unspecified unspecified  	O	null

0 ב ב ב preposition unspecified unspecified unspecified unspecified unspecified 0 	O	null
1 - - - punctuation unspecified unspecified unspecified unspecified unspecified  	O	null
2 , , , punctuation unspecified unspecified unspecified unspecified unspecified  	O	null
3 ###NUMBER### ###NUMBER### ###NUMBER### numeral unspecified unspecified unspecified unspecified unspecified  	I_DATE	null
4 ב ב בהיותו preposition unspecified unspecified unspecified unspecified unspecified 0 
4 היות היות בהיותו noun masculine singular absolute unspecified unspecified  
4 ו ו בהיותו possessive masculine singular unspecified 3 unspecified 0 	O	null
5 ב ב בן preposition unspecified unspecified unspecified unspecified unspecified  
5 הן הן בן pronomial feminine plural unspecified 3 unspecified 0 	O	null
6 שבע CARD7 שבע numeral feminine singular absolute unspecified unspecified  	O	null
7 - - - punctuation unspecified unspecified unspecified unspecified unspecified  	O	null
8 עשרה CARD10 עשרה numeral masculine plural absolute unspecified unspecified  	O	null
9 , , , punctuation unspecified unspecified unspecified unspecified unspecified  	O	null
10 עלה עלה עלה verb masculine singular unspecified 3 past  	O	null
11 ל ל לבדו preposition unspecified unspecified unspecified unspecified unspecified 0 
11 בד בד לבדו noun masculine singular absolute unspecified unspecified  
11 ו ו לבדו possessive masculine singular unspecified 3 unspecified 0 	O	null
12 ארצה ארצה ארצה adverb unspecified unspecified unspecified unspecified unspecified  	O	null
13 ב ב במסגרת preposition unspecified unspecified unspecified unspecified unspecified 0 
13 מסגרת מסגרת במסגרת noun feminine singular construct unspecified unspecified  	O	null
14 " " " punctuation unspecified unspecified unspecified unspecified unspecified  	O	null
15 עליית עלייה עליית noun feminine singular construct unspecified unspecified  	O	null
16 ה ה הנוער definiteArticle unspecified unspecified unspecified unspecified unspecified 0 
16 הנוער נוער הנוער noun masculine singular absolute unspecified unspecified  	O	null
17 " " " punctuation unspecified unspecified unspecified unspecified unspecified  	O	null
18 , , , punctuation unspecified unspecified unspecified unspecified unspecified  	O	null
19 התחנך התחנך התחנך verb masculine singular unspecified 3 past  	O	null
20 במשך במשך במשך preposition unspecified unspecified unspecified unspecified unspecified  	O	null
21 חצי חץ חצי noun masculine plural construct unspecified unspecified  	O	null
22 שנה שנה שנה noun feminine singular absolute unspecified unspecified  	O	null
23 ב ב בכפר preposition unspecified unspecified unspecified unspecified unspecified 0 
23 כפר כפר בכפר noun masculine singular construct unspecified unspecified  	O	null
24 ה ה הנוער definiteArticle unspecified unspecified unspecified unspecified unspecified 0 
24 הנוער נוער הנוער noun masculine singular absolute unspecified unspecified  	O	null
25 מאיר מאיר מאיר properName unspecified unspecified unspecified unspecified unspecified  	I_PERS	null
26 ש ש שפיה relativizer/subordinatingConjunction unspecified unspecified unspecified unspecified unspecified 0 
26 פי פה שפיה noun masculine singular absolute unspecified unspecified  
26 ה ה שפיה possessive feminine singular unspecified 3 unspecified 0 	O	null
27 , , , punctuation unspecified unspecified unspecified unspecified unspecified  	O	null
28 ו ו ואחר conjunction unspecified unspecified unspecified unspecified unspecified 0 
28 אחר אחר ואחר preposition unspecified unspecified unspecified unspecified unspecified  	O	null
29 כך כך כך pronoun unspecified unspecified unspecified unspecified unspecified  	O	null
30 הצטרף הצטרף הצטרף verb masculine singular unspecified 3 past  	O	null
31 ל ל לגרעין preposition unspecified unspecified unspecified unspecified unspecified 0 
31 ה ה לגרעין definiteArticle unspecified unspecified unspecified unspecified unspecified 0 
31 הגרעין גרעין לגרעין noun masculine singular absolute unspecified unspecified  	O	null
32 ה ה הקיבוצי definiteArticle unspecified unspecified unspecified unspecified unspecified 0 
32 הקיבוצי קיבוצי הקיבוצי adjective masculine singular absolute unspecified unspecified  	O	null
33 יסעור יסעור יסעור noun masculine singular absolute unspecified unspecified  	O	null
34 ב ב במושבה preposition unspecified unspecified unspecified unspecified unspecified 0 
34 ה ה במושבה definiteArticle unspecified unspecified unspecified unspecified unspecified 0 
34 המושבה מושבה במושבה noun feminine singular absolute unspecified unspecified  	O	null
35 מגדיאל מגדיאל מגדיאל properName unspecified unspecified unspecified unspecified unspecified  	I_PERS	null
36 . . . punctuation unspecified unspecified unspecified unspecified unspecified  	O	null

0 ב ב בסתיו preposition unspecified unspecified unspecified unspecified unspecified 0 
0 ה ה בסתיו definiteArticle unspecified unspecified unspecified unspecified unspecified 0 
0 הסתיו סתיו בסתיו noun masculine singular absolute unspecified unspecified  	I_DATE	null
1 , , , punctuation unspecified unspecified unspecified unspecified unspecified  	O	null
2 ###NUMBER### ###NUMBER### ###NUMBER### numeral unspecified unspecified unspecified unspecified unspecified  	I_DATE	null
3 כש כש כשהגיעו temporalSubConj unspecified unspecified unspecified unspecified unspecified 0 
3 הגיעו הגיע כשהגיעו verb masculine-and-feminine plural unspecified 3 past  	O	null
4 אל אל אליו preposition unspecified unspecified unspecified unspecified unspecified  
4 ו ו אליו pronomial masculine singular unspecified 3 unspecified 0 	O	null
5 שמועות שמועה שמועות noun feminine plural absolute unspecified unspecified  	O	null
6 על על על preposition unspecified unspecified unspecified unspecified unspecified  	O	null
7 מות מוות מותם noun masculine singular absolute unspecified unspecified  
7 ם ם מותם possessive masculine plural unspecified 3 unspecified 0 	O	null
8 של של של shel-preposition unspecified unspecified unspecified unspecified unspecified  	O	null
9 הורי הורה הוריו noun masculine plural absolute unspecified unspecified  
9 ו ו הוריו possessive masculine singular unspecified 3 unspecified 0 	O	null
10 ו ו ואחותו conjunction unspecified unspecified unspecified unspecified unspecified 0 
10 אחות אח ואחותו noun feminine singular absolute unspecified unspecified  
10 ו ו ואחותו possessive masculine singular unspecified 3 unspecified 0 	O	null
11 ב ב במחנה preposition unspecified unspecified unspecified unspecified unspecified 0 
11 מחנה מחנה במחנה noun masculine singular construct unspecified unspecified  	I_ORG	null
12 ה ה הריכוז definiteArticle unspecified unspecified unspecified unspecified unspecified 0 
12 הריכוז ריכוז הריכוז noun masculine singular absolute unspecified unspecified  	I_ORG	null
13 בטרנסדניסטריה בטרנסדניסטריה בטרנסדניסטריה properName unspecified unspecified unspecified unspecified unspecified  	I_PERS	null
14 , , , punctuation unspecified unspecified unspecified unspecified unspecified  	O	null
15 רומניה רומני רומניה properName unspecified unspecified unspecified unspecified unspecified  	I_LOC	null
16 , , , punctuation unspecified unspecified unspecified unspecified unspecified  	O	null
17 התגייס התגייס התגייס verb masculine singular unspecified 3 past  	O	null
18 ל ל לצבא preposition unspecified unspecified unspecified unspecified unspecified 0 
18 ה ה לצבא definiteArticle unspecified unspecified unspecified unspecified unspecified 0 
18 הצבא צבא לצבא noun masculine singular absolute unspecified unspecified  	O	null
19 ה ה הבריטי definiteArticle unspecified unspecified unspecified unspecified unspecified 0 
19 הבריטי בריטי הבריטי adjective masculine singular absolute unspecified unspecified  	O	null
20 ו ו ויצא conjunction unspecified unspecified unspecified unspecified unspecified 0 
20 יצא יצא ויצא verb masculine singular unspecified 3 past  	O	null
21 ל ל לאירופה preposition unspecified unspecified unspecified unspecified unspecified 0 
21 אירופה אירופה לאירופה properName unspecified unspecified unspecified unspecified unspecified  	I_LOC	null
22 . . . punctuation unspecified unspecified unspecified unspecified unspecified  	O	null

0 ב ב ב preposition unspecified unspecified unspecified unspecified unspecified 0 	I_ORG	null
1 - - - punctuation unspecified unspecified unspecified unspecified unspecified  	I_ORG	null
2 ###NUMBER### ###NUMBER### ###NUMBER### numeral unspecified unspecified unspecified unspecified unspecified  	I_DATE	null
3 חזר חזר חזר verb masculine singular unspecified 3 past  	O	null
4 ארצה ארצה ארצה adverb unspecified unspecified unspecified unspecified unspecified  	O	null
5 ו ו ועבד conjunction unspecified unspecified unspecified unspecified unspecified 0 
5 עבד עבד ועבד verb masculine singular unspecified 3 past  	O	null
6 ב ב בליטוש preposition unspecified unspecified unspecified unspecified unspecified 0 
6 ליטוש ליטוש בליטוש noun masculine singular construct unspecified unspecified  	O	null
7 יהלומים יהלום יהלומים noun masculine plural absolute unspecified unspecified  	O	null
8 , , , punctuation unspecified unspecified unspecified unspecified unspecified  	O	null
9 אך אך אך conjunction unspecified unspecified unspecified unspecified unspecified  	O	null
10 כעבור כעבור כעבור preposition unspecified unspecified unspecified unspecified unspecified  	O	null
11 זמן זמן זמן noun masculine singular absolute unspecified unspecified  	O	null
12 קצר קצר קצר adjective masculine singular absolute unspecified unspecified  	O	null
13 שב שב שב verb masculine singular unspecified 3 past  	O	null
14 ו ו ולבש conjunction unspecified unspecified unspecified unspecified unspecified 0 
14 לבש לבש ולבש verb masculine singular unspecified 3 past  	O	null
15 מדים מד מדים noun masculine plural absolute unspecified unspecified  	O	null
16 , , , punctuation unspecified unspecified unspecified unspecified unspecified  	O	null
17 הפעם הפעם הפעם adverb unspecified unspecified unspecified unspecified unspecified  	O	null
18 מדי מדי מדי adverb unspecified unspecified unspecified unspecified unspecified  	O	null
19 צה"ל צה"ל צה"ל properName unspecified unspecified unspecified unspecified unspecified  	I_ORG	null
20 , , , punctuation unspecified unspecified unspecified unspecified unspecified  	O	null
21 השתתף השתתף השתתף verb masculine singular unspecified 3 past  	O	null
22 ב ב במלחמת preposition unspecified unspecified unspecified unspecified unspecified 0 
22 מלחמת מלחמה במלחמת noun feminine singular construct unspecified unspecified  	O	null
23 ה ה העצמאות definiteArticle unspecified unspecified unspecified unspecified unspecified 0 
23 העצמאות עצמאות העצמאות noun feminine singular absolute unspecified unspecified  	O	null
24 כ כ כקצין preposition unspecified unspecified unspecified unspecified unspecified 0 
24 קצין קצין כקצין noun masculine singular absolute unspecified unspecified  	O	null
25 ב ב בחיל preposition unspecified unspecified unspecified unspecified unspecified 0 
25 חיל חיל בחיל noun masculine singular construct unspecified unspecified  	I_ORG	null
26 ה ה התותחנים definiteArticle unspecified unspecified unspecified unspecified unspecified 0 
26 התותחנים תותחן התותחנים noun masculine plural absolute unspecified unspecified  	I_ORG	null
27 ו ו ונלחם conjunction unspecified unspecified unspecified unspecified unspecified 0 
27 נלחם נלחם ונלחם verb masculine singular unspecified 3 past  	O	null
28 בקרב בקרב בקרב preposition unspecified unspecified unspecified unspecified unspecified  	O	null
29 לטרון לטרון לטרון properName unspecified unspecified unspecified unspecified unspecified  	I_PERS	null
30 . . . punctuation unspecified unspecified unspecified unspecified unspecified  	O	null

0 אחרי אחרי אחרי preposition unspecified unspecified unspecified unspecified unspecified  	O	null
1 ה ה המלחמה definiteArticle unspecified unspecified unspecified unspecified unspecified 0 
1 המלחמה מלחמה המלחמה noun feminine singular absolute unspecified unspecified  	O	null
2 התגייס התגייס התגייס verb masculine singular unspecified 3 past  	O	null
3 ל ל לצבא preposition unspecified unspecified unspecified unspecified unspecified 0 
3 צבא צבא לצבא noun masculine singular construct unspecified unspecified  	O	null
4 ה ה הקבע definiteArticle unspecified unspecified unspecified unspecified unspecified 0 
4 הקבע קבע הקבע noun masculine singular absolute unspecified unspecified  	O	null
5 ו ו ולקח conjunction unspecified unspecified unspecified unspecified unspecified 0 
5 לקח לקח ולקח verb masculine singular unspecified 3 past  	O	null
6 חלק חלק חלק adverb unspecified unspecified unspecified unspecified unspecified  	O	null
7 ב ב במלחמת preposition unspecified unspecified unspecified unspecified unspecified 0 
7 מלחמת מלחמה במלחמת noun feminine singular construct unspecified unspecified  	O	null
8 סיני סיני סיני properName unspecified unspecified unspecified unspecified unspecified  	I_LOC	null
9 ) ) ) punctuation unspecified unspecified unspecified unspecified unspecified  	O	null
10 . . . punctuation unspecified unspecified unspecified unspecified unspecified  	O	null
11 ###NUMBER### ###NUMBER### ###NUMBER### numeral unspecified unspecified unspecified unspecified unspecified  	I_DATE	null
12 ב ב באיחור preposition unspecified unspecified unspecified unspecified unspecified 0 
12 איחור איחור באיחור noun masculine singular absolute unspecified unspecified  	O	null
13 ניכר ניכר ניכר adjective masculine singular absolute unspecified unspecified  	O	null
14 עבר עבר עבר verb masculine singular unspecified 3 past  	O	null
15 ב ב במסגרת preposition unspecified unspecified unspecified unspecified unspecified 0 
15 מסגרת מסגרת במסגרת noun feminine singular construct unspecified unspecified  	O	null
16 ה ה המכינה definiteArticle unspecified unspecified unspecified unspecified unspecified 0 
16 המכינה מכינה המכינה noun feminine singular absolute unspecified unspecified  	O	null
17 ה ה הצבאית definiteArticle unspecified unspecified unspecified unspecified unspecified 0 
17 הצבאית צבאי הצבאית adjective feminine singular absolute unspecified unspecified  	O	null
18 את את את at-preposition unspecified unspecified unspecified unspecified unspecified  	O	null
19 בחינות בחינה בחינות noun feminine plural construct unspecified unspecified  	O	null
20 ה ה הבגרות definiteArticle unspecified unspecified unspecified unspecified unspecified 0 
20 הבגרות בגרות הבגרות noun feminine singular absolute unspecified unspecified  	O	null
21 , , , punctuation unspecified unspecified unspecified unspecified unspecified  	O	null
22 ו ו וב conjunction unspecified unspecified unspecified unspecified unspecified 0 
22 ב ב וב preposition unspecified unspecified unspecified unspecified unspecified 0 	O	null
23 - - - punctuation unspecified unspecified unspecified unspecified unspecified  	O	null
24 ###NUMBER### ###NUMBER### ###NUMBER### numeral unspecified unspecified unspecified unspecified unspecified  	I_DATE	null
25 החל החל החל verb masculine singular unspecified 3 past  	O	null
26 ללמוד למד ללמוד verb unspecified unspecified unspecified unspecified infinitive  	O	null
27 ב ב באוניברסיטת preposition unspecified unspecified unspecified unspecified unspecified 0 
27 אוניברסיטת אוניברסיטה באוניברסיטת noun feminine singular construct unspecified unspecified  	I_ORG	null
28 תל תל תל properName unspecified unspecified unspecified unspecified unspecified  	I_ORG	null
29 אביב אביב אביב properName unspecified unspecified unspecified unspecified unspecified  	I_ORG	null
30 ב ב בחוגים preposition unspecified unspecified unspecified unspecified unspecified 0 
30 חוגים חוג בחוגים noun masculine plural absolute unspecified unspecified  	O	null
31 ל ל לפילוסופיה preposition unspecified unspecified unspecified unspecified unspecified 0 
31 ה ה לפילוסופיה definiteArticle unspecified unspecified unspecified unspecified unspecified 0 
31 הפילוסופיה פילוסופיה לפילוסופיה noun feminine singular absolute unspecified unspecified  	O	null
32 ו ו ולספרות conjunction unspecified unspecified unspecified unspecified unspecified 0 
32 ל ל ולספרות preposition unspecified unspecified unspecified unspecified unspecified 0 
32 ספרות ספרות ולספרות noun feminine singular absolute unspecified unspecified  	O	null
33 עברית עברי עברית adjective feminine singular absolute unspecified unspecified  	O	null
34 . . . punctuation unspecified unspecified unspecified unspecified unspecified  	O	null

0 מ מ מ preposition unspecified unspecified unspecified unspecified unspecified 0 	O	null
1 - - - punctuation unspecified unspecified unspecified unspecified unspecified  	O	null
2 ###NUMBER### ###NUMBER### ###NUMBER### numeral unspecified unspecified unspecified unspecified unspecified  	I_DATE	null
3 עבד עבד עבד verb masculine singular unspecified 3 past  	O	null
4 כ כ כעורך preposition unspecified unspecified unspecified unspecified unspecified 0 
4 עורך עורך כעורך noun masculine singular construct unspecified unspecified  	O	null
5 לילה לילה לילה noun masculine singular absolute unspecified unspecified  	O	null
6 ב ב בעיתון preposition unspecified unspecified unspecified unspecified unspecified 0 
6 ה ה בעיתון definiteArticle unspecified unspecified unspecified unspecified unspecified 0 
6 העיתון עיתון בעיתון noun masculine singular absolute unspecified unspecified  	O	null
7 עלהמשמרוכתב עלהמשמרוכתב עלהמשמרוכתב participle feminine singular construct any unspecified  	O	null
8 ב ב בעיתון preposition unspecified unspecified unspecified unspecified unspecified 0 
8 עיתון עיתון בעיתון noun masculine singular absolute unspecified unspecified  	O	null
9 זה זה זה pronoun masculine singular unspecified 3 unspecified  	O	null
10 טור טור טור noun masculine singular absolute unspecified unspecified  	O	null
11 שבועי שבועי שבועי adjective masculine singular absolute unspecified unspecified  	O	null
12 על על על preposition unspecified unspecified unspecified unspecified unspecified  	O	null
13 נושאי נושא נושאי noun masculine plural construct unspecified unspecified  	O	null
14 חברה חבר חברה noun feminine singular absolute unspecified unspecified  	O	null
15 ו ו ותרבות conjunction unspecified unspecified unspecified unspecified unspecified 0 
15 תרבות תרבות ותרבות noun feminine singular absolute unspecified unspecified  	O	null
16 . . . punctuation unspecified unspecified unspecified unspecified unspecified  	O	null

0 אחרי אחרי אחרי preposition unspecified unspecified unspecified unspecified unspecified  	O	null
1 מלחמת מלחמה מלחמת noun feminine singular construct unspecified unspecified  	O	null
2 ששתהימים ששתהימים ששתהימים verb masculine plural unspecified any beinoni  	O	null
3 ) ) ) punctuation unspecified unspecified unspecified unspecified unspecified  	O	null
4 היה הוא היה copula masculine singular unspecified 3 past  	O	null
5 ###NUMBER### ###NUMBER### ###NUMBER### numeral unspecified unspecified unspecified unspecified unspecified  	O	null
6 פעיל פעיל פעיל noun masculine singular absolute unspecified unspecified  	O	null
7 ב ב בוועד preposition unspecified unspecified unspecified unspecified unspecified 0 
7 ה ה בוועד definiteArticle unspecified unspecified unspecified unspecified unspecified 0 
7 הוועד ועד בוועד noun masculine singular absolute unspecified unspecified  	O	null
8 ל ל לשלום preposition unspecified unspecified unspecified unspecified unspecified 0 
8 ה ה לשלום definiteArticle unspecified unspecified unspecified unspecified unspecified 0 
8 השלום שלום לשלום noun masculine singular absolute unspecified unspecified  	O	null
9 ו ו וביטחון conjunction unspecified unspecified unspecified unspecified unspecified 0 
9 ביטחון ביטחון וביטחון noun masculine singular absolute unspecified unspecified  	O	null
10 . . . punctuation unspecified unspecified unspecified unspecified unspecified  	O	null

0 ב ב במלחמת preposition unspecified unspecified unspecified unspecified unspecified 0 
0 מלחמת מלחמה במלחמת noun feminine singular construct unspecified unspecified  	O	null
1 יום יום יום noun masculine singular construct unspecified unspecified  	I_DATE	null
2 הכיפורים כיפור הכיפורים properName unspecified unspecified unspecified unspecified unspecified  	I_DATE	null
3 ( ( ( punctuation unspecified unspecified unspecified unspecified unspecified  	O	null
4 ###NUMBER### ###NUMBER### ###NUMBER### numeral unspecified unspecified unspecified unspecified unspecified  	I_DATE	null
5 ) ) ) punctuation unspecified unspecified unspecified unspecified unspecified  	O	null
6 נפל נפל נפל verb masculine singular unspecified 3 past  	O	null
7 בן בן בן noun masculine singular construct unspecified unspecified  	O	null
8 אחי אח אחיו noun masculine plural absolute unspecified unspecified  
8 ו ו אחיו possessive masculine singular unspecified 3 unspecified 0 	O	null
9 , , , punctuation unspecified unspecified unspecified unspecified unspecified  	O	null
10 ש ש שהיה relativizer/subordinatingConjunction unspecified unspecified unspecified unspecified unspecified 0 
10 היה הוא שהיה copula masculine singular unspecified 3 past  	O	null
11 סופר סופר סופר noun masculine singular absolute unspecified unspecified  	O	null
12 מתחיל התחיל מתחיל verb masculine singular unspecified any beinoni  	O	null
13 ו ו ונקרא conjunction unspecified unspecified unspecified unspecified unspecified 0 
13 נקרא נקרא ונקרא verb masculine singular unspecified 3 past  	O	null
14 על על על preposition unspecified unspecified unspecified unspecified unspecified  	O	null
15 שם שם שם noun masculine singular construct unspecified unspecified  	O	null
16 אבי אב אביו noun masculine singular absolute unspecified unspecified  
16 ו ו אביו possessive masculine singular unspecified 3 unspecified 0 	O	null
17 של של של shel-preposition unspecified unspecified unspecified unspecified unspecified  	O	null
18 אורפז אורפז אורפז properName unspecified unspecified unspecified unspecified unspecified  	I_PERS	null
19 ש ש שנספה relativizer/subordinatingConjunction unspecified unspecified unspecified unspecified unspecified 0 
19 נספה נספה שנספה verb masculine singular unspecified 3 past  	O	null
20 ב ב בשואה preposition unspecified unspecified unspecified unspecified unspecified 0 
20 ה ה בשואה definiteArticle unspecified unspecified unspecified unspecified unspecified 0 
20 השואה שואה בשואה noun feminine singular absolute unspecified unspecified  	O	null
21 . . . punctuation unspecified unspecified unspecified unspecified unspecified  	O	null

0 ה ה האירוע definiteArticle unspecified unspecified unspecified unspecified unspecified 0 
0 האירוע אירוע האירוע noun masculine singular absolute unspecified unspecified  	O	null
1 הטביע הטביע הטביע verb masculine singular unspecified 3 past  	O	null
2 ב ב בו preposition unspecified unspecified unspecified unspecified unspecified  
2 ו ו בו pronomial masculine singular unspecified 3 unspecified 0 	O	null
3 חותם חותם חותם noun masculine singular absolute unspecified unspecified  	O	null
4 עמוק עמוק עמוק adjective masculine singular absolute unspecified unspecified  	O	null
5 ו ו והשפיע conjunction unspecified unspecified unspecified unspecified unspecified 0 
5 השפיע השפיע והשפיע verb masculine singular unspecified 3 past  	O	null
6 על על על preposition unspecified unspecified unspecified unspecified unspecified  	O	null
7 כתיבת כתיבה כתיבתו noun feminine singular absolute unspecified unspecified  
7 ו ו כתיבתו possessive masculine singular unspecified 3 unspecified 0 	O	null
8 . . . punctuation unspecified unspecified unspecified unspecified unspecified  	O	null

0 היה הוא היה copula masculine singular unspecified 3 past  	O	null
1 נשוי נשוי נשוי adjective masculine singular absolute unspecified unspecified  	O	null
2 שלוש CARD3 שלוש numeral feminine singular absolute unspecified unspecified  	O	null
3 פעמים פעם פעמים noun feminine plural absolute unspecified unspecified  	O	null
4 . . . punctuation unspecified unspecified unspecified unspecified unspecified  	O	null

0 מתגורר התגורר מתגורר verb masculine singular unspecified any beinoni  	I_LOC	null
1 ב ב בתל preposition unspecified unspecified unspecified unspecified unspecified 0 
1 תל תל בתל properName unspecified unspecified unspecified unspecified unspecified  	I_LOC	null
2 אביב אביב אביב properName unspecified unspecified unspecified unspecified unspecified  	I_LOC	null
3 . . . punctuation unspecified unspecified unspecified unspecified unspecified  	O	null

0 פירסם פרסם פירסם verb masculine singular unspecified 3 past  	O	null
1 שמונה CARD8 שמונה numeral masculine plural absolute unspecified unspecified  	O	null
2 - - - punctuation unspecified unspecified unspecified unspecified unspecified  	O	null
3 עשר CARD10 עשר numeral feminine singular absolute unspecified unspecified  	O	null
4 ספרים ספר ספרים noun masculine plural absolute unspecified unspecified  	O	null
5 , , , punctuation unspecified unspecified unspecified unspecified unspecified  	O	null
6 ב ב בהם preposition unspecified unspecified unspecified unspecified unspecified  
6 הם הם בהם pronomial masculine plural unspecified 3 unspecified 0 	O	null
7 שישה CARD6 שישה numeral masculine plural absolute unspecified unspecified  	O	null
8 רומנים רומן רומנים noun masculine plural absolute unspecified unspecified  	O	null
9 , , , punctuation unspecified unspecified unspecified unspecified unspecified  	O	null
10 שישה CARD6 שישה numeral masculine plural absolute unspecified unspecified  	O	null
11 קובצי קבץ קובצי participle masculine plural construct any unspecified  	O	null
12 סיפורים סיפור סיפורים noun masculine plural absolute unspecified unspecified  	O	null
13 קצרים קצר קצרים adjective masculine plural absolute unspecified unspecified  	O	null
14 , , , punctuation unspecified unspecified unspecified unspecified unspecified  	O	null
15 שלוש CARD3 שלוש numeral feminine singular absolute unspecified unspecified  	O	null
16 נובלות נובלה נובלות noun feminine plural absolute unspecified unspecified  	O	null
17 , , , punctuation unspecified unspecified unspecified unspecified unspecified  	O	null
18 ספר ספר ספר noun masculine singular absolute unspecified unspecified  	O	null
19 ש ש שירה relativizer/subordinatingConjunction unspecified unspecified unspecified unspecified unspecified 0 
19 ירה ירה שירה verb masculine singular unspecified 3 past  	O	null
20 אחד איחד אחד verb masculine singular unspecified 3 past  	O	null
21 ו ו וספר conjunction unspecified unspecified unspecified unspecified unspecified 0 
21 ספר ספר וספר noun masculine singular construct unspecified unspecified  	O	null
22 מסות מסה מסות noun feminine plural absolute unspecified unspecified  	O	null
23 ו ו והגות conjunction unspecified unspecified unspecified unspecified unspecified 0 
23 הגות הגות והגות noun feminine singular absolute unspecified unspecified  	O	null
24 ( ( ( punctuation unspecified unspecified unspecified unspecified unspecified  	O	null
25 ה ה הצליין definiteArticle unspecified unspecified unspecified unspecified unspecified 0 
25 הצליין צליין הצליין noun masculine singular absolute unspecified unspecified  	O	null
26 ה ה החילוני definiteArticle unspecified unspecified unspecified unspecified unspecified 0 
26 החילוני חילוני החילוני adjective masculine singular absolute unspecified unspecified  	O	null
27 , , , punctuation unspecified unspecified unspecified unspecified unspecified  	O	null
28 ) ) ) punctuation unspecified unspecified unspecified unspecified unspecified  	O	null
29 ###NUMBER### ###NUMBER### ###NUMBER### numeral unspecified unspecified unspecified unspecified unspecified  	I_DATE	null
30 ש ש שהניע relativizer/subordinatingConjunction unspecified unspecified unspecified unspecified unspecified 0 
30 הניע הניע שהניע verb masculine singular unspecified 3 past  	O	null
31 את את את at-preposition unspecified unspecified unspecified unspecified unspecified  	O	null
32 ה ה הכותבים definiteArticle unspecified unspecified unspecified unspecified unspecified 0 
32 הכותבים כותב הכותבים noun masculine plural absolute unspecified unspecified  	O	null
33 על על עליו preposition unspecified unspecified unspecified unspecified unspecified  
33 ו ו עליו pronomial masculine singular unspecified 3 unspecified 0 	O	null
34 להוסיף הוסיף להוסיף verb unspecified unspecified unspecified unspecified infinitive  	O	null
35 לו לו לו conjunction unspecified unspecified unspecified unspecified unspecified  	O	null
36 את את את at-preposition unspecified unspecified unspecified unspecified unspecified  	O	null
37 ה ה התואר definiteArticle unspecified unspecified unspecified unspecified unspecified 0 
37 התואר תואר התואר noun masculine singular absolute unspecified unspecified  	O	null
38 פילוסוף פילוסוף פילוסוף adjective masculine singular absolute unspecified unspecified  	O	null
39 ל ל לצד preposition unspecified unspecified unspecified unspecified unspecified 0 
39 צד צד לצד noun masculine singular construct unspecified unspecified  	O	null
40 ה ה התואר definiteArticle unspecified unspecified unspecified unspecified unspecified 0 
40 התואר תואר התואר noun masculine singular absolute unspecified unspecified  	O	null
41 סופר ספר סופר participle masculine singular absolute any unspecified  	O	null
42 . . . punctuation unspecified unspecified unspecified unspecified unspecified  	O	null

0 ב ב ב preposition unspecified unspecified unspecified unspecified unspecified 0 	I_ORG	null
1 - - - punctuation unspecified unspecified unspecified unspecified unspecified  	I_ORG	null
2 ###NUMBER### ###NUMBER### ###NUMBER### numeral unspecified unspecified unspecified unspecified unspecified  	I_DATE	null
3 ראה ראה ראה verb masculine singular unspecified 3 past  	O	null
4 אור אור אור noun masculine singular construct unspecified unspecified  	O	null
5 ספר ספר ספרו noun masculine singular absolute unspecified unspecified  
5 ו ו ספרו possessive masculine singular unspecified 3 unspecified 0 	O	null
6 נגיעות נגיעה נגיעות noun feminine plural absolute unspecified unspecified  	O	null
7 ב ב בהוצאת preposition unspecified unspecified unspecified unspecified unspecified 0 
7 הוצאת הוצאה בהוצאת noun feminine singular construct unspecified unspecified  	O	null
8 אבן אבן אבן properName unspecified unspecified unspecified unspecified unspecified  	I_PERS	null
9 חושן חושן חושן properName unspecified unspecified unspecified unspecified unspecified  	I_PERS	null
10 . . . punctuation unspecified unspecified unspecified unspecified unspecified  	O	null

0 ה ה הספר definiteArticle unspecified unspecified unspecified unspecified unspecified 0 
0 הספר ספר הספר noun masculine singular absolute unspecified unspecified  	O	null
1 , , , punctuation unspecified unspecified unspecified unspecified unspecified  	O	null
2 ש ש שנדפס relativizer/subordinatingConjunction unspecified unspecified unspecified unspecified unspecified 0 
2 נדפס נדפס שנדפס verb masculine singular unspecified 3 past  	O	null
3 ב ב בארבעים preposition unspecified unspecified unspecified unspecified unspecified 0 
3 ארבעים ORD-CARD40 בארבעים numeral masculine-and-feminine plural construct unspecified unspecified  	O	null
4 עותקים עותק עותקים noun masculine plural absolute unspecified unspecified  	O	null
5 ממוספרים מוספר ממוספרים verb masculine plural unspecified any beinoni  	O	null
6 ש ש שלא relativizer/subordinatingConjunction unspecified unspecified unspecified unspecified unspecified 0 
6 לא לא שלא negation unspecified unspecified unspecified unspecified unspecified  	O	null
7 ל ל למכירה preposition unspecified unspecified unspecified unspecified unspecified 0 
7 ה ה למכירה definiteArticle unspecified unspecified unspecified unspecified unspecified 0 
7 המכירה מכירה למכירה noun feminine singular absolute unspecified unspecified  	O	null
8 , , , punctuation unspecified unspecified unspecified unspecified unspecified  	O	null
9 כולל כולל כולל noun masculine singular construct unspecified unspecified  	O	null
10 שירים שיר שירים noun masculine plural absolute unspecified unspecified  	O	null
11 אפיגרמטיים אפיגרמטיים אפיגרמטיים adjective feminine singular absolute unspecified unspecified  	O	null
12 תמציתיים תמציתי תמציתיים adjective masculine plural absolute unspecified unspecified  	O	null
13 ו ו ומלוטשים conjunction unspecified unspecified unspecified unspecified unspecified 0 
13 מלוטשים מלוטש ומלוטשים adjective masculine plural absolute unspecified unspecified  	O	null
14 להפליא הפליא להפליא verb unspecified unspecified unspecified unspecified infinitive  	O	null
15 . . . punctuation unspecified unspecified unspecified unspecified unspecified  	O	null

0 החל החל החל verb masculine singular unspecified 3 past  	O	null
1 לכתוב כתב לכתוב verb unspecified unspecified unspecified unspecified infinitive  	O	null
2 ב ב בסוף preposition unspecified unspecified unspecified unspecified unspecified 0 
2 סוף סוף בסוף noun masculine singular construct unspecified unspecified  	O	null
3 שנות שנה שנות noun feminine plural construct unspecified unspecified  	I_DATE	null
4 ה ה הארבעים definiteArticle unspecified unspecified unspecified unspecified unspecified 0 
4 הארבעים ORD-CARD40 הארבעים numeral masculine-and-feminine plural absolute unspecified unspecified  	I_DATE	null
5 , , , punctuation unspecified unspecified unspecified unspecified unspecified  	O	null
6 כאשר כאשר כאשר conjunction unspecified unspecified unspecified unspecified unspecified  	O	null
7 ב ב ב preposition unspecified unspecified unspecified unspecified unspecified 0 	I_ORG	null
8 - - - punctuation unspecified unspecified unspecified unspecified unspecified  	I_ORG	null
9 ###NUMBER### ###NUMBER### ###NUMBER### numeral unspecified unspecified unspecified unspecified unspecified  	I_DATE	null
10 השתתף השתתף השתתף verb masculine singular unspecified 3 past  	O	null
11 ב ב בתחרות preposition unspecified unspecified unspecified unspecified unspecified 0 
11 תחרות תחרות בתחרות noun feminine singular construct unspecified unspecified  	O	null
12 סיפורים סיפור סיפורים noun masculine plural absolute unspecified unspecified  	O	null
13 ו ו וזכה conjunction unspecified unspecified unspecified unspecified unspecified 0 
13 זכה זכה וזכה verb masculine singular unspecified 3 past  	O	null
14 ב ב במקום preposition unspecified unspecified unspecified unspecified unspecified 0 
14 ה ה במקום definiteArticle unspecified unspecified unspecified unspecified unspecified 0 
14 המקום מקום במקום noun masculine singular absolute unspecified unspecified  	O	null
15 ה ה הראשון definiteArticle unspecified unspecified unspecified unspecified unspecified 0 
15 הראשון ORD1 הראשון numeral masculine singular absolute unspecified unspecified  	O	null
16 . . . punctuation unspecified unspecified unspecified unspecified unspecified  	O	null

0 ה ה הסיפור definiteArticle unspecified unspecified unspecified unspecified unspecified 0 
0 הסיפור סיפור הסיפור noun masculine singular absolute unspecified unspecified  	O	null
1 פורסם פורסם פורסם verb masculine singular unspecified 3 past  	O	null
2 ב ב בשבועון preposition unspecified unspecified unspecified unspecified unspecified 0 
2 ה ה בשבועון definiteArticle unspecified unspecified unspecified unspecified unspecified 0 
2 השבועון שבועון בשבועון noun masculine singular absolute unspecified unspecified  	O	null
3 ב ב במחנה preposition unspecified unspecified unspecified unspecified unspecified 0 
3 ה ה במחנה definiteArticle unspecified unspecified unspecified unspecified unspecified 0 
3 המחנה מחנה במחנה noun masculine singular absolute unspecified unspecified  	O	null
4 ו ו ואף conjunction unspecified unspecified unspecified unspecified unspecified 0 
4 אף אף ואף conjunction unspecified unspecified unspecified unspecified unspecified  	O	null
5 נקרא נקרא נקרא verb masculine singular unspecified 3 past  	O	null
6 ב ב ברדיו preposition unspecified unspecified unspecified unspecified unspecified 0 
6 ה ה ברדיו definiteArticle unspecified unspecified unspecified unspecified unspecified 0 
6 הרדיו רדיו ברדיו noun masculine singular absolute unspecified unspecified  	O	null
7 . . . punctuation unspecified unspecified unspecified unspecified unspecified  	O	null

0 לקראת לקראת לקראת preposition unspecified unspecified unspecified unspecified unspecified  	O	null
1 קריאת קריאה קריאתו noun feminine singular absolute unspecified unspecified  
1 ו ו קריאתו possessive masculine singular unspecified 3 unspecified 0 	O	null
2 טילפנו טילפן טילפנו verb masculine-and-feminine plural unspecified 3 past  	O	null
3 אל אל אליו preposition unspecified unspecified unspecified unspecified unspecified  
3 ו ו אליו pronomial masculine singular unspecified 3 unspecified 0 	O	null
4 מ מ מ preposition unspecified unspecified unspecified unspecified unspecified 0 	I_ORG	null
5 " " " punctuation unspecified unspecified unspecified unspecified unspecified  	I_ORG	null
6 קול קול קול properName unspecified unspecified unspecified unspecified unspecified  	I_ORG	null
7 ישראל ישראל ישראל properName unspecified unspecified unspecified unspecified unspecified  	I_ORG	null
8 " " " punctuation unspecified unspecified unspecified unspecified unspecified  	O	null
9 וביקשוהו וביקשוהו וביקשוהו verb masculine-and-feminine plural unspecified 3 future  	O	null
10 לעברת עברת לעברת verb unspecified unspecified unspecified unspecified infinitive  	O	null
11 את את את at-preposition unspecified unspecified unspecified unspecified unspecified  	O	null
12 שם שם שמו noun masculine singular absolute unspecified unspecified  
12 ו ו שמו possessive masculine singular unspecified 3 unspecified 0 	O	null
13 ה ה ה numeral unspecified unspecified unspecified unspecified unspecified  	O	null
14 " " " punctuation unspecified unspecified unspecified unspecified unspecified  	O	null
15 גלות גלות גלותי noun feminine singular absolute unspecified unspecified  
15 י י גלותי possessive masculine-and-feminine singular unspecified 1 unspecified 0 	O	null
16 " " " punctuation unspecified unspecified unspecified unspecified unspecified  	O	null
17 ל ל לשם preposition unspecified unspecified unspecified unspecified unspecified 0 
17 שם שם לשם noun masculine singular absolute unspecified unspecified  	O	null
18 עברי עברי עברי adjective masculine singular absolute unspecified unspecified  	O	null
19 , , , punctuation unspecified unspecified unspecified unspecified unspecified  	O	null
20 ו ו ואף conjunction unspecified unspecified unspecified unspecified unspecified 0 
20 אף אף ואף conjunction unspecified unspecified unspecified unspecified unspecified  	O	null
21 הפנו הפנה הפנו verb masculine-and-feminine plural unspecified 3 past  	O	null
22 את את אותו at-preposition unspecified unspecified unspecified unspecified unspecified  
22 ו ו אותו pronomial masculine singular unspecified 3 unspecified 0 	O	null
23 לשם לשם לשם preposition unspecified unspecified unspecified unspecified unspecified  	O	null
24 כך כך כך pronoun unspecified unspecified unspecified unspecified unspecified  	O	null
25 אל אל אל preposition unspecified unspecified unspecified unspecified unspecified  	O	null
26 משרדי משרד משרדי noun masculine plural construct unspecified unspecified  	O	null
27 " " " punctuation unspecified unspecified unspecified unspecified unspecified  	O	null
28 ה ה הקרן definiteArticle unspecified unspecified unspecified unspecified unspecified 0 
28 הקרן קרן הקרן noun feminine singular absolute unspecified unspecified  	O	null
29 ה ה הקיימת definiteArticle unspecified unspecified unspecified unspecified unspecified 0 
29 הקיימת קיים הקיימת adjective feminine singular absolute unspecified unspecified  	O	null
30 " " " punctuation unspecified unspecified unspecified unspecified unspecified  	O	null
31 . . . punctuation unspecified unspecified unspecified unspecified unspecified  	O	null

0 ה ה הפקיד definiteArticle unspecified unspecified unspecified unspecified unspecified 0 
0 הפקיד פקיד הפקיד noun masculine singular absolute unspecified unspecified  	O	null
1 הציע הציע הציע verb masculine singular unspecified 3 past  	O	null
2 לו לו לו conjunction unspecified unspecified unspecified unspecified unspecified  	O	null
3 את את את at-preposition unspecified unspecified unspecified unspecified unspecified  	O	null
4 ה ה השם definiteArticle unspecified unspecified unspecified unspecified unspecified 0 
4 השם שם השם noun masculine singular absolute unspecified unspecified  	O	null
5 אורפז אורפז אורפז properName unspecified unspecified unspecified unspecified unspecified  	I_PERS	null
6 , , , punctuation unspecified unspecified unspecified unspecified unspecified  	O	null
7 ו ו והוא conjunction unspecified unspecified unspecified unspecified unspecified 0 
7 הוא הוא והוא pronoun masculine singular unspecified 3 unspecified  	O	null
8 קיבל קיבל קיבל verb masculine singular unspecified 3 past  	O	null
9 את את את at-preposition unspecified unspecified unspecified unspecified unspecified  	O	null
10 ה ה ההצעה definiteArticle unspecified unspecified unspecified unspecified unspecified 0 
10 ההצעה הצעה ההצעה noun feminine singular absolute unspecified unspecified  	O	null
11 מיד מייד מיד adverb unspecified unspecified unspecified unspecified unspecified  	I_LOC	null
12 . . . punctuation unspecified unspecified unspecified unspecified unspecified  	O	null

0 אולם אולם אולם conjunction unspecified unspecified unspecified unspecified unspecified  	O	null
1 בדיעבד בדיעבד בדיעבד adverb unspecified unspecified unspecified unspecified unspecified  	O	null
2 הוא הוא הוא pronoun masculine singular unspecified 3 unspecified  	O	null
3 החשיב החשיב החשיב verb masculine singular unspecified 3 past  	O	null
4 כ כ כפרסומו preposition unspecified unspecified unspecified unspecified unspecified 0 
4 פרסום פרסום כפרסומו noun masculine singular absolute unspecified unspecified  
4 ו ו כפרסומו possessive masculine singular unspecified 3 unspecified 0 	O	null
5 ה ה הראשון definiteArticle unspecified unspecified unspecified unspecified unspecified 0 
5 הראשון ORD1 הראשון numeral masculine singular absolute unspecified unspecified  	O	null
6 סיפור סיפור סיפור noun masculine singular absolute unspecified unspecified  	O	null
7 אחר אחר אחר adjective masculine singular absolute unspecified unspecified  	O	null
8 , , , punctuation unspecified unspecified unspecified unspecified unspecified  	O	null
9 " " " punctuation unspecified unspecified unspecified unspecified unspecified  	O	null
10 וריאציות וריאציה וריאציות noun feminine plural absolute unspecified unspecified  	O	null
11 על על על preposition unspecified unspecified unspecified unspecified unspecified  	O	null
12 נושא נושא נושא noun masculine singular absolute unspecified unspecified  	O	null
13 אחד CARD1 אחד numeral masculine singular absolute unspecified unspecified  	O	null
14 " " " punctuation unspecified unspecified unspecified unspecified unspecified  	O	null
15 , , , punctuation unspecified unspecified unspecified unspecified unspecified  	O	null
16 ש ש שהתפרסם relativizer/subordinatingConjunction unspecified unspecified unspecified unspecified unspecified 0 
16 התפרסם התפרסם שהתפרסם verb masculine singular unspecified 3 past  	O	null
17 כעבור כעבור כעבור preposition unspecified unspecified unspecified unspecified unspecified  	O	null
18 ארבע CARD4 ארבע numeral feminine singular absolute unspecified unspecified  	O	null
19 שנים שנה שנים noun feminine plural absolute unspecified unspecified  	O	null
20 ( ( ( punctuation unspecified unspecified unspecified unspecified unspecified  	O	null
21 ###NUMBER### ###NUMBER### ###NUMBER### numeral unspecified unspecified unspecified unspecified unspecified  	I_DATE	null
22 ) ) ) punctuation unspecified unspecified unspecified unspecified unspecified  	O	null
23 ו ו ונכלל conjunction unspecified unspecified unspecified unspecified unspecified 0 
23 נכלל נכלל ונכלל verb masculine singular unspecified 3 past  	O	null
24 ב ב בקובץ preposition unspecified unspecified unspecified unspecified unspecified 0 
24 קובץ קובץ בקובץ noun masculine singular construct unspecified unspecified  	O	null
25 סיפורי סיפור סיפוריו noun masculine plural absolute unspecified unspecified  
25 ו ו סיפוריו possessive masculine singular unspecified 3 unspecified 0 	O	null
26 ה ה הראשון definiteArticle unspecified unspecified unspecified unspecified unspecified 0 
26 הראשון ORD1 הראשון numeral masculine singular absolute unspecified unspecified  	O	null
27 , , , punctuation unspecified unspecified unspecified unspecified unspecified  	O	null
28 עשב עשב עשב noun masculine singular construct unspecified unspecified  	O	null
29 פרא פרא פרא noun masculine singular absolute unspecified unspecified  	O	null
30 ( ( ( punctuation unspecified unspecified unspecified unspecified unspecified  	O	null
31 ה ה הקיבוץ definiteArticle unspecified unspecified unspecified unspecified unspecified 0 
31 הקיבוץ קיבוץ הקיבוץ noun masculine singular absolute unspecified unspecified  	O	null
32 ה ה המאוחד definiteArticle unspecified unspecified unspecified unspecified unspecified 0 
32 המאוחד מאוחד המאוחד adjective masculine singular absolute unspecified unspecified  	O	null
33 , , , punctuation unspecified unspecified unspecified unspecified unspecified  	O	null
34 ###NUMBER### ###NUMBER### ###NUMBER### numeral unspecified unspecified unspecified unspecified unspecified  	I_DATE	null
35 ) ) ) punctuation unspecified unspecified unspecified unspecified unspecified  	O	null
36 . . . punctuation unspecified unspecified unspecified unspecified unspecified  	O	null

0 ב ב ב preposition unspecified unspecified unspecified unspecified unspecified 0 	O	null
1 - - - punctuation unspecified unspecified unspecified unspecified unspecified  	O	null
2 ###NUMBER### ###NUMBER### ###NUMBER### numeral unspecified unspecified unspecified unspecified unspecified  	I_DATE	null
3 חזר חזר חזר verb masculine singular unspecified 3 past  	O	null
4 להשתמש השתמש להשתמש verb unspecified unspecified unspecified unspecified infinitive  	O	null
5 ב ב בשם preposition unspecified unspecified unspecified unspecified unspecified 0 
5 שם שם בשם noun masculine singular construct unspecified unspecified  	O	null
6 אבותי אב אבותיו noun masculine plural absolute unspecified unspecified  
6 ו ו אבותיו possessive masculine singular unspecified 3 unspecified 0 	O	null
7 , , , punctuation unspecified unspecified unspecified unspecified unspecified  	O	null
8 אוורבוך אוורבוך אוורבוך properName unspecified unspecified unspecified unspecified unspecified  	I_PERS	null
9 , , , punctuation unspecified unspecified unspecified unspecified unspecified  	O	null
10 ו ו וצירף conjunction unspecified unspecified unspecified unspecified unspecified 0 
10 צירף צירף וצירף verb masculine singular unspecified 3 past  	O	null
11 את את אותו at-preposition unspecified unspecified unspecified unspecified unspecified  
11 ו ו אותו pronomial masculine singular unspecified 3 unspecified 0 	O	null
12 ל ל לשמו preposition unspecified unspecified unspecified unspecified unspecified 0 
12 שם שם לשמו noun masculine singular absolute unspecified unspecified  
12 ו ו לשמו possessive masculine singular unspecified 3 unspecified 0 	O	null
13 ה ה הישראלי definiteArticle unspecified unspecified unspecified unspecified unspecified 0 
13 הישראלי ישראלי הישראלי adjective masculine singular absolute unspecified unspecified  	O	null
14 אורפז אורפז אורפז properName unspecified unspecified unspecified unspecified unspecified  	I_PERS	null
15 . . . punctuation unspecified unspecified unspecified unspecified unspecified  	O	null

0 ה ה המתח definiteArticle unspecified unspecified unspecified unspecified unspecified 0 
0 המתח מתח המתח noun masculine singular absolute unspecified unspecified  	O	null
1 ה ה הקיומי definiteArticle unspecified unspecified unspecified unspecified unspecified 0 
1 הקיומי קיומי הקיומי adjective masculine singular absolute unspecified unspecified  	O	null
2 ש ש שבין relativizer/subordinatingConjunction unspecified unspecified unspecified unspecified unspecified 0 
2 בין בין שבין preposition unspecified unspecified unspecified unspecified unspecified  	O	null
3 ה ה ההוויה definiteArticle unspecified unspecified unspecified unspecified unspecified 0 
3 ההוויה הוויה ההוויה noun feminine singular absolute unspecified unspecified  	O	null
4 ה ה הישראלית definiteArticle unspecified unspecified unspecified unspecified unspecified 0 
4 הישראלית ישראלי הישראלית adjective feminine singular absolute unspecified unspecified  	O	null
5 ל ל להוויה preposition unspecified unspecified unspecified unspecified unspecified 0 
5 ה ה להוויה definiteArticle unspecified unspecified unspecified unspecified unspecified 0 
5 ההוויה הוויה להוויה noun feminine singular absolute unspecified unspecified  	O	null
6 ה ה היהודית definiteArticle unspecified unspecified unspecified unspecified unspecified 0 
6 היהודית יהודי היהודית adjective feminine singular absolute unspecified unspecified  	O	null
7 ניכר ניכר ניכר adjective masculine singular absolute unspecified unspecified  	O	null
8 מאז מאז מאז adverb unspecified unspecified unspecified unspecified unspecified  	O	null
9 ב ב בכתיבתו preposition unspecified unspecified unspecified unspecified unspecified 0 
9 כתיבת כתיבה בכתיבתו noun feminine singular absolute unspecified unspecified  
9 ו ו בכתיבתו possessive masculine singular unspecified 3 unspecified 0 	O	null
10 . . . punctuation unspecified unspecified unspecified unspecified unspecified  	O	null

0 עד עד עד noun masculine singular absolute unspecified unspecified  	O	null
1 ל ל לרומן preposition unspecified unspecified unspecified unspecified unspecified 0 
1 רומן רומן לרומן noun masculine singular construct unspecified unspecified  	O	null
2 בית בית בית noun masculine singular absolute unspecified unspecified  	O	null
3 ל ל לאדם preposition unspecified unspecified unspecified unspecified unspecified 0 
3 אדם אדם לאדם noun masculine singular absolute unspecified unspecified  	O	null
4 אחד CARD1 אחד numeral masculine singular absolute unspecified unspecified  	O	null
5 ( ( ( punctuation unspecified unspecified unspecified unspecified unspecified  	O	null
6 ###NUMBER### ###NUMBER### ###NUMBER### numeral unspecified unspecified unspecified unspecified unspecified  	I_DATE	null
7 ) ) ) punctuation unspecified unspecified unspecified unspecified unspecified  	O	null
8 מעוגנת עוגן מעוגנת verb feminine singular unspecified any beinoni  	O	null
9 יצירת יצירה יצירתו noun feminine singular absolute unspecified unspecified  
9 ו ו יצירתו possessive masculine singular unspecified 3 unspecified 0 	O	null
10 ב ב במרחבים preposition unspecified unspecified unspecified unspecified unspecified 0 
10 מרחבים מרחב במרחבים noun masculine plural absolute unspecified unspecified  	O	null
11 ה ה הארץ definiteArticle unspecified unspecified unspecified unspecified unspecified 0 
11 הארץ ארץ הארץ noun feminine singular absolute unspecified unspecified  	O	null
12 - - - punctuation unspecified unspecified unspecified unspecified unspecified  	O	null
13 ישראליים ישראלי ישראליים adjective masculine plural absolute unspecified unspecified  	O	null
14 ה ה המנותקים definiteArticle unspecified unspecified unspecified unspecified unspecified 0 
14 המנותקים נותק המנותקים participle masculine plural absolute any unspecified  	O	null
15 מ מ מעולם preposition unspecified unspecified unspecified unspecified unspecified 0 
15 עולם עולם מעולם noun masculine singular construct unspecified unspecified  	O	null
16 ילדות ילדות ילדותו noun feminine singular absolute unspecified unspecified  
16 ו ו ילדותו possessive masculine singular unspecified 3 unspecified 0 	O	null
17 ה ה האירופי definiteArticle unspecified unspecified unspecified unspecified unspecified 0 
17 האירופי אירופי האירופי adjective masculine singular absolute unspecified unspecified  	O	null
18 ו ו ומן conjunction unspecified unspecified unspecified unspecified unspecified 0 
18 מן מן ומן preposition unspecified unspecified unspecified unspecified unspecified  	O	null
19 ה ה ההקשר definiteArticle unspecified unspecified unspecified unspecified unspecified 0 
19 ההקשר הקשר ההקשר noun masculine singular absolute unspecified unspecified  	O	null
20 ה ה ההיסטורי definiteArticle unspecified unspecified unspecified unspecified unspecified 0 
20 ההיסטורי היסטורי ההיסטורי adjective masculine singular absolute unspecified unspecified  	O	null
21 ה ה היהודי definiteArticle unspecified unspecified unspecified unspecified unspecified 0 
21 היהודי יהודי היהודי adjective masculine singular absolute unspecified unspecified  	O	null
22 . . . punctuation unspecified unspecified unspecified unspecified unspecified  	O	null

0 עם עם עם preposition unspecified unspecified unspecified unspecified unspecified  	O	null
1 פרסום פרסום פרסום noun masculine singular construct unspecified unspecified  	O	null
2 רחוב רחוב רחוב noun masculine singular absolute unspecified unspecified  	O	null
3 הטומוז'נה הטומוז'נה הטומוז'נה verb masculine-and-feminine plural unspecified 2 imperative  	O	null
4 ( ( ( punctuation unspecified unspecified unspecified unspecified unspecified  	O	null
5 ###NUMBER### ###NUMBER### ###NUMBER### numeral unspecified unspecified unspecified unspecified unspecified  	I_DATE	null
6 ) ) ) punctuation unspecified unspecified unspecified unspecified unspecified  	O	null
7 חזר חזר חזר verb masculine singular unspecified 3 past  	O	null
8 אל אל אל preposition unspecified unspecified unspecified unspecified unspecified  	O	null
9 מחוזות מחוז מחוזות noun masculine plural construct unspecified unspecified  	O	null
10 ילדות ילדות ילדותו noun feminine singular absolute unspecified unspecified  
10 ו ו ילדותו possessive masculine singular unspecified 3 unspecified 0 	O	null
11 , , , punctuation unspecified unspecified unspecified unspecified unspecified  	O	null
12 אל אל אל preposition unspecified unspecified unspecified unspecified unspecified  	O	null
13 מורשת מורשה מורשת noun feminine singular construct unspecified unspecified  	O	null
14 אבותי אב אבותיו noun masculine plural absolute unspecified unspecified  
14 ו ו אבותיו possessive masculine singular unspecified 3 unspecified 0 	O	null
15 ו ו ואל conjunction unspecified unspecified unspecified unspecified unspecified 0 
15 אל אל ואל preposition unspecified unspecified unspecified unspecified unspecified  	O	null
16 תרבות תרבות תרבותם noun feminine singular absolute unspecified unspecified  
16 ם ם תרבותם possessive masculine plural unspecified 3 unspecified 0 	O	null
17 ה ה היידית definiteArticle unspecified unspecified unspecified unspecified unspecified 0 
17 היידית יידי היידית adjective feminine singular absolute unspecified unspecified  	O	null
18 . . . punctuation unspecified unspecified unspecified unspecified unspecified  	O	null

0 עם עם עם preposition unspecified unspecified unspecified unspecified unspecified  	O	null
1 זאת זאת זאת pronoun feminine singular unspecified 3 unspecified  	O	null
2 , , , punctuation unspecified unspecified unspecified unspecified unspecified  	O	null
3 כתיבת כתיבה כתיבתו noun feminine singular absolute unspecified unspecified  
3 ו ו כתיבתו possessive masculine singular unspecified 3 unspecified 0 	O	null
4 מתפתחת התפתח מתפתחת verb feminine singular unspecified any beinoni  	O	null
5 ו ו ומשתנה conjunction unspecified unspecified unspecified unspecified unspecified 0 
5 משתנה משתנה ומשתנה adjective feminine singular absolute unspecified unspecified  	O	null
6 מ מ מעשור preposition unspecified unspecified unspecified unspecified unspecified 0 
6 עשור עשור מעשור noun masculine singular absolute unspecified unspecified  	O	null
7 ל ל לעשור preposition unspecified unspecified unspecified unspecified unspecified 0 
7 ה ה לעשור definiteArticle unspecified unspecified unspecified unspecified unspecified 0 
7 העשור עשור לעשור noun masculine singular absolute unspecified unspecified  	O	null
8 . . . punctuation unspecified unspecified unspecified unspecified unspecified  	O	null

0 עשב עשב עשב noun masculine singular construct unspecified unspecified  	O	null
1 פרא פרא פרא noun masculine singular absolute unspecified unspecified  	O	null
2 ו ו והרומן conjunction unspecified unspecified unspecified unspecified unspecified 0 
2 ה ה והרומן definiteArticle unspecified unspecified unspecified unspecified unspecified 0 
2 הרומן רומן והרומן noun masculine singular absolute unspecified unspecified  	O	null
3 עור עור עור noun masculine singular absolute unspecified unspecified  	O	null
4 בעד בעד בעד preposition unspecified unspecified unspecified unspecified unspecified  	O	null
5 עור עור עור noun masculine singular absolute unspecified unspecified  	O	null
6 ( ( ( punctuation unspecified unspecified unspecified unspecified unspecified  	O	null
7 ###NUMBER### ###NUMBER### ###NUMBER### numeral unspecified unspecified unspecified unspecified unspecified  	I_DATE	null
8 ) ) ) punctuation unspecified unspecified unspecified unspecified unspecified  	O	null
9 פותחים פתח פותחים verb masculine plural unspecified any beinoni  	O	null
10 את את את at-preposition unspecified unspecified unspecified unspecified unspecified  	O	null
11 ה ה הפרק definiteArticle unspecified unspecified unspecified unspecified unspecified 0 
11 הפרק פארק הפרק noun masculine singular absolute unspecified unspecified  	O	null
12 ה ה הראשון definiteArticle unspecified unspecified unspecified unspecified unspecified 0 
12 הראשון ORD1 הראשון numeral masculine singular absolute unspecified unspecified  	O	null
13 ב ב בכתיבתו preposition unspecified unspecified unspecified unspecified unspecified 0 
13 כתיבת כתיבה בכתיבתו noun feminine singular absolute unspecified unspecified  
13 ו ו בכתיבתו possessive masculine singular unspecified 3 unspecified 0 	O	null
14 , , , punctuation unspecified unspecified unspecified unspecified unspecified  	O	null
15 שבו ישב שבו verb masculine-and-feminine plural unspecified 2 imperative  	O	null
16 הושפע הושפע הושפע verb masculine singular unspecified 3 past  	O	null
17 מ מ מעלייתו preposition unspecified unspecified unspecified unspecified unspecified 0 
17 עליית עלייה מעלייתו noun feminine singular absolute unspecified unspecified  
17 ו ו מעלייתו possessive masculine singular unspecified 3 unspecified 0 	O	null
18 ארצה ארצה ארצה adverb unspecified unspecified unspecified unspecified unspecified  	O	null
19 ו ו ומפגישתו conjunction unspecified unspecified unspecified unspecified unspecified 0 
19 מ מ ומפגישתו preposition unspecified unspecified unspecified unspecified unspecified 0 
19 פגישת פגישה ומפגישתו noun feminine singular absolute unspecified unspecified  
19 ו ו ומפגישתו possessive masculine singular unspecified 3 unspecified 0 	O	null
20 עם עם עם preposition unspecified unspecified unspecified unspecified unspecified  	O	null
21 ה ה המציאות definiteArticle unspecified unspecified unspecified unspecified unspecified 0 
21 המציאות מציאות המציאות noun feminine singular absolute unspecified unspecified  	O	null
22 ה ה הארץ definiteArticle unspecified unspecified unspecified unspecified unspecified 0 
22 הארץ ארץ הארץ noun feminine singular absolute unspecified unspecified  	O	null
23 - - - punctuation unspecified unspecified unspecified unspecified unspecified  	O	null
24 ישראלית ישראלי ישראלית adjective feminine singular absolute unspecified unspecified  	O	null
25 ה ה האידיאליסטית definiteArticle unspecified unspecified unspecified unspecified unspecified 0 
25 האידיאליסטית אידיאליסטי האידיאליסטית adjective feminine singular absolute unspecified unspecified  	O	null
26 . . . punctuation unspecified unspecified unspecified unspecified unspecified  	O	null

0 סיפורי סיפור סיפורי noun masculine plural construct unspecified unspecified  	O	null
1 עשב עשב עשב noun masculine singular absolute unspecified unspecified  	O	null
2 פרא פרא פרא noun masculine singular absolute unspecified unspecified  	O	null
3 כתובים כתוב כתובים adjective masculine plural absolute unspecified unspecified  	O	null
4 ב ב בז'אנר preposition unspecified unspecified unspecified unspecified unspecified 0 
4 ה ה בז'אנר definiteArticle unspecified unspecified unspecified unspecified unspecified 0 
4 הז'אנר ז'אנר בז'אנר noun masculine singular absolute unspecified unspecified  	O	null
5 ה ה הריאליסטי definiteArticle unspecified unspecified unspecified unspecified unspecified 0 
5 הריאליסטי ריאליסטי הריאליסטי adjective masculine singular absolute unspecified unspecified  	O	null
6 ה ה המאפיין definiteArticle unspecified unspecified unspecified unspecified unspecified 0 
6 המאפיין אפיין המאפיין participle masculine singular absolute any unspecified  	O	null
7 את את את at-preposition unspecified unspecified unspecified unspecified unspecified  	O	null
8 כתיבת כתיבה כתיבתם noun feminine singular absolute unspecified unspecified  
8 ם ם כתיבתם possessive masculine plural unspecified 3 unspecified 0 	O	null
9 של של של shel-preposition unspecified unspecified unspecified unspecified unspecified  	O	null
10 רוב רוב רוב noun masculine singular construct unspecified unspecified  	O	null
11 סופרי סופר סופרי noun masculine plural construct unspecified unspecified  	O	null
12 דור דור דור properName unspecified unspecified unspecified unspecified unspecified  	I_PERS	null
13 תש"ח תש"ח תש"ח properName unspecified unspecified unspecified unspecified unspecified  	I_PERS	null
14 , , , punctuation unspecified unspecified unspecified unspecified unspecified  	O	null
15 אך אך אך conjunction unspecified unspecified unspecified unspecified unspecified  	O	null
16 עם עם עם preposition unspecified unspecified unspecified unspecified unspecified  	O	null
17 נטייה נטייה נטייה noun feminine singular absolute unspecified unspecified  	O	null
18 ל ל לסגנון preposition unspecified unspecified unspecified unspecified unspecified 0 
18 סגנון סגנון לסגנון noun masculine singular absolute unspecified unspecified  	O	null
19 פיוטי פיוטי פיוטי adjective masculine singular absolute unspecified unspecified  	O	null
20 . . . punctuation unspecified unspecified unspecified unspecified unspecified  	O	null

0 ה ה האמונה definiteArticle unspecified unspecified unspecified unspecified unspecified 0 
0 האמונה אמונה האמונה noun feminine singular absolute unspecified unspecified  	O	null
1 ב ב בערכי preposition unspecified unspecified unspecified unspecified unspecified 0 
1 ערכי ערך בערכי noun masculine plural construct unspecified unspecified  	O	null
2 ה ה החלוציות definiteArticle unspecified unspecified unspecified unspecified unspecified 0 
2 החלוציות חלוציות החלוציות noun feminine singular absolute unspecified unspecified  	O	null
3 ה ה הסוציאליסטית definiteArticle unspecified unspecified unspecified unspecified unspecified 0 
3 הסוציאליסטית סוציאליסטי הסוציאליסטית adjective feminine singular absolute unspecified unspecified  	O	null
4 ו ו ותחושת conjunction unspecified unspecified unspecified unspecified unspecified 0 
4 תחושת תחושה ותחושת noun feminine singular construct unspecified unspecified  	O	null
5 ה ה הגאולה definiteArticle unspecified unspecified unspecified unspecified unspecified 0 
5 הגאולה גאולה הגאולה noun feminine singular absolute unspecified unspecified  	O	null
6 ה ה הציונית definiteArticle unspecified unspecified unspecified unspecified unspecified 0 
6 הציונית ציוני הציונית adjective feminine singular absolute unspecified unspecified  	O	null
7 , , , punctuation unspecified unspecified unspecified unspecified unspecified  	O	null
8 ה ה המלווה definiteArticle unspecified unspecified unspecified unspecified unspecified 0 
8 המלווה הלווה המלווה participle feminine singular absolute any unspecified  	O	null
9 ב ב בהדחקת preposition unspecified unspecified unspecified unspecified unspecified 0 
9 הדחקת הדחקה בהדחקת noun feminine singular construct unspecified unspecified  	O	null
10 ה ה העבר definiteArticle unspecified unspecified unspecified unspecified unspecified 0 
10 העבר עבר העבר noun masculine singular absolute unspecified unspecified  	O	null
11 ה ה הגלותי definiteArticle unspecified unspecified unspecified unspecified unspecified 0 
11 הגלותי הגלותי הגלותי adjective masculine singular absolute unspecified unspecified  	O	null
12 , , , punctuation unspecified unspecified unspecified unspecified unspecified  	O	null
13 מאפיינות אפיין מאפיינות verb feminine plural unspecified any beinoni  	O	null
14 את את את at-preposition unspecified unspecified unspecified unspecified unspecified  	O	null
15 עולם עולם עולמם noun masculine singular absolute unspecified unspecified  
15 ם ם עולמם possessive masculine plural unspecified 3 unspecified 0 	O	null
16 של של של shel-preposition unspecified unspecified unspecified unspecified unspecified  	O	null
17 גיבורי גיבור גיבורי noun masculine plural construct unspecified unspecified  	O	null
18 ה ה הסיפורים definiteArticle unspecified unspecified unspecified unspecified unspecified 0 
18 הסיפורים סיפור הסיפורים noun masculine plural absolute unspecified unspecified  	O	null
19 . . . punctuation unspecified unspecified unspecified unspecified unspecified  	O	null

0 התקבלות התקבלות התקבלותו noun feminine singular absolute unspecified unspecified  
0 ו ו התקבלותו possessive masculine singular unspecified 3 unspecified 0 	O	null
1 של של של shel-preposition unspecified unspecified unspecified unspecified unspecified  	O	null
2 ה ה הסופר definiteArticle unspecified unspecified unspecified unspecified unspecified 0 
2 הסופר סופר הסופר noun masculine singular absolute unspecified unspecified  	O	null
3 ה ה הצעיר definiteArticle unspecified unspecified unspecified unspecified unspecified 0 
3 הצעיר צעיר הצעיר adjective masculine singular absolute unspecified unspecified  	O	null
4 היתה הוא היתה copula feminine singular unspecified 3 past  	O	null
5 מבטיחה הבטיח מבטיחה verb feminine singular unspecified any beinoni  	O	null
6 . . . punctuation unspecified unspecified unspecified unspecified unspecified  	O	null

0 רוב רוב רוב noun masculine singular construct unspecified unspecified  	O	null
1 ה ה הביקורות definiteArticle unspecified unspecified unspecified unspecified unspecified 0 
1 הביקורות ביקורת הביקורות noun feminine plural absolute unspecified unspecified  	O	null
2 על על על preposition unspecified unspecified unspecified unspecified unspecified  	O	null
3 עשב עשב עשב noun masculine singular construct unspecified unspecified  	O	null
4 פרא פרא פרא noun masculine singular absolute unspecified unspecified  	O	null
5 היו הוא היו copula masculine plural unspecified 2 imperative  	O	null
6 אוהדות אוהד אוהדות adjective feminine plural absolute unspecified unspecified  	O	null
7 ו ו ושיבחו conjunction unspecified unspecified unspecified unspecified unspecified 0 
7 שיבחו שיבח ושיבחו verb masculine-and-feminine plural unspecified 3 past  	O	null
8 את את את at-preposition unspecified unspecified unspecified unspecified unspecified  	O	null
9 סגנון סגנון סגנונו noun masculine singular absolute unspecified unspecified  
9 ו ו סגנונו possessive masculine singular unspecified 3 unspecified 0 	O	null
10 ה ה הפיוטי definiteArticle unspecified unspecified unspecified unspecified unspecified 0 
10 הפיוטי פיוטי הפיוטי adjective masculine singular absolute unspecified unspecified  	O	null
11 . . . punctuation unspecified unspecified unspecified unspecified unspecified  	O	null

0 עור עור עור noun masculine singular absolute unspecified unspecified  	O	null
1 בעד בעד בעד preposition unspecified unspecified unspecified unspecified unspecified  	O	null
2 עור עור עור noun masculine singular absolute unspecified unspecified  	O	null
3 , , , punctuation unspecified unspecified unspecified unspecified unspecified  	O	null
4 רומן רומן רומן noun masculine singular construct unspecified unspecified  	O	null
5 ה ה הבכורה definiteArticle unspecified unspecified unspecified unspecified unspecified 0 
5 הבכורה בכור הבכורה noun feminine singular absolute unspecified unspecified  	O	null
6 של של שלו shel-preposition unspecified unspecified unspecified unspecified unspecified  
6 ו ו שלו pronomial masculine singular unspecified 3 unspecified 0 	O	null
7 , , , punctuation unspecified unspecified unspecified unspecified unspecified  	O	null
8 כתוב כתוב כתוב adjective masculine singular absolute unspecified unspecified  	O	null
9 ב ב בנוסח preposition unspecified unspecified unspecified unspecified unspecified 0 
9 נוסח נוסח בנוסח noun masculine singular construct unspecified unspecified  	O	null
10 זרם זרם זרם noun masculine singular construct unspecified unspecified  	O	null
11 ה ה התודעה definiteArticle unspecified unspecified unspecified unspecified unspecified 0 
11 התודעה תודעה התודעה noun feminine singular absolute unspecified unspecified  	O	null
12 ה ה המושפע definiteArticle unspecified unspecified unspecified unspecified unspecified 0 
12 המושפע הושפע המושפע participle masculine singular absolute any unspecified  	O	null
13 מס' מספר מס' noun masculine singular absolute unspecified unspecified  	O	null
14 יזהר יזהר יזהר properName unspecified unspecified unspecified unspecified unspecified  	I_PERS	null
15 ו ו ומוקדש conjunction unspecified unspecified unspecified unspecified unspecified 0 
15 מוקדש הוקדש ומוקדש verb masculine singular unspecified any beinoni  	O	null
16 ל ל לפיתוח preposition unspecified unspecified unspecified unspecified unspecified 0 
16 פיתוח פיתוח לפיתוח noun masculine singular construct unspecified unspecified  	O	null
17 מוטיב מוטיב מוטיב noun masculine singular construct unspecified unspecified  	O	null
18 ה ה הזר definiteArticle unspecified unspecified unspecified unspecified unspecified 0 
18 הזר זר הזר noun masculine singular absolute unspecified unspecified  	O	null
19 ו ו ותחושת conjunction unspecified unspecified unspecified unspecified unspecified 0 
19 תחושת תחושה ותחושת noun feminine singular construct unspecified unspecified  	O	null
20 ה ה האבסורד definiteArticle unspecified unspecified unspecified unspecified unspecified 0 
20 האבסורד אבסורד האבסורד noun masculine singular absolute unspecified unspecified  	O	null
21 ב ב בהשפעת preposition unspecified unspecified unspecified unspecified unspecified 0 
21 השפעת השפעה בהשפעת noun feminine singular construct unspecified unspecified  	O	null
22 אלבר אלבר אלבר properName unspecified unspecified unspecified unspecified unspecified  	I_PERS	null
23 קאמי קאמי קאמי properName unspecified unspecified unspecified unspecified unspecified  	I_PERS	null
24 . . . punctuation unspecified unspecified unspecified unspecified unspecified  	O	null

0 ל ל לספר preposition unspecified unspecified unspecified unspecified unspecified 0 
0 ספר ספר לספר noun masculine singular absolute unspecified unspecified  	O	null
1 זה זה זה pronoun masculine singular unspecified 3 unspecified  	O	null
2 ה ה הביקורת definiteArticle unspecified unspecified unspecified unspecified unspecified 0 
2 הביקורת ביקורת הביקורת noun feminine singular absolute unspecified unspecified  	O	null
3 כבר כבר כבר adverb unspecified unspecified unspecified unspecified unspecified  	O	null
4 לא לא לא negation unspecified unspecified unspecified unspecified unspecified  	O	null
5 האירה האיר האירה verb feminine singular unspecified 3 past  	O	null
6 פנים פנים פנים noun masculine singular absolute unspecified unspecified  	O	null
7 . . . punctuation unspecified unspecified unspecified unspecified unspecified  	O	null

0 כ כ כתיבתו preposition unspecified unspecified unspecified unspecified unspecified 0 
0 תיבת תיבה כתיבתו noun feminine singular absolute unspecified unspecified  
0 ו ו כתיבתו possessive masculine singular unspecified 3 unspecified 0 	O	null
1 כ כ כבר preposition unspecified unspecified unspecified unspecified unspecified 0 
1 בר בר כבר properName unspecified unspecified unspecified unspecified unspecified  	I_PERS	null
2 מבשרת בישר מבשרת participle feminine singular construct any unspecified  	O	null
3 את את את at-preposition unspecified unspecified unspecified unspecified unspecified  	O	null
4 ה ה השלב definiteArticle unspecified unspecified unspecified unspecified unspecified 0 
4 השלב שלב השלב noun masculine singular absolute unspecified unspecified  	O	null
5 ה ה הבא definiteArticle unspecified unspecified unspecified unspecified unspecified 0 
5 הבא בא הבא participle masculine singular absolute any unspecified  	O	null
6 , , , punctuation unspecified unspecified unspecified unspecified unspecified  	O	null
7 ה ה האקזיסטנציאליסטי definiteArticle unspecified unspecified unspecified unspecified unspecified 0 
7 האקזיסטנציאליסטי אקזיסטנציאליסטי האקזיסטנציאליסטי adjective masculine singular absolute unspecified unspecified  	O	null
8 , , , punctuation unspecified unspecified unspecified unspecified unspecified  	O	null
9 ש ש שהחל relativizer/subordinatingConjunction unspecified unspecified unspecified unspecified unspecified 0 
9 החל החל שהחל verb masculine singular unspecified 3 past  	O	null
10 ב ב בנובלה preposition unspecified unspecified unspecified unspecified unspecified 0 
10 ה ה בנובלה definiteArticle unspecified unspecified unspecified unspecified unspecified 0 
10 הנובלה נובלה בנובלה noun feminine singular absolute unspecified unspecified  	O	null
11 מות מוות מות noun masculine singular construct unspecified unspecified  	O	null
12 ליסאנדה ליסאנדה ליסאנדה properName unspecified unspecified unspecified unspecified unspecified  	I_ORG	null
13 ( ( ( punctuation unspecified unspecified unspecified unspecified unspecified  	O	null
14 ###NUMBER### ###NUMBER### ###NUMBER### numeral unspecified unspecified unspecified unspecified unspecified  	I_DATE	null
15 ) ) ) punctuation unspecified unspecified unspecified unspecified unspecified  	O	null
16 ו ו ונמשך conjunction unspecified unspecified unspecified unspecified unspecified 0 
16 נמש נמש ונמשך noun masculine singular absolute unspecified unspecified  
16 ך ך ונמשך possessive feminine singular unspecified 2 unspecified 0 	O	null
17 ב ב בסיפורי preposition unspecified unspecified unspecified unspecified unspecified 0 
17 סיפורי סיפור בסיפורי noun masculine plural construct unspecified unspecified  	O	null
18 ציד ציד ציד noun masculine singular construct unspecified unspecified  	O	null
19 ה ה הצביה definiteArticle unspecified unspecified unspecified unspecified unspecified 0 
19 הצביה צבי הצביה noun feminine singular absolute unspecified unspecified  	O	null
20 ) ) ) punctuation unspecified unspecified unspecified unspecified unspecified  	O	null
21 , , , punctuation unspecified unspecified unspecified unspecified unspecified  	O	null
22 ###NUMBER### ###NUMBER### ###NUMBER### numeral unspecified unspecified unspecified unspecified unspecified  	I_DATE	null
23 ב ב בנובלה preposition unspecified unspecified unspecified unspecified unspecified 0 
23 ה ה בנובלה definiteArticle unspecified unspecified unspecified unspecified unspecified 0 
23 הנובלה נובלה בנובלה noun feminine singular absolute unspecified unspecified  	O	null
24 נמלים נמל נמלים noun masculine plural absolute unspecified unspecified  	O	null
25 ) ) ) punctuation unspecified unspecified unspecified unspecified unspecified  	O	null
26 , , , punctuation unspecified unspecified unspecified unspecified unspecified  	O	null
27 ###NUMBER### ###NUMBER### ###NUMBER### numeral unspecified unspecified unspecified unspecified unspecified  	I_DATE	null
28 ב ב ב preposition unspecified unspecified unspecified unspecified unspecified 0 	O	null
29 " " " punctuation unspecified unspecified unspecified unspecified unspecified  	O	null
30 מדרגה מדרגה מדרגה noun feminine singular absolute unspecified unspecified  	O	null
31 צרה צרה צרה noun feminine singular absolute unspecified unspecified  	O	null
32 " " " punctuation unspecified unspecified unspecified unspecified unspecified  	O	null
33 ( ( ( punctuation unspecified unspecified unspecified unspecified unspecified  	O	null
34 פורסם פורסם פורסם verb masculine singular unspecified 3 past  	O	null
35 ב ב בשלוש preposition unspecified unspecified unspecified unspecified unspecified 0 
35 שלוש CARD3 בשלוש numeral feminine singular construct unspecified unspecified  	O	null
36 נובלות נבל נובלות verb feminine plural unspecified any beinoni  	O	null
37 , , , punctuation unspecified unspecified unspecified unspecified unspecified  	O	null
38 ) ) ) punctuation unspecified unspecified unspecified unspecified unspecified  	O	null
39 ###NUMBER### ###NUMBER### ###NUMBER### numeral unspecified unspecified unspecified unspecified unspecified  	I_DATE	null
40 ו ו ובקובץ conjunction unspecified unspecified unspecified unspecified unspecified 0 
40 ב ב ובקובץ preposition unspecified unspecified unspecified unspecified unspecified 0 
40 קובץ קובץ ובקובץ noun masculine singular construct unspecified unspecified  	O	null
41 ה ה הסיפורים definiteArticle unspecified unspecified unspecified unspecified unspecified 0 
41 הסיפורים סיפור הסיפורים noun masculine plural absolute unspecified unspecified  	O	null
42 עיר עיר עיר noun feminine singular construct unspecified unspecified  	O	null
43 ש ש שאין relativizer/subordinatingConjunction unspecified unspecified unspecified unspecified unspecified 0 
43 אין יש שאין existential unspecified unspecified unspecified unspecified unspecified  	O	null
44 ב ב בה preposition unspecified unspecified unspecified unspecified unspecified  
44 ה ה בה pronomial feminine singular unspecified 3 unspecified 0 	O	null
45 מ מ מסתור preposition unspecified unspecified unspecified unspecified unspecified 0 
45 סתור סתר מסתור participle masculine singular construct any unspecified  	I_ORG	null
46 ) ) ) punctuation unspecified unspecified unspecified unspecified unspecified  	O	null
47 . . . punctuation unspecified unspecified unspecified unspecified unspecified  	O	null
48 ###NUMBER### ###NUMBER### ###NUMBER### numeral unspecified unspecified unspecified unspecified unspecified  	I_DATE	null
49 פרק פרק פרק noun masculine singular construct unspecified unspecified  	O	null
50 זה זה זה pronoun masculine singular unspecified 3 unspecified  	O	null
51 ב ב בכתיבתו preposition unspecified unspecified unspecified unspecified unspecified 0 
51 כ כ בכתיבתו adverb unspecified unspecified unspecified unspecified unspecified 0 
51 תיבת תיבה בכתיבתו noun feminine singular absolute unspecified unspecified  
51 ו ו בכתיבתו possessive masculine singular unspecified 3 unspecified 0 	O	null
52 , , , punctuation unspecified unspecified unspecified unspecified unspecified  	O	null
53 ה ה המתפרש definiteArticle unspecified unspecified unspecified unspecified unspecified 0 
53 המתפרש התפרש המתפרש participle masculine singular absolute any unspecified  	O	null
54 על על על preposition unspecified unspecified unspecified unspecified unspecified  	O	null
55 פני פני פני noun masculine singular absolute unspecified unspecified  	O	null
56 שנות שנה שנות noun feminine plural construct unspecified unspecified  	I_DATE	null
57 ה ה השישים definiteArticle unspecified unspecified unspecified unspecified unspecified 0 
57 השישים ORD-CARD60 השישים numeral masculine-and-feminine plural absolute unspecified unspecified  	I_DATE	null
58 ו ו ומסתיים conjunction unspecified unspecified unspecified unspecified unspecified 0 
58 מסתיים הסתיים ומסתיים verb masculine singular unspecified any beinoni  	O	null
59 באמצע באמצע באמצע adverb unspecified unspecified unspecified unspecified unspecified  	O	null
60 שנות שנה שנות noun feminine plural construct unspecified unspecified  	O	null
61 ה ה השבעים definiteArticle unspecified unspecified unspecified unspecified unspecified 0 
61 השבעים ORD-CARD70 השבעים numeral masculine-and-feminine plural absolute unspecified unspecified  	O	null
62 , , , punctuation unspecified unspecified unspecified unspecified unspecified  	O	null
63 מסמן סימן מסמן verb masculine singular unspecified any beinoni  	O	null
64 מהלך מהלך מהלך noun masculine singular construct unspecified unspecified  	O	null
65 חדש חדש חדש adjective masculine singular absolute unspecified unspecified  	O	null
66 ב ב בסגנונו preposition unspecified unspecified unspecified unspecified unspecified 0 
66 סגנון סגנון בסגנונו noun masculine singular absolute unspecified unspecified  
66 ו ו בסגנונו possessive masculine singular unspecified 3 unspecified 0 	O	null
67 של של של shel-preposition unspecified unspecified unspecified unspecified unspecified  	O	null
68 אורפז אורפז אורפז properName unspecified unspecified unspecified unspecified unspecified  	I_PERS	null
69 , , , punctuation unspecified unspecified unspecified unspecified unspecified  	O	null
70 ה ה הנתפש definiteArticle unspecified unspecified unspecified unspecified unspecified 0 
70 הנתפש נתפש הנתפש participle masculine singular absolute any unspecified  	O	null
71 עתה עתה עתה adverb unspecified unspecified unspecified unspecified unspecified  	O	null
72 כ כ כסופר preposition unspecified unspecified unspecified unspecified unspecified 0 
72 סופר סופר כסופר properName unspecified unspecified unspecified unspecified unspecified  	I_PERS	null
73 ש ש שכתיבתו relativizer/subordinatingConjunction unspecified unspecified unspecified unspecified unspecified 0 
73 כ כ שכתיבתו adverb unspecified unspecified unspecified unspecified unspecified 0 
73 תיבת תיבה שכתיבתו noun feminine singular absolute unspecified unspecified  
73 ו ו שכתיבתו possessive masculine singular unspecified 3 unspecified 0 	O	null
74 חדשנית חדשני חדשנית adjective feminine singular absolute unspecified unspecified  	O	null
75 ו ו וניסיונית conjunction unspecified unspecified unspecified unspecified unspecified 0 
75 ניסיונית ניסיוני וניסיונית adjective feminine singular absolute unspecified unspecified  	O	null
76 . . . punctuation unspecified unspecified unspecified unspecified unspecified  	O	null

0 תיאור תיאור תיאור noun masculine singular construct unspecified unspecified  	O	null
1 זה זה זה pronoun masculine singular unspecified 3 unspecified  	O	null
2 ידבק דבק ידבק verb masculine singular unspecified 3 future  	O	null
3 ב ב בו preposition unspecified unspecified unspecified unspecified unspecified  
3 ו ו בו pronomial masculine singular unspecified 3 unspecified 0 	O	null
4 כש כש כשתחול temporalSubConj unspecified unspecified unspecified unspecified unspecified 0 
4 תחול חל כשתחול verb feminine singular unspecified 3 future  	O	null
5 תפנית תפנית תפנית noun feminine singular absolute unspecified unspecified  	O	null
6 נוספת נוסף נוספת adjective feminine singular absolute unspecified unspecified  	O	null
7 ב ב בכתיבתו preposition unspecified unspecified unspecified unspecified unspecified 0 
7 כתיבת כתיבה בכתיבתו noun feminine singular absolute unspecified unspecified  
7 ו ו בכתיבתו possessive masculine singular unspecified 3 unspecified 0 	O	null
8 , , , punctuation unspecified unspecified unspecified unspecified unspecified  	O	null
9 מן מן מן preposition unspecified unspecified unspecified unspecified unspecified  	O	null
10 ה ה ההפשטה definiteArticle unspecified unspecified unspecified unspecified unspecified 0 
10 ההפשטה הפשטה ההפשטה noun feminine singular absolute unspecified unspecified  	O	null
11 ה ה המודרניסטית definiteArticle unspecified unspecified unspecified unspecified unspecified 0 
11 המודרניסטית המודרניסטית המודרניסטית adjective feminine singular absolute unspecified unspecified  	O	null
12 אל אל אל preposition unspecified unspecified unspecified unspecified unspecified  	O	null
13 ה ה הריאליזם definiteArticle unspecified unspecified unspecified unspecified unspecified 0 
13 הריאליזם ריאליזם הריאליזם noun masculine singular absolute unspecified unspecified  	O	null
14 ה ה המחודש definiteArticle unspecified unspecified unspecified unspecified unspecified 0 
14 המחודש מחודש המחודש adjective masculine singular absolute unspecified unspecified  	O	null
15 , , , punctuation unspecified unspecified unspecified unspecified unspecified  	O	null
16 ו ו והוא conjunction unspecified unspecified unspecified unspecified unspecified 0 
16 הוא הוא והוא pronoun masculine singular unspecified 3 unspecified  	O	null
17 יעלים העלים יעלים verb masculine singular unspecified 3 future  	O	null
18 מ מ מעיניהם preposition unspecified unspecified unspecified unspecified unspecified 0 
18 עין עין מעיניהם noun feminine plural absolute unspecified unspecified  
18 הם הם מעיניהם possessive masculine plural unspecified 3 unspecified 0 	O	null
19 של של של shel-preposition unspecified unspecified unspecified unspecified unspecified  	O	null
20 חלק חלק חלק noun masculine singular absolute unspecified unspecified  	O	null
21 מ מ מהמבקרים preposition unspecified unspecified unspecified unspecified unspecified 0 
21 ה ה מהמבקרים definiteArticle unspecified unspecified unspecified unspecified unspecified 0 
21 המבקרים מבקר מהמבקרים noun masculine plural absolute unspecified unspecified  	O	null
22 את את את at-preposition unspecified unspecified unspecified unspecified unspecified  	O	null
23 ה ה התמורות definiteArticle unspecified unspecified unspecified unspecified unspecified 0 
23 התמורות תמורה התמורות noun feminine plural absolute unspecified unspecified  	O	null
24 ו ו ואת conjunction unspecified unspecified unspecified unspecified unspecified 0 
24 את את ואת at-preposition unspecified unspecified unspecified unspecified unspecified  	O	null
25 ה ה החידושים definiteArticle unspecified unspecified unspecified unspecified unspecified 0 
25 החידושים חידוש החידושים noun masculine plural absolute unspecified unspecified  	O	null
26 ב ב בכתיבתו preposition unspecified unspecified unspecified unspecified unspecified 0 
26 כתיבת כתיבה בכתיבתו noun feminine singular absolute unspecified unspecified  
26 ו ו בכתיבתו possessive masculine singular unspecified 3 unspecified 0 	O	null
27 . . . punctuation unspecified unspecified unspecified unspecified unspecified  	O	null

0 ב ב בשלב preposition unspecified unspecified unspecified unspecified unspecified 0 
0 שלב שלב בשלב noun masculine singular absolute unspecified unspecified  	O	null
1 זה זה זה pronoun masculine singular unspecified 3 unspecified  	O	null
2 , , , punctuation unspecified unspecified unspecified unspecified unspecified  	O	null
3 מ מ מכל preposition unspecified unspecified unspecified unspecified unspecified 0 
3 כל כול מכל quantifier unspecified unspecified construct unspecified unspecified  	O	null
4 מקום מקום מקום noun masculine singular absolute unspecified unspecified  	O	null
5 , , , punctuation unspecified unspecified unspecified unspecified unspecified  	O	null
6 סגנון סגנון סגנונו noun masculine singular absolute unspecified unspecified  
6 ו ו סגנונו possessive masculine singular unspecified 3 unspecified 0 	O	null
7 ניכר ניכר ניכר adjective masculine singular absolute unspecified unspecified  	O	null
8 ב ב בעמימות preposition unspecified unspecified unspecified unspecified unspecified 0 
8 עמימות עמימות בעמימות noun feminine singular absolute unspecified unspecified  	O	null
9 סיפורית סיפורי סיפורית adjective feminine singular absolute unspecified unspecified  	O	null
10 , , , punctuation unspecified unspecified unspecified unspecified unspecified  	O	null
11 ב ב בשבירת preposition unspecified unspecified unspecified unspecified unspecified 0 
11 שבירת שבירה בשבירת noun feminine singular construct unspecified unspecified  	O	null
12 ה ה הרציפות definiteArticle unspecified unspecified unspecified unspecified unspecified 0 
12 הרציפות רציפות הרציפות noun feminine singular absolute unspecified unspecified  	O	null
13 ה ה העלילתית definiteArticle unspecified unspecified unspecified unspecified unspecified 0 
13 העלילתית העלילתית העלילתית adjective feminine singular absolute unspecified unspecified  	O	null
14 ו ו ובנטייה conjunction unspecified unspecified unspecified unspecified unspecified 0 
14 ב ב ובנטייה preposition unspecified unspecified unspecified unspecified unspecified 0 
14 נטייה נטייה ובנטייה noun feminine singular absolute unspecified unspecified  	O	null
15 אל אל אל preposition unspecified unspecified unspecified unspecified unspecified  	O	null
16 ה ה האלגוריה definiteArticle unspecified unspecified unspecified unspecified unspecified 0 
16 האלגוריה האלגוריה האלגוריה noun feminine singular absolute unspecified unspecified  	O	null
17 ו ו והסמל conjunction unspecified unspecified unspecified unspecified unspecified 0 
17 ה ה והסמל definiteArticle unspecified unspecified unspecified unspecified unspecified 0 
17 הסמל סמל והסמל noun masculine singular absolute unspecified unspecified  	O	null
18 . . . punctuation unspecified unspecified unspecified unspecified unspecified  	O	null

0 ה ה האמירה definiteArticle unspecified unspecified unspecified unspecified unspecified 0 
0 האמירה אמירה האמירה noun feminine singular absolute unspecified unspecified  	O	null
1 של של של shel-preposition unspecified unspecified unspecified unspecified unspecified  	O	null
2 ה ה הנובלות definiteArticle unspecified unspecified unspecified unspecified unspecified 0 
2 הנובלות נובלה הנובלות noun feminine plural absolute unspecified unspecified  	O	null
3 ו ו והסיפורים conjunction unspecified unspecified unspecified unspecified unspecified 0 
3 ה ה והסיפורים definiteArticle unspecified unspecified unspecified unspecified unspecified 0 
3 הסיפורים סיפור והסיפורים noun masculine plural absolute unspecified unspecified  	O	null
4 ה ה האלה definiteArticle unspecified unspecified unspecified unspecified unspecified 0 
4 האלה אלה האלה pronoun masculine-and-feminine plural unspecified 3 unspecified  	O	null
5 חותרת חתר חותרת verb feminine singular unspecified any beinoni  	O	null
6 אל אל אל preposition unspecified unspecified unspecified unspecified unspecified  	O	null
7 מעבר מעבר מעבר noun masculine singular absolute unspecified unspecified  	O	null
8 ל ל לחברתי preposition unspecified unspecified unspecified unspecified unspecified 0 
8 חברתי חברתי לחברתי adjective masculine singular absolute unspecified unspecified  	O	null
9 ו ו ולהיסטורי conjunction unspecified unspecified unspecified unspecified unspecified 0 
9 ל ל ולהיסטורי preposition unspecified unspecified unspecified unspecified unspecified 0 
9 ה ה ולהיסטורי definiteArticle unspecified unspecified unspecified unspecified unspecified 0 
9 ההיסטורי היסטורי ולהיסטורי adjective masculine singular absolute unspecified unspecified  	O	null
10 , , , punctuation unspecified unspecified unspecified unspecified unspecified  	O	null
11 ו ו ומביעה conjunction unspecified unspecified unspecified unspecified unspecified 0 
11 מביעה הביע ומביעה verb feminine singular unspecified any beinoni  	O	null
12 כמיהה כמיהה כמיהה noun feminine singular absolute unspecified unspecified  	O	null
13 ל ל לבשורה preposition unspecified unspecified unspecified unspecified unspecified 0 
13 בשורה בשורה לבשורה noun feminine singular absolute unspecified unspecified  	O	null
14 חדשה חדש חדשה adjective feminine singular absolute unspecified unspecified  	O	null
15 . . . punctuation unspecified unspecified unspecified unspecified unspecified  	O	null

0 ה ה העולם definiteArticle unspecified unspecified unspecified unspecified unspecified 0 
0 העולם עולם העולם noun masculine singular absolute unspecified unspecified  	O	null
1 של של של shel-preposition unspecified unspecified unspecified unspecified unspecified  	O	null
2 ה ה הגיבורים definiteArticle unspecified unspecified unspecified unspecified unspecified 0 
2 הגיבורים גיבור הגיבורים noun masculine plural absolute unspecified unspecified  	O	null
3 מאופיין אופיין מאופיין verb masculine singular unspecified any beinoni  	O	null
4 ב ב בהרס preposition unspecified unspecified unspecified unspecified unspecified 0 
4 הרס הרס בהרס noun masculine singular construct unspecified unspecified  	O	null
5 מסגרות מסגרת מסגרות noun feminine plural absolute unspecified unspecified  	O	null
6 ו ו ובאלימות conjunction unspecified unspecified unspecified unspecified unspecified 0 
6 ב ב ובאלימות preposition unspecified unspecified unspecified unspecified unspecified 0 
6 ה ה ובאלימות definiteArticle unspecified unspecified unspecified unspecified unspecified 0 
6 האלימות אלימות ובאלימות noun feminine singular absolute unspecified unspecified  	O	null
7 , , , punctuation unspecified unspecified unspecified unspecified unspecified  	O	null
8 ו ו והוא conjunction unspecified unspecified unspecified unspecified unspecified 0 
8 הוא הוא והוא pronoun masculine singular unspecified 3 unspecified  	O	null
9 מבטא ביטא מבטא verb masculine singular unspecified any beinoni  	O	null
10 ב ב במובלע preposition unspecified unspecified unspecified unspecified unspecified 0 
10 ה ה במובלע definiteArticle unspecified unspecified unspecified unspecified unspecified 0 
10 המובלע הובלע במובלע participle masculine singular absolute any unspecified  	O	null
11 את את את at-preposition unspecified unspecified unspecified unspecified unspecified  	O	null
12 ה ה השבר definiteArticle unspecified unspecified unspecified unspecified unspecified 0 
12 השבר שבר השבר noun masculine singular absolute unspecified unspecified  	O	null
13 ה ה החברתי definiteArticle unspecified unspecified unspecified unspecified unspecified 0 
13 החברתי חברתי החברתי adjective masculine singular absolute unspecified unspecified  	O	null
14 ו ו והפרטי conjunction unspecified unspecified unspecified unspecified unspecified 0 
14 ה ה והפרטי definiteArticle unspecified unspecified unspecified unspecified unspecified 0 
14 הפרטי פרטי והפרטי adjective masculine singular absolute unspecified unspecified  	O	null
15 ש ש שחל relativizer/subordinatingConjunction unspecified unspecified unspecified unspecified unspecified 0 
15 חל חל שחל verb masculine singular unspecified 3 past  	O	null
16 ב ב באמונה preposition unspecified unspecified unspecified unspecified unspecified 0 
16 ה ה באמונה definiteArticle unspecified unspecified unspecified unspecified unspecified 0 
16 האמונה אמונה באמונה noun feminine singular absolute unspecified unspecified  	O	null
17 ה ה הנאיבית definiteArticle unspecified unspecified unspecified unspecified unspecified 0 
17 הנאיבית נאיבי הנאיבית adjective feminine singular absolute unspecified unspecified  	O	null
18 ב ב באפשרות preposition unspecified unspecified unspecified unspecified unspecified 0 
18 אפשרות אפשרות באפשרות noun feminine singular construct unspecified unspecified  	O	null
19 מימוש מימוש מימושם noun masculine singular absolute unspecified unspecified  
19 ם ם מימושם possessive masculine plural unspecified 3 unspecified 0 	O	null
20 של של של shel-preposition unspecified unspecified unspecified unspecified unspecified  	O	null
21 ערכים ערך ערכים noun masculine plural absolute unspecified unspecified  	O	null
22 רצויים רצה רצויים participle masculine plural absolute any unspecified  	O	null
23 . . . punctuation unspecified unspecified unspecified unspecified unspecified  	O	null

0 בין בין בין preposition unspecified unspecified unspecified unspecified unspecified  	O	null
1 יצירות יצירה יצירות noun feminine plural construct unspecified unspecified  	O	null
2 ה ה העשור definiteArticle unspecified unspecified unspecified unspecified unspecified 0 
2 העשור עשור העשור noun masculine singular absolute unspecified unspecified  	O	null
3 ה ה השני definiteArticle unspecified unspecified unspecified unspecified unspecified 0 
3 השני ORD2 השני numeral masculine singular absolute unspecified unspecified  	O	null
4 ב ב בכתיבתו preposition unspecified unspecified unspecified unspecified unspecified 0 
4 כתיבת כתיבה בכתיבתו noun feminine singular absolute unspecified unspecified  
4 ו ו בכתיבתו possessive masculine singular unspecified 3 unspecified 0 	O	null
5 עומד עמד עומד verb masculine singular unspecified any beinoni  	O	null
6 ה ה הרומן definiteArticle unspecified unspecified unspecified unspecified unspecified 0 
6 הרומן רומן הרומן noun masculine singular absolute unspecified unspecified  	O	null
7 מסע מסע מסע noun masculine singular construct unspecified unspecified  	O	null
8 דניאל דניאל דניאל properName unspecified unspecified unspecified unspecified unspecified  	I_PERS	null
9 ) ) ) punctuation unspecified unspecified unspecified unspecified unspecified  	O	null
10 , , , punctuation unspecified unspecified unspecified unspecified unspecified  	O	null
11 ###NUMBER### ###NUMBER### ###NUMBER### numeral unspecified unspecified unspecified unspecified unspecified  	I_DATE	null
12 ש ש שנפוץ relativizer/subordinatingConjunction unspecified unspecified unspecified unspecified unspecified 0 
12 נפוץ נפוץ שנפוץ verb masculine singular unspecified 3 past  	O	null
13 ב ב בשלושים preposition unspecified unspecified unspecified unspecified unspecified 0 
13 שלושים ORD-CARD30 בשלושים numeral masculine-and-feminine plural construct unspecified unspecified  	O	null
14 אלף ORD-CARD1000 אלף numeral masculine plural absolute unspecified unspecified  	O	null
15 עותקים עותק עותקים noun masculine plural absolute unspecified unspecified  	O	null
16 ו ו והיה conjunction unspecified unspecified unspecified unspecified unspecified 0 
16 היה הוא והיה copula masculine singular unspecified 3 past  	O	null
17 ל ל לספר preposition unspecified unspecified unspecified unspecified unspecified 0 
17 ספר ספר לספר noun masculine singular construct unspecified unspecified  	O	null
18 פולחן פולחן פולחן noun masculine singular absolute unspecified unspecified  	O	null
19 . . . punctuation unspecified unspecified unspecified unspecified unspecified  	O	null

0 זהו זהו זהו pronoun masculine singular unspecified 3 unspecified  	O	null
1 סיפור סיפור סיפורו noun masculine singular absolute unspecified unspecified  
1 ו ו סיפורו possessive masculine singular unspecified 3 unspecified 0 	O	null
2 של של של shel-preposition unspecified unspecified unspecified unspecified unspecified  	O	null
3 מומו מומו מומו properName unspecified unspecified unspecified unspecified unspecified  	I_PERS	null
4 ה ה הבורח definiteArticle unspecified unspecified unspecified unspecified unspecified 0 
4 הבורח ברח הבורח participle masculine singular absolute any unspecified  	O	null
5 אל אל אל preposition unspecified unspecified unspecified unspecified unspecified  	O	null
6 ה ה הים definiteArticle unspecified unspecified unspecified unspecified unspecified 0 
6 הים ים הים noun masculine singular absolute unspecified unspecified  	O	null
7 מפני מפני מפני properName unspecified unspecified unspecified unspecified unspecified  	I_PERS	null
8 רסקין רסקין רסקין properName unspecified unspecified unspecified unspecified unspecified  	I_PERS	null
9 , , , punctuation unspecified unspecified unspecified unspecified unspecified  	O	null
10 בעל בעל בעל noun masculine singular construct unspecified unspecified  	O	null
11 מפעלי מפעל מפעלי noun masculine plural construct unspecified unspecified  	O	null
12 כל כול כל quantifier unspecified unspecified construct unspecified unspecified  	O	null
13 - - - punctuation unspecified unspecified unspecified unspecified unspecified  	I_LOC	null
14 פלסט פלסט פלסט properName unspecified unspecified unspecified unspecified unspecified  	I_LOC	null
15 . . . punctuation unspecified unspecified unspecified unspecified unspecified  	O	null

0 ה ה הפלסטיק definiteArticle unspecified unspecified unspecified unspecified unspecified 0 
0 הפלסטיק פלסטיק הפלסטיק noun masculine singular absolute unspecified unspecified  	O	null
1 משמש משמש משמש verb masculine singular unspecified 3 past  	I_LOC	null
2 כמטפורה כמטפורה כמטפורה properName unspecified unspecified unspecified unspecified unspecified  	I_PERS	null
3 ל ל לחיים preposition unspecified unspecified unspecified unspecified unspecified 0 
3 ה ה לחיים definiteArticle unspecified unspecified unspecified unspecified unspecified 0 
3 החיים חיים לחיים noun masculine plural absolute unspecified unspecified  	O	null
4 לא לא לא negation unspecified unspecified unspecified unspecified unspecified  	O	null
5 אותנטיים אותנטי אותנטיים adjective masculine plural absolute unspecified unspecified  	O	null
6 , , , punctuation unspecified unspecified unspecified unspecified unspecified  	O	null
7 ו ו והבריחה conjunction unspecified unspecified unspecified unspecified unspecified 0 
7 ה ה והבריחה definiteArticle unspecified unspecified unspecified unspecified unspecified 0 
7 הבריחה בריחה והבריחה noun feminine singular absolute unspecified unspecified  	O	null
8 ל ל לים preposition unspecified unspecified unspecified unspecified unspecified 0 
8 ה ה לים definiteArticle unspecified unspecified unspecified unspecified unspecified 0 
8 הים ים לים noun masculine singular absolute unspecified unspecified  	O	null
9 היא הוא היא pronoun feminine singular unspecified 3 unspecified  	O	null
10 בבואת בבואה בבואת noun feminine singular construct unspecified unspecified  	O	null
11 ה ה המרד definiteArticle unspecified unspecified unspecified unspecified unspecified 0 
11 המרד מרד המרד noun masculine singular absolute unspecified unspecified  	O	null
12 ה ה האקזיסטנציאלי definiteArticle unspecified unspecified unspecified unspecified unspecified 0 
12 האקזיסטנציאלי האקזיסטנציאלי האקזיסטנציאלי adjective masculine singular absolute unspecified unspecified  	O	null
13 ו ו והחירות conjunction unspecified unspecified unspecified unspecified unspecified 0 
13 ה ה והחירות definiteArticle unspecified unspecified unspecified unspecified unspecified 0 
13 החירות חירות והחירות noun feminine singular absolute unspecified unspecified  	O	null
14 , , , punctuation unspecified unspecified unspecified unspecified unspecified  	O	null
15 כמו כמו כמו conjunction unspecified unspecified unspecified unspecified unspecified  	O	null
16 אצל אצל אצל preposition unspecified unspecified unspecified unspecified unspecified  	O	null
17 קאמי קאמי קאמי properName unspecified unspecified unspecified unspecified unspecified  	I_PERS	null
18 . . . punctuation unspecified unspecified unspecified unspecified unspecified  	O	null

0 מ מ מבחינה preposition unspecified unspecified unspecified unspecified unspecified 0 
0 בחינה בחינה מבחינה noun feminine singular absolute unspecified unspecified  	O	null
1 סגנונית סגנונית סגנונית adjective feminine singular absolute unspecified unspecified  	O	null
2 ה ה הרומן definiteArticle unspecified unspecified unspecified unspecified unspecified 0 
2 הרומן רומן הרומן noun masculine singular absolute unspecified unspecified  	O	null
3 נטוע נטוע נטוע adjective masculine singular absolute unspecified unspecified  	O	null
4 ב ב בהוויה preposition unspecified unspecified unspecified unspecified unspecified 0 
4 ה ה בהוויה definiteArticle unspecified unspecified unspecified unspecified unspecified 0 
4 ההוויה הוויה בהוויה noun feminine singular absolute unspecified unspecified  	O	null
5 ה ה הסמלנית definiteArticle unspecified unspecified unspecified unspecified unspecified 0 
5 הסמלנית הסמלנית הסמלנית noun feminine singular absolute unspecified unspecified  	O	null
6 של של של shel-preposition unspecified unspecified unspecified unspecified unspecified  	O	null
7 ה ה השלב definiteArticle unspecified unspecified unspecified unspecified unspecified 0 
7 השלב שלב השלב noun masculine singular absolute unspecified unspecified  	O	null
8 ה ה הקודם definiteArticle unspecified unspecified unspecified unspecified unspecified 0 
8 הקודם קודם הקודם adjective masculine singular absolute unspecified unspecified  	O	null
9 , , , punctuation unspecified unspecified unspecified unspecified unspecified  	O	null
10 אך אך אך conjunction unspecified unspecified unspecified unspecified unspecified  	O	null
11 גם גם גם conjunction unspecified unspecified unspecified unspecified unspecified  	O	null
12 ב ב בהוויה preposition unspecified unspecified unspecified unspecified unspecified 0 
12 ה ה בהוויה definiteArticle unspecified unspecified unspecified unspecified unspecified 0 
12 ההוויה הוויה בהוויה noun feminine singular absolute unspecified unspecified  	O	null
13 ה ה החברתית definiteArticle unspecified unspecified unspecified unspecified unspecified 0 
13 החברתית חברתי החברתית adjective feminine singular absolute unspecified unspecified  	O	null
14 ו ו וההיסטורית conjunction unspecified unspecified unspecified unspecified unspecified 0 
14 ה ה וההיסטורית definiteArticle unspecified unspecified unspecified unspecified unspecified 0 
14 ההיסטורית היסטורי וההיסטורית adjective feminine singular absolute unspecified unspecified  	O	null
15 ש ש שאליה relativizer/subordinatingConjunction unspecified unspecified unspecified unspecified unspecified 0 
15 אל אל שאליה preposition unspecified unspecified unspecified unspecified unspecified  
15 ה ה שאליה pronomial feminine singular unspecified 3 unspecified 0 	O	null
16 נפתחת נפתח נפתחת verb feminine singular unspecified any beinoni  	O	null
17 יצירת יצירה יצירת noun feminine singular construct unspecified unspecified  	O	null
18 אורפז אורפז אורפז properName unspecified unspecified unspecified unspecified unspecified  	I_PERS	null
19 ב ב בשלב preposition unspecified unspecified unspecified unspecified unspecified 0 
19 ה ה בשלב definiteArticle unspecified unspecified unspecified unspecified unspecified 0 
19 השלב שלב בשלב noun masculine singular absolute unspecified unspecified  	O	null
20 ה ה הבא definiteArticle unspecified unspecified unspecified unspecified unspecified 0 
20 הבא בא הבא adjective masculine singular absolute unspecified unspecified  	O	null
21 , , , punctuation unspecified unspecified unspecified unspecified unspecified  	O	null
22 החל החל החל verb masculine singular unspecified 3 past  	O	null
23 ב ב באמצע preposition unspecified unspecified unspecified unspecified unspecified 0 
23 אמצע אמצע באמצע noun masculine singular construct unspecified unspecified  	O	null
24 שנות שנה שנות noun feminine plural construct unspecified unspecified  	O	null
25 ה ה השבעים definiteArticle unspecified unspecified unspecified unspecified unspecified 0 
25 השבעים ORD-CARD70 השבעים numeral masculine-and-feminine plural absolute unspecified unspecified  	O	null
26 , , , punctuation unspecified unspecified unspecified unspecified unspecified  	O	null
27 לאחר לאחר לאחר conjunction unspecified unspecified unspecified unspecified unspecified  	O	null
28 מלחמת מלחמה מלחמת noun feminine singular construct unspecified unspecified  	I_DATE	null
29 יום יום יום noun masculine singular construct unspecified unspecified  	I_DATE	null
30 ה ה הכיפורים definiteArticle unspecified unspecified unspecified unspecified unspecified 0 
30 הכיפורים כיפור הכיפורים noun masculine plural absolute unspecified unspecified  	I_DATE	null
31 ) ) ) punctuation unspecified unspecified unspecified unspecified unspecified  	O	null
32 . . . punctuation unspecified unspecified unspecified unspecified unspecified  	O	null
33 ###NUMBER### ###NUMBER### ###NUMBER### numeral unspecified unspecified unspecified unspecified unspecified  	I_DATE	null
34 מ מ מאמצע preposition unspecified unspecified unspecified unspecified unspecified 0 
34 אמצע אמצע מאמצע noun masculine singular construct unspecified unspecified  	O	null
35 שנות שנה שנות noun feminine plural construct unspecified unspecified  	O	null
36 ה ה השבעים definiteArticle unspecified unspecified unspecified unspecified unspecified 0 
36 השבעים ORD-CARD70 השבעים numeral masculine-and-feminine plural absolute unspecified unspecified  	O	null
37 , , , punctuation unspecified unspecified unspecified unspecified unspecified  	O	null
38 עם עם עם preposition unspecified unspecified unspecified unspecified unspecified  	O	null
39 פרסום פרסום פרסום noun masculine singular construct unspecified unspecified  	O	null
40 ה ה הרומן definiteArticle unspecified unspecified unspecified unspecified unspecified 0 
40 הרומן רומן הרומן noun masculine singular absolute unspecified unspecified  	O	null
41 בית בית בית noun masculine singular absolute unspecified unspecified  	O	null
42 ל ל לאדם preposition unspecified unspecified unspecified unspecified unspecified 0 
42 אדם אדם לאדם noun masculine singular absolute unspecified unspecified  	O	null
43 אחד CARD1 אחד numeral masculine singular absolute unspecified unspecified  	O	null
44 ) ) ) punctuation unspecified unspecified unspecified unspecified unspecified  	O	null
45 , , , punctuation unspecified unspecified unspecified unspecified unspecified  	O	null
46 ###NUMBER### ###NUMBER### ###NUMBER### numeral unspecified unspecified unspecified unspecified unspecified  	I_DATE	null
47 חלה חל חלה verb feminine singular unspecified 3 past  	O	null
48 ב ב ביצירתו preposition unspecified unspecified unspecified unspecified unspecified 0 
48 יצירת יצירה ביצירתו noun feminine singular absolute unspecified unspecified  
48 ו ו ביצירתו possessive masculine singular unspecified 3 unspecified 0 	O	null
49 תפנית תפנית תפנית noun feminine singular absolute unspecified unspecified  	O	null
50 נוספת נוסף נוספת adjective feminine singular absolute unspecified unspecified  	O	null
51 , , , punctuation unspecified unspecified unspecified unspecified unspecified  	O	null
52 מן מן מן preposition unspecified unspecified unspecified unspecified unspecified  	O	null
53 ה ה העמדה definiteArticle unspecified unspecified unspecified unspecified unspecified 0 
53 העמדה עמדה העמדה noun feminine singular absolute unspecified unspecified  	O	null
54 ה ה המוחצנת definiteArticle unspecified unspecified unspecified unspecified unspecified 0 
54 המוחצנת המוחצנת המוחצנת adjective feminine singular absolute unspecified unspecified  	O	null
55 ו ו והמרוחקת conjunction unspecified unspecified unspecified unspecified unspecified 0 
55 ה ה והמרוחקת definiteArticle unspecified unspecified unspecified unspecified unspecified 0 
55 המרוחקת מרוחק והמרוחקת adjective feminine singular absolute unspecified unspecified  	O	null
56 אל אל אל preposition unspecified unspecified unspecified unspecified unspecified  	O	null
57 ה ה העמדה definiteArticle unspecified unspecified unspecified unspecified unspecified 0 
57 העמדה עמדה העמדה noun feminine singular absolute unspecified unspecified  	O	null
58 ה ה המעורבת definiteArticle unspecified unspecified unspecified unspecified unspecified 0 
58 המעורבת מעורב המעורבת adjective feminine singular absolute unspecified unspecified  	O	null
59 ב ב במציאות preposition unspecified unspecified unspecified unspecified unspecified 0 
59 ה ה במציאות definiteArticle unspecified unspecified unspecified unspecified unspecified 0 
59 המציאות מציאות במציאות noun feminine singular absolute unspecified unspecified  	O	null
60 ה ה הישראלית definiteArticle unspecified unspecified unspecified unspecified unspecified 0 
60 הישראלית ישראלי הישראלית adjective feminine singular absolute unspecified unspecified  	O	null
61 מצד מצד מצד preposition unspecified unspecified unspecified unspecified unspecified  	O	null
62 אחד CARD1 אחד numeral masculine singular absolute unspecified unspecified  	O	null
63 , , , punctuation unspecified unspecified unspecified unspecified unspecified  	O	null
64 ו ו ואל conjunction unspecified unspecified unspecified unspecified unspecified 0 
64 אל אל ואל preposition unspecified unspecified unspecified unspecified unspecified  	O	null
65 ה ה הנהייה definiteArticle unspecified unspecified unspecified unspecified unspecified 0 
65 הנהייה נהייה הנהייה noun feminine singular absolute unspecified unspecified  	O	null
66 אל אל אל preposition unspecified unspecified unspecified unspecified unspecified  	O	null
67 עולם עולם עולם noun masculine singular construct unspecified unspecified  	O	null
68 ה ה האבות definiteArticle unspecified unspecified unspecified unspecified unspecified 0 
68 האבות אב האבות noun masculine plural absolute unspecified unspecified  	O	null
69 ה ה הגלותי definiteArticle unspecified unspecified unspecified unspecified unspecified 0 
69 הגלותי הגלותי הגלותי adjective masculine singular absolute unspecified unspecified  	O	null
70 , , , punctuation unspecified unspecified unspecified unspecified unspecified  	O	null
71 על על על preposition unspecified unspecified unspecified unspecified unspecified  	O	null
72 סמלי סמל סמליו noun masculine plural absolute unspecified unspecified  
72 ו ו סמליו possessive masculine singular unspecified 3 unspecified 0 	O	null
73 ה ה היהודיים definiteArticle unspecified unspecified unspecified unspecified unspecified 0 
73 היהודיים יהודי היהודיים adjective masculine plural absolute unspecified unspecified  	O	null
74 ו ו ושפתו conjunction unspecified unspecified unspecified unspecified unspecified 0 
74 שפת שפה ושפתו noun feminine singular absolute unspecified unspecified  
74 ו ו ושפתו possessive masculine singular unspecified 3 unspecified 0 	O	null
75 ה ה היידית definiteArticle unspecified unspecified unspecified unspecified unspecified 0 
75 היידית יידי היידית adjective feminine singular absolute unspecified unspecified  	O	null
76 , , , punctuation unspecified unspecified unspecified unspecified unspecified  	O	null
77 מ מ מצד preposition unspecified unspecified unspecified unspecified unspecified 0 
77 צד צד מצד noun masculine singular absolute unspecified unspecified  	O	null
78 אחר אחר אחר adjective masculine singular absolute unspecified unspecified  	O	null
79 . . . punctuation unspecified unspecified unspecified unspecified unspecified  	O	null

0 שיא שיא שיאה noun masculine singular absolute unspecified unspecified  
0 ה ה שיאה possessive feminine singular unspecified 3 unspecified 0 	O	null
1 של של של shel-preposition unspecified unspecified unspecified unspecified unspecified  	O	null
2 מגמה מגמה מגמה noun feminine singular absolute unspecified unspecified  	O	null
3 זו זו זו pronoun feminine singular unspecified 3 unspecified  	O	null
4 ב ב בקובץ preposition unspecified unspecified unspecified unspecified unspecified 0 
4 קובץ קובץ בקובץ noun masculine singular construct unspecified unspecified  	O	null
5 ה ה הסיפורים definiteArticle unspecified unspecified unspecified unspecified unspecified 0 
5 הסיפורים סיפור הסיפורים noun masculine plural absolute unspecified unspecified  	O	null
6 רחוב רחוב רחוב noun masculine singular absolute unspecified unspecified  	O	null
7 הטומוז'נה הטומוז'נה הטומוז'נה verb masculine-and-feminine plural unspecified 2 imperative  	O	null
8 ( ( ( punctuation unspecified unspecified unspecified unspecified unspecified  	O	null
9 ) ) ) punctuation unspecified unspecified unspecified unspecified unspecified  	O	null
10 . . . punctuation unspecified unspecified unspecified unspecified unspecified  	O	null
11 ###NUMBER### ###NUMBER### ###NUMBER### numeral unspecified unspecified unspecified unspecified unspecified  	I_DATE	null
12 ה ה הספר definiteArticle unspecified unspecified unspecified unspecified unspecified 0 
12 הספר ספר הספר noun masculine singular absolute unspecified unspecified  	O	null
13 , , , punctuation unspecified unspecified unspecified unspecified unspecified  	O	null
14 ש ש שזכה relativizer/subordinatingConjunction unspecified unspecified unspecified unspecified unspecified 0 
14 זכה זכה שזכה verb masculine singular unspecified 3 past  	O	null
15 ל ל לשבחי preposition unspecified unspecified unspecified unspecified unspecified 0 
15 שבחי שבח לשבחי noun masculine plural construct unspecified unspecified  	O	null
16 ה ה המבקרים definiteArticle unspecified unspecified unspecified unspecified unspecified 0 
16 המבקרים מבקר המבקרים noun masculine plural absolute unspecified unspecified  	O	null
17 , , , punctuation unspecified unspecified unspecified unspecified unspecified  	O	null
18 אינו הוא אינו copula masculine singular unspecified 3 beinoni  	O	null
19 נוטה נטה נוטה verb masculine singular unspecified any beinoni  	O	null
20 ל ל להתרפקות preposition unspecified unspecified unspecified unspecified unspecified 0 
20 התרפקות התרפקות להתרפקות noun feminine singular absolute unspecified unspecified  	O	null
21 נוסטלגית נוסטלגי נוסטלגית adjective feminine singular absolute unspecified unspecified  	O	null
22 ממותקת ממותק ממותקת adjective feminine singular absolute unspecified unspecified  	O	null
23 , , , punctuation unspecified unspecified unspecified unspecified unspecified  	O	null
24 גם גם גם conjunction unspecified unspecified unspecified unspecified unspecified  	O	null
25 לא לא לא negation unspecified unspecified unspecified unspecified unspecified  	O	null
26 ל ל לכתיבה preposition unspecified unspecified unspecified unspecified unspecified 0 
26 כתיבה כתיבה לכתיבה noun feminine singular absolute unspecified unspecified  	O	null
27 ריאליסטית ריאליסטי ריאליסטית adjective feminine singular absolute unspecified unspecified  	O	null
28 מובהקת מובהק מובהקת adjective feminine singular absolute unspecified unspecified  	O	null
29 . . . punctuation unspecified unspecified unspecified unspecified unspecified  	O	null

0 מודגשים הודגש מודגשים verb masculine plural unspecified any beinoni  	O	null
1 ב ב בו preposition unspecified unspecified unspecified unspecified unspecified  
1 ו ו בו pronomial masculine singular unspecified 3 unspecified 0 	O	null
2 ה ה הקווים definiteArticle unspecified unspecified unspecified unspecified unspecified 0 
2 הקווים קו הקווים noun masculine plural absolute unspecified unspecified  	O	null
3 ה ה האלימים definiteArticle unspecified unspecified unspecified unspecified unspecified 0 
3 האלימים אלים האלימים adjective masculine plural absolute unspecified unspecified  	O	null
4 ו ו והדמוניים conjunction unspecified unspecified unspecified unspecified unspecified 0 
4 ה ה והדמוניים definiteArticle unspecified unspecified unspecified unspecified unspecified 0 
4 הדמוניים דמוני והדמוניים adjective masculine plural absolute unspecified unspecified  	O	null
5 ב ב בהוויה preposition unspecified unspecified unspecified unspecified unspecified 0 
5 ה ה בהוויה definiteArticle unspecified unspecified unspecified unspecified unspecified 0 
5 ההוויה הוויה בהוויה noun feminine singular absolute unspecified unspecified  	O	null
6 ה ה היהודית definiteArticle unspecified unspecified unspecified unspecified unspecified 0 
6 היהודית יהודי היהודית adjective feminine singular absolute unspecified unspecified  	O	null
7 ה ה הגלותית definiteArticle unspecified unspecified unspecified unspecified unspecified 0 
7 הגלותית הגלותית הגלותית adjective feminine singular absolute unspecified unspecified  	O	null
8 , , , punctuation unspecified unspecified unspecified unspecified unspecified  	O	null
9 באמצעות באמצעות באמצעות preposition unspecified unspecified unspecified unspecified unspecified  	O	null
10 גילויים גילוי גילויים noun masculine plural absolute unspecified unspecified  	O	null
11 של של של shel-preposition unspecified unspecified unspecified unspecified unspecified  	O	null
12 ארוטיות ארוטי ארוטיות adjective feminine plural absolute unspecified unspecified  	O	null
13 מעוותת מעוות מעוותת adjective feminine singular absolute unspecified unspecified  	O	null
14 , , , punctuation unspecified unspecified unspecified unspecified unspecified  	O	null
15 אימה אימה אימה noun feminine singular absolute unspecified unspecified  	O	null
16 , , , punctuation unspecified unspecified unspecified unspecified unspecified  	O	null
17 מבוכה מבוכה מבוכה noun feminine singular absolute unspecified unspecified  	O	null
18 , , , punctuation unspecified unspecified unspecified unspecified unspecified  	O	null
19 בדידות בדידות בדידות noun feminine singular absolute unspecified unspecified  	O	null
20 ו ו ופסימיות conjunction unspecified unspecified unspecified unspecified unspecified 0 
20 פסימיות פסימיות ופסימיות noun feminine singular absolute unspecified unspecified  	O	null
21 . . . punctuation unspecified unspecified unspecified unspecified unspecified  	O	null

0 ה ה הכתיבה definiteArticle unspecified unspecified unspecified unspecified unspecified 0 
0 הכתיבה כתיבה הכתיבה noun feminine singular absolute unspecified unspecified  	O	null
1 מערבת עירב מערבת verb feminine singular unspecified any beinoni  	O	null
2 סמלנות סמלנות סמלנות adjective feminine plural absolute unspecified unspecified  	O	null
3 , , , punctuation unspecified unspecified unspecified unspecified unspecified  	O	null
4 אלגוריה אלגוריה אלגוריה properName unspecified unspecified unspecified unspecified unspecified  	I_PERS	null
5 , , , punctuation unspecified unspecified unspecified unspecified unspecified  	O	null
6 סוריאליזם סוריאליזם סוריאליזם noun masculine singular absolute unspecified unspecified  	O	null
7 , , , punctuation unspecified unspecified unspecified unspecified unspecified  	O	null
8 זרם זרם זרם noun masculine singular construct unspecified unspecified  	O	null
9 תודעה תודעה תודעה noun feminine singular absolute unspecified unspecified  	O	null
10 ו ו וריאליזם conjunction unspecified unspecified unspecified unspecified unspecified 0 
10 ריאליזם ריאליזם וריאליזם noun masculine singular absolute unspecified unspecified  	O	null
11 פרטני פרטני פרטני adjective masculine singular absolute unspecified unspecified  	O	null
12 ה ה המנכר definiteArticle unspecified unspecified unspecified unspecified unspecified 0 
12 המנכר המנכר המנכר participle masculine singular absolute any unspecified  	O	null
13 את את את at-preposition unspecified unspecified unspecified unspecified unspecified  	O	null
14 ה ה המראות definiteArticle unspecified unspecified unspecified unspecified unspecified 0 
14 המראות מראה המראות noun masculine plural absolute unspecified unspecified  	O	null
15 בשל בשל בשל preposition unspecified unspecified unspecified unspecified unspecified  	O	null
16 בידוד בידוד בידוד noun masculine singular construct unspecified unspecified  	O	null
17 רצף רצף רצף noun masculine singular construct unspecified unspecified  	O	null
18 ה ה הזמן definiteArticle unspecified unspecified unspecified unspecified unspecified 0 
18 הזמן זמן הזמן noun masculine singular absolute unspecified unspecified  	O	null
19 ל ל למקטעים preposition unspecified unspecified unspecified unspecified unspecified 0 
19 מקטעים מקטע למקטעים noun masculine plural absolute unspecified unspecified  	O	null
20 קטנים קטן קטנים adjective masculine plural absolute unspecified unspecified  	O	null
21 . . . punctuation unspecified unspecified unspecified unspecified unspecified  	O	null

0 אותו אותו אותו quantifier unspecified unspecified construct unspecified unspecified  	O	null
1 עירוב עירוב עירוב noun masculine singular construct unspecified unspecified  	O	null
2 סגנוני סגנון סגנוני noun masculine plural construct unspecified unspecified  	O	null
3 ניכר ניכר ניכר adjective masculine singular absolute unspecified unspecified  	O	null
4 גם גם גם conjunction unspecified unspecified unspecified unspecified unspecified  	O	null
5 ב ב בטרילוגיה preposition unspecified unspecified unspecified unspecified unspecified 0 
5 ה ה בטרילוגיה definiteArticle unspecified unspecified unspecified unspecified unspecified 0 
5 הטרילוגיה הטרילוגיה בטרילוגיה noun feminine singular absolute unspecified unspecified  	O	null
6 ש ש שהתפרסמה relativizer/subordinatingConjunction unspecified unspecified unspecified unspecified unspecified 0 
6 התפרסמה התפרסם שהתפרסמה verb feminine singular unspecified 3 past  	O	null
7 ב ב בשנות preposition unspecified unspecified unspecified unspecified unspecified 0 
7 שנות שנה בשנות noun feminine plural construct unspecified unspecified  	I_DATE	null
8 ה ה השמונים definiteArticle unspecified unspecified unspecified unspecified unspecified 0 
8 השמונים ORD-CARD80 השמונים numeral masculine-and-feminine plural absolute unspecified unspecified  	I_DATE	null
9 : : : punctuation unspecified unspecified unspecified unspecified unspecified  	O	null
10 הרומניםהגבירה הרומניםהגבירה הרומניםהגבירה verb masculine-and-feminine plural unspecified 2 imperative  	O	null
11 ) ) ) punctuation unspecified unspecified unspecified unspecified unspecified  	O	null
12 , , , punctuation unspecified unspecified unspecified unspecified unspecified  	O	null
13 ###NUMBER### ###NUMBER### ###NUMBER### numeral unspecified unspecified unspecified unspecified unspecified  	I_DATE	null
14 העלם העלם העלם noun masculine singular absolute unspecified unspecified  	O	null
15 ( ( ( punctuation unspecified unspecified unspecified unspecified unspecified  	O	null
16 ###NUMBER### ###NUMBER### ###NUMBER### numeral unspecified unspecified unspecified unspecified unspecified  	I_DATE	null
17 ) ) ) punctuation unspecified unspecified unspecified unspecified unspecified  	O	null
18 ו ו והכלה conjunction unspecified unspecified unspecified unspecified unspecified 0 
18 ה ה והכלה definiteArticle unspecified unspecified unspecified unspecified unspecified 0 
18 הכלה כלה והכלה noun feminine singular absolute unspecified unspecified  	O	null
19 ה ה הנצחית definiteArticle unspecified unspecified unspecified unspecified unspecified 0 
19 הנצחית נצחי הנצחית adjective feminine singular absolute unspecified unspecified  	O	null
20 ( ( ( punctuation unspecified unspecified unspecified unspecified unspecified  	O	null
21 ) ) ) punctuation unspecified unspecified unspecified unspecified unspecified  	O	null
22 . . . punctuation unspecified unspecified unspecified unspecified unspecified  	O	null
23 ###NUMBER### ###NUMBER### ###NUMBER### numeral unspecified unspecified unspecified unspecified unspecified  	I_DATE	null
24 אלא אלא אלא conjunction unspecified unspecified unspecified unspecified unspecified  	O	null
25 ש ש שעתה relativizer/subordinatingConjunction unspecified unspecified unspecified unspecified unspecified 0 
25 עתה עתה שעתה adverb unspecified unspecified unspecified unspecified unspecified  	O	null
26 מוליכה הוליך מוליכה verb feminine singular unspecified any beinoni  	O	null
27 ה ה המיתולוגיה definiteArticle unspecified unspecified unspecified unspecified unspecified 0 
27 המיתולוגיה מיתולוגיה המיתולוגיה noun feminine singular absolute unspecified unspecified  	O	null
28 ה ה הפרטית definiteArticle unspecified unspecified unspecified unspecified unspecified 0 
28 הפרטית פרטי הפרטית adjective feminine singular absolute unspecified unspecified  	O	null
29 של של של shel-preposition unspecified unspecified unspecified unspecified unspecified  	O	null
30 ה ה הילדות definiteArticle unspecified unspecified unspecified unspecified unspecified 0 
30 הילדות ילדות הילדות noun feminine singular absolute unspecified unspecified  	O	null
31 מ מ מרחוב preposition unspecified unspecified unspecified unspecified unspecified 0 
31 רחוב רחוב מרחוב noun masculine singular absolute unspecified unspecified  	O	null
32 הטומוז'נה הטומוז'נה הטומוז'נה verb masculine-and-feminine plural unspecified 2 imperative  	O	null
33 אל אל אל noun masculine singular construct unspecified unspecified  	O	null
34 ה ה המיתולוגיה definiteArticle unspecified unspecified unspecified unspecified unspecified 0 
34 המיתולוגיה מיתולוגיה המיתולוגיה noun feminine singular absolute unspecified unspecified  	O	null
35 ה ה הפנטסטית definiteArticle unspecified unspecified unspecified unspecified unspecified 0 
35 הפנטסטית הפנטסטית הפנטסטית adjective feminine singular absolute unspecified unspecified  	O	null
36 של של של shel-preposition unspecified unspecified unspecified unspecified unspecified  	O	null
37 ה ה העולם definiteArticle unspecified unspecified unspecified unspecified unspecified 0 
37 העולם עולם העולם noun masculine singular absolute unspecified unspecified  	O	null
38 ה ה היהודי definiteArticle unspecified unspecified unspecified unspecified unspecified 0 
38 היהודי יהודי היהודי adjective masculine singular absolute unspecified unspecified  	O	null
39 , , , punctuation unspecified unspecified unspecified unspecified unspecified  	O	null
40 שבה שב שבה verb feminine singular unspecified 3 past  	O	null
41 , , , punctuation unspecified unspecified unspecified unspecified unspecified  	O	null
42 בין בין בין preposition unspecified unspecified unspecified unspecified unspecified  	O	null
43 ה ה השאר definiteArticle unspecified unspecified unspecified unspecified unspecified 0 
43 השאר שאר השאר noun masculine singular absolute unspecified unspecified  	O	null
44 , , , punctuation unspecified unspecified unspecified unspecified unspecified  	O	null
45 מתנהל התנהל מתנהל verb masculine singular unspecified any beinoni  	O	null
46 ויכוח ויכוח ויכוח noun masculine singular absolute unspecified unspecified  	O	null
47 היסטורי היסטורי היסטורי adjective masculine singular absolute unspecified unspecified  	O	null
48 בין בין בין preposition unspecified unspecified unspecified unspecified unspecified  	O	null
49 ה ה היהדות definiteArticle unspecified unspecified unspecified unspecified unspecified 0 
49 היהדות יהדות היהדות noun feminine singular absolute unspecified unspecified  	O	null
50 ל ל לנצרות preposition unspecified unspecified unspecified unspecified unspecified 0 
50 ה ה לנצרות definiteArticle unspecified unspecified unspecified unspecified unspecified 0 
50 הנצרות נצרות לנצרות noun feminine singular absolute unspecified unspecified  	O	null
51 . . . punctuation unspecified unspecified unspecified unspecified unspecified  	O	null

0 ב ב בשנות preposition unspecified unspecified unspecified unspecified unspecified 0 
0 שנות שנה בשנות noun feminine plural construct unspecified unspecified  	I_DATE	null
1 ה ה התשעים definiteArticle unspecified unspecified unspecified unspecified unspecified 0 
1 התשעים ORD-CARD90 התשעים numeral masculine-and-feminine plural absolute unspecified unspecified  	I_DATE	null
2 מסמנת סימן מסמנת verb feminine singular unspecified any beinoni  	O	null
3 כתיבת כתיבה כתיבתו noun feminine singular absolute unspecified unspecified  
3 ו ו כתיבתו possessive masculine singular unspecified 3 unspecified 0 	O	null
4 שיבה שיבה שיבה noun feminine singular absolute unspecified unspecified  	O	null
5 אל אל אל preposition unspecified unspecified unspecified unspecified unspecified  	O	null
6 ה ה הז'אנר definiteArticle unspecified unspecified unspecified unspecified unspecified 0 
6 הז'אנר ז'אנר הז'אנר noun masculine singular absolute unspecified unspecified  	O	null
7 ה ה הריאליסטי definiteArticle unspecified unspecified unspecified unspecified unspecified 0 
7 הריאליסטי ריאליסטי הריאליסטי adjective masculine singular absolute unspecified unspecified  	O	null
8 . . . punctuation unspecified unspecified unspecified unspecified unspecified  	O	null

0 ב ב בספרי preposition unspecified unspecified unspecified unspecified unspecified 0 
0 ספרי ספר בספרי noun masculine plural construct unspecified unspecified  	O	null
1 ה ה הפרוזה definiteArticle unspecified unspecified unspecified unspecified unspecified 0 
1 הפרוזה פרוזה הפרוזה noun feminine singular absolute unspecified unspecified  	O	null
2 ש ש שראו relativizer/subordinatingConjunction unspecified unspecified unspecified unspecified unspecified 0 
2 ראו ראה שראו verb masculine-and-feminine plural unspecified 3 past  	O	null
3 אור אור אור noun masculine singular absolute unspecified unspecified  	O	null
4 ב ב בעשור preposition unspecified unspecified unspecified unspecified unspecified 0 
4 עשור עשור בעשור noun masculine singular absolute unspecified unspecified  	O	null
5 זה זה זה pronoun masculine singular unspecified 3 unspecified  	O	null
6 ( ( ( punctuation unspecified unspecified unspecified unspecified unspecified  	O	null
7 אהבותקטנות,טירופים אהבותקטנות,טירופים אהבותקטנות,טירופים noun feminine plural absolute unspecified unspecified  	O	null
8 קטנים קטן קטנים adjective masculine plural absolute unspecified unspecified  	O	null
9 , , , punctuation unspecified unspecified unspecified unspecified unspecified  	O	null
10 ; ; ; punctuation unspecified unspecified unspecified unspecified unspecified  	O	null
11 לילה לילה לילה noun masculine singular absolute unspecified unspecified  	O	null
12 ###NUMBER### ###NUMBER### ###NUMBER### numeral unspecified unspecified unspecified unspecified unspecified  	I_DATE	null
13 ב ב בסנטה preposition unspecified unspecified unspecified unspecified unspecified 0 
13 סנטה סנטה בסנטה noun masculine singular construct unspecified unspecified  	O	null
14 פאולינה פאולינה פאולינה properName unspecified unspecified unspecified unspecified unspecified  	I_PERS	null
15 , , , punctuation unspecified unspecified unspecified unspecified unspecified  	O	null
16 ) ) ) punctuation unspecified unspecified unspecified unspecified unspecified  	O	null
17 ###NUMBER### ###NUMBER### ###NUMBER### numeral unspecified unspecified unspecified unspecified unspecified  	I_DATE	null
18 הוא הוא הוא pronoun masculine singular unspecified 3 unspecified  	O	null
19 מתעד תיעד מתעד verb masculine singular unspecified any beinoni  	O	null
20 את את את at-preposition unspecified unspecified unspecified unspecified unspecified  	O	null
21 ישראל ישראל ישראל properName unspecified unspecified unspecified unspecified unspecified  	I_PERS	null
22 תוך תוך תוך preposition unspecified unspecified unspecified unspecified unspecified  	O	null
23 ויתור ויתור ויתור noun masculine singular absolute unspecified unspecified  	O	null
24 על על על preposition unspecified unspecified unspecified unspecified unspecified  	O	null
25 ה ה הבדיה definiteArticle unspecified unspecified unspecified unspecified unspecified 0 
25 הבדיה בדיה הבדיה noun feminine singular absolute unspecified unspecified  	O	null
26 ה ה המופלגת definiteArticle unspecified unspecified unspecified unspecified unspecified 0 
26 המופלגת מופלג המופלגת adjective feminine singular absolute unspecified unspecified  	O	null
27 ו ו ועל conjunction unspecified unspecified unspecified unspecified unspecified 0 
27 על על ועל preposition unspecified unspecified unspecified unspecified unspecified  	O	null
28 ה ה ההתחקות definiteArticle unspecified unspecified unspecified unspecified unspecified 0 
28 ההתחקות התחקות ההתחקות noun feminine singular absolute unspecified unspecified  	O	null
29 אחר אחר אחר preposition unspecified unspecified unspecified unspecified unspecified  	O	null
30 שורשי שורש שורשי noun masculine plural construct unspecified unspecified  	O	null
31 ה ה ההוויה definiteArticle unspecified unspecified unspecified unspecified unspecified 0 
31 ההוויה הוויה ההוויה noun feminine singular absolute unspecified unspecified  	O	null
32 ה ה היהודית definiteArticle unspecified unspecified unspecified unspecified unspecified 0 
32 היהודית יהודי היהודית adjective feminine singular absolute unspecified unspecified  	O	null
33 , , , punctuation unspecified unspecified unspecified unspecified unspecified  	O	null
34 ש ש שאפיינו relativizer/subordinatingConjunction unspecified unspecified unspecified unspecified unspecified 0 
34 אפיינו אפיין שאפיינו verb masculine-and-feminine plural unspecified 3 past  	O	null
35 את את את at-preposition unspecified unspecified unspecified unspecified unspecified  	O	null
36 כתיבת כתיבה כתיבתו noun feminine singular absolute unspecified unspecified  
36 ו ו כתיבתו possessive masculine singular unspecified 3 unspecified 0 	O	null
37 ב ב בעבר preposition unspecified unspecified unspecified unspecified unspecified 0 
37 ה ה בעבר definiteArticle unspecified unspecified unspecified unspecified unspecified 0 
37 העבר עבר בעבר noun masculine singular absolute unspecified unspecified  	O	null
38 . . . punctuation unspecified unspecified unspecified unspecified unspecified  	O	null

0 ב ב במבט preposition unspecified unspecified unspecified unspecified unspecified 0 
0 מבט מבט במבט noun masculine singular construct unspecified unspecified  	O	null
1 - - - punctuation unspecified unspecified unspecified unspecified unspecified  	O	null
2 על על על preposition unspecified unspecified unspecified unspecified unspecified  	O	null
3 נראה נראה נראה verb masculine singular unspecified 3 past  	O	null
4 כי כי כי conjunction unspecified unspecified unspecified unspecified unspecified  	O	null
5 סגנון סגנון סגנונו noun masculine singular absolute unspecified unspecified  
5 ו ו סגנונו possessive masculine singular unspecified 3 unspecified 0 	O	null
6 של של של shel-preposition unspecified unspecified unspecified unspecified unspecified  	O	null
7 אורפז אורפז אורפז properName unspecified unspecified unspecified unspecified unspecified  	I_PERS	null
8 נע נע נע verb masculine singular unspecified 3 past  	O	null
9 בין בין בין preposition unspecified unspecified unspecified unspecified unspecified  	O	null
10 ה ה הריאליזם definiteArticle unspecified unspecified unspecified unspecified unspecified 0 
10 הריאליזם ריאליזם הריאליזם noun masculine singular absolute unspecified unspecified  	O	null
11 לבין לבין לבין preposition unspecified unspecified unspecified unspecified unspecified  	O	null
12 המטא המטא המטא noun masculine singular construct unspecified unspecified  	O	null
13 - - - punctuation unspecified unspecified unspecified unspecified unspecified  	O	null
14 ריאליזם ריאליזם ריאליזם noun masculine singular absolute unspecified unspecified  	O	null
15 , , , punctuation unspecified unspecified unspecified unspecified unspecified  	O	null
16 בין בין בין preposition unspecified unspecified unspecified unspecified unspecified  	O	null
17 ה ה ההיצמדות definiteArticle unspecified unspecified unspecified unspecified unspecified 0 
17 ההיצמדות היצמדות ההיצמדות noun feminine singular absolute unspecified unspecified  	O	null
18 ל ל לפרטי preposition unspecified unspecified unspecified unspecified unspecified 0 
18 פרטי פרט לפרטי noun masculine plural construct unspecified unspecified  	O	null
19 ה ה המקום definiteArticle unspecified unspecified unspecified unspecified unspecified 0 
19 המקום מקום המקום noun masculine singular absolute unspecified unspecified  	O	null
20 לבין לבין לבין preposition unspecified unspecified unspecified unspecified unspecified  	O	null
21 ה ה ההפלגה definiteArticle unspecified unspecified unspecified unspecified unspecified 0 
21 ההפלגה הפלגה ההפלגה noun feminine singular absolute unspecified unspecified  	O	null
22 אל אל אל preposition unspecified unspecified unspecified unspecified unspecified  	O	null
23 מרחבי מרחב מרחבי noun masculine plural construct unspecified unspecified  	O	null
24 ה ה הדמיון definiteArticle unspecified unspecified unspecified unspecified unspecified 0 
24 הדמיון דמיון הדמיון noun masculine singular absolute unspecified unspecified  	O	null
25 ו ו וההכללה conjunction unspecified unspecified unspecified unspecified unspecified 0 
25 ה ה וההכללה definiteArticle unspecified unspecified unspecified unspecified unspecified 0 
25 ההכללה הכללה וההכללה noun feminine singular absolute unspecified unspecified  	O	null
26 ה ה האינטלקטואלית definiteArticle unspecified unspecified unspecified unspecified unspecified 0 
26 האינטלקטואלית אינטלקטואלי האינטלקטואלית adjective feminine singular absolute unspecified unspecified  	O	null
27 . . . punctuation unspecified unspecified unspecified unspecified unspecified  	O	null

0 כתיבת כתיבה כתיבתו noun feminine singular absolute unspecified unspecified  
0 ו ו כתיבתו possessive masculine singular unspecified 3 unspecified 0 	O	null
1 , , , punctuation unspecified unspecified unspecified unspecified unspecified  	O	null
2 כמו כמו כמו conjunction unspecified unspecified unspecified unspecified unspecified  	O	null
3 שמותי שם שמותיו noun masculine plural absolute unspecified unspecified  
3 ו ו שמותיו possessive masculine singular unspecified 3 unspecified 0 	O	null
4 , , , punctuation unspecified unspecified unspecified unspecified unspecified  	O	null
5 נולדה נולד נולדה verb feminine singular unspecified 3 past  	O	null
6 פעמיים פעמיים פעמיים adverb unspecified unspecified unspecified unspecified unspecified  	O	null
7 מחדש מחדש מחדש adverb unspecified unspecified unspecified unspecified unspecified  	O	null
8 מתוך מתוך מתוך preposition unspecified unspecified unspecified unspecified unspecified  	O	null
9 שתי CARD2 שתי numeral feminine dual construct unspecified unspecified  	O	null
10 מיתות מיתה מיתות noun feminine plural absolute unspecified unspecified  	O	null
11 , , , punctuation unspecified unspecified unspecified unspecified unspecified  	O	null
12 מות מוות מות noun masculine singular construct unspecified unspecified  	O	null
13 משפחת משפחה משפחתו noun feminine singular absolute unspecified unspecified  
13 ו ו משפחתו possessive masculine singular unspecified 3 unspecified 0 	O	null
14 ב ב בשואה preposition unspecified unspecified unspecified unspecified unspecified 0 
14 ה ה בשואה definiteArticle unspecified unspecified unspecified unspecified unspecified 0 
14 השואה שואה בשואה noun feminine singular absolute unspecified unspecified  	O	null
15 ו ו ומות conjunction unspecified unspecified unspecified unspecified unspecified 0 
15 מות מוות ומות noun masculine singular construct unspecified unspecified  	O	null
16 בן בן בן noun masculine singular construct unspecified unspecified  	O	null
17 אחי אח אחיו noun masculine plural absolute unspecified unspecified  
17 ו ו אחיו possessive masculine singular unspecified 3 unspecified 0 	O	null
18 ב ב במלחמה preposition unspecified unspecified unspecified unspecified unspecified 0 
18 ה ה במלחמה definiteArticle unspecified unspecified unspecified unspecified unspecified 0 
18 המלחמה מלחמה במלחמה noun feminine singular absolute unspecified unspecified  	O	null
19 . . . punctuation unspecified unspecified unspecified unspecified unspecified  	O	null

0 ב ב בתולדות preposition unspecified unspecified unspecified unspecified unspecified 0 
0 תולדות תולדה בתולדות noun feminine plural construct unspecified unspecified  	O	null
1 ה ה הסיפורת definiteArticle unspecified unspecified unspecified unspecified unspecified 0 
1 הסיפורת סיפורת הסיפורת noun feminine singular absolute unspecified unspecified  	O	null
2 ה ה הישראלית definiteArticle unspecified unspecified unspecified unspecified unspecified 0 
2 הישראלית ישראלי הישראלית adjective feminine singular absolute unspecified unspecified  	O	null
3 שמור שמור שמור adjective masculine singular absolute unspecified unspecified  	O	null
4 ל ל לאורפז preposition unspecified unspecified unspecified unspecified unspecified 0 
4 אורפז אורפז לאורפז properName feminine singular unspecified unspecified unspecified  	I_PERS	null
5 מקום מקום מקום noun masculine singular absolute unspecified unspecified  	O	null
6 מיוחד מיוחד מיוחד adjective masculine singular absolute unspecified unspecified  	O	null
7 כ כ כסופר preposition unspecified unspecified unspecified unspecified unspecified 0 
7 ה ה כסופר definiteArticle unspecified unspecified unspecified unspecified unspecified 0 
7 הסופר סופר כסופר noun masculine singular absolute unspecified unspecified  	O	null
8 ש ש שחיפש relativizer/subordinatingConjunction unspecified unspecified unspecified unspecified unspecified 0 
8 חיפש חיפש שחיפש verb masculine singular unspecified 3 past  	O	null
9 ו ו ומצא conjunction unspecified unspecified unspecified unspecified unspecified 0 
9 מצא מצא ומצא verb masculine singular unspecified 3 past  	O	null
10 כמה כמה כמה quantifier unspecified unspecified construct unspecified unspecified  	O	null
11 אפיקי אפיק אפיקי noun masculine plural construct unspecified unspecified  	O	null
12 יצירה יצירה יצירה noun feminine singular absolute unspecified unspecified  	O	null
13 ניסיוניים ניסיוני ניסיוניים adjective masculine plural absolute unspecified unspecified  	O	null
14 , , , punctuation unspecified unspecified unspecified unspecified unspecified  	O	null
15 ה ה המשקפים definiteArticle unspecified unspecified unspecified unspecified unspecified 0 
15 המשקפים שיקף המשקפים participle masculine plural absolute any unspecified  	O	null
16 תפישת תפישה תפישת noun feminine singular construct unspecified unspecified  	O	null
17 עולם עולם עולם noun masculine singular absolute unspecified unspecified  	O	null
18 מקורית מקורי מקורית adjective feminine singular absolute unspecified unspecified  	O	null
19 ו ו וייחודית conjunction unspecified unspecified unspecified unspecified unspecified 0 
19 ייחודית ייחודי וייחודית adjective feminine singular absolute unspecified unspecified  	O	null
20 . . . punctuation unspecified unspecified unspecified unspecified unspecified  	O	null

0 זכה זך זכה adjective feminine singular absolute unspecified unspecified  	O	null
1 ב ב בפרסים preposition unspecified unspecified unspecified unspecified unspecified 0 
1 ה ה בפרסים definiteArticle unspecified unspecified unspecified unspecified unspecified 0 
1 הפרסים פרס בפרסים noun masculine plural absolute unspecified unspecified  	O	null
2 רבים רב רבים verb masculine plural unspecified any beinoni  	O	null
3 : : : punctuation unspecified unspecified unspecified unspecified unspecified  	O	null
4 פרס פרס פרס properName masculine singular unspecified unspecified unspecified  	I_LOC	null
5 ב ב ברש preposition unspecified unspecified unspecified unspecified unspecified 0 
5 רש רש ברש adjective masculine singular construct unspecified unspecified  	O	null
6 ) ) ) punctuation unspecified unspecified unspecified unspecified unspecified  	O	null
7 , , , punctuation unspecified unspecified unspecified unspecified unspecified  	O	null
8 ###NUMBER### ###NUMBER### ###NUMBER### numeral unspecified unspecified unspecified unspecified unspecified  	I_DATE	null
9 פרס פרס פרס properName masculine singular unspecified unspecified unspecified  	I_PERS	null
10 טלפיר טלפיר טלפיר properName unspecified unspecified unspecified unspecified unspecified  	I_PERS	null
11 ) ) ) punctuation unspecified unspecified unspecified unspecified unspecified  	O	null
12 , , , punctuation unspecified unspecified unspecified unspecified unspecified  	O	null
13 ###NUMBER### ###NUMBER### ###NUMBER### numeral unspecified unspecified unspecified unspecified unspecified  	I_DATE	null
14 פרס פרס פרס properName masculine singular unspecified unspecified unspecified  	I_PERS	null
15 פיכמן פיכמן פיכמן properName unspecified unspecified unspecified unspecified unspecified  	I_PERS	null
16 ) ) ) punctuation unspecified unspecified unspecified unspecified unspecified  	O	null
17 , , , punctuation unspecified unspecified unspecified unspecified unspecified  	O	null
18 ###NUMBER### ###NUMBER### ###NUMBER### numeral unspecified unspecified unspecified unspecified unspecified  	I_DATE	null
19 פרס פרס פרס properName masculine singular unspecified unspecified unspecified  	I_PERS	null
20 ה ה היצירה definiteArticle unspecified unspecified unspecified unspecified unspecified 0 
20 היצירה יצירה היצירה noun feminine singular absolute unspecified unspecified  	O	null
21 עלשם עלשם עלשם noun masculine singular absolute unspecified unspecified  	O	null
22 ראש ראש ראש noun masculine singular construct unspecified unspecified  	O	null
23 ה ה הממשלה definiteArticle unspecified unspecified unspecified unspecified unspecified 0 
23 הממשלה ממשלה הממשלה noun feminine singular absolute unspecified unspecified  	O	null
24 לוי לוי לוי properName unspecified unspecified unspecified unspecified unspecified  	I_PERS	null
25 אשכול אשכול אשכול properName unspecified unspecified unspecified unspecified unspecified  	I_PERS	null
26 , , , punctuation unspecified unspecified unspecified unspecified unspecified  	O	null
27 ###NUMBER### ###NUMBER### ###NUMBER### numeral unspecified unspecified unspecified unspecified unspecified  	I_DATE	null
28 , , , punctuation unspecified unspecified unspecified unspecified unspecified  	O	null
29 ###NUMBER### ###NUMBER### ###NUMBER### numeral unspecified unspecified unspecified unspecified unspecified  	I_DATE	null
30 ) ) ) punctuation unspecified unspecified unspecified unspecified unspecified  	O	null
31 , , , punctuation unspecified unspecified unspecified unspecified unspecified  	O	null
32 ###NUMBER### ###NUMBER### ###NUMBER### numeral unspecified unspecified unspecified unspecified unspecified  	I_DATE	null
33 פרס פרס פרס properName masculine singular unspecified unspecified unspecified  	I_DATE	null
34 ישראל ישראל ישראל properName unspecified unspecified unspecified unspecified unspecified  	I_PERS	null
35 אפרת אפרת אפרת properName unspecified unspecified unspecified unspecified unspecified  	I_PERS	null
36 ) ) ) punctuation unspecified unspecified unspecified unspecified unspecified  	O	null
37 , , , punctuation unspecified unspecified unspecified unspecified unspecified  	O	null
38 ###NUMBER### ###NUMBER### ###NUMBER### numeral unspecified unspecified unspecified unspecified unspecified  	I_DATE	null
39 פרס פרס פרס properName masculine singular unspecified unspecified unspecified  	I_PERS	null
40 ביאליק ביאליק ביאליק properName unspecified unspecified unspecified unspecified unspecified  	I_PERS	null
41 על על על preposition unspecified unspecified unspecified unspecified unspecified  	O	null
42 מפעל מפעל מפעל noun masculine singular construct unspecified unspecified  	O	null
43 חיים חיים חיים noun masculine plural absolute unspecified unspecified  	O	null
44 ) ) ) punctuation unspecified unspecified unspecified unspecified unspecified  	O	null
45 , , , punctuation unspecified unspecified unspecified unspecified unspecified  	O	null
46 ###NUMBER### ###NUMBER### ###NUMBER### numeral unspecified unspecified unspecified unspecified unspecified  	I_DATE	null
47 פרס פרס פרס properName masculine singular unspecified unspecified unspecified  	I_PERS	null
48 ניומן ניומן ניומן properName unspecified unspecified unspecified unspecified unspecified  	I_PERS	null
49 מ מ מאוניברסיטת preposition unspecified unspecified unspecified unspecified unspecified 0 
49 אוניברסיטת אוניברסיטה מאוניברסיטת noun feminine singular construct unspecified unspecified  	I_ORG	null
50 בר בר בר properName unspecified unspecified unspecified unspecified unspecified  	I_ORG	null
51 - - - properName unspecified unspecified unspecified unspecified unspecified  	I_ORG	null
52 אילן אילן אילן properName unspecified unspecified unspecified unspecified unspecified  	I_ORG	null
53 על על על preposition unspecified unspecified unspecified unspecified unspecified  	O	null
54 מפעל מפעל מפעל noun masculine singular construct unspecified unspecified  	O	null
55 חיים חיים חיים noun masculine plural absolute unspecified unspecified  	O	null
56 ) ) ) punctuation unspecified unspecified unspecified unspecified unspecified  	O	null
57 , , , punctuation unspecified unspecified unspecified unspecified unspecified  	O	null
58 ###NUMBER### ###NUMBER### ###NUMBER### numeral unspecified unspecified unspecified unspecified unspecified  	I_DATE	null
59 פרס פרס פרס properName masculine singular unspecified unspecified unspecified  	I_PERS	null
60 נשיא נשיא נשיא noun masculine singular construct unspecified unspecified  	O	null
61 ה ה המדינה definiteArticle unspecified unspecified unspecified unspecified unspecified 0 
61 המדינה מדינה המדינה noun feminine singular absolute unspecified unspecified  	O	null
62 על על על preposition unspecified unspecified unspecified unspecified unspecified  	O	null
63 מפעל מפעל מפעל noun masculine singular construct unspecified unspecified  	O	null
64 חיים חיים חיים noun masculine plural absolute unspecified unspecified  	O	null
65 ( ( ( punctuation unspecified unspecified unspecified unspecified unspecified  	O	null
66 ###NUMBER### ###NUMBER### ###NUMBER### numeral unspecified unspecified unspecified unspecified unspecified  	I_DATE	null
67 ) ) ) punctuation unspecified unspecified unspecified unspecified unspecified  	O	null
68 ו ו ופרס conjunction unspecified unspecified unspecified unspecified unspecified 0 
68 פרס פרס ופרס properName unspecified unspecified unspecified unspecified unspecified  	I_PERS	null
69 ישראל ישראל ישראל properName unspecified unspecified unspecified unspecified unspecified  	I_PERS	null
70 ) ) ) punctuation unspecified unspecified unspecified unspecified unspecified  	O	null
71 . . . punctuation unspecified unspecified unspecified unspecified unspecified  	O	null
72 ###NUMBER### ###NUMBER### ###NUMBER### numeral unspecified unspecified unspecified unspecified unspecified  	I_DATE	null
73 References References References foreign unspecified unspecified unspecified unspecified unspecified  	O	null
74 : : : punctuation unspecified unspecified unspecified unspecified unspecified  	O	null
75 ב ב בלבן preposition unspecified unspecified unspecified unspecified unspecified 0 
75 לב לב בלבן noun masculine singular absolute unspecified unspecified  
75 ן ן בלבן possessive feminine plural unspecified 3 unspecified 0 	O	null
76 , , , punctuation unspecified unspecified unspecified unspecified unspecified  	O	null
77 אברהם אברהם אברהם properName unspecified unspecified unspecified unspecified unspecified  	I_PERS	null
78 . . . punctuation unspecified unspecified unspecified unspecified unspecified  	O	null

0 גל גל גל noun masculine singular absolute unspecified unspecified  	O	null
1 אחר אחר אחר adjective masculine singular absolute unspecified unspecified  	O	null
2 ב ב בסיפורת preposition unspecified unspecified unspecified unspecified unspecified 0 
2 ה ה בסיפורת definiteArticle unspecified unspecified unspecified unspecified unspecified 0 
2 הסיפורת סיפורת בסיפורת noun feminine singular absolute unspecified unspecified  	O	null
3 ה ה העברית definiteArticle unspecified unspecified unspecified unspecified unspecified 0 
3 העברית עברי העברית adjective feminine singular absolute unspecified unspecified  	O	null
4 . . . punctuation unspecified unspecified unspecified unspecified unspecified  	O	null

0 ירושלים ירושלים ירושלים properName unspecified unspecified unspecified unspecified unspecified  	I_LOC	null
1 : : : punctuation unspecified unspecified unspecified unspecified unspecified  	O	null
2 כתר כתר כתר noun masculine singular absolute unspecified unspecified  	O	null
3 . . . punctuation unspecified unspecified unspecified unspecified unspecified  	O	null

0 ###NUMBER### ###NUMBER### ###NUMBER### numeral unspecified unspecified unspecified unspecified unspecified  	I_DATE	null
1 . . . punctuation unspecified unspecified unspecified unspecified unspecified  	O	null

0 - - - punctuation unspecified unspecified unspecified unspecified unspecified  	O	null
1 ###NUMBER### ###NUMBER### ###NUMBER### numeral unspecified unspecified unspecified unspecified unspecified  	O	null
2 ; ; ; punctuation unspecified unspecified unspecified unspecified unspecified  	O	null
3 ###NUMBER### ###NUMBER### ###NUMBER### numeral unspecified unspecified unspecified unspecified unspecified  	O	null
4 ב ב ברמה preposition unspecified unspecified unspecified unspecified unspecified 0 
4 ה ה ברמה definiteArticle unspecified unspecified unspecified unspecified unspecified 0 
4 הרמה רמה ברמה noun feminine singular absolute unspecified unspecified  	O	null
5 , , , punctuation unspecified unspecified unspecified unspecified unspecified  	O	null
6 ישראל ישראל ישראל properName unspecified unspecified unspecified unspecified unspecified  	I_LOC	null
7 . . . punctuation unspecified unspecified unspecified unspecified unspecified  	O	null

0 " " " punctuation unspecified unspecified unspecified unspecified unspecified  	O	null
1 תרנגול תרנגול תרנגול noun masculine singular absolute unspecified unspecified  	O	null
2 של של של shel-preposition unspecified unspecified unspecified unspecified unspecified  	O	null
3 זהב זהב זהב noun masculine singular absolute unspecified unspecified  	O	null
4 על על על preposition unspecified unspecified unspecified unspecified unspecified  	O	null
5 גג גג גג noun masculine singular construct unspecified unspecified  	O	null
6 תל תל תל properName unspecified unspecified unspecified unspecified unspecified  	I_ORG	null
7 אביבי אביבי אביבי adjective masculine singular absolute unspecified unspecified  	O	null
8 " " " punctuation unspecified unspecified unspecified unspecified unspecified  	O	null
9 . . . punctuation unspecified unspecified unspecified unspecified unspecified  	O	null

0 עכשיו עכשיו עכשיו adverb unspecified unspecified unspecified unspecified unspecified  	O	null
1 ###NUMBER### ###NUMBER### ###NUMBER### numeral unspecified unspecified unspecified unspecified unspecified  	O	null
2 - - - punctuation unspecified unspecified unspecified unspecified unspecified  	O	null
3 ###NUMBER### ###NUMBER### ###NUMBER### numeral unspecified unspecified unspecified unspecified unspecified  	O	null
4 . . . punctuation unspecified unspecified unspecified unspecified unspecified  	O	null

0 ###NUMBER### ###NUMBER### ###NUMBER### numeral unspecified unspecified unspecified unspecified unspecified  	I_DATE	null
1 . . . punctuation unspecified unspecified unspecified unspecified unspecified  	O	null

0 - - - punctuation unspecified unspecified unspecified unspecified unspecified  	O	null
1 ###NUMBER### ###NUMBER### ###NUMBER### numeral unspecified unspecified unspecified unspecified unspecified  	O	null
2 ; ; ; punctuation unspecified unspecified unspecified unspecified unspecified  	O	null
3 ###NUMBER### ###NUMBER### ###NUMBER### numeral unspecified unspecified unspecified unspecified unspecified  	O	null
4 ברתנא ברתנא ברתנא properName unspecified unspecified unspecified unspecified unspecified  	I_PERS	null
5 , , , punctuation unspecified unspecified unspecified unspecified unspecified  	O	null
6 אורציון אורציון אורציון properName unspecified unspecified unspecified unspecified unspecified  	I_PERS	null
7 . . . punctuation unspecified unspecified unspecified unspecified unspecified  	O	null

0       punctuation unspecified unspecified unspecified unspecified unspecified  	O	null
1 " " " punctuation unspecified unspecified unspecified unspecified unspecified  	O	null
2 יצחק יצחק יצחק properName unspecified unspecified unspecified unspecified unspecified  	I_PERS	null
3 אוורבוך אוורבוך אוורבוך properName unspecified unspecified unspecified unspecified unspecified  	I_PERS	null
4 אורפז אורפז אורפז properName unspecified unspecified unspecified unspecified unspecified  	I_PERS	null
5 : : : punctuation unspecified unspecified unspecified unspecified unspecified  	O	null
6 אקזיסטנציאליסם אקזיסטנציאליסם אקזיסטנציאליסם properName unspecified unspecified unspecified unspecified unspecified  	I_ORG	null
7 , , , punctuation unspecified unspecified unspecified unspecified unspecified  	O	null
8 סמליות סמלי סמליות adjective feminine plural absolute unspecified unspecified  	O	null
9 , , , punctuation unspecified unspecified unspecified unspecified unspecified  	O	null
10 מטאפיסיקה מטאפיסיקה מטאפיסיקה verb masculine plural unspecified any beinoni  	O	null
11 " " " punctuation unspecified unspecified unspecified unspecified unspecified  	O	null
12 . . . punctuation unspecified unspecified unspecified unspecified unspecified  	O	null

0 ה ה הפנטאסיה definiteArticle unspecified unspecified unspecified unspecified unspecified 0 
0 הפנטאסיה הפנטאסיה הפנטאסיה noun feminine plural absolute unspecified unspecified  	O	null
1 ב ב בסיפורת preposition unspecified unspecified unspecified unspecified unspecified 0 
1 סיפורת סיפורת בסיפורת noun feminine singular construct unspecified unspecified  	O	null
2 דור דור דור noun masculine singular construct unspecified unspecified  	O	null
3 ה ה המדינה definiteArticle unspecified unspecified unspecified unspecified unspecified 0 
3 המדינה מדינה המדינה noun feminine singular absolute unspecified unspecified  	O	null
4 . . . punctuation unspecified unspecified unspecified unspecified unspecified  	O	null

0 תלאביב תלאביב תלאביב properName unspecified unspecified unspecified unspecified unspecified  	I_PERS	null
1 : : : punctuation unspecified unspecified unspecified unspecified unspecified  	O	null
2 ה ה הקיבוץ definiteArticle unspecified unspecified unspecified unspecified unspecified 0 
2 הקיבוץ קיבוץ הקיבוץ noun masculine singular absolute unspecified unspecified  	O	null
3 ה ה המאוחד definiteArticle unspecified unspecified unspecified unspecified unspecified 0 
3 המאוחד מאוחד המאוחד adjective masculine singular absolute unspecified unspecified  	O	null
4 . . . punctuation unspecified unspecified unspecified unspecified unspecified  	O	null

0 ###NUMBER### ###NUMBER### ###NUMBER### numeral unspecified unspecified unspecified unspecified unspecified  	I_DATE	null
1 . . . punctuation unspecified unspecified unspecified unspecified unspecified  	O	null

0 - - - punctuation unspecified unspecified unspecified unspecified unspecified  	O	null
1 ###NUMBER### ###NUMBER### ###NUMBER### numeral unspecified unspecified unspecified unspecified unspecified  	O	null
2 ; ; ; punctuation unspecified unspecified unspecified unspecified unspecified  	O	null
3 ###NUMBER### ###NUMBER### ###NUMBER### numeral unspecified unspecified unspecified unspecified unspecified  	O	null
4 כספי כספי כספי properName unspecified unspecified unspecified unspecified unspecified  	I_PERS	null
5 , , , punctuation unspecified unspecified unspecified unspecified unspecified  	O	null
6 זהבה זהבה זהבה properName unspecified unspecified unspecified unspecified unspecified  	I_PERS	null
7 ו ו ויגאל conjunction unspecified unspecified unspecified unspecified unspecified 0 
7 יגאל יגאל ויגאל properName unspecified unspecified unspecified unspecified unspecified  	B_PERS	null
8 שוורץ שוורץ שוורץ properName unspecified unspecified unspecified unspecified unspecified  	I_PERS	null
9 . . . punctuation unspecified unspecified unspecified unspecified unspecified  	O	null

0 " " " punctuation unspecified unspecified unspecified unspecified unspecified  	O	null
1 ' ' ' punctuation unspecified unspecified unspecified unspecified unspecified  	O	null
2 טוב טוב טוב adjective masculine singular absolute unspecified unspecified  	O	null
3 ל ל לי preposition unspecified unspecified unspecified unspecified unspecified  
3 י י לי pronomial masculine-and-feminine singular unspecified 1 unspecified 0 	O	null
4 שם שם שם adverb unspecified unspecified unspecified unspecified unspecified  	O	null
5 ב ב בארצות preposition unspecified unspecified unspecified unspecified unspecified 0 
5 ארצות ארץ בארצות noun feminine plural construct unspecified unspecified  	O	null
6 ה ה התפר definiteArticle unspecified unspecified unspecified unspecified unspecified 0 
6 התפר תפר התפר noun masculine singular absolute unspecified unspecified  	O	null
7 ' ' ' punctuation unspecified unspecified unspecified unspecified unspecified  	O	null
8 : : : punctuation unspecified unspecified unspecified unspecified unspecified  	O	null
9 ריאיון ראיון ריאיון noun masculine singular absolute unspecified unspecified  	O	null
10 ב ב בהתכתבות preposition unspecified unspecified unspecified unspecified unspecified 0 
10 התכתבות התכתבות בהתכתבות noun feminine singular absolute unspecified unspecified  	O	null
11 עם עם עם preposition unspecified unspecified unspecified unspecified unspecified  	O	null
12 יצחק יצחק יצחק properName unspecified unspecified unspecified unspecified unspecified  	I_PERS	null
13 אוורבוך אוורבוך אוורבוך properName unspecified unspecified unspecified unspecified unspecified  	I_PERS	null
14 אורפז אורפז אורפז properName unspecified unspecified unspecified unspecified unspecified  	I_PERS	null
15 " " " punctuation unspecified unspecified unspecified unspecified unspecified  	O	null
16 . . . punctuation unspecified unspecified unspecified unspecified unspecified  	O	null
17       punctuation unspecified unspecified unspecified unspecified unspecified  	O	null
18 מכאן מכאן מכאן adverb unspecified unspecified unspecified unspecified unspecified  	O	null
19 ו ו ו conjunction unspecified unspecified unspecified unspecified unspecified  	O	null
20 ' ' ' punctuation unspecified unspecified unspecified unspecified unspecified  	O	null
21 . . . punctuation unspecified unspecified unspecified unspecified unspecified  	O	null
22 דצמבר דצמבר דצמבר properName unspecified unspecified unspecified unspecified unspecified  	I_DATE	null
23 ###NUMBER### ###NUMBER### ###NUMBER### numeral unspecified unspecified unspecified unspecified unspecified  	I_DATE	null
24 - - - punctuation unspecified unspecified unspecified unspecified unspecified  	O	null
25 ###NUMBER### ###NUMBER### ###NUMBER### numeral unspecified unspecified unspecified unspecified unspecified  	O	null
26 ; ; ; punctuation unspecified unspecified unspecified unspecified unspecified  	O	null
27 פרי פרי פרי properName unspecified unspecified unspecified unspecified unspecified  	I_PERS	null
28 מנחם מנחם מנחם properName unspecified unspecified unspecified unspecified unspecified  	I_PERS	null
29 . . . punctuation unspecified unspecified unspecified unspecified unspecified  	O	null

0 " " " punctuation unspecified unspecified unspecified unspecified unspecified  	O	null
1 חוט חוט חוט noun masculine singular absolute unspecified unspecified  	O	null
2 של של של shel-preposition unspecified unspecified unspecified unspecified unspecified  	O	null
3 זהב זהב זהב noun masculine singular absolute unspecified unspecified  	O	null
4 ו ו וחוט conjunction unspecified unspecified unspecified unspecified unspecified 0 
4 חוט חוט וחוט noun masculine singular absolute unspecified unspecified  	O	null
5 של של של shel-preposition unspecified unspecified unspecified unspecified unspecified  	O	null
6 כסף כסף כסף noun masculine singular absolute unspecified unspecified  	O	null
7 " " " punctuation unspecified unspecified unspecified unspecified unspecified  	O	null
8 . . . punctuation unspecified unspecified unspecified unspecified unspecified  	O	null

0 דבר דבר דבר noun masculine singular absolute unspecified unspecified  	O	null
1 . . . punctuation unspecified unspecified unspecified unspecified unspecified  	O	null

0 ###NUMEXP### ###NUMEXP### ###NUMEXP### numberExpression unspecified unspecified unspecified unspecified unspecified  	I_DATE	null
1 ; ; ; punctuation unspecified unspecified unspecified unspecified unspecified  	O	null
2 שמיר שמיר שמיר properName unspecified unspecified unspecified unspecified unspecified  	I_PERS	null
3 , , , punctuation unspecified unspecified unspecified unspecified unspecified  	O	null
4 זיוה זיוה זיוה properName unspecified unspecified unspecified unspecified unspecified  	I_PERS	null
5 . . . punctuation unspecified unspecified unspecified unspecified unspecified  	O	null

0 " " " punctuation unspecified unspecified unspecified unspecified unspecified  	O	null
1 קליל קליל קליל adjective masculine singular absolute unspecified unspecified  	O	null
2 ו ו ועמוק conjunction unspecified unspecified unspecified unspecified unspecified 0 
2 עמוק עמוק ועמוק adjective masculine singular absolute unspecified unspecified  	O	null
3 , , , punctuation unspecified unspecified unspecified unspecified unspecified  	O	null
4 על על על preposition unspecified unspecified unspecified unspecified unspecified  	O	null
5 אהבות אהבה אהבות noun feminine plural absolute unspecified unspecified  	O	null
6 קטנות קטן קטנות adjective feminine plural absolute unspecified unspecified  	O	null
7 , , , punctuation unspecified unspecified unspecified unspecified unspecified  	O	null
8 טירופים טירוף טירופים noun masculine plural absolute unspecified unspecified  	O	null
9 קטנים קטן קטנים adjective masculine plural absolute unspecified unspecified  	O	null
10 " " " punctuation unspecified unspecified unspecified unspecified unspecified  	O	null
11 . . . punctuation unspecified unspecified unspecified unspecified unspecified  	O	null

0 ידיעות ידיעה ידיעות noun feminine plural absolute unspecified unspecified  	I_ORG	null
1 אחרונות אחרון אחרונות adjective feminine plural absolute unspecified unspecified  	I_ORG	null
2 . . . punctuation unspecified unspecified unspecified unspecified unspecified  	O	null

0 ###NUMEXP### ###NUMEXP### ###NUMEXP### numberExpression unspecified unspecified unspecified unspecified unspecified  	I_DATE	null
1 ; ; ; punctuation unspecified unspecified unspecified unspecified unspecified  	O	null
2 שקד שקד שקד properName unspecified unspecified unspecified unspecified unspecified  	I_PERS	null
3 , , , punctuation unspecified unspecified unspecified unspecified unspecified  	O	null
4 גרשון גרשון גרשון properName unspecified unspecified unspecified unspecified unspecified  	I_PERS	null
5 . . . punctuation unspecified unspecified unspecified unspecified unspecified  	O	null

0 גל גל גל noun masculine singular absolute unspecified unspecified  	O	null
1 אחר אחר אחר preposition unspecified unspecified unspecified unspecified unspecified  	O	null
2 גל גל גל noun masculine singular absolute unspecified unspecified  	O	null
3 ב ב בסיפורת preposition unspecified unspecified unspecified unspecified unspecified 0 
3 ה ה בסיפורת definiteArticle unspecified unspecified unspecified unspecified unspecified 0 
3 הסיפורת סיפורת בסיפורת noun feminine singular absolute unspecified unspecified  	O	null
4 ה ה העברית definiteArticle unspecified unspecified unspecified unspecified unspecified 0 
4 העברית עברי העברית adjective feminine singular absolute unspecified unspecified  	O	null
5 . . . punctuation unspecified unspecified unspecified unspecified unspecified  	O	null

0 ירושלים ירושלים ירושלים properName unspecified unspecified unspecified unspecified unspecified  	I_LOC	null
1 : : : punctuation unspecified unspecified unspecified unspecified unspecified  	O	null
2 כתר כתר כתר noun masculine singular absolute unspecified unspecified  	O	null
3 . . . punctuation unspecified unspecified unspecified unspecified unspecified  	O	null

0 ###NUMBER### ###NUMBER### ###NUMBER### numeral unspecified unspecified unspecified unspecified unspecified  	I_DATE	null
1 . . . punctuation unspecified unspecified unspecified unspecified unspecified  	O	null

0 ###NUMBER### ###NUMBER### ###NUMBER### numeral unspecified unspecified unspecified unspecified unspecified  	O	null
1 - - - punctuation unspecified unspecified unspecified unspecified unspecified  	O	null
2 ###NUMBER### ###NUMBER### ###NUMBER### numeral unspecified unspecified unspecified unspecified unspecified  	O	null
3 . . . punctuation unspecified unspecified unspecified unspecified unspecified  	O	null

