0 Name Name Name foreign unspecified unspecified unspecified unspecified unspecified  	O	null
1 : : : punctuation unspecified unspecified unspecified unspecified unspecified  	O	null
2 צייטלין צייטלין צייטלין properName unspecified unspecified unspecified unspecified unspecified  	I_ORG	null
3 , , , punctuation unspecified unspecified unspecified unspecified unspecified  	O	null
4 אהרן אהרן אהרן properName unspecified unspecified unspecified unspecified unspecified  	I_PERS	null
5 Birth Birth Birth foreign unspecified unspecified unspecified unspecified unspecified  	O	null
6 Year Year Year foreign unspecified unspecified unspecified unspecified unspecified  	O	null
7 : : : punctuation unspecified unspecified unspecified unspecified unspecified  	O	null
8 ###NUMBER### ###NUMBER### ###NUMBER### numeral unspecified unspecified unspecified unspecified unspecified  	I_DATE	null
9 Death Death Death foreign unspecified unspecified unspecified unspecified unspecified  	O	null
10 Year Year Year foreign unspecified unspecified unspecified unspecified unspecified  	O	null
11 : : : punctuation unspecified unspecified unspecified unspecified unspecified  	O	null
12 ###NUMBER### ###NUMBER### ###NUMBER### numeral unspecified unspecified unspecified unspecified unspecified  	I_DATE	null
13 Birth Birth Birth foreign unspecified unspecified unspecified unspecified unspecified  	O	null
14 Place Place Place foreign unspecified unspecified unspecified unspecified unspecified  	O	null
15 : : : punctuation unspecified unspecified unspecified unspecified unspecified  	O	null
16 Occupation Occupation Occupation foreign unspecified unspecified unspecified unspecified unspecified  	O	null
17 : : : punctuation unspecified unspecified unspecified unspecified unspecified  	O	null
18 משורר משורר משורר noun masculine singular absolute unspecified unspecified  	O	null
19 , , , punctuation unspecified unspecified unspecified unspecified unspecified  	O	null
20 מחזאי מחזאי מחזאי noun masculine singular absolute unspecified unspecified  	O	null
21 , , , punctuation unspecified unspecified unspecified unspecified unspecified  	O	null
22 עיתונאי עיתונאי עיתונאי noun masculine singular absolute unspecified unspecified  	O	null
23 ו ו ועורך conjunction unspecified unspecified unspecified unspecified unspecified 0 
23 עורך עורך ועורך noun masculine singular construct unspecified unspecified  	O	null
24 Entry Entry Entry foreign unspecified unspecified unspecified unspecified unspecified  	O	null
25 writer writer writer foreign unspecified unspecified unspecified unspecified unspecified  	O	null
26 : : : punctuation unspecified unspecified unspecified unspecified unspecified  	O	null
27 אבנר אבנר אבנר properName unspecified unspecified unspecified unspecified unspecified  	I_PERS	null
28 הולצמן הולצמן הולצמן properName unspecified unspecified unspecified unspecified unspecified  	I_PERS	null
29 Entry Entry Entry foreign unspecified unspecified unspecified unspecified unspecified  	O	null
30 Value Value Value foreign unspecified unspecified unspecified unspecified unspecified  	O	null
31 : : : punctuation unspecified unspecified unspecified unspecified unspecified  	O	null
32 בן בן בנו noun masculine singular absolute unspecified unspecified  
32 ו ו בנו possessive masculine singular unspecified 3 unspecified 0 	O	null
33 ה ה הבכור definiteArticle unspecified unspecified unspecified unspecified unspecified 0 
33 הבכור בכור הבכור noun masculine singular absolute unspecified unspecified  	O	null
34 של של של shel-preposition unspecified unspecified unspecified unspecified unspecified  	O	null
35 ה ה הסופר definiteArticle unspecified unspecified unspecified unspecified unspecified 0 
35 הסופר סופר הסופר noun masculine singular absolute unspecified unspecified  	O	null
36 - - - punctuation unspecified unspecified unspecified unspecified unspecified  	O	null
37 ה ה המיסטיקן definiteArticle unspecified unspecified unspecified unspecified unspecified 0 
37 המיסטיקן מיסטיקן המיסטיקן noun masculine singular absolute unspecified unspecified  	O	null
38 הלל הלל הלל properName unspecified unspecified unspecified unspecified unspecified  	I_PERS	null
39 צייטלין צייטלין צייטלין properName unspecified unspecified unspecified unspecified unspecified  	I_PERS	null
40 , , , punctuation unspecified unspecified unspecified unspecified unspecified  	O	null
41 נולד נולד נולד verb masculine singular unspecified 3 past  	O	null
42 ב ב באובארוביץ' preposition unspecified unspecified unspecified unspecified unspecified 0 
42 אובארוביץ' אובארוביץ' באובארוביץ' properName unspecified unspecified unspecified unspecified unspecified  	I_PERS	null
43 ש ש שברוסיה relativizer/subordinatingConjunction unspecified unspecified unspecified unspecified unspecified 0 
43 ב ב שברוסיה preposition unspecified unspecified unspecified unspecified unspecified 0 
43 רוסיה רוסי שברוסיה properName unspecified unspecified unspecified unspecified unspecified  	I_LOC	null
44 ה ה הלבנה definiteArticle unspecified unspecified unspecified unspecified unspecified 0 
44 הלבנה לבן הלבנה adjective feminine singular absolute unspecified unspecified  	O	null
45 ו ו ועשה conjunction unspecified unspecified unspecified unspecified unspecified 0 
45 עשה עשה ועשה verb masculine singular unspecified 3 past  	O	null
46 את את את at-preposition unspecified unspecified unspecified unspecified unspecified  	O	null
47 שנות שנה שנות noun feminine plural construct unspecified unspecified  	O	null
48 ילדות ילדות ילדותו noun feminine singular absolute unspecified unspecified  
48 ו ו ילדותו possessive masculine singular unspecified 3 unspecified 0 	O	null
49 ב ב בהומל preposition unspecified unspecified unspecified unspecified unspecified 0 
49 הומל הומל בהומל noun masculine singular absolute unspecified unspecified  	O	null
50 ו ו ובווילנה conjunction unspecified unspecified unspecified unspecified unspecified 0 
50 ב ב ובווילנה preposition unspecified unspecified unspecified unspecified unspecified 0 
50 ווילנה וילנה ובווילנה properName unspecified unspecified unspecified unspecified unspecified  	I_LOC	null
51 . . . punctuation unspecified unspecified unspecified unspecified unspecified  	O	null

0 ב ב ב preposition unspecified unspecified unspecified unspecified unspecified 0 	I_ORG	null
1 - - - punctuation unspecified unspecified unspecified unspecified unspecified  	I_ORG	null
2 ###NUMBER### ###NUMBER### ###NUMBER### numeral unspecified unspecified unspecified unspecified unspecified  	I_DATE	null
3 עבר עבר עבר verb masculine singular unspecified 3 past  	O	null
4 עם עם עם preposition unspecified unspecified unspecified unspecified unspecified  	O	null
5 משפחת משפחה משפחתו noun feminine singular absolute unspecified unspecified  
5 ו ו משפחתו possessive masculine singular unspecified 3 unspecified 0 	O	null
6 ל ל לוורשה preposition unspecified unspecified unspecified unspecified unspecified 0 
6 וורשה ורשה לוורשה properName unspecified unspecified unspecified unspecified unspecified  	I_LOC	null
7 , , , punctuation unspecified unspecified unspecified unspecified unspecified  	O	null
8 ו ו ובה conjunction unspecified unspecified unspecified unspecified unspecified 0 
8 ב ב ובה preposition unspecified unspecified unspecified unspecified unspecified  
8 ה ה ובה pronomial feminine singular unspecified 3 unspecified 0 	O	null
9 ישב ישב ישב verb masculine singular unspecified 3 past  	O	null
10 עד עד עד preposition unspecified unspecified unspecified unspecified unspecified  	O	null
11 פרוץ פרץ פרוץ verb masculine singular unspecified 2 imperative  	O	null
12 מלחמת מלחמה מלחמת noun feminine singular construct unspecified unspecified  	O	null
13 ה ה העולם definiteArticle unspecified unspecified unspecified unspecified unspecified 0 
13 העולם עולם העולם noun masculine singular absolute unspecified unspecified  	O	null
14 ה ה השנייה definiteArticle unspecified unspecified unspecified unspecified unspecified 0 
14 השנייה ORD2 השנייה numeral feminine singular absolute unspecified unspecified  	O	null
15 . . . punctuation unspecified unspecified unspecified unspecified unspecified  	O	null

0 פעילות פעילות פעילותו noun feminine singular absolute unspecified unspecified  
0 ו ו פעילותו possessive masculine singular unspecified 3 unspecified 0 	O	null
1 ה ה הספרותית definiteArticle unspecified unspecified unspecified unspecified unspecified 0 
1 הספרותית ספרותי הספרותית adjective feminine singular absolute unspecified unspecified  	O	null
2 החלה החל החלה verb feminine singular unspecified 3 past  	O	null
3 ב ב בגיל preposition unspecified unspecified unspecified unspecified unspecified 0 
3 גיל גיל בגיל noun masculine singular construct unspecified unspecified  	O	null
4 אחת CARD1 אחת numeral feminine singular absolute unspecified unspecified  	O	null
5 - - - punctuation unspecified unspecified unspecified unspecified unspecified  	O	null
6 עשרה CARD10 עשרה numeral masculine plural absolute unspecified unspecified  	O	null
7 ב ב בפרסום preposition unspecified unspecified unspecified unspecified unspecified 0 
7 פרסום פרסום בפרסום noun masculine singular construct unspecified unspecified  	O	null
8 שירים שיר שירים noun masculine plural absolute unspecified unspecified  	O	null
9 ב ב בעיתון preposition unspecified unspecified unspecified unspecified unspecified 0 
9 עיתון עיתון בעיתון noun masculine singular construct unspecified unspecified  	O	null
10 ה ה הילדים definiteArticle unspecified unspecified unspecified unspecified unspecified 0 
10 הילדים ילד הילדים noun masculine plural absolute unspecified unspecified  	O	null
11 ה ה העברי definiteArticle unspecified unspecified unspecified unspecified unspecified 0 
11 העברי עברי העברי adjective masculine singular absolute unspecified unspecified  	O	null
12 ה ה הפרחים definiteArticle unspecified unspecified unspecified unspecified unspecified 0 
12 הפרחים פרח הפרחים noun masculine plural absolute unspecified unspecified  	O	null
13 ) ) ) punctuation unspecified unspecified unspecified unspecified unspecified  	O	null
14 . . . punctuation unspecified unspecified unspecified unspecified unspecified  	O	null
15 ###NUMBER### ###NUMBER### ###NUMBER### numeral unspecified unspecified unspecified unspecified unspecified  	I_DATE	null
16 ב ב ב preposition unspecified unspecified unspecified unspecified unspecified 0 	I_ORG	null
17 - - - punctuation unspecified unspecified unspecified unspecified unspecified  	I_ORG	null
18 ###NUMBER### ###NUMBER### ###NUMBER### numeral unspecified unspecified unspecified unspecified unspecified  	I_DATE	null
19 פורסמה פורסם פורסמה verb feminine singular unspecified 3 past  	O	null
20 יצירת יצירה יצירתו noun feminine singular absolute unspecified unspecified  
20 ו ו יצירתו possessive masculine singular unspecified 3 unspecified 0 	O	null
21 ה ה הראשונה definiteArticle unspecified unspecified unspecified unspecified unspecified 0 
21 הראשונה ORD1 הראשונה numeral feminine singular absolute unspecified unspecified  	O	null
22 ב ב ביידיש preposition unspecified unspecified unspecified unspecified unspecified 0 
22 יידיש יידיש ביידיש properName unspecified unspecified unspecified unspecified unspecified  	I_LOC	null
23 , , , punctuation unspecified unspecified unspecified unspecified unspecified  	O	null
24 ה ה הפואמה definiteArticle unspecified unspecified unspecified unspecified unspecified 0 
24 הפואמה פואמה הפואמה noun feminine singular absolute unspecified unspecified  	O	null
25 - - - punctuation unspecified unspecified unspecified unspecified unspecified  	O	null
26 ב ב בפרוזה preposition unspecified unspecified unspecified unspecified unspecified 0 
26 ה ה בפרוזה definiteArticle unspecified unspecified unspecified unspecified unspecified 0 
26 הפרוזה פרוזה בפרוזה noun feminine singular absolute unspecified unspecified  	O	null
27 " " " punctuation unspecified unspecified unspecified unspecified unspecified  	O	null
28 די די די adverb unspecified unspecified unspecified unspecified unspecified  	O	null
29 מטרוניתא מטרוניתא מטרוניתא noun feminine singular construct unspecified unspecified  	O	null
30 " " " punctuation unspecified unspecified unspecified unspecified unspecified  	O	null
31 , , , punctuation unspecified unspecified unspecified unspecified unspecified  	O	null
32 ב ב בירחון preposition unspecified unspecified unspecified unspecified unspecified 0 
32 ה ה בירחון definiteArticle unspecified unspecified unspecified unspecified unspecified 0 
32 הירחון ירחון בירחון noun masculine singular absolute unspecified unspecified  	O	null
33 די די די adverb unspecified unspecified unspecified unspecified unspecified  	O	null
34 יודישע יודישע יודישע properName unspecified unspecified unspecified unspecified unspecified  	I_PERS	null
35 ו ו וועלט conjunction unspecified unspecified unspecified unspecified unspecified 0 
35 ועל ועל וועלט noun masculine singular absolute unspecified unspecified  
35 ה ה וועלט possessive feminine singular unspecified 3 unspecified 0 	O	null
36 , , , punctuation unspecified unspecified unspecified unspecified unspecified  	O	null
37 ו ו ומאז conjunction unspecified unspecified unspecified unspecified unspecified 0 
37 מאז מאז ומאז adverb unspecified unspecified unspecified unspecified unspecified  	O	null
38 פעל פעל פעל verb masculine singular unspecified 3 past  	O	null
39 כל כול כל quantifier unspecified unspecified construct unspecified unspecified  	O	null
40 ימי יום ימיו noun masculine plural absolute unspecified unspecified  
40 ו ו ימיו possessive masculine singular unspecified 3 unspecified 0 	O	null
41 כ כ כסופר preposition unspecified unspecified unspecified unspecified unspecified 0 
41 סופר סופר כסופר noun masculine singular absolute unspecified unspecified  	O	null
42 דו דו דו wPrefix unspecified unspecified unspecified unspecified unspecified  	I_ORG	null
43 - - - punctuation unspecified unspecified unspecified unspecified unspecified  	I_ORG	null
44 לשוני לשוני לשוני adjective masculine singular absolute unspecified unspecified  	I_ORG	null
45 . . . punctuation unspecified unspecified unspecified unspecified unspecified  	O	null

0 הוא הוא הוא pronoun masculine singular unspecified 3 unspecified  	O	null
1 עצמו עצמו עצמו pronoun unspecified unspecified unspecified unspecified unspecified  
1 ו ו עצמו pronomial masculine singular unspecified 3 unspecified 0 	O	null
2 נהג נהג נהג verb masculine singular unspecified 3 past  	O	null
3 להעיד העיד להעיד verb unspecified unspecified unspecified unspecified infinitive  	O	null
4 על על על preposition unspecified unspecified unspecified unspecified unspecified  	O	null
5 ה ה הטבעיות definiteArticle unspecified unspecified unspecified unspecified unspecified 0 
5 הטבעיות טבעיות הטבעיות noun feminine singular absolute unspecified unspecified  	O	null
6 שבה שב שבה verb feminine singular unspecified 3 past  	O	null
7 מתלכדות התלכד מתלכדות verb feminine plural unspecified any beinoni  	O	null
8 בתוך בתוך בתוכו preposition unspecified unspecified unspecified unspecified unspecified  
8 ו ו בתוכו pronomial masculine singular unspecified 3 unspecified 0 	O	null
9 שתי CARD2 שתי numeral feminine dual construct unspecified unspecified  	O	null
10 ה ה הלשונות definiteArticle unspecified unspecified unspecified unspecified unspecified 0 
10 הלשונות לשון הלשונות noun feminine plural absolute unspecified unspecified  	O	null
11 ב ב בעלות preposition unspecified unspecified unspecified unspecified unspecified 0 
11 עלות עלות בעלות noun feminine singular construct unspecified unspecified  	O	null
12 ה ה האלף definiteArticle unspecified unspecified unspecified unspecified unspecified 0 
12 האלף אלף האלף properName feminine singular unspecified unspecified unspecified  	I_LOC	null
13 - - - punctuation unspecified unspecified unspecified unspecified unspecified  	O	null
14 בית בית בית noun masculine singular construct unspecified unspecified  	O	null
15 ה ה המשותף definiteArticle unspecified unspecified unspecified unspecified unspecified 0 
15 המשותף משותף המשותף adjective masculine singular absolute unspecified unspecified  	O	null
16 , , , punctuation unspecified unspecified unspecified unspecified unspecified  	O	null
17 עד עד עד preposition unspecified unspecified unspecified unspecified unspecified  	O	null
18 ש ש שאינו relativizer/subordinatingConjunction unspecified unspecified unspecified unspecified unspecified 0 
18 אינו הוא שאינו copula masculine singular unspecified 3 beinoni  	O	null
19 מרגיש הרגיש מרגיש verb masculine singular unspecified any beinoni  	O	null
20 כלל כלל כלל adverb unspecified unspecified unspecified unspecified unspecified  	O	null
21 ב ב בחציצה preposition unspecified unspecified unspecified unspecified unspecified 0 
21 חציצה חציצה בחציצה noun feminine singular absolute unspecified unspecified  	O	null
22 בין בין ביניהן preposition unspecified unspecified unspecified unspecified unspecified  
22 הן הן ביניהן pronomial feminine plural unspecified 3 unspecified 0 	O	null
23 . . . punctuation unspecified unspecified unspecified unspecified unspecified  	O	null

0 ב ב ב preposition unspecified unspecified unspecified unspecified unspecified 0 	I_ORG	null
1 - - - punctuation unspecified unspecified unspecified unspecified unspecified  	I_ORG	null
2 ###NUMBER### ###NUMBER### ###NUMBER### numeral unspecified unspecified unspecified unspecified unspecified  	I_DATE	null
3 יצא יצא יצא verb masculine singular unspecified 3 past  	O	null
4 עם עם עם preposition unspecified unspecified unspecified unspecified unspecified  	O	null
5 אחי אח אחיו noun masculine plural absolute unspecified unspecified  
5 ו ו אחיו possessive masculine singular unspecified 3 unspecified 0 	O	null
6 ה ה הצעיר definiteArticle unspecified unspecified unspecified unspecified unspecified 0 
6 הצעיר צעיר הצעיר adjective masculine singular absolute unspecified unspecified  	O	null
7 אלחנן אלחנן אלחנן properName unspecified unspecified unspecified unspecified unspecified  	I_PERS	null
8 ל ל לארץישראל preposition unspecified unspecified unspecified unspecified unspecified 0 
8 ארץישראל ארץישראל לארץישראל properName unspecified unspecified unspecified unspecified unspecified  	I_PERS	null
9 ו ו ועשה conjunction unspecified unspecified unspecified unspecified unspecified 0 
9 עשה עשה ועשה verb masculine singular unspecified 3 past  	O	null
10 ב ב בה preposition unspecified unspecified unspecified unspecified unspecified  
10 ה ה בה pronomial feminine singular unspecified 3 unspecified 0 	O	null
11 כ כ כשנה preposition unspecified unspecified unspecified unspecified unspecified 0 
11 שנה שנה כשנה noun feminine singular absolute unspecified unspecified  	O	null
12 , , , punctuation unspecified unspecified unspecified unspecified unspecified  	O	null
13 בעיקר בעיקר בעיקר adverb unspecified unspecified unspecified unspecified unspecified  	O	null
14 ב ב בהוראה preposition unspecified unspecified unspecified unspecified unspecified 0 
14 הוראה הוראה בהוראה noun feminine singular absolute unspecified unspecified  	O	null
15 ב ב בזכרון preposition unspecified unspecified unspecified unspecified unspecified 0 
15 זכרון זיכרון בזכרון noun masculine singular construct unspecified unspecified  	I_LOC	null
16 יעקב יעקב יעקב properName unspecified unspecified unspecified unspecified unspecified  	I_LOC	null
17 . . . punctuation unspecified unspecified unspecified unspecified unspecified  	O	null

0 ב ב בשהותו preposition unspecified unspecified unspecified unspecified unspecified 0 
0 שהות שהות בשהותו noun feminine singular absolute unspecified unspecified  
0 ו ו בשהותו possessive masculine singular unspecified 3 unspecified 0 	O	null
1 ב ב בארץ preposition unspecified unspecified unspecified unspecified unspecified 0 
1 ה ה בארץ definiteArticle unspecified unspecified unspecified unspecified unspecified 0 
1 הארץ ארץ בארץ noun feminine singular absolute unspecified unspecified  	O	null
2 מסר מסר מסר verb masculine singular unspecified 3 past  	O	null
3 ל ל לפרסום preposition unspecified unspecified unspecified unspecified unspecified 0 
3 פרסום פרסום לפרסום noun masculine singular absolute unspecified unspecified  	O	null
4 ב ב בירחון preposition unspecified unspecified unspecified unspecified unspecified 0 
4 ירחון ירחון בירחון noun masculine singular construct unspecified unspecified  	O	null
5 ה ה השילוח definiteArticle unspecified unspecified unspecified unspecified unspecified 0 
5 השילוח שילוח השילוח noun masculine singular absolute unspecified unspecified  	O	null
6 פואמה פואמה פואמה noun feminine singular absolute unspecified unspecified  	O	null
7 ב ב בשם preposition unspecified unspecified unspecified unspecified unspecified 0 
7 שם שם בשם noun masculine singular construct unspecified unspecified  	O	null
8 " " " punctuation unspecified unspecified unspecified unspecified unspecified  	O	null
9 יונה יון יונה properName unspecified unspecified unspecified unspecified unspecified  	I_PERS	null
10 בן בן בן noun masculine singular absolute unspecified unspecified  	O	null
11 אמיתי אמיתי אמיתי properName unspecified unspecified unspecified unspecified unspecified  	I_PERS	null
12 " " " punctuation unspecified unspecified unspecified unspecified unspecified  	O	null
13 , , , punctuation unspecified unspecified unspecified unspecified unspecified  	O	null
14 ה ה הנחשבת definiteArticle unspecified unspecified unspecified unspecified unspecified 0 
14 הנחשבת נחשב הנחשבת participle feminine singular absolute any unspecified  	O	null
15 ל ל ליצירתו preposition unspecified unspecified unspecified unspecified unspecified 0 
15 יצירת יצירה ליצירתו noun feminine singular absolute unspecified unspecified  
15 ו ו ליצירתו possessive masculine singular unspecified 3 unspecified 0 	O	null
16 ה ה הבוגרת definiteArticle unspecified unspecified unspecified unspecified unspecified 0 
16 הבוגרת בוגר הבוגרת adjective feminine singular absolute unspecified unspecified  	O	null
17 ה ה הראשונה definiteArticle unspecified unspecified unspecified unspecified unspecified 0 
17 הראשונה ORD1 הראשונה numeral feminine singular absolute unspecified unspecified  	O	null
18 ב ב בעברית preposition unspecified unspecified unspecified unspecified unspecified 0 
18 עברית עברית בעברית properName feminine singular unspecified unspecified unspecified  	I_LOC	null
19 . . . punctuation unspecified unspecified unspecified unspecified unspecified  	O	null

0 ב ב בשובו preposition unspecified unspecified unspecified unspecified unspecified 0 
0 שוב שוב בשובו noun masculine singular absolute unspecified unspecified  
0 ו ו בשובו possessive masculine singular unspecified 3 unspecified 0 	O	null
1 ל ל לוורשה preposition unspecified unspecified unspecified unspecified unspecified 0 
1 וורשה ורשה לוורשה properName unspecified unspecified unspecified unspecified unspecified  	I_LOC	null
2 ב ב ב preposition unspecified unspecified unspecified unspecified unspecified 0 	I_ORG	null
3 - - - punctuation unspecified unspecified unspecified unspecified unspecified  	I_ORG	null
4 ###NUMBER### ###NUMBER### ###NUMBER### numeral unspecified unspecified unspecified unspecified unspecified  	I_DATE	null
5 חיבר חיבר חיבר verb masculine singular unspecified 3 past  	O	null
6 את את את at-preposition unspecified unspecified unspecified unspecified unspecified  	O	null
7 מטטרון מטטרון מטטרון properName unspecified unspecified unspecified unspecified unspecified  	I_PERS	null
8 , , , punctuation unspecified unspecified unspecified unspecified unspecified  	O	null
9 פואמה פואמה פואמה noun feminine singular absolute unspecified unspecified  	O	null
10 אפוקליפטית אפוקליפטי אפוקליפטית adjective feminine singular absolute unspecified unspecified  	O	null
11 מקיפה מקיף מקיפה adjective feminine singular absolute unspecified unspecified  	O	null
12 ב ב ביידיש preposition unspecified unspecified unspecified unspecified unspecified 0 
12 יידיש יידיש ביידיש properName unspecified unspecified unspecified unspecified unspecified  	I_LOC	null
13 , , , punctuation unspecified unspecified unspecified unspecified unspecified  	O	null
14 ש ש שהופיעה relativizer/subordinatingConjunction unspecified unspecified unspecified unspecified unspecified 0 
14 הופיעה הופיע שהופיעה verb feminine singular unspecified 3 past  	O	null
15 כ כ כספר preposition unspecified unspecified unspecified unspecified unspecified 0 
15 ספר ספר כספר noun masculine singular absolute unspecified unspecified  	O	null
16 ב ב ב preposition unspecified unspecified unspecified unspecified unspecified 0 	I_ORG	null
17 - - - punctuation unspecified unspecified unspecified unspecified unspecified  	I_ORG	null
18 ###NUMBER### ###NUMBER### ###NUMBER### numeral unspecified unspecified unspecified unspecified unspecified  	I_DATE	null
19 ו ו ועוררה conjunction unspecified unspecified unspecified unspecified unspecified 0 
19 עוררה עורר ועוררה verb feminine singular unspecified 3 past  	O	null
20 מיד מייד מיד adverb unspecified unspecified unspecified unspecified unspecified  	O	null
21 תגובות תגובה תגובות noun feminine plural absolute unspecified unspecified  	O	null
22 ביטול ביטול ביטול noun masculine singular absolute unspecified unspecified  	O	null
23 חריפות חריף חריפות adjective feminine plural absolute unspecified unspecified  	O	null
24 מצד מצד מצד preposition unspecified unspecified unspecified unspecified unspecified  	O	null
25 צעירי צעיר צעירי noun masculine plural construct unspecified unspecified  	O	null
26 ה ה המודרניזם definiteArticle unspecified unspecified unspecified unspecified unspecified 0 
26 המודרניזם מודרניזם המודרניזם noun masculine singular absolute unspecified unspecified  	O	null
27 ב ב בשירת preposition unspecified unspecified unspecified unspecified unspecified 0 
27 שירת שירה בשירת noun feminine singular construct unspecified unspecified  	O	null
28 יידיש יידיש יידיש properName feminine singular unspecified unspecified unspecified  	O	null
29 דאז דאז דאז adverb unspecified unspecified unspecified unspecified unspecified  	I_LOC	null
30 , , , punctuation unspecified unspecified unspecified unspecified unspecified  	O	null
31 אורי אורי אורי properName unspecified unspecified unspecified unspecified unspecified  	I_PERS	null
32 צבי צבי צבי properName unspecified unspecified unspecified unspecified unspecified  	I_PERS	null
33 גרינברג גרינברג גרינברג properName unspecified unspecified unspecified unspecified unspecified  	I_PERS	null
34 ו ו ומלך conjunction unspecified unspecified unspecified unspecified unspecified 0 
34 מלך מלך ומלך noun masculine singular construct unspecified unspecified  	O	null
35 ראביץ' ראביץ' ראביץ' properName unspecified unspecified unspecified unspecified unspecified  	I_LOC	null
36 . . . punctuation unspecified unspecified unspecified unspecified unspecified  	O	null

0 היה הוא היה copula masculine singular unspecified 3 past  	O	null
1 זה זה זה pronoun masculine singular unspecified 3 unspecified  	O	null
2 ה ה הראשון definiteArticle unspecified unspecified unspecified unspecified unspecified 0 
2 הראשון ORD1 הראשון numeral masculine singular absolute unspecified unspecified  	O	null
3 ב ב בסדרה preposition unspecified unspecified unspecified unspecified unspecified 0 
3 סדרה סדרה בסדרה noun feminine singular absolute unspecified unspecified  	O	null
4 של של של shel-preposition unspecified unspecified unspecified unspecified unspecified  	O	null
5 פולמוסים פולמוס פולמוסים noun masculine plural absolute unspecified unspecified  	O	null
6 סוערים סוער סוערים adjective masculine plural absolute unspecified unspecified  	O	null
7 ש ש שצייטלין relativizer/subordinatingConjunction unspecified unspecified unspecified unspecified unspecified 0 
7 צייטלין צייטלין שצייטלין properName unspecified unspecified unspecified unspecified unspecified  	I_PERS	null
8 היה הוא היה copula masculine singular unspecified 3 past  	O	null
9 מעורב מעורב מעורב adjective masculine singular absolute unspecified unspecified  	O	null
10 ב ב בהם preposition unspecified unspecified unspecified unspecified unspecified  
10 הם הם בהם pronomial masculine plural unspecified 3 unspecified 0 	O	null
11 ב ב בשנות preposition unspecified unspecified unspecified unspecified unspecified 0 
11 שנות שנה בשנות noun feminine plural construct unspecified unspecified  	O	null
12 ה ה העשרים definiteArticle unspecified unspecified unspecified unspecified unspecified 0 
12 העשרים ORD-CARD20 העשרים numeral masculine-and-feminine plural absolute unspecified unspecified  	O	null
13 ו ו והשלושים conjunction unspecified unspecified unspecified unspecified unspecified 0 
13 ה ה והשלושים definiteArticle unspecified unspecified unspecified unspecified unspecified 0 
13 השלושים ORD-CARD30 והשלושים numeral masculine-and-feminine plural absolute unspecified unspecified  	O	null
14 , , , punctuation unspecified unspecified unspecified unspecified unspecified  	O	null
15 כ כ כחלק preposition unspecified unspecified unspecified unspecified unspecified 0 
15 חלק חלק כחלק noun masculine singular absolute unspecified unspecified  	O	null
16 מ מ מנוכחותו preposition unspecified unspecified unspecified unspecified unspecified 0 
16 נוכחות נוכחות מנוכחותו noun feminine singular absolute unspecified unspecified  
16 ו ו מנוכחותו possessive masculine singular unspecified 3 unspecified 0 	O	null
17 ה ה האינטנסיבית definiteArticle unspecified unspecified unspecified unspecified unspecified 0 
17 האינטנסיבית אינטנסיבי האינטנסיבית adjective feminine singular absolute unspecified unspecified  	O	null
18 כ כ כמשורר preposition unspecified unspecified unspecified unspecified unspecified 0 
18 ה ה כמשורר definiteArticle unspecified unspecified unspecified unspecified unspecified 0 
18 המשורר משורר כמשורר noun masculine singular absolute unspecified unspecified  	O	null
19 , , , punctuation unspecified unspecified unspecified unspecified unspecified  	O	null
20 מחזאי מחזאי מחזאי noun masculine singular absolute unspecified unspecified  	O	null
21 , , , punctuation unspecified unspecified unspecified unspecified unspecified  	O	null
22 עיתונאי עיתונאי עיתונאי noun masculine singular absolute unspecified unspecified  	O	null
23 , , , punctuation unspecified unspecified unspecified unspecified unspecified  	O	null
24 עורך עורך עורך noun masculine singular absolute unspecified unspecified  	O	null
25 ו ו ועסקןציבור conjunction unspecified unspecified unspecified unspecified unspecified 0 
25 עסקןציבור עסקןציבור ועסקןציבור noun feminine plural construct unspecified unspecified  	O	null
26 ב ב בחלל preposition unspecified unspecified unspecified unspecified unspecified 0 
26 ה ה בחלל definiteArticle unspecified unspecified unspecified unspecified unspecified 0 
26 החלל חלל בחלל noun masculine singular absolute unspecified unspecified  	O	null
27 ה ה הקטן definiteArticle unspecified unspecified unspecified unspecified unspecified 0 
27 הקטן קטן הקטן adjective masculine singular absolute unspecified unspecified  	O	null
28 ו ו והדחוס conjunction unspecified unspecified unspecified unspecified unspecified 0 
28 ה ה והדחוס definiteArticle unspecified unspecified unspecified unspecified unspecified 0 
28 הדחוס דחוס והדחוס adjective masculine singular absolute unspecified unspecified  	O	null
29 של של של shel-preposition unspecified unspecified unspecified unspecified unspecified  	O	null
30 חיי חיים חיי noun masculine plural construct unspecified unspecified  	O	null
31 ה ה הספרות definiteArticle unspecified unspecified unspecified unspecified unspecified 0 
31 הספרות ספרות הספרות noun feminine singular absolute unspecified unspecified  	O	null
32 ה ה היהודית definiteArticle unspecified unspecified unspecified unspecified unspecified 0 
32 היהודית יהודי היהודית adjective feminine singular absolute unspecified unspecified  	O	null
33 ב ב בוורשה preposition unspecified unspecified unspecified unspecified unspecified 0 
33 וורשה ורשה בוורשה properName unspecified unspecified unspecified unspecified unspecified  	I_LOC	null
34 . . . punctuation unspecified unspecified unspecified unspecified unspecified  	O	null

0 אחד איחד אחד verb masculine singular unspecified 3 past  	O	null
1 מ מ ממפעליו preposition unspecified unspecified unspecified unspecified unspecified 0 
1 מפעלי מפעל ממפעליו noun masculine plural absolute unspecified unspecified  
1 ו ו ממפעליו possessive masculine singular unspecified 3 unspecified 0 	O	null
2 ה ה הבולטים definiteArticle unspecified unspecified unspecified unspecified unspecified 0 
2 הבולטים בולט הבולטים adjective masculine plural absolute unspecified unspecified  	O	null
3 היה הוא היה copula masculine singular unspecified 3 past  	O	null
4 ייסוד ייסוד ייסודו noun masculine singular absolute unspecified unspecified  
4 ו ו ייסודו possessive masculine singular unspecified 3 unspecified 0 	O	null
5 ו ו ועריכתו conjunction unspecified unspecified unspecified unspecified unspecified 0 
5 עריכת עריכה ועריכתו noun feminine singular absolute unspecified unspecified  
5 ו ו ועריכתו possessive masculine singular unspecified 3 unspecified 0 	O	null
6 של של של shel-preposition unspecified unspecified unspecified unspecified unspecified  	O	null
7 ה ה הירחון definiteArticle unspecified unspecified unspecified unspecified unspecified 0 
7 הירחון ירחון הירחון noun masculine singular absolute unspecified unspecified  	O	null
8 גלאָבּוּס גלאָבּוּס גלאָבּוּס properName unspecified unspecified unspecified unspecified unspecified  	I_DATE	null
9 - - - punctuation unspecified unspecified unspecified unspecified unspecified  	O	null
10 ###NUMBER### ###NUMBER### ###NUMBER### numeral unspecified unspecified unspecified unspecified unspecified  	I_DATE	null
11 ) ) ) punctuation unspecified unspecified unspecified unspecified unspecified  	O	null
12 , , , punctuation unspecified unspecified unspecified unspecified unspecified  	O	null
13 ###NUMBER### ###NUMBER### ###NUMBER### numeral unspecified unspecified unspecified unspecified unspecified  	I_DATE	null
14 ש ש שנועד relativizer/subordinatingConjunction unspecified unspecified unspecified unspecified unspecified 0 
14 נועד נועד שנועד verb masculine singular unspecified 3 past  	O	null
15 לתת נתן לתת verb unspecified unspecified unspecified unspecified infinitive  	O	null
16 במה במה במה noun feminine singular absolute unspecified unspecified  	O	null
17 ל ל למיטב preposition unspecified unspecified unspecified unspecified unspecified 0 
17 מיטב מיטב למיטב noun masculine singular construct unspecified unspecified  	O	null
18 ספרות ספרות ספרות noun feminine singular construct unspecified unspecified  	O	null
19 יידיש יידיש יידיש properName unspecified unspecified unspecified unspecified unspecified  	I_ORG	null
20 ב ב בפולין preposition unspecified unspecified unspecified unspecified unspecified 0 
20 פולין פולין בפולין properName unspecified unspecified unspecified unspecified unspecified  	I_LOC	null
21 ו ו ומחוצה conjunction unspecified unspecified unspecified unspecified unspecified 0 
21 מחוצה מחוץ ומחוצה adjective feminine singular absolute unspecified unspecified  	O	null
22 ל ל לה preposition unspecified unspecified unspecified unspecified unspecified  
22 ה ה לה pronomial feminine singular unspecified 3 unspecified 0 	O	null
23 מתוך מתוך מתוך preposition unspecified unspecified unspecified unspecified unspecified  	O	null
24 ניתוק ניתוק ניתוק noun masculine singular absolute unspecified unspecified  	O	null
25 מ מ מהקשרים preposition unspecified unspecified unspecified unspecified unspecified 0 
25 הקשרים הקשר מהקשרים noun masculine plural absolute unspecified unspecified  	O	null
26 פוליטיים פוליטי פוליטיים adjective masculine plural absolute unspecified unspecified  	O	null
27 - - - punctuation unspecified unspecified unspecified unspecified unspecified  	O	null
28 מפלגתיים מפלגתי מפלגתיים adjective masculine plural absolute unspecified unspecified  	O	null
29 ו ו ומתוך conjunction unspecified unspecified unspecified unspecified unspecified 0 
29 מתוך מתוך ומתוך preposition unspecified unspecified unspecified unspecified unspecified  	O	null
30 התעמתות התעמתות התעמתות noun feminine singular absolute unspecified unspecified  	O	null
31 גלויה גלוי גלויה adjective feminine singular absolute unspecified unspecified  	O	null
32 עם עם עם preposition unspecified unspecified unspecified unspecified unspecified  	O	null
33 פרסומי פרסום פרסומיה noun masculine plural absolute unspecified unspecified  
33 ה ה פרסומיה possessive feminine singular unspecified 3 unspecified 0 	O	null
34 של של של shel-preposition unspecified unspecified unspecified unspecified unspecified  	O	null
35 תנועת תנועה תנועת noun feminine singular construct unspecified unspecified  	O	null
36 " " " punctuation unspecified unspecified unspecified unspecified unspecified  	O	null
37 הבונד הבונד הבונד properName unspecified unspecified unspecified unspecified unspecified  	I_ORG	null
38 " " " punctuation unspecified unspecified unspecified unspecified unspecified  	O	null
39 . . . punctuation unspecified unspecified unspecified unspecified unspecified  	O	null

0 נטיית נטייה נטייתו noun feminine singular absolute unspecified unspecified  
0 ו ו נטייתו possessive masculine singular unspecified 3 unspecified 0 	O	null
1 ל ל לעיצוב preposition unspecified unspecified unspecified unspecified unspecified 0 
1 עיצוב עיצוב לעיצוב noun masculine singular construct unspecified unspecified  	O	null
2 שירי שיר שירי noun masculine plural construct unspecified unspecified  	O	null
3 - - - punctuation unspecified unspecified unspecified unspecified unspecified  	O	null
4 הגות הגות הגותי noun feminine singular absolute unspecified unspecified  
4 י י הגותי possessive masculine-and-feminine singular unspecified 1 unspecified 0 	O	null
5 של של של shel-preposition unspecified unspecified unspecified unspecified unspecified  	O	null
6 נושאים נושא נושאים noun masculine plural absolute unspecified unspecified  	O	null
7 מיסטיים מיסטי מיסטיים adjective masculine plural absolute unspecified unspecified  	O	null
8 - - - punctuation unspecified unspecified unspecified unspecified unspecified  	O	null
9 אפוקליפטיים אפוקליפטי אפוקליפטיים adjective masculine plural absolute unspecified unspecified  	O	null
10 ב ב בצורות preposition unspecified unspecified unspecified unspecified unspecified 0 
10 צורות צורה בצורות noun feminine plural absolute unspecified unspecified  	O	null
11 ספרותיות ספרותי ספרותיות adjective feminine plural absolute unspecified unspecified  	O	null
12 רחבות רחב רחבות adjective feminine plural absolute unspecified unspecified  	O	null
13 התחזקה התחזק התחזקה verb feminine singular unspecified 3 past  	O	null
14 ו ו והלכה conjunction unspecified unspecified unspecified unspecified unspecified 0 
14 הלכה הלך והלכה verb feminine singular unspecified 3 past  	O	null
15 ב ב בשנות preposition unspecified unspecified unspecified unspecified unspecified 0 
15 שנות שנה בשנות noun feminine plural construct unspecified unspecified  	I_DATE	null
16 ה ה השלושים definiteArticle unspecified unspecified unspecified unspecified unspecified 0 
16 השלושים ORD-CARD30 השלושים numeral masculine-and-feminine plural absolute unspecified unspecified  	I_DATE	null
17 , , , punctuation unspecified unspecified unspecified unspecified unspecified  	O	null
18 ו ו וככל conjunction unspecified unspecified unspecified unspecified unspecified 0 
18 ככל ככל וככל conjunction unspecified unspecified unspecified unspecified unspecified  	O	null
19 ש ש שהתקדרה relativizer/subordinatingConjunction unspecified unspecified unspecified unspecified unspecified 0 
19 התקדרה התקדר שהתקדרה verb feminine singular unspecified 3 past  	O	null
20 מציאות מציאות מציאות noun feminine singular construct unspecified unspecified  	O	null
21 חיי חיים חייהם noun masculine plural absolute unspecified unspecified  
21 הם הם חייהם possessive masculine plural unspecified 3 unspecified 0 	O	null
22 של של של shel-preposition unspecified unspecified unspecified unspecified unspecified  	O	null
23 יהודי יהודי יהודי noun masculine singular absolute unspecified unspecified  	O	null
24 פולין פולין פולין properName unspecified unspecified unspecified unspecified unspecified  	I_LOC	null
25 ו ו והתגברה conjunction unspecified unspecified unspecified unspecified unspecified 0 
25 התגברה התגבר והתגברה verb feminine singular unspecified 3 past  	O	null
26 אימת אימה אימת noun feminine singular construct unspecified unspecified  	O	null
27 ה ה הנאציזם definiteArticle unspecified unspecified unspecified unspecified unspecified 0 
27 הנאציזם הנאציזם הנאציזם noun masculine singular absolute unspecified unspecified  	O	null
28 התרבו התרבה התרבו verb masculine-and-feminine plural unspecified 3 past  	O	null
29 ב ב בשירתו preposition unspecified unspecified unspecified unspecified unspecified 0 
29 שירת שירה בשירתו noun feminine singular absolute unspecified unspecified  
29 ו ו בשירתו possessive masculine singular unspecified 3 unspecified 0 	O	null
30 ו ו ובמחזותיו conjunction unspecified unspecified unspecified unspecified unspecified 0 
30 ב ב ובמחזותיו preposition unspecified unspecified unspecified unspecified unspecified 0 
30 מחזותי מחזה ובמחזותיו noun masculine plural absolute unspecified unspecified  
30 ו ו ובמחזותיו possessive masculine singular unspecified 3 unspecified 0 	O	null
31 , , , punctuation unspecified unspecified unspecified unspecified unspecified  	O	null
32 בעיקר בעיקר בעיקר adverb unspecified unspecified unspecified unspecified unspecified  	O	null
33 ב ב ביידיש preposition unspecified unspecified unspecified unspecified unspecified 0 
33 יידיש יידיש ביידיש properName unspecified unspecified unspecified unspecified unspecified  	I_LOC	null
34 , , , punctuation unspecified unspecified unspecified unspecified unspecified  	O	null
35 תיאורי תיאור תיאורי noun masculine plural construct unspecified unspecified  	O	null
36 חורבן חורבן חורבן noun masculine singular absolute unspecified unspecified  	O	null
37 ו ו וכיליון conjunction unspecified unspecified unspecified unspecified unspecified 0 
37 כיליון כיליון וכיליון noun masculine singular absolute unspecified unspecified  	O	null
38 מזעזעים זיעזע מזעזעים verb masculine plural unspecified any beinoni  	O	null
39 ב ב בעוצמתם preposition unspecified unspecified unspecified unspecified unspecified 0 
39 עוצמת עוצמה בעוצמתם noun feminine singular absolute unspecified unspecified  
39 ם ם בעוצמתם possessive masculine plural unspecified 3 unspecified 0 	O	null
40 . . . punctuation unspecified unspecified unspecified unspecified unspecified  	O	null

0 ב ב ב preposition unspecified unspecified unspecified unspecified unspecified 0 	I_ORG	null
1 - - - punctuation unspecified unspecified unspecified unspecified unspecified  	I_ORG	null
2 ###NUMBER### ###NUMBER### ###NUMBER### numeral unspecified unspecified unspecified unspecified unspecified  	I_DATE	null
3 שהה שהה שהה verb masculine singular unspecified 3 past  	O	null
4 בניויורק בניויורק בניויורק properName unspecified unspecified unspecified unspecified unspecified  	O	null
5 לרגל לרגל לרגל preposition unspecified unspecified unspecified unspecified unspecified  	O	null
6 בכורת בכור בכורת noun feminine singular construct unspecified unspecified  	O	null
7 אחד CARD1 אחד numeral masculine singular absolute unspecified unspecified  	O	null
8 מ מ ממחזותיו preposition unspecified unspecified unspecified unspecified unspecified 0 
8 מחזותי מחזה ממחזותיו noun masculine plural absolute unspecified unspecified  
8 ו ו ממחזותיו possessive masculine singular unspecified 3 unspecified 0 	O	null
9 , , , punctuation unspecified unspecified unspecified unspecified unspecified  	O	null
10 ו ו ושם conjunction unspecified unspecified unspecified unspecified unspecified 0 
10 שם שם ושם adverb unspecified unspecified unspecified unspecified unspecified  	O	null
11 מצאה מצא מצאה verb feminine singular unspecified 3 past  	O	null
12 את את אותו at-preposition unspecified unspecified unspecified unspecified unspecified  
12 ו ו אותו pronomial masculine singular unspecified 3 unspecified 0 	O	null
13 מלחמת מלחמה מלחמת noun feminine singular construct unspecified unspecified  	O	null
14 ה ה העולם definiteArticle unspecified unspecified unspecified unspecified unspecified 0 
14 העולם עולם העולם noun masculine singular absolute unspecified unspecified  	O	null
15 ה ה השנייה definiteArticle unspecified unspecified unspecified unspecified unspecified 0 
15 השנייה ORD2 השנייה numeral feminine singular absolute unspecified unspecified  	O	null
16 . . . punctuation unspecified unspecified unspecified unspecified unspecified  	O	null

0 משפחת משפחה משפחתו noun feminine singular absolute unspecified unspecified  
0 ו ו משפחתו possessive masculine singular unspecified 3 unspecified 0 	O	null
1 ב ב בפולין preposition unspecified unspecified unspecified unspecified unspecified 0 
1 פולין פולין בפולין properName unspecified unspecified unspecified unspecified unspecified  	I_LOC	null
2 נספתה נספה נספתה verb feminine singular unspecified 3 past  	O	null
3 , , , punctuation unspecified unspecified unspecified unspecified unspecified  	O	null
4 ו ו ומאז conjunction unspecified unspecified unspecified unspecified unspecified 0 
4 מאז מאז ומאז adverb unspecified unspecified unspecified unspecified unspecified  	O	null
5 נעשתה נעשה נעשתה verb feminine singular unspecified 3 past  	O	null
6 ניויורק ניויורק ניויורק properName unspecified unspecified unspecified unspecified unspecified  	I_PERS	null
7 ל ל לביתו preposition unspecified unspecified unspecified unspecified unspecified 0 
7 בית בית לביתו noun masculine singular absolute unspecified unspecified  
7 ו ו לביתו possessive masculine singular unspecified 3 unspecified 0 	O	null
8 ל ל לשארית preposition unspecified unspecified unspecified unspecified unspecified 0 
8 שארית שארית לשארית noun feminine singular construct unspecified unspecified  	O	null
9 ימי יום ימיו noun masculine plural absolute unspecified unspecified  
9 ו ו ימיו possessive masculine singular unspecified 3 unspecified 0 	O	null
10 . . . punctuation unspecified unspecified unspecified unspecified unspecified  	O	null

0 עד עד עד preposition unspecified unspecified unspecified unspecified unspecified  	O	null
1 מהרה במהרה מהרה adverb unspecified unspecified unspecified unspecified unspecified  	O	null
2 ניכר ניכר ניכר verb masculine singular unspecified 3 past  	O	null
3 חותם חותם חותמו noun masculine singular absolute unspecified unspecified  
3 ו ו חותמו possessive masculine singular unspecified 3 unspecified 0 	O	null
4 ב ב בחיי preposition unspecified unspecified unspecified unspecified unspecified 0 
4 חיי חיים בחיי noun masculine plural construct unspecified unspecified  	O	null
5 ה ה התרבות definiteArticle unspecified unspecified unspecified unspecified unspecified 0 
5 התרבות תרבות התרבות noun feminine singular absolute unspecified unspecified  	O	null
6 של של של shel-preposition unspecified unspecified unspecified unspecified unspecified  	O	null
7 יהודי יהודי יהודי noun masculine singular absolute unspecified unspecified  	O	null
8 ארצות ארץ ארצות properName unspecified unspecified unspecified unspecified unspecified  	I_LOC	null
9 הברית ברית הברית properName unspecified unspecified unspecified unspecified unspecified  	I_LOC	null
10 , , , punctuation unspecified unspecified unspecified unspecified unspecified  	O	null
11 הן הן הן conjunction unspecified unspecified unspecified unspecified unspecified  	O	null
12 כ כ כמשתתף preposition unspecified unspecified unspecified unspecified unspecified 0 
12 משתתף משתתף כמשתתף noun masculine singular absolute unspecified unspecified  	O	null
13 בולט בולט בולט adjective masculine singular absolute unspecified unspecified  	O	null
14 ב ב בעיתונות preposition unspecified unspecified unspecified unspecified unspecified 0 
14 עיתונות עיתונות בעיתונות noun feminine singular construct unspecified unspecified  	O	null
15 יידיש יידיש יידיש properName feminine singular unspecified unspecified unspecified  	O	null
16 ה ה המקומית definiteArticle unspecified unspecified unspecified unspecified unspecified 0 
16 המקומית מקומי המקומית adjective feminine singular absolute unspecified unspecified  	O	null
17 ו ו והן conjunction unspecified unspecified unspecified unspecified unspecified 0 
17 הן הן והן conjunction unspecified unspecified unspecified unspecified unspecified  	O	null
18 ב ב בכהונתו preposition unspecified unspecified unspecified unspecified unspecified 0 
18 כהונת כהונה בכהונתו noun feminine singular absolute unspecified unspecified  
18 ו ו בכהונתו possessive masculine singular unspecified 3 unspecified 0 	O	null
19 כ כ כמרצה preposition unspecified unspecified unspecified unspecified unspecified 0 
19 ה ה כמרצה definiteArticle unspecified unspecified unspecified unspecified unspecified 0 
19 המרצה הרצה כמרצה participle masculine singular absolute any unspecified  	O	null
20 ל ל לספרות preposition unspecified unspecified unspecified unspecified unspecified 0 
20 ספרות ספרות לספרות noun feminine singular absolute unspecified unspecified  	O	null
21 עברית עברי עברית adjective feminine singular absolute unspecified unspecified  	O	null
22 ב ב בסמינר preposition unspecified unspecified unspecified unspecified unspecified 0 
22 ה ה בסמינר definiteArticle unspecified unspecified unspecified unspecified unspecified 0 
22 הסמינר סמינר בסמינר noun masculine singular absolute unspecified unspecified  	O	null
23 ה ה התיאולוגי definiteArticle unspecified unspecified unspecified unspecified unspecified 0 
23 התיאולוגי התיאולוגי התיאולוגי adjective masculine singular absolute unspecified unspecified  	O	null
24 ה ה היהודי definiteArticle unspecified unspecified unspecified unspecified unspecified 0 
24 היהודי יהודי היהודי adjective masculine singular absolute unspecified unspecified  	O	null
25 . . . punctuation unspecified unspecified unspecified unspecified unspecified  	O	null

0 יצירת יצירה יצירתו noun feminine singular absolute unspecified unspecified  
0 ו ו יצירתו possessive masculine singular unspecified 3 unspecified 0 	O	null
1 ה ה הדו definiteArticle unspecified unspecified unspecified unspecified unspecified 0 
1 הדו דו הדו wPrefix unspecified unspecified unspecified unspecified unspecified  	I_ORG	null
2 - - - punctuation unspecified unspecified unspecified unspecified unspecified  	I_ORG	null
3 לשונית לשוני לשונית adjective feminine singular absolute unspecified unspecified  	I_ORG	null
4 ב ב בשירה preposition unspecified unspecified unspecified unspecified unspecified 0 
4 שירה שירה בשירה noun feminine singular absolute unspecified unspecified  	O	null
5 ו ו ובדרמה conjunction unspecified unspecified unspecified unspecified unspecified 0 
5 ב ב ובדרמה preposition unspecified unspecified unspecified unspecified unspecified 0 
5 ה ה ובדרמה definiteArticle unspecified unspecified unspecified unspecified unspecified 0 
5 הדרמה דרמה ובדרמה noun feminine singular absolute unspecified unspecified  	O	null
6 עמדה עמד עמדה verb feminine singular unspecified 3 past  	O	null
7 מאז מאז מאז adverb unspecified unspecified unspecified unspecified unspecified  	O	null
8 ואילך ואילך ואילך adverb unspecified unspecified unspecified unspecified unspecified  	O	null
9 ב ב בסימנן preposition unspecified unspecified unspecified unspecified unspecified 0 
9 סימן סימן בסימנן noun masculine singular absolute unspecified unspecified  
9 ן ן בסימנן possessive feminine plural unspecified 3 unspecified 0 	O	null
10 של של של shel-preposition unspecified unspecified unspecified unspecified unspecified  	O	null
11 שתי CARD2 שתי numeral feminine dual construct unspecified unspecified  	O	null
12 חוויות חוויה חוויות noun feminine plural absolute unspecified unspecified  	O	null
13 היסטוריות היסטורי היסטוריות adjective feminine plural absolute unspecified unspecified  	O	null
14 מרכזיות מרכזי מרכזיות adjective feminine plural absolute unspecified unspecified  	O	null
15 : : : punctuation unspecified unspecified unspecified unspecified unspecified  	O	null
16 חורבן חורבן חורבנה noun masculine singular absolute unspecified unspecified  
16 ה ה חורבנה possessive feminine singular unspecified 3 unspecified 0 	O	null
17 של של של shel-preposition unspecified unspecified unspecified unspecified unspecified  	O	null
18 יהדות יהדות יהדות noun feminine singular construct unspecified unspecified  	O	null
19 אירופה אירופה אירופה properName unspecified unspecified unspecified unspecified unspecified  	I_LOC	null
20 ו ו ותקומתה conjunction unspecified unspecified unspecified unspecified unspecified 0 
20 תקומת תקומה ותקומתה noun feminine singular absolute unspecified unspecified  
20 ה ה ותקומתה possessive feminine singular unspecified 3 unspecified 0 	O	null
21 של של של shel-preposition unspecified unspecified unspecified unspecified unspecified  	O	null
22 מדינת מדינה מדינת noun feminine singular construct unspecified unspecified  	I_ORG	null
23 ישראל ישראל ישראל properName unspecified unspecified unspecified unspecified unspecified  	I_ORG	null
24 , , , punctuation unspecified unspecified unspecified unspecified unspecified  	O	null
25 ש ש שאותה relativizer/subordinatingConjunction unspecified unspecified unspecified unspecified unspecified 0 
25 את את שאותה at-preposition unspecified unspecified unspecified unspecified unspecified  
25 ה ה שאותה pronomial feminine singular unspecified 3 unspecified 0 	O	null
26 תפש תפש תפש verb masculine singular unspecified 3 past  	O	null
27 ב ב במונחים preposition unspecified unspecified unspecified unspecified unspecified 0 
27 מונחים מונח במונחים noun masculine plural absolute unspecified unspecified  	O	null
28 משיחיים משיחי משיחיים adjective masculine plural absolute unspecified unspecified  	O	null
29 . . . punctuation unspecified unspecified unspecified unspecified unspecified  	O	null

0 יצירת יצירה יצירתו noun feminine singular absolute unspecified unspecified  
0 ו ו יצירתו possessive masculine singular unspecified 3 unspecified 0 	O	null
1 ה ה המרכזית definiteArticle unspecified unspecified unspecified unspecified unspecified 0 
1 המרכזית מרכזי המרכזית adjective feminine singular absolute unspecified unspecified  	O	null
2 מן מן מן preposition unspecified unspecified unspecified unspecified unspecified  	O	null
3 ה ה השנים definiteArticle unspecified unspecified unspecified unspecified unspecified 0 
3 השנים שנה השנים noun feminine plural absolute unspecified unspecified  	O	null
4 ההן ההין ההן verb masculine singular unspecified 2 imperative  	O	null
5 היא הוא היא pronoun feminine singular unspecified 3 unspecified  	O	null
6 ה ה הפואמה definiteArticle unspecified unspecified unspecified unspecified unspecified 0 
6 הפואמה פואמה הפואמה noun feminine singular absolute unspecified unspecified  	O	null
7 ה ה הדרמטית definiteArticle unspecified unspecified unspecified unspecified unspecified 0 
7 הדרמטית דרמטי הדרמטית adjective feminine singular absolute unspecified unspecified  	O	null
8 בין בין בין preposition unspecified unspecified unspecified unspecified unspecified  	O	null
9 ה ה האש definiteArticle unspecified unspecified unspecified unspecified unspecified 0 
9 האש אש האש noun feminine singular absolute unspecified unspecified  	O	null
10 ו ו והישע conjunction unspecified unspecified unspecified unspecified unspecified 0 
10 ה ה והישע definiteArticle unspecified unspecified unspecified unspecified unspecified 0 
10 הישע ישע והישע noun masculine singular absolute unspecified unspecified  	O	null
11 ) ) ) punctuation unspecified unspecified unspecified unspecified unspecified  	O	null
12 , , , punctuation unspecified unspecified unspecified unspecified unspecified  	O	null
13 ###NUMBER### ###NUMBER### ###NUMBER### numeral unspecified unspecified unspecified unspecified unspecified  	I_DATE	null
14 ה ה המגוללת definiteArticle unspecified unspecified unspecified unspecified unspecified 0 
14 המגוללת גולל המגוללת participle feminine singular absolute any unspecified  	O	null
15 את את את at-preposition unspecified unspecified unspecified unspecified unspecified  	O	null
16 קורות קורה קורות noun feminine plural construct unspecified unspecified  	O	null
17 ה ה השנים definiteArticle unspecified unspecified unspecified unspecified unspecified 0 
17 השנים שנה השנים noun feminine plural absolute unspecified unspecified  	O	null
18 ###NUMBER### ###NUMBER### ###NUMBER### numeral unspecified unspecified unspecified unspecified unspecified  	I_DATE	null
19 - - - punctuation unspecified unspecified unspecified unspecified unspecified  	O	null
20 ###NUMBER### ###NUMBER### ###NUMBER### numeral unspecified unspecified unspecified unspecified unspecified  	I_DATE	null
21 . . . punctuation unspecified unspecified unspecified unspecified unspecified  	O	null

0 היא הוא היא pronoun feminine singular unspecified 3 unspecified  	O	null
1 פותחת פתח פותחת verb feminine singular unspecified any beinoni  	O	null
2 ב ב בתיאור preposition unspecified unspecified unspecified unspecified unspecified 0 
2 תיאור תיאור בתיאור noun masculine singular construct unspecified unspecified  	O	null
3 זוועות זוועה זוועות noun feminine plural construct unspecified unspecified  	O	null
4 ה ה השואה definiteArticle unspecified unspecified unspecified unspecified unspecified 0 
4 השואה שואה השואה noun feminine singular absolute unspecified unspecified  	O	null
5 , , , punctuation unspecified unspecified unspecified unspecified unspecified  	O	null
6 ה ה המומחשות definiteArticle unspecified unspecified unspecified unspecified unspecified 0 
6 המומחשות הומחש המומחשות participle feminine plural absolute any unspecified  	O	null
7 באמצעות באמצעות באמצעות preposition unspecified unspecified unspecified unspecified unspecified  	O	null
8 סדרה סדרה סדרה noun feminine singular absolute unspecified unspecified  	O	null
9 של של של shel-preposition unspecified unspecified unspecified unspecified unspecified  	O	null
10 דמויות דמות דמויות noun feminine plural absolute unspecified unspecified  	O	null
11 יהודים יהודי יהודים noun masculine plural absolute unspecified unspecified  	O	null
12 ו ו ולא conjunction unspecified unspecified unspecified unspecified unspecified 0 
12 לא לא ולא negation unspecified unspecified unspecified unspecified unspecified  	O	null
13 - - - punctuation unspecified unspecified unspecified unspecified unspecified  	O	null
14 יהודים יהודי יהודים adjective masculine plural absolute unspecified unspecified  	O	null
15 . . . punctuation unspecified unspecified unspecified unspecified unspecified  	O	null

0 ה ה השאלה definiteArticle unspecified unspecified unspecified unspecified unspecified 0 
0 השאלה שאלה השאלה noun feminine singular absolute unspecified unspecified  	O	null
1 ה ה הנשאלת definiteArticle unspecified unspecified unspecified unspecified unspecified 0 
1 הנשאלת נשאל הנשאלת participle feminine singular absolute any unspecified  	O	null
2 ב ב בפי preposition unspecified unspecified unspecified unspecified unspecified 0 
2 פי פה בפי noun masculine singular construct unspecified unspecified  	O	null
3 כול כול כולן quantifier unspecified unspecified unspecified unspecified unspecified  
3 הן הן כולן pronomial feminine plural unspecified 3 unspecified 0 	O	null
4 היא הוא היא copula feminine singular unspecified 3 beinoni  	O	null
5 : : : punctuation unspecified unspecified unspecified unspecified unspecified  	O	null
6 היכן היכן היכן interrogative unspecified unspecified unspecified unspecified unspecified  	O	null
7 ה ה ההמשך definiteArticle unspecified unspecified unspecified unspecified unspecified 0 
7 ההמשך המשך ההמשך noun masculine singular absolute unspecified unspecified  	O	null
8 מכאן מכאן מכאן adverb unspecified unspecified unspecified unspecified unspecified  	O	null
9 ו ו והלאה conjunction unspecified unspecified unspecified unspecified unspecified 0 
9 הלאה הלאה והלאה adverb unspecified unspecified unspecified unspecified unspecified  	O	null
10 ? ? ? punctuation unspecified unspecified unspecified unspecified unspecified  	O	null

0 ה ה התשובה definiteArticle unspecified unspecified unspecified unspecified unspecified 0 
0 התשובה תשובה התשובה noun feminine singular absolute unspecified unspecified  	O	null
1 ה ה הניתנת definiteArticle unspecified unspecified unspecified unspecified unspecified 0 
1 הניתנת ניתן הניתנת participle feminine singular absolute any unspecified  	O	null
2 על על על preposition unspecified unspecified unspecified unspecified unspecified  	O	null
3 ידי יד ידי noun feminine plural construct unspecified unspecified  	O	null
4 ה ה הדמות definiteArticle unspecified unspecified unspecified unspecified unspecified 0 
4 הדמות דמות הדמות noun feminine singular absolute unspecified unspecified  	O	null
5 ה ה המרכזית definiteArticle unspecified unspecified unspecified unspecified unspecified 0 
5 המרכזית מרכזי המרכזית adjective feminine singular absolute unspecified unspecified  	O	null
6 , , , punctuation unspecified unspecified unspecified unspecified unspecified  	O	null
7 שאלתיאל שאלתיאל שאלתיאל properName unspecified unspecified unspecified unspecified unspecified  	I_PERS	null
8 , , , punctuation unspecified unspecified unspecified unspecified unspecified  	O	null
9 פרטיזן פרטיזן פרטיזן noun masculine singular absolute unspecified unspecified  	O	null
10 ש ש ששכל relativizer/subordinatingConjunction unspecified unspecified unspecified unspecified unspecified 0 
10 שכל שכל ששכל verb masculine singular unspecified 3 past  	O	null
11 את את את at-preposition unspecified unspecified unspecified unspecified unspecified  	O	null
12 כל כול כל quantifier unspecified unspecified construct unspecified unspecified  	O	null
13 משפחת משפחה משפחתו noun feminine singular absolute unspecified unspecified  
13 ו ו משפחתו possessive masculine singular unspecified 3 unspecified 0 	O	null
14 ב ב בשואה preposition unspecified unspecified unspecified unspecified unspecified 0 
14 ה ה בשואה definiteArticle unspecified unspecified unspecified unspecified unspecified 0 
14 השואה שואה בשואה noun feminine singular absolute unspecified unspecified  	O	null
15 , , , punctuation unspecified unspecified unspecified unspecified unspecified  	O	null
16 היא הוא היא pronoun feminine singular unspecified 3 unspecified  	O	null
17 : : : punctuation unspecified unspecified unspecified unspecified unspecified  	O	null
18 ב ב במלחמת preposition unspecified unspecified unspecified unspecified unspecified 0 
18 מלחמת מלחמה במלחמת noun feminine singular construct unspecified unspecified  	O	null
19 ה ה העצמאות definiteArticle unspecified unspecified unspecified unspecified unspecified 0 
19 העצמאות עצמאות העצמאות noun feminine singular absolute unspecified unspecified  	O	null
20 ב ב בארץ preposition unspecified unspecified unspecified unspecified unspecified 0 
20 ארץ ארץ בארץ noun feminine singular construct unspecified unspecified  	I_LOC	null
21 ישראל ישראל ישראל properName unspecified unspecified unspecified unspecified unspecified  	I_LOC	null
22 . . . punctuation unspecified unspecified unspecified unspecified unspecified  	O	null

0 ה ה השאלה definiteArticle unspecified unspecified unspecified unspecified unspecified 0 
0 השאלה שאלה השאלה noun feminine singular absolute unspecified unspecified  	O	null
1 ה ה ההגותית definiteArticle unspecified unspecified unspecified unspecified unspecified 0 
1 ההגותית ההגותית ההגותית adjective feminine singular absolute unspecified unspecified  	O	null
2 ש ש שביסוד relativizer/subordinatingConjunction unspecified unspecified unspecified unspecified unspecified 0 
2 ב ב שביסוד preposition unspecified unspecified unspecified unspecified unspecified 0 
2 יסוד יסוד שביסוד noun masculine singular construct unspecified unspecified  	O	null
3 ה ה היצירה definiteArticle unspecified unspecified unspecified unspecified unspecified 0 
3 היצירה יצירה היצירה noun feminine singular absolute unspecified unspecified  	O	null
4 היא הוא היא copula feminine singular unspecified 3 beinoni  	O	null
5 : : : punctuation unspecified unspecified unspecified unspecified unspecified  	O	null
6 מה מה מה interrogative unspecified unspecified unspecified unspecified unspecified  	O	null
7 בין בין בין preposition unspecified unspecified unspecified unspecified unspecified  	O	null
8 הוויית הוויית הוויית noun feminine singular construct unspecified unspecified  	O	null
9 ה ה הגאולה definiteArticle unspecified unspecified unspecified unspecified unspecified 0 
9 הגאולה גאולה הגאולה noun feminine singular absolute unspecified unspecified  	O	null
10 ה ה הציונית definiteArticle unspecified unspecified unspecified unspecified unspecified 0 
10 הציונית ציוני הציונית adjective feminine singular absolute unspecified unspecified  	O	null
11 בארץישראל בארץישראל בארץישראל properName unspecified unspecified unspecified unspecified unspecified  	O	null
12 ו ו ובין conjunction unspecified unspecified unspecified unspecified unspecified 0 
12 בין בין ובין preposition unspecified unspecified unspecified unspecified unspecified  	O	null
13 הוויית הוויית הוויית noun feminine singular construct unspecified unspecified  	O	null
14 ה ה החורבן definiteArticle unspecified unspecified unspecified unspecified unspecified 0 
14 החורבן חורבן החורבן noun masculine singular absolute unspecified unspecified  	O	null
15 ש ש שקדמה relativizer/subordinatingConjunction unspecified unspecified unspecified unspecified unspecified 0 
15 קדמה קדם שקדמה verb feminine singular unspecified 3 past  	O	null
16 ל ל לה preposition unspecified unspecified unspecified unspecified unspecified  
16 ה ה לה pronomial feminine singular unspecified 3 unspecified 0 	O	null
17 , , , punctuation unspecified unspecified unspecified unspecified unspecified  	O	null
18 מה מה מה interrogative unspecified unspecified unspecified unspecified unspecified  	O	null
19 בין בין בין preposition unspecified unspecified unspecified unspecified unspecified  	O	null
20 ה ה העם definiteArticle unspecified unspecified unspecified unspecified unspecified 0 
20 העם עם העם noun masculine singular absolute unspecified unspecified  	O	null
21 ה ה הישראלי definiteArticle unspecified unspecified unspecified unspecified unspecified 0 
21 הישראלי ישראלי הישראלי adjective masculine singular absolute unspecified unspecified  	O	null
22 ה ה החדש definiteArticle unspecified unspecified unspecified unspecified unspecified 0 
22 החדש חדש החדש adjective masculine singular absolute unspecified unspecified  	O	null
23 ל ל לעולמם preposition unspecified unspecified unspecified unspecified unspecified 0 
23 עולם עולם לעולמם noun masculine singular absolute unspecified unspecified  
23 ם ם לעולמם possessive masculine plural unspecified 3 unspecified 0 	O	null
24 של של של shel-preposition unspecified unspecified unspecified unspecified unspecified  	O	null
25 אבותי אב אבותיו noun masculine plural absolute unspecified unspecified  
25 ו ו אבותיו possessive masculine singular unspecified 3 unspecified 0 	O	null
26 ב ב בגולה preposition unspecified unspecified unspecified unspecified unspecified 0 
26 ה ה בגולה definiteArticle unspecified unspecified unspecified unspecified unspecified 0 
26 הגולה גולה בגולה noun masculine singular absolute unspecified unspecified  	O	null
27 ו ו ולהיסטוריה conjunction unspecified unspecified unspecified unspecified unspecified 0 
27 ל ל ולהיסטוריה preposition unspecified unspecified unspecified unspecified unspecified 0 
27 ה ה ולהיסטוריה definiteArticle unspecified unspecified unspecified unspecified unspecified 0 
27 ההיסטוריה היסטוריה ולהיסטוריה noun feminine singular absolute unspecified unspecified  	O	null
28 ה ה היהודית definiteArticle unspecified unspecified unspecified unspecified unspecified 0 
28 היהודית יהודי היהודית adjective feminine singular absolute unspecified unspecified  	O	null
29 כול כול כולה quantifier unspecified unspecified unspecified unspecified unspecified  
29 ה ה כולה pronomial feminine singular unspecified 3 unspecified 0 	O	null
30 , , , punctuation unspecified unspecified unspecified unspecified unspecified  	O	null
31 ו ו והאם conjunction unspecified unspecified unspecified unspecified unspecified 0 
31 האם האם והאם interrogative unspecified unspecified unspecified unspecified unspecified  	O	null
32 יש יש יש existential unspecified unspecified unspecified unspecified unspecified  	O	null
33 ב ב בתקומת preposition unspecified unspecified unspecified unspecified unspecified 0 
33 תקומת תקומה בתקומת noun feminine singular construct unspecified unspecified  	O	null
34 ישראל ישראל ישראל properName unspecified unspecified unspecified unspecified unspecified  	I_LOC	null
35 משום משום משום conjunction unspecified unspecified unspecified unspecified unspecified  	O	null
36 נחמת נחמה נחמת noun feminine singular construct unspecified unspecified  	O	null
37 - - - punctuation unspecified unspecified unspecified unspecified unspecified  	O	null
38 מה מה מה interrogative unspecified unspecified unspecified unspecified unspecified  	O	null
39 על על על preposition unspecified unspecified unspecified unspecified unspecified  	O	null
40 אובדן אובדן אובדנה noun masculine singular absolute unspecified unspecified  
40 ה ה אובדנה possessive feminine singular unspecified 3 unspecified 0 	O	null
41 של של של shel-preposition unspecified unspecified unspecified unspecified unspecified  	O	null
42 יהדות יהדות יהדות noun feminine singular construct unspecified unspecified  	O	null
43 אירופה אירופה אירופה properName unspecified unspecified unspecified unspecified unspecified  	I_LOC	null
44 . . . punctuation unspecified unspecified unspecified unspecified unspecified  	O	null

0 מעין מעין מעין preposition unspecified unspecified unspecified unspecified unspecified  	O	null
1 המשך המשך המשך noun masculine singular absolute unspecified unspecified  	O	null
2 ל ל להתלבטות preposition unspecified unspecified unspecified unspecified unspecified 0 
2 התלבטות התלבטות להתלבטות noun feminine singular absolute unspecified unspecified  	O	null
3 זו זו זו pronoun feminine singular unspecified 3 unspecified  	O	null
4 ניתן ניתן ניתן verb masculine singular unspecified 3 past  	O	null
5 ב ב בספרו preposition unspecified unspecified unspecified unspecified unspecified 0 
5 ספר ספר בספרו noun masculine singular absolute unspecified unspecified  
5 ו ו בספרו possessive masculine singular unspecified 3 unspecified 0 	O	null
6 מן מן מן preposition unspecified unspecified unspecified unspecified unspecified  	O	null
7 ה ה האדם definiteArticle unspecified unspecified unspecified unspecified unspecified 0 
7 האדם אדם האדם noun masculine singular absolute unspecified unspecified  	O	null
8 ו ו ומעלה conjunction unspecified unspecified unspecified unspecified unspecified 0 
8 מעלה מעלה ומעלה noun feminine singular absolute unspecified unspecified  	O	null
9 ) ) ) punctuation unspecified unspecified unspecified unspecified unspecified  	O	null
10 , , , punctuation unspecified unspecified unspecified unspecified unspecified  	O	null
11 ###NUMBER### ###NUMBER### ###NUMBER### numeral unspecified unspecified unspecified unspecified unspecified  	I_DATE	null
12 ה ה המכנס definiteArticle unspecified unspecified unspecified unspecified unspecified 0 
12 המכנס כינס המכנס participle masculine singular absolute any unspecified  	O	null
13 שתי CARD2 שתי numeral feminine dual construct unspecified unspecified  	O	null
14 פואמות פואמה פואמות noun feminine plural absolute unspecified unspecified  	O	null
15 , , , punctuation unspecified unspecified unspecified unspecified unspecified  	O	null
16 ו ו ובהן conjunction unspecified unspecified unspecified unspecified unspecified 0 
16 ב ב ובהן preposition unspecified unspecified unspecified unspecified unspecified 0 
16 הן הוא ובהן pronoun feminine plural unspecified 3 unspecified  	O	null
17 ביטויים ביטוי ביטויים noun masculine plural absolute unspecified unspecified  	O	null
18 של של של shel-preposition unspecified unspecified unspecified unspecified unspecified  	O	null
19 אכזבה אכזבה אכזבה noun feminine singular absolute unspecified unspecified  	O	null
20 מ מ מדיוקנה preposition unspecified unspecified unspecified unspecified unspecified 0 
20 דיוקן דיוקן מדיוקנה noun masculine singular absolute unspecified unspecified  
20 ה ה מדיוקנה possessive feminine singular unspecified 3 unspecified 0 	O	null
21 של של של shel-preposition unspecified unspecified unspecified unspecified unspecified  	O	null
22 ה ה המדינה definiteArticle unspecified unspecified unspecified unspecified unspecified 0 
22 המדינה מדינה המדינה noun feminine singular absolute unspecified unspecified  	O	null
23 ה ה החדשה definiteArticle unspecified unspecified unspecified unspecified unspecified 0 
23 החדשה חדש החדשה adjective feminine singular absolute unspecified unspecified  	O	null
24 , , , punctuation unspecified unspecified unspecified unspecified unspecified  	O	null
25 תוך תוך תוך preposition unspecified unspecified unspecified unspecified unspecified  	O	null
26 כדי כדי כדי conjunction unspecified unspecified unspecified unspecified unspecified  	O	null
27 התבדות התבדות התבדות noun feminine singular construct unspecified unspecified  	O	null
28 ה ה התקוות definiteArticle unspecified unspecified unspecified unspecified unspecified 0 
28 התקוות תקווה התקוות noun feminine plural absolute unspecified unspecified  	O	null
29 ה ה המשיחיות definiteArticle unspecified unspecified unspecified unspecified unspecified 0 
29 המשיחיות משיחי המשיחיות adjective feminine plural absolute unspecified unspecified  	O	null
30 ש ש שנתלו relativizer/subordinatingConjunction unspecified unspecified unspecified unspecified unspecified 0 
30 נתלו נתלה שנתלו verb masculine-and-feminine plural unspecified 3 past  	O	null
31 ב ב בה preposition unspecified unspecified unspecified unspecified unspecified  
31 ה ה בה pronomial feminine singular unspecified 3 unspecified 0 	O	null
32 . . . punctuation unspecified unspecified unspecified unspecified unspecified  	O	null

0 ראייה ראייה ראייה noun feminine singular absolute unspecified unspecified  	O	null
1 זו זו זו pronoun feminine singular unspecified 3 unspecified  	O	null
2 מתגלמת התגלם מתגלמת verb feminine singular unspecified any beinoni  	O	null
3 ב ב בנעימה preposition unspecified unspecified unspecified unspecified unspecified 0 
3 נעימה נעימה בנעימה noun feminine singular absolute unspecified unspecified  	O	null
4 סאטירית סאטירית סאטירית adjective feminine singular absolute unspecified unspecified  	O	null
5 - - - punctuation unspecified unspecified unspecified unspecified unspecified  	O	null
6 ביקורתית ביקורתי ביקורתית adjective feminine singular absolute unspecified unspecified  	O	null
7 חריפה חריף חריפה adjective feminine singular absolute unspecified unspecified  	O	null
8 . . . punctuation unspecified unspecified unspecified unspecified unspecified  	O	null

0 ביטוי ביטוי ביטוי noun masculine singular construct unspecified unspecified  	O	null
1 עיוני עיון עיוני noun masculine plural construct unspecified unspecified  	O	null
2 ישיר ישיר ישיר adjective masculine singular absolute unspecified unspecified  	O	null
3 ל ל לשאלות preposition unspecified unspecified unspecified unspecified unspecified 0 
3 שאלות שאלה לשאלות noun feminine plural construct unspecified unspecified  	O	null
4 אלה אלה אלה pronoun masculine-and-feminine plural unspecified 3 unspecified  	O	null
5 ניתן ניתן ניתן modal masculine singular unspecified any unspecified  	O	null
6 בספר סיפר בספרו verb unspecified unspecified unspecified unspecified infinitive  
6 ו ו בספרו accusative-or-nominative masculine singular unspecified 3 unspecified 0 	O	null
7 מדינה מדינה מדינה noun feminine singular absolute unspecified unspecified  	O	null
8 ו ו וחזון conjunction unspecified unspecified unspecified unspecified unspecified 0 
8 חזון חזון וחזון properName unspecified unspecified unspecified unspecified unspecified  	I_PERS	null
9 מדינה מדינה מדינה noun feminine singular absolute unspecified unspecified  	O	null
10 ) ) ) punctuation unspecified unspecified unspecified unspecified unspecified  	O	null
11 . . . punctuation unspecified unspecified unspecified unspecified unspecified  	O	null
12 ###NUMBER### ###NUMBER### ###NUMBER### numeral unspecified unspecified unspecified unspecified unspecified  	I_DATE	null
13 שירת שירה שירתו noun feminine singular absolute unspecified unspecified  
13 ו ו שירתו possessive masculine singular unspecified 3 unspecified 0 	O	null
14 ה ה העברית definiteArticle unspecified unspecified unspecified unspecified unspecified 0 
14 העברית עברית העברית properName feminine singular unspecified unspecified unspecified  	I_PERS	null
15 כונסה כונס כונסה verb feminine singular unspecified 3 past  	O	null
16 ב ב בספריו preposition unspecified unspecified unspecified unspecified unspecified 0 
16 ספרי ספר בספריו noun masculine plural absolute unspecified unspecified  
16 ו ו בספריו possessive masculine singular unspecified 3 unspecified 0 	O	null
17 שירים שיר שירים noun masculine plural absolute unspecified unspecified  	O	null
18 ו ו ופואמות conjunction unspecified unspecified unspecified unspecified unspecified 0 
18 פואמות פואמה ופואמות noun feminine plural construct unspecified unspecified  	O	null
19 ( ( ( punctuation unspecified unspecified unspecified unspecified unspecified  	O	null
20 ###NUMBER### ###NUMBER### ###NUMBER### numeral unspecified unspecified unspecified unspecified unspecified  	I_DATE	null
21 ) ) ) punctuation unspecified unspecified unspecified unspecified unspecified  	O	null
22 ו ו ורוח conjunction unspecified unspecified unspecified unspecified unspecified 0 
22 רוח רוח ורוח noun feminine singular construct unspecified unspecified  	O	null
23 מ מ ממצולה preposition unspecified unspecified unspecified unspecified unspecified 0 
23 מצולה מצולה ממצולה noun feminine singular absolute unspecified unspecified  	O	null
24 ) ) ) punctuation unspecified unspecified unspecified unspecified unspecified  	O	null
25 . . . punctuation unspecified unspecified unspecified unspecified unspecified  	O	null
26 ###NUMBER### ###NUMBER### ###NUMBER### numeral unspecified unspecified unspecified unspecified unspecified  	I_DATE	null
27 שירת שירה שירתו noun feminine singular absolute unspecified unspecified  
27 ו ו שירתו possessive masculine singular unspecified 3 unspecified 0 	O	null
28 ב ב ביידיש preposition unspecified unspecified unspecified unspecified unspecified 0 
28 יידיש יידיש ביידיש properName feminine singular unspecified unspecified unspecified  	I_LOC	null
29 כונסה כונס כונסה verb feminine singular unspecified 3 past  	O	null
30 ב ב בשני preposition unspecified unspecified unspecified unspecified unspecified 0 
30 שני שני בשני properName feminine singular unspecified unspecified unspecified  	I_LOC	null
31 כרכים כרך כרכים noun masculine plural absolute unspecified unspecified  	O	null
32 מקיפים הקיף מקיפים verb masculine plural unspecified any beinoni  	O	null
33 , , , punctuation unspecified unspecified unspecified unspecified unspecified  	O	null
34 אַלע אַלע אַלע properName unspecified unspecified unspecified unspecified unspecified  	I_PERS	null
35 לידער לידער לידער properName unspecified unspecified unspecified unspecified unspecified  	I_PERS	null
36 און און און properName unspecified unspecified unspecified unspecified unspecified  	I_PERS	null
37 פאָעמעס פאָעמעס פאָעמעס noun masculine singular absolute unspecified unspecified  	O	null
38 - - - punctuation unspecified unspecified unspecified unspecified unspecified  	O	null
39 ###NUMBER### ###NUMBER### ###NUMBER### numeral unspecified unspecified unspecified unspecified unspecified  	I_DATE	null
40 ) ) ) punctuation unspecified unspecified unspecified unspecified unspecified  	O	null
41 , , , punctuation unspecified unspecified unspecified unspecified unspecified  	O	null
42 ###NUMBER### ###NUMBER### ###NUMBER### numeral unspecified unspecified unspecified unspecified unspecified  	I_DATE	null
43 ו ו ומחזותיו conjunction unspecified unspecified unspecified unspecified unspecified 0 
43 מ מ ומחזותיו preposition unspecified unspecified unspecified unspecified unspecified 0 
43 חזותי חזה ומחזותיו noun masculine plural absolute unspecified unspecified  
43 ו ו ומחזותיו possessive masculine singular unspecified 3 unspecified 0 	O	null
44 ב ב בכרך preposition unspecified unspecified unspecified unspecified unspecified 0 
44 כרך כרך בכרך noun masculine singular construct unspecified unspecified  	O	null
45 געזאַמלטע געזאַמלטע געזאַמלטע properName unspecified unspecified unspecified unspecified unspecified  	I_ORG	null
46 דראַמעס דראַמעס דראַמעס properName unspecified unspecified unspecified unspecified unspecified  	I_ORG	null
47 ) ) ) punctuation unspecified unspecified unspecified unspecified unspecified  	O	null
48 . . . punctuation unspecified unspecified unspecified unspecified unspecified  	O	null
49 ###NUMBER### ###NUMBER### ###NUMBER### numeral unspecified unspecified unspecified unspecified unspecified  	I_DATE	null
50 שלושה CARD3 שלושה numeral masculine plural absolute unspecified unspecified  	O	null
51 מ מ ממחזותיו preposition unspecified unspecified unspecified unspecified unspecified 0 
51 מחזותי מחזה ממחזותיו noun masculine plural absolute unspecified unspecified  
51 ו ו ממחזותיו possessive masculine singular unspecified 3 unspecified 0 	O	null
52 הופיעו הופיע הופיעו verb masculine-and-feminine plural unspecified 2 imperative  	O	null
53 ב ב בנוסח preposition unspecified unspecified unspecified unspecified unspecified 0 
53 נוסח נוסח בנוסח noun masculine singular construct unspecified unspecified  	O	null
54 עברי עבר עברי noun masculine plural construct unspecified unspecified  	O	null
55 ב ב בכרך preposition unspecified unspecified unspecified unspecified unspecified 0 
55 כרך כרך בכרך noun masculine singular construct unspecified unspecified  	O	null
56 ברנר ברנר ברנר properName unspecified unspecified unspecified unspecified unspecified  	I_LOC	null
57 , , , punctuation unspecified unspecified unspecified unspecified unspecified  	O	null
58 אסתרקה אסתרקה אסתרקה properName unspecified unspecified unspecified unspecified unspecified  	I_LOC	null
59 , , , punctuation unspecified unspecified unspecified unspecified unspecified  	O	null
60 וייצמן וייצמן וייצמן properName unspecified unspecified unspecified unspecified unspecified  	I_PERS	null
61 ה ה השני definiteArticle unspecified unspecified unspecified unspecified unspecified 0 
61 השני שני השני noun masculine singular absolute unspecified unspecified  	O	null
62 ( ( ( punctuation unspecified unspecified unspecified unspecified unspecified  	O	null
63 ###NUMBER### ###NUMBER### ###NUMBER### numeral unspecified unspecified unspecified unspecified unspecified  	I_DATE	null
64 ) ) ) punctuation unspecified unspecified unspecified unspecified unspecified  	O	null
65 ב ב בעריכת preposition unspecified unspecified unspecified unspecified unspecified 0 
65 עריכת עריכה בעריכת noun feminine singular construct unspecified unspecified  	O	null
66 חוקר חוקר חוקרו noun masculine singular absolute unspecified unspecified  
66 ו ו חוקרו possessive masculine singular unspecified 3 unspecified 0 	O	null
67 ה ה המובהק definiteArticle unspecified unspecified unspecified unspecified unspecified 0 
67 המובהק הובהק המובהק participle masculine singular absolute any unspecified  	O	null
68 , , , punctuation unspecified unspecified unspecified unspecified unspecified  	O	null
69 יחיאל יחיאל יחיאל properName unspecified unspecified unspecified unspecified unspecified  	I_PERS	null
70 ש ש שיינטוך relativizer/subordinatingConjunction unspecified unspecified unspecified unspecified unspecified 0 
70 יינטוך יינטוך שיינטוך properName unspecified unspecified unspecified unspecified unspecified  	I_PERS	null
71 . . . punctuation unspecified unspecified unspecified unspecified unspecified  	O	null

0 מסות מסה מסותיו noun feminine plural absolute unspecified unspecified  
0 ו ו מסותיו possessive masculine singular unspecified 3 unspecified 0 	O	null
1 ה ה הספרותיות definiteArticle unspecified unspecified unspecified unspecified unspecified 0 
1 הספרותיות ספרותי הספרותיות adjective feminine plural absolute unspecified unspecified  	O	null
2 כונסו כונס כונסו verb masculine-and-feminine plural unspecified 3 past  	O	null
3 ב ב בשני preposition unspecified unspecified unspecified unspecified unspecified 0 
3 שני שני בשני noun masculine singular construct unspecified unspecified  	O	null
4 כרכי כרך כרכי noun masculine plural construct unspecified unspecified  	O	null
5 בין בין בין preposition unspecified unspecified unspecified unspecified unspecified  	O	null
6 אמונה אמונה אמונה noun feminine singular absolute unspecified unspecified  	O	null
7 ל ל לאמנות preposition unspecified unspecified unspecified unspecified unspecified 0 
7 ה ה לאמנות definiteArticle unspecified unspecified unspecified unspecified unspecified 0 
7 האמנות אמנות לאמנות noun feminine singular absolute unspecified unspecified  	O	null
8 ( ( ( punctuation unspecified unspecified unspecified unspecified unspecified  	O	null
9 ###NUMBER### ###NUMBER### ###NUMBER### numeral unspecified unspecified unspecified unspecified unspecified  	I_DATE	null
10 ) ) ) punctuation unspecified unspecified unspecified unspecified unspecified  	O	null
11 עם עם עם preposition unspecified unspecified unspecified unspecified unspecified  	O	null
12 דברי דבר דברי noun masculine plural construct unspecified unspecified  	O	null
13 מבוא מבוא מבוא noun masculine singular absolute unspecified unspecified  	O	null
14 של של של shel-preposition unspecified unspecified unspecified unspecified unspecified  	O	null
15 דב דב דב properName unspecified unspecified unspecified unspecified unspecified  	I_PERS	null
16 סדן סדן סדן noun masculine singular absolute unspecified unspecified  	O	null
17 . . . punctuation unspecified unspecified unspecified unspecified unspecified  	O	null

0 תחום תחום תחום noun masculine singular absolute unspecified unspecified  	O	null
1 בפני בפני בפני preposition unspecified unspecified unspecified unspecified unspecified  	O	null
2 עצמו עצמו עצמו pronoun unspecified unspecified unspecified unspecified unspecified  
2 ו ו עצמו pronomial masculine singular unspecified 3 unspecified 0 	O	null
3 ב ב בעבודתו preposition unspecified unspecified unspecified unspecified unspecified 0 
3 עבודת עבודה בעבודתו noun feminine singular absolute unspecified unspecified  
3 ו ו בעבודתו possessive masculine singular unspecified 3 unspecified 0 	O	null
4 הוא הוא הוא pronoun masculine singular unspecified 3 unspecified  	O	null
5 עיסוק עיסוק עיסוקו noun masculine singular absolute unspecified unspecified  
5 ו ו עיסוקו possessive masculine singular unspecified 3 unspecified 0 	O	null
6 ה ה המחקרי definiteArticle unspecified unspecified unspecified unspecified unspecified 0 
6 המחקרי מחקרי המחקרי adjective masculine singular absolute unspecified unspecified  	O	null
7 - - - punctuation unspecified unspecified unspecified unspecified unspecified  	O	null
8 הגות הגות הגותי noun feminine singular absolute unspecified unspecified  
8 י י הגותי possessive masculine-and-feminine singular unspecified 1 unspecified 0 	O	null
9 בפרפסיכולוגיה בפרפסיכולוגיה בפרפסיכולוגיה adjective masculine singular construct unspecified unspecified  	O	null
10 , , , punctuation unspecified unspecified unspecified unspecified unspecified  	O	null
11 ו ו והוא conjunction unspecified unspecified unspecified unspecified unspecified 0 
11 הוא הוא והוא pronoun masculine singular unspecified 3 unspecified  	O	null
12 הניב הניב הניב verb masculine singular unspecified 3 past  	O	null
13 שני CARD2 שני numeral masculine dual construct unspecified unspecified  	O	null
14 כרכים כרך כרכים noun masculine plural absolute unspecified unspecified  	O	null
15 גדולים גדול גדולים adjective masculine plural absolute unspecified unspecified  	O	null
16 ב ב בשם preposition unspecified unspecified unspecified unspecified unspecified 0 
16 שם שם בשם noun masculine singular construct unspecified unspecified  	O	null
17 ה ה המציאות definiteArticle unspecified unspecified unspecified unspecified unspecified 0 
17 המציאות מציאות המציאות noun feminine singular absolute unspecified unspecified  	O	null
18 ה ה האחרת definiteArticle unspecified unspecified unspecified unspecified unspecified 0 
18 האחרת אחר האחרת adjective feminine singular absolute unspecified unspecified  	O	null
19 , , , punctuation unspecified unspecified unspecified unspecified unspecified  	O	null
20 ###NUMBER### ###NUMBER### ###NUMBER### numeral unspecified unspecified unspecified unspecified unspecified  	I_DATE	null
21 ) ) ) punctuation unspecified unspecified unspecified unspecified unspecified  	O	null
22 , , , punctuation unspecified unspecified unspecified unspecified unspecified  	O	null
23 ###NUMBER### ###NUMBER### ###NUMBER### numeral unspecified unspecified unspecified unspecified unspecified  	I_DATE	null
24 ה ה המכילים definiteArticle unspecified unspecified unspecified unspecified unspecified 0 
24 המכילים הכיל המכילים participle masculine plural absolute any unspecified  	O	null
25 מקבץ מקבץ מקבץ noun masculine singular construct unspecified unspecified  	O	null
26 עדויות עדות עדויות noun feminine plural absolute unspecified unspecified  	O	null
27 של של של shel-preposition unspecified unspecified unspecified unspecified unspecified  	O	null
28 אנשי איש אנשי noun masculine plural construct unspecified unspecified  	O	null
29 - - - punctuation unspecified unspecified unspecified unspecified unspecified  	O	null
30 שם שם שם noun masculine singular absolute unspecified unspecified  	O	null
31 על על על preposition unspecified unspecified unspecified unspecified unspecified  	O	null
32 התנסויות התנסות התנסויות noun feminine plural absolute unspecified unspecified  	O	null
33 על על על preposition unspecified unspecified unspecified unspecified unspecified  	O	null
34 - - - punctuation unspecified unspecified unspecified unspecified unspecified  	O	null
35 טבעיות טבעי טבעיות adjective feminine plural absolute unspecified unspecified  	O	null
36 ש ש שחוו relativizer/subordinatingConjunction unspecified unspecified unspecified unspecified unspecified 0 
36 חוו חווה שחוו verb masculine-and-feminine plural unspecified 3 past  	O	null
37 . . . punctuation unspecified unspecified unspecified unspecified unspecified  	O	null

0 מבין מבין מבין preposition unspecified unspecified unspecified unspecified unspecified  	O	null
1 עבודות עבודה עבודותיו noun feminine plural absolute unspecified unspecified  
1 ו ו עבודותיו possessive masculine singular unspecified 3 unspecified 0 	O	null
2 ב ב בשדה preposition unspecified unspecified unspecified unspecified unspecified 0 
2 שדה שדה בשדה noun masculine singular construct unspecified unspecified  	O	null
3 ה ה התרגום definiteArticle unspecified unspecified unspecified unspecified unspecified 0 
3 התרגום תרגום התרגום noun masculine singular absolute unspecified unspecified  	O	null
4 יצוין צוין יצוין verb masculine singular unspecified 3 future  	O	null
5 קובץ קובץ קובץ noun masculine singular construct unspecified unspecified  	O	null
6 ה ה התרגומים definiteArticle unspecified unspecified unspecified unspecified unspecified 0 
6 התרגומים תרגום התרגומים noun masculine plural absolute unspecified unspecified  	O	null
7 ל ל לעברית preposition unspecified unspecified unspecified unspecified unspecified 0 
7 עברית עברית לעברית properName feminine singular unspecified unspecified unspecified  	I_LOC	null
8 של של של shel-preposition unspecified unspecified unspecified unspecified unspecified  	O	null
9 שירי שיר שירי properName unspecified unspecified unspecified unspecified unspecified  	I_PERS	null
10 ביאליק ביאליק ביאליק properName unspecified unspecified unspecified unspecified unspecified  	I_PERS	null
11 ב ב ביידיש preposition unspecified unspecified unspecified unspecified unspecified 0 
11 יידיש יידיש ביידיש properName feminine singular unspecified unspecified unspecified  	B_PERS	null
12 ) ) ) punctuation unspecified unspecified unspecified unspecified unspecified  	O	null
13 . . . punctuation unspecified unspecified unspecified unspecified unspecified  	O	null
14 ###NUMBER### ###NUMBER### ###NUMBER### numeral unspecified unspecified unspecified unspecified unspecified  	I_DATE	null
15 אהרן אהרן אהרן properName unspecified unspecified unspecified unspecified unspecified  	I_PERS	null
16 צייטלין צייטלין צייטלין properName unspecified unspecified unspecified unspecified unspecified  	I_PERS	null
17 נפטר נפטר נפטר verb masculine singular unspecified 3 past  	O	null
18 בניויורק בניויורק בניויורק properName unspecified unspecified unspecified unspecified unspecified  	I_PERS	null
19 ו ו והובא conjunction unspecified unspecified unspecified unspecified unspecified 0 
19 הובא הובא והובא verb masculine singular unspecified 3 past  	O	null
20 ל ל לקבורה preposition unspecified unspecified unspecified unspecified unspecified 0 
20 קבורה קבורה לקבורה noun feminine singular absolute unspecified unspecified  	O	null
21 ב ב בירושלים preposition unspecified unspecified unspecified unspecified unspecified 0 
21 ירושלים ירושלים בירושלים properName unspecified unspecified unspecified unspecified unspecified  	I_LOC	null
22 על על על preposition unspecified unspecified unspecified unspecified unspecified  	O	null
23 הר הר הר properName unspecified unspecified unspecified unspecified unspecified  	I_PERS	null
24 הזיתים זית הזיתים properName unspecified unspecified unspecified unspecified unspecified  	I_PERS	null
25 . . . punctuation unspecified unspecified unspecified unspecified unspecified  	O	null

0 References References References foreign unspecified unspecified unspecified unspecified unspecified  	O	null
1 : : : punctuation unspecified unspecified unspecified unspecified unspecified  	O	null
2 ברתיני ברתיני ברתיני properName unspecified unspecified unspecified unspecified unspecified  	I_ORG	null
3 , , , punctuation unspecified unspecified unspecified unspecified unspecified  	O	null
4 ק"א ק"א ק"א properName unspecified unspecified unspecified unspecified unspecified  	I_PERS	null
5 . . . punctuation unspecified unspecified unspecified unspecified unspecified  	O	null

0 " " " punctuation unspecified unspecified unspecified unspecified unspecified  	O	null
1 מן מן מן preposition unspecified unspecified unspecified unspecified unspecified  	O	null
2 ה ה האדם definiteArticle unspecified unspecified unspecified unspecified unspecified 0 
2 האדם אדם האדם noun masculine singular absolute unspecified unspecified  	O	null
3 ו ו ומעלה conjunction unspecified unspecified unspecified unspecified unspecified 0 
3 מעלה העלה ומעלה verb masculine singular unspecified any beinoni  	O	null
4 : : : punctuation unspecified unspecified unspecified unspecified unspecified  	O	null
5 על על על preposition unspecified unspecified unspecified unspecified unspecified  	O	null
6 אהרן אהרן אהרן properName unspecified unspecified unspecified unspecified unspecified  	I_PERS	null
7 צייטלין צייטלין צייטלין properName unspecified unspecified unspecified unspecified unspecified  	I_PERS	null
8 " " " punctuation unspecified unspecified unspecified unspecified unspecified  	O	null
9 . . . punctuation unspecified unspecified unspecified unspecified unspecified  	O	null

0 שדה שדה שדה properName unspecified unspecified unspecified unspecified unspecified  	I_PERS	null
1 ראייה ראייה ראייה noun feminine singular absolute unspecified unspecified  	O	null
2 . . . punctuation unspecified unspecified unspecified unspecified unspecified  	O	null

0 ירושלים ירושלים ירושלים properName unspecified unspecified unspecified unspecified unspecified  	I_LOC	null
1 : : : punctuation unspecified unspecified unspecified unspecified unspecified  	O	null
2 מוסד מוסד מוסד properName unspecified unspecified unspecified unspecified unspecified  	I_PERS	null
3 ביאליק ביאליק ביאליק properName unspecified unspecified unspecified unspecified unspecified  	I_PERS	null
4 . . . punctuation unspecified unspecified unspecified unspecified unspecified  	O	null

0 ###NUMBER### ###NUMBER### ###NUMBER### numeral unspecified unspecified unspecified unspecified unspecified  	I_DATE	null
1 . . . punctuation unspecified unspecified unspecified unspecified unspecified  	O	null

0 - - - punctuation unspecified unspecified unspecified unspecified unspecified  	O	null
1 ###NUMBER### ###NUMBER### ###NUMBER### numeral unspecified unspecified unspecified unspecified unspecified  	O	null
2 ; ; ; punctuation unspecified unspecified unspecified unspecified unspecified  	O	null
3 ###NUMBER### ###NUMBER### ###NUMBER### numeral unspecified unspecified unspecified unspecified unspecified  	O	null
4 דן דן דן properName unspecified unspecified unspecified unspecified unspecified  	I_PERS	null
5 , , , punctuation unspecified unspecified unspecified unspecified unspecified  	O	null
6 יוסף יוסף יוסף properName unspecified unspecified unspecified unspecified unspecified  	I_PERS	null
7 . . . punctuation unspecified unspecified unspecified unspecified unspecified  	O	null

0 " " " punctuation unspecified unspecified unspecified unspecified unspecified  	O	null
1 אהרן אהרן אהרן properName unspecified unspecified unspecified unspecified unspecified  	I_PERS	null
2 צייטלין צייטלין צייטלין properName unspecified unspecified unspecified unspecified unspecified  	I_PERS	null
3 : : : punctuation unspecified unspecified unspecified unspecified unspecified  	O	null
4 בין בין בין preposition unspecified unspecified unspecified unspecified unspecified  	O	null
5 חורבן חורבן חורבן noun masculine singular absolute unspecified unspecified  	O	null
6 ל ל לגאולה preposition unspecified unspecified unspecified unspecified unspecified 0 
6 ה ה לגאולה definiteArticle unspecified unspecified unspecified unspecified unspecified 0 
6 הגאולה גאל לגאולה participle feminine singular absolute any unspecified  	O	null
7 " " " punctuation unspecified unspecified unspecified unspecified unspecified  	O	null
8 . . . punctuation unspecified unspecified unspecified unspecified unspecified  	O	null

0 ה ה הנכרי definiteArticle unspecified unspecified unspecified unspecified unspecified 0 
0 הנכרי נכרי הנכרי adjective masculine singular absolute unspecified unspecified  	O	null
1 ו ו והמנדרין conjunction unspecified unspecified unspecified unspecified unspecified 0 
1 ה ה והמנדרין definiteArticle unspecified unspecified unspecified unspecified unspecified 0 
1 המנדרין המנדרין והמנדרין adjective masculine singular absolute unspecified unspecified  	O	null
2 . . . punctuation unspecified unspecified unspecified unspecified unspecified  	O	null

0 רמתגן רמתגן רמתגן properName unspecified unspecified unspecified unspecified unspecified  	I_PERS	null
1 : : : punctuation unspecified unspecified unspecified unspecified unspecified  	O	null
2 מסדה מסדה מסדה properName unspecified unspecified unspecified unspecified unspecified  	I_PERS	null
3 . . . punctuation unspecified unspecified unspecified unspecified unspecified  	O	null

0 ###NUMBER### ###NUMBER### ###NUMBER### numeral unspecified unspecified unspecified unspecified unspecified  	I_DATE	null
1 . . . punctuation unspecified unspecified unspecified unspecified unspecified  	O	null

0 - - - punctuation unspecified unspecified unspecified unspecified unspecified  	O	null
1 ###NUMBER### ###NUMBER### ###NUMBER### numeral unspecified unspecified unspecified unspecified unspecified  	O	null
2 ; ; ; punctuation unspecified unspecified unspecified unspecified unspecified  	O	null
3 ###NUMBER### ###NUMBER### ###NUMBER### numeral unspecified unspecified unspecified unspecified unspecified  	O	null
4 וינפלד וינפלד וינפלד properName unspecified unspecified unspecified unspecified unspecified  	O	null
5 , , , punctuation unspecified unspecified unspecified unspecified unspecified  	O	null
6 דוד דוד דוד properName unspecified unspecified unspecified unspecified unspecified  	I_PERS	null
7 . . . punctuation unspecified unspecified unspecified unspecified unspecified  	O	null

0 " " " punctuation unspecified unspecified unspecified unspecified unspecified  	O	null
1 אהרן אהרן אהרן properName unspecified unspecified unspecified unspecified unspecified  	I_PERS	null
2 אליעזר אליעזר אליעזר properName unspecified unspecified unspecified unspecified unspecified  	I_PERS	null
3 צייטלין צייטלין צייטלין properName unspecified unspecified unspecified unspecified unspecified  	I_PERS	null
4 " " " punctuation unspecified unspecified unspecified unspecified unspecified  	O	null
5 . . . punctuation unspecified unspecified unspecified unspecified unspecified  	O	null

0 ה ה השירה definiteArticle unspecified unspecified unspecified unspecified unspecified 0 
0 השירה שירה השירה noun feminine singular absolute unspecified unspecified  	O	null
1 ה ה העברית definiteArticle unspecified unspecified unspecified unspecified unspecified 0 
1 העברית עברי העברית adjective feminine singular absolute unspecified unspecified  	O	null
2 ב ב בפולין preposition unspecified unspecified unspecified unspecified unspecified 0 
2 פולין פולין בפולין properName unspecified unspecified unspecified unspecified unspecified  	I_LOC	null
3 בין בין בין preposition unspecified unspecified unspecified unspecified unspecified  	O	null
4 שתי CARD2 שתי numeral feminine dual construct unspecified unspecified  	O	null
5 מלחמות מלחמה מלחמות noun feminine plural construct unspecified unspecified  	O	null
6 ה ה העולם definiteArticle unspecified unspecified unspecified unspecified unspecified 0 
6 העולם עולם העולם noun masculine singular absolute unspecified unspecified  	O	null
7 . . . punctuation unspecified unspecified unspecified unspecified unspecified  	O	null

0 ירושלים ירושלים ירושלים properName unspecified unspecified unspecified unspecified unspecified  	I_LOC	null
1 : : : punctuation unspecified unspecified unspecified unspecified unspecified  	O	null
2 מוסד מוסד מוסד properName unspecified unspecified unspecified unspecified unspecified  	I_PERS	null
3 ביאליק ביאליק ביאליק properName unspecified unspecified unspecified unspecified unspecified  	I_PERS	null
4 . . . punctuation unspecified unspecified unspecified unspecified unspecified  	O	null

0 . . . punctuation unspecified unspecified unspecified unspecified unspecified  	O	null
1 ###NUMBER### ###NUMBER### ###NUMBER### numeral unspecified unspecified unspecified unspecified unspecified  	I_DATE	null
2 - - - punctuation unspecified unspecified unspecified unspecified unspecified  	O	null
3 ###NUMBER### ###NUMBER### ###NUMBER### numeral unspecified unspecified unspecified unspecified unspecified  	O	null
4 ; ; ; punctuation unspecified unspecified unspecified unspecified unspecified  	O	null
5 ###NUMBER### ###NUMBER### ###NUMBER### numeral unspecified unspecified unspecified unspecified unspecified  	O	null
6 נוברשטרן נוברשטרן נוברשטרן verb masculine singular unspecified any beinoni  	O	null
7 , , , punctuation unspecified unspecified unspecified unspecified unspecified  	O	null
8 אברהם אברהם אברהם properName unspecified unspecified unspecified unspecified unspecified  	I_PERS	null
9 . . . punctuation unspecified unspecified unspecified unspecified unspecified  	O	null

0 " " " punctuation unspecified unspecified unspecified unspecified unspecified  	O	null
1 ה ה העיצוב definiteArticle unspecified unspecified unspecified unspecified unspecified 0 
1 העיצוב עיצוב העיצוב noun masculine singular absolute unspecified unspecified  	O	null
2 ה ה הכפול definiteArticle unspecified unspecified unspecified unspecified unspecified 0 
2 הכפול כפול הכפול adjective masculine singular absolute unspecified unspecified  	O	null
3 : : : punctuation unspecified unspecified unspecified unspecified unspecified  	O	null
4 יעקב יעקב יעקב properName unspecified unspecified unspecified unspecified unspecified  	I_PERS	null
5 פראנק פראנק פראנק properName unspecified unspecified unspecified unspecified unspecified  	I_PERS	null
6 ב ב בתפיסותיהם preposition unspecified unspecified unspecified unspecified unspecified 0 
6 תפיסות תפיסה בתפיסותיהם noun feminine plural absolute unspecified unspecified  
6 הם הם בתפיסותיהם possessive masculine plural unspecified 3 unspecified 0 	O	null
7 של של של shel-preposition unspecified unspecified unspecified unspecified unspecified  	O	null
8 משה משה משה properName unspecified unspecified unspecified unspecified unspecified  	I_PERS	null
9 קולבאק קולבאק קולבאק properName unspecified unspecified unspecified unspecified unspecified  	I_PERS	null
10 ו ו ושל conjunction unspecified unspecified unspecified unspecified unspecified 0 
10 של של ושל shel-preposition unspecified unspecified unspecified unspecified unspecified  	O	null
11 אהרן אהרן אהרן properName unspecified unspecified unspecified unspecified unspecified  	I_PERS	null
12 צייטלין צייטלין צייטלין properName unspecified unspecified unspecified unspecified unspecified  	I_PERS	null
13 " " " punctuation unspecified unspecified unspecified unspecified unspecified  	O	null
14 . . . punctuation unspecified unspecified unspecified unspecified unspecified  	O	null

0 קסם קסם קסם noun masculine singular construct unspecified unspecified  	O	null
1 ה ה הדמדומים definiteArticle unspecified unspecified unspecified unspecified unspecified 0 
1 הדמדומים דמדום הדמדומים noun masculine plural absolute unspecified unspecified  	O	null
2 : : : punctuation unspecified unspecified unspecified unspecified unspecified  	O	null
3 אפוקליפסה אפוקליפסה אפוקליפסה noun feminine singular absolute unspecified unspecified  	O	null
4 ו ו ומשיחיות conjunction unspecified unspecified unspecified unspecified unspecified 0 
4 משיחיות משיחיות ומשיחיות noun feminine singular absolute unspecified unspecified  	O	null
5 ב ב בספרות preposition unspecified unspecified unspecified unspecified unspecified 0 
5 ספרות ספרות בספרות noun feminine singular construct unspecified unspecified  	O	null
6 יידיש יידיש יידיש properName feminine singular unspecified unspecified unspecified  	I_LOC	null
7 . . . punctuation unspecified unspecified unspecified unspecified unspecified  	O	null

0 ירושלים ירושלים ירושלים properName unspecified unspecified unspecified unspecified unspecified  	I_LOC	null
1 : : : punctuation unspecified unspecified unspecified unspecified unspecified  	O	null
2 הוצאת הוצאה הוצאת noun feminine singular construct unspecified unspecified  	O	null
3 מאגנס מאגנס מאגנס properName unspecified unspecified unspecified unspecified unspecified  	I_LOC	null
4 . . . punctuation unspecified unspecified unspecified unspecified unspecified  	O	null

0 ###NUMBER### ###NUMBER### ###NUMBER### numeral unspecified unspecified unspecified unspecified unspecified  	I_DATE	null
1 . . . punctuation unspecified unspecified unspecified unspecified unspecified  	O	null

0 - - - punctuation unspecified unspecified unspecified unspecified unspecified  	O	null
1 ###NUMBER### ###NUMBER### ###NUMBER### numeral unspecified unspecified unspecified unspecified unspecified  	O	null
2 ; ; ; punctuation unspecified unspecified unspecified unspecified unspecified  	O	null
3 ###NUMBER### ###NUMBER### ###NUMBER### numeral unspecified unspecified unspecified unspecified unspecified  	O	null
4 רבינוביץ רבינוביץ רבינוביץ properName unspecified unspecified unspecified unspecified unspecified  	I_PERS	null
5 , , , punctuation unspecified unspecified unspecified unspecified unspecified  	O	null
6 ישעיה ישעיה ישעיה properName masculine singular unspecified unspecified unspecified  	I_PERS	null
7 . . . punctuation unspecified unspecified unspecified unspecified unspecified  	O	null

0 " " " punctuation unspecified unspecified unspecified unspecified unspecified  	O	null
1 ב ב במזל preposition unspecified unspecified unspecified unspecified unspecified 0 
1 מזל מזל במזל noun masculine singular construct unspecified unspecified  	O	null
2 ה ה הדמות definiteArticle unspecified unspecified unspecified unspecified unspecified 0 
2 הדמות דמות הדמות noun feminine singular absolute unspecified unspecified  	O	null
3 – – – punctuation unspecified unspecified unspecified unspecified unspecified  	O	null
4 אהרן אהרן אהרן properName unspecified unspecified unspecified unspecified unspecified  	I_PERS	null
5 צייטלין צייטלין צייטלין properName unspecified unspecified unspecified unspecified unspecified  	I_PERS	null
6 " " " punctuation unspecified unspecified unspecified unspecified unspecified  	O	null
7 . . . punctuation unspecified unspecified unspecified unspecified unspecified  	O	null

0 ב ב בחבלי preposition unspecified unspecified unspecified unspecified unspecified 0 
0 חבלי חבל בחבלי noun masculine plural construct unspecified unspecified  	O	null
1 דור דור דורם noun masculine singular absolute unspecified unspecified  
1 ם ם דורם possessive masculine plural unspecified 3 unspecified 0 	O	null
2 . . . punctuation unspecified unspecified unspecified unspecified unspecified  	O	null

0 תלאביב תלאביב תלאביב properName unspecified unspecified unspecified unspecified unspecified  	I_PERS	null
1 : : : punctuation unspecified unspecified unspecified unspecified unspecified  	O	null
2 עם עם עם preposition unspecified unspecified unspecified unspecified unspecified  	O	null
3 עובד עובד עובד noun masculine singular absolute unspecified unspecified  	O	null
4 . . . punctuation unspecified unspecified unspecified unspecified unspecified  	O	null

0 ###NUMBER### ###NUMBER### ###NUMBER### numeral unspecified unspecified unspecified unspecified unspecified  	I_DATE	null
1 . . . punctuation unspecified unspecified unspecified unspecified unspecified  	O	null

0 - - - punctuation unspecified unspecified unspecified unspecified unspecified  	O	null
1 ###NUMBER### ###NUMBER### ###NUMBER### numeral unspecified unspecified unspecified unspecified unspecified  	O	null
2 ; ; ; punctuation unspecified unspecified unspecified unspecified unspecified  	O	null
3 ###NUMBER### ###NUMBER### ###NUMBER### numeral unspecified unspecified unspecified unspecified unspecified  	O	null
4 ש ש שיינטוך relativizer/subordinatingConjunction unspecified unspecified unspecified unspecified unspecified 0 
4 יינטוך יינטוך שיינטוך properName unspecified unspecified unspecified unspecified unspecified  	O	null
5 , , , punctuation unspecified unspecified unspecified unspecified unspecified  	O	null
6 יחיאל יחיאל יחיאל properName unspecified unspecified unspecified unspecified unspecified  	I_PERS	null
7 . . . punctuation unspecified unspecified unspecified unspecified unspecified  	O	null

0 ב ב ברשות preposition unspecified unspecified unspecified unspecified unspecified 0 
0 רשות רשות ברשות noun feminine singular construct unspecified unspecified  	I_ORG	null
1 ה ה הרבים definiteArticle unspecified unspecified unspecified unspecified unspecified 0 
1 הרבים רב הרבים adjective masculine plural absolute unspecified unspecified  	I_ORG	null
2 ו ו וברשות conjunction unspecified unspecified unspecified unspecified unspecified 0 
2 ב ב וברשות preposition unspecified unspecified unspecified unspecified unspecified 0 
2 ה ה וברשות definiteArticle unspecified unspecified unspecified unspecified unspecified 0 
2 הרשות רשות וברשות noun feminine singular absolute unspecified unspecified  	I_ORG	null
3 ה ה היחיד definiteArticle unspecified unspecified unspecified unspecified unspecified 0 
3 היחיד יחיד היחיד adjective masculine singular absolute unspecified unspecified  	I_ORG	null
4 : : : punctuation unspecified unspecified unspecified unspecified unspecified  	O	null
5 אהרן אהרן אהרן properName unspecified unspecified unspecified unspecified unspecified  	I_PERS	null
6 צייטלין צייטלין צייטלין properName unspecified unspecified unspecified unspecified unspecified  	I_PERS	null
7 ו ו וספרות conjunction unspecified unspecified unspecified unspecified unspecified 0 
7 ספרות ספרות וספרות noun feminine singular construct unspecified unspecified  	O	null
8 יידיש יידיש יידיש properName unspecified unspecified unspecified unspecified unspecified  	I_LOC	null
9 . . . punctuation unspecified unspecified unspecified unspecified unspecified  	O	null

0 ירושלים ירושלים ירושלים properName unspecified unspecified unspecified unspecified unspecified  	I_LOC	null
1 : : : punctuation unspecified unspecified unspecified unspecified unspecified  	O	null
2 מאגנס מאגנס מאגנס properName unspecified unspecified unspecified unspecified unspecified  	I_LOC	null
3 . . . punctuation unspecified unspecified unspecified unspecified unspecified  	O	null

0 ###NUMBER### ###NUMBER### ###NUMBER### numeral unspecified unspecified unspecified unspecified unspecified  	I_DATE	null
1 . . . punctuation unspecified unspecified unspecified unspecified unspecified  	O	null

