0 Name Name Name foreign unspecified unspecified unspecified unspecified unspecified  	O	null
1 : : : punctuation unspecified unspecified unspecified unspecified unspecified  	O	null
2 קאופמן קאופמן קאופמן properName unspecified unspecified unspecified unspecified unspecified  	I_ORG	null
3 , , , punctuation unspecified unspecified unspecified unspecified unspecified  	O	null
4 עזריאל עזריאל עזריאל properName unspecified unspecified unspecified unspecified unspecified  	I_PERS	null
5 Birth Birth Birth foreign unspecified unspecified unspecified unspecified unspecified  	O	null
6 Year Year Year foreign unspecified unspecified unspecified unspecified unspecified  	O	null
7 : : : punctuation unspecified unspecified unspecified unspecified unspecified  	O	null
8 ###NUMBER### ###NUMBER### ###NUMBER### numeral unspecified unspecified unspecified unspecified unspecified  	I_DATE	null
9 Death Death Death foreign unspecified unspecified unspecified unspecified unspecified  	O	null
10 Year Year Year foreign unspecified unspecified unspecified unspecified unspecified  	O	null
11 : : : punctuation unspecified unspecified unspecified unspecified unspecified  	O	null
12 ###NUMBER### ###NUMBER### ###NUMBER### numeral unspecified unspecified unspecified unspecified unspecified  	I_DATE	null
13 Birth Birth Birth foreign unspecified unspecified unspecified unspecified unspecified  	O	null
14 Place Place Place foreign unspecified unspecified unspecified unspecified unspecified  	O	null
15 : : : punctuation unspecified unspecified unspecified unspecified unspecified  	O	null
16 סוקולוב סוקולוב סוקולוב properName unspecified unspecified unspecified unspecified unspecified  	I_ORG	null
17 , , , punctuation unspecified unspecified unspecified unspecified unspecified  	O	null
18 פולין פולין פולין properName unspecified unspecified unspecified unspecified unspecified  	I_LOC	null
19 Occupation Occupation Occupation foreign unspecified unspecified unspecified unspecified unspecified  	O	null
20 : : : punctuation unspecified unspecified unspecified unspecified unspecified  	O	null
21 משורר משורר משורר noun masculine singular absolute unspecified unspecified  	O	null
22 ו ו ועורך conjunction unspecified unspecified unspecified unspecified unspecified 0 
22 עורך עורך ועורך noun masculine singular construct unspecified unspecified  	O	null
23 Entry Entry Entry foreign unspecified unspecified unspecified unspecified unspecified  	O	null
24 writer writer writer foreign unspecified unspecified unspecified unspecified unspecified  	O	null
25 : : : punctuation unspecified unspecified unspecified unspecified unspecified  	O	null
26 רחל רחל רחל properName unspecified unspecified unspecified unspecified unspecified  	I_PERS	null
27 פרנקל פרנקל פרנקל properName unspecified unspecified unspecified unspecified unspecified  	I_PERS	null
28 - - - punctuation unspecified unspecified unspecified unspecified unspecified  	O	null
29 מ מ מדן preposition unspecified unspecified unspecified unspecified unspecified 0 
29 דן דן מדן properName unspecified unspecified unspecified unspecified unspecified  	I_ORG	null
30 Entry Entry Entry foreign unspecified unspecified unspecified unspecified unspecified  	O	null
31 Value Value Value foreign unspecified unspecified unspecified unspecified unspecified  	O	null
32 : : : punctuation unspecified unspecified unspecified unspecified unspecified  	O	null
33 נולד נולד נולד verb masculine singular unspecified 3 past  	O	null
34 ב ב בסוקולוב preposition unspecified unspecified unspecified unspecified unspecified 0 
34 סוקולוב סוקולוב בסוקולוב properName unspecified unspecified unspecified unspecified unspecified  	I_PERS	null
35 , , , punctuation unspecified unspecified unspecified unspecified unspecified  	O	null
36 פולין פולין פולין properName unspecified unspecified unspecified unspecified unspecified  	I_LOC	null
37 . . . punctuation unspecified unspecified unspecified unspecified unspecified  	O	null

0 בית בית בית noun masculine singular construct unspecified unspecified  	O	null
1 אבי אב אביו noun masculine singular absolute unspecified unspecified  
1 ו ו אביו possessive masculine singular unspecified 3 unspecified 0 	O	null
2 , , , punctuation unspecified unspecified unspecified unspecified unspecified  	O	null
3 פרוון פרוון פרוון participle masculine singular construct any unspecified  	O	null
4 ב ב במקצועו preposition unspecified unspecified unspecified unspecified unspecified 0 
4 מקצוע מקצוע במקצועו noun masculine singular absolute unspecified unspecified  
4 ו ו במקצועו possessive masculine singular unspecified 3 unspecified 0 	O	null
5 , , , punctuation unspecified unspecified unspecified unspecified unspecified  	O	null
6 היה הוא היה copula masculine singular unspecified 3 past  	O	null
7 מרכז מרכז מרכז noun masculine singular absolute unspecified unspecified  	O	null
8 ל ל למפגשי preposition unspecified unspecified unspecified unspecified unspecified 0 
8 מפגשי מפגש למפגשי noun masculine plural construct unspecified unspecified  	O	null
9 ספרות ספרות ספרות noun feminine singular absolute unspecified unspecified  	O	null
10 ו ו ותרבות conjunction unspecified unspecified unspecified unspecified unspecified 0 
10 תרבות תרבות ותרבות noun feminine singular absolute unspecified unspecified  	O	null
11 יידית יידי יידית adjective feminine singular absolute unspecified unspecified  	O	null
12 ו ו ועברית conjunction unspecified unspecified unspecified unspecified unspecified 0 
12 עברית עברי ועברית adjective feminine singular absolute unspecified unspecified  	O	null
13 . . . punctuation unspecified unspecified unspecified unspecified unspecified  	O	null

0 כך כך כך pronoun unspecified unspecified unspecified unspecified unspecified  	O	null
1 השתלבו השתלב השתלבו verb masculine-and-feminine plural unspecified 3 past  	O	null
2 ב ב בעולמו preposition unspecified unspecified unspecified unspecified unspecified 0 
2 עולם עולם בעולמו noun masculine singular absolute unspecified unspecified  
2 ו ו בעולמו possessive masculine singular unspecified 3 unspecified 0 	O	null
3 לימודי לימוד לימודי noun masculine plural construct unspecified unspecified  	O	null
4 ה ה הגמרא definiteArticle unspecified unspecified unspecified unspecified unspecified 0 
4 הגמרא גמרא הגמרא noun feminine singular absolute unspecified unspecified  	O	null
5 , , , punctuation unspecified unspecified unspecified unspecified unspecified  	O	null
6 ש ש שלמד relativizer/subordinatingConjunction unspecified unspecified unspecified unspecified unspecified 0 
6 למד למד שלמד verb masculine singular unspecified 3 past  	O	null
7 ב ב בחדר preposition unspecified unspecified unspecified unspecified unspecified 0 
7 חדר חדר בחדר noun masculine singular absolute unspecified unspecified  	O	null
8 עד עד עד preposition unspecified unspecified unspecified unspecified unspecified  	O	null
9 גיל גיל גיל noun masculine singular construct unspecified unspecified  	O	null
10 עשר CARD10 עשר numeral feminine singular absolute unspecified unspecified  	O	null
11 , , , punctuation unspecified unspecified unspecified unspecified unspecified  	O	null
12 עם עם עם preposition unspecified unspecified unspecified unspecified unspecified  	O	null
13 לימודי לימוד לימודי noun masculine plural construct unspecified unspecified  	O	null
14 ה ה הלשון definiteArticle unspecified unspecified unspecified unspecified unspecified 0 
14 הלשון לשון הלשון noun feminine singular absolute unspecified unspecified  	O	null
15 ה ה העברית definiteArticle unspecified unspecified unspecified unspecified unspecified 0 
15 העברית עברי העברית adjective feminine singular absolute unspecified unspecified  	O	null
16 ו ו ותרבותה conjunction unspecified unspecified unspecified unspecified unspecified 0 
16 תרבות תרבות ותרבותה noun feminine singular absolute unspecified unspecified  
16 ה ה ותרבותה possessive feminine singular unspecified 3 unspecified 0 	O	null
17 . . . punctuation unspecified unspecified unspecified unspecified unspecified  	O	null

0 מ מ מגיל preposition unspecified unspecified unspecified unspecified unspecified 0 
0 גיל גיל מגיל noun masculine singular absolute unspecified unspecified  	O	null
1 שבע שבע שבע adjective masculine singular absolute unspecified unspecified  	O	null
2 למד למד למד verb masculine singular unspecified 3 past  	O	null
3 גם גם גם conjunction unspecified unspecified unspecified unspecified unspecified  	O	null
4 ב ב בבית preposition unspecified unspecified unspecified unspecified unspecified 0 
4 בית בית בבית noun masculine singular construct unspecified unspecified  	O	null
5 ספר ספר ספר noun masculine singular absolute unspecified unspecified  	O	null
6 פולני פולני פולני adjective masculine singular absolute unspecified unspecified  	O	null
7 . . . punctuation unspecified unspecified unspecified unspecified unspecified  	O	null

0 ב ב בספטמבר preposition unspecified unspecified unspecified unspecified unspecified 0 
0 ספטמבר ספטמבר בספטמבר properName unspecified unspecified unspecified unspecified unspecified  	I_DATE	null
1 ###NUMBER### ###NUMBER### ###NUMBER### numeral unspecified unspecified unspecified unspecified unspecified  	I_DATE	null
2 נכבשה נכבש נכבשה verb feminine singular unspecified 3 past  	O	null
3 עיר עיר עיר noun feminine singular construct unspecified unspecified  	O	null
4 הולדת הולדה הולדתו noun feminine singular absolute unspecified unspecified  
4 ו ו הולדתו possessive masculine singular unspecified 3 unspecified 0 	O	null
5 ב ב בידי preposition unspecified unspecified unspecified unspecified unspecified 0 
5 ידי יד בידי noun feminine plural construct unspecified unspecified  	O	null
6 ה ה הנאצים definiteArticle unspecified unspecified unspecified unspecified unspecified 0 
6 הנאצים נאצי הנאצים noun masculine plural absolute unspecified unspecified  	O	null
7 , , , punctuation unspecified unspecified unspecified unspecified unspecified  	O	null
8 ו ו וחקירת conjunction unspecified unspecified unspecified unspecified unspecified 0 
8 חקירת חקירה וחקירת noun feminine singular construct unspecified unspecified  	O	null
9 אבי אב אביו noun masculine singular absolute unspecified unspecified  
9 ו ו אביו possessive masculine singular unspecified 3 unspecified 0 	O	null
10 על על על preposition unspecified unspecified unspecified unspecified unspecified  	O	null
11 ידי יד ידי noun feminine plural construct unspecified unspecified  	O	null
12 קצין קצין קצין noun masculine singular construct unspecified unspecified  	O	null
13 אס אס אס properName unspecified unspecified unspecified unspecified unspecified  	I_ORG	null
14 - - - punctuation unspecified unspecified unspecified unspecified unspecified  	O	null
15 אס אס אס properName unspecified unspecified unspecified unspecified unspecified  	I_ORG	null
16 ב ב בנוכחותו preposition unspecified unspecified unspecified unspecified unspecified 0 
16 נוכחות נוכחות בנוכחותו noun feminine singular absolute unspecified unspecified  
16 ו ו בנוכחותו possessive masculine singular unspecified 3 unspecified 0 	O	null
17 הותירה הותיר הותירה verb feminine singular unspecified 3 past  	O	null
18 את את את at-preposition unspecified unspecified unspecified unspecified unspecified  	O	null
19 רישום רישום רישומה noun masculine singular absolute unspecified unspecified  
19 ה ה רישומה possessive feminine singular unspecified 3 unspecified 0 	O	null
20 ה ה העז definiteArticle unspecified unspecified unspecified unspecified unspecified 0 
20 העז עז העז adjective masculine singular absolute unspecified unspecified  	O	null
21 ב ב בנפשו preposition unspecified unspecified unspecified unspecified unspecified 0 
21 נפש נפש בנפשו noun feminine singular absolute unspecified unspecified  
21 ו ו בנפשו possessive masculine singular unspecified 3 unspecified 0 	O	null
22 . . . punctuation unspecified unspecified unspecified unspecified unspecified  	O	null

0 ה ה המשפחה definiteArticle unspecified unspecified unspecified unspecified unspecified 0 
0 המשפחה משפחה המשפחה noun feminine singular absolute unspecified unspecified  	O	null
1 ברחה ברח ברחה verb feminine singular unspecified 3 past  	O	null
2 ל ל לצד preposition unspecified unspecified unspecified unspecified unspecified 0 
2 ה ה לצד definiteArticle unspecified unspecified unspecified unspecified unspecified 0 
2 הצד צד לצד noun masculine singular absolute unspecified unspecified  	O	null
3 ה ה הסובייטי definiteArticle unspecified unspecified unspecified unspecified unspecified 0 
3 הסובייטי סובייטי הסובייטי adjective masculine singular absolute unspecified unspecified  	O	null
4 ב ב ברוסיה preposition unspecified unspecified unspecified unspecified unspecified 0 
4 ה ה ברוסיה definiteArticle unspecified unspecified unspecified unspecified unspecified 0 
4 הרוסיה רוסי ברוסיה noun feminine singular absolute unspecified unspecified  	I_LOC	null
5 ה ה הלבנה definiteArticle unspecified unspecified unspecified unspecified unspecified 0 
5 הלבנה לבן הלבנה adjective feminine singular absolute unspecified unspecified  	O	null
6 , , , punctuation unspecified unspecified unspecified unspecified unspecified  	O	null
7 ו ו ובמאי conjunction unspecified unspecified unspecified unspecified unspecified 0 
7 ב ב ובמאי preposition unspecified unspecified unspecified unspecified unspecified 0 
7 מאי מאי ובמאי properName unspecified unspecified unspecified unspecified unspecified  	I_DATE	null
8 ###NUMBER### ###NUMBER### ###NUMBER### numeral unspecified unspecified unspecified unspecified unspecified  	I_DATE	null
9 נלקחו נלקח נלקחו verb masculine-and-feminine plural unspecified 3 past  	O	null
10 ל ל לארכנגלסק preposition unspecified unspecified unspecified unspecified unspecified 0 
10 ארכנגלסק ארכנגלסק לארכנגלסק noun masculine singular absolute unspecified unspecified  	O	null
11 , , , punctuation unspecified unspecified unspecified unspecified unspecified  	O	null
12 ל ל לעבודות preposition unspecified unspecified unspecified unspecified unspecified 0 
12 עבודות עבודה לעבודות noun feminine plural construct unspecified unspecified  	O	null
13 כפייה כפייה כפייה noun feminine singular absolute unspecified unspecified  	O	null
14 ב ב ביערות preposition unspecified unspecified unspecified unspecified unspecified 0 
14 יערות יער ביערות noun masculine plural construct unspecified unspecified  	O	null
15 ה ה הצפון definiteArticle unspecified unspecified unspecified unspecified unspecified 0 
15 הצפון צפון הצפון noun masculine singular absolute unspecified unspecified  	O	null
16 . . . punctuation unspecified unspecified unspecified unspecified unspecified  	O	null

0 הוא הוא הוא pronoun masculine singular unspecified 3 unspecified  	O	null
1 למד למד למד verb masculine singular unspecified 3 past  	O	null
2 ב ב בבית preposition unspecified unspecified unspecified unspecified unspecified 0 
2 בית בית בבית noun masculine singular construct unspecified unspecified  	O	null
3 ספר ספר ספר noun masculine singular absolute unspecified unspecified  	O	null
4 סובייטי סובייטי סובייטי adjective masculine singular absolute unspecified unspecified  	O	null
5 כפרי כפרי כפרי adjective masculine singular absolute unspecified unspecified  	O	null
6 , , , punctuation unspecified unspecified unspecified unspecified unspecified  	O	null
7 ו ו וב conjunction unspecified unspecified unspecified unspecified unspecified 0 
7 ב ב וב preposition unspecified unspecified unspecified unspecified unspecified 0 	I_ORG	null
8 - - - punctuation unspecified unspecified unspecified unspecified unspecified  	I_ORG	null
9 ###NUMBER### ###NUMBER### ###NUMBER### numeral unspecified unspecified unspecified unspecified unspecified  	I_DATE	null
10 שוחררה שוחרר שוחררה verb feminine singular unspecified 3 past  	O	null
11 ה ה המשפחה definiteArticle unspecified unspecified unspecified unspecified unspecified 0 
11 המשפחה משפחה המשפחה noun feminine singular absolute unspecified unspecified  	O	null
12 ו ו ועברה conjunction unspecified unspecified unspecified unspecified unspecified 0 
12 עברה עבר ועברה verb feminine singular unspecified 3 past  	O	null
13 ל ל למרכז preposition unspecified unspecified unspecified unspecified unspecified 0 
13 מרכז מרכז למרכז noun masculine singular construct unspecified unspecified  	O	null
14 פינוי פינוי פינוי noun masculine singular construct unspecified unspecified  	O	null
15 אוכלוסין אוכלוסין אוכלוסין noun masculine plural absolute unspecified unspecified  	O	null
16 מ מ מאזורי preposition unspecified unspecified unspecified unspecified unspecified 0 
16 אזורי אזור מאזורי noun masculine plural construct unspecified unspecified  	O	null
17 מלחמה מלחמה מלחמה noun feminine singular absolute unspecified unspecified  	O	null
18 ב ב באזור preposition unspecified unspecified unspecified unspecified unspecified 0 
18 ה ה באזור definiteArticle unspecified unspecified unspecified unspecified unspecified 0 
18 האזור אזור באזור noun masculine singular absolute unspecified unspecified  	O	null
19 ה ה הקר definiteArticle unspecified unspecified unspecified unspecified unspecified 0 
19 הקר קר הקר adjective masculine singular absolute unspecified unspecified  	O	null
20 של של של shel-preposition unspecified unspecified unspecified unspecified unspecified  	O	null
21 ה ה הוולגה definiteArticle unspecified unspecified unspecified unspecified unspecified 0 
21 הוולגה וולגה הוולגה properName masculine singular unspecified unspecified unspecified  	I_LOC	null
22 . . . punctuation unspecified unspecified unspecified unspecified unspecified  	O	null

0 משם משם משם adverb unspecified unspecified unspecified unspecified unspecified  	O	null
1 נלקחו נלקח נלקחו verb masculine-and-feminine plural unspecified 3 past  	O	null
2 על על על preposition unspecified unspecified unspecified unspecified unspecified  	O	null
3 ידי יד ידי noun feminine plural construct unspecified unspecified  	O	null
4 איכרים איכר איכרים noun masculine plural absolute unspecified unspecified  	O	null
5 ל ל לקולחוז preposition unspecified unspecified unspecified unspecified unspecified 0 
5 קולחוז קולחוז לקולחוז noun masculine singular absolute unspecified unspecified  	O	null
6 , , , punctuation unspecified unspecified unspecified unspecified unspecified  	O	null
7 שבו ישב שבו verb masculine-and-feminine plural unspecified 2 imperative  	O	null
8 עברו עבר עברו verb masculine-and-feminine plural unspecified 3 past  	O	null
9 על על עליו preposition unspecified unspecified unspecified unspecified unspecified  
9 ו ו עליו pronomial masculine singular unspecified 3 unspecified 0 	O	null
10 שנות שנה שנותיו noun feminine plural absolute unspecified unspecified  
10 ו ו שנותיו possessive masculine singular unspecified 3 unspecified 0 	O	null
11 מ מ מגיל preposition unspecified unspecified unspecified unspecified unspecified 0 
11 גיל גיל מגיל noun masculine singular construct unspecified unspecified  	O	null
12 שתים שתים שתים noun masculine singular construct unspecified unspecified  	O	null
13 - - - punctuation unspecified unspecified unspecified unspecified unspecified  	O	null
14 עשרה CARD10 עשרה numeral masculine plural absolute unspecified unspecified  	O	null
15 עד עד עד noun masculine singular absolute unspecified unspecified  	O	null
16 שבע שבע שבע adjective masculine singular absolute unspecified unspecified  	O	null
17 - - - punctuation unspecified unspecified unspecified unspecified unspecified  	O	null
18 עשרה CARD10 עשרה numeral masculine plural absolute unspecified unspecified  	O	null
19 . . . punctuation unspecified unspecified unspecified unspecified unspecified  	O	null

0 ל ל לקיום preposition unspecified unspecified unspecified unspecified unspecified 0 
0 קיום קיום לקיום noun masculine singular construct unspecified unspecified  	O	null
1 משפחת משפחה משפחתו noun feminine singular absolute unspecified unspecified  
1 ו ו משפחתו possessive masculine singular unspecified 3 unspecified 0 	O	null
2 עסק עסק עסק verb masculine singular unspecified 3 past  	O	null
3 ב ב בסנדלרות preposition unspecified unspecified unspecified unspecified unspecified 0 
3 ה ה בסנדלרות definiteArticle unspecified unspecified unspecified unspecified unspecified 0 
3 הסנדלרות סנדלרות בסנדלרות noun feminine singular absolute unspecified unspecified  	O	null
4 , , , punctuation unspecified unspecified unspecified unspecified unspecified  	O	null
5 ב ב בתיקון preposition unspecified unspecified unspecified unspecified unspecified 0 
5 תיקון תיקון בתיקון noun masculine singular construct unspecified unspecified  	O	null
6 גגות גג גגות noun masculine plural absolute unspecified unspecified  	O	null
7 , , , punctuation unspecified unspecified unspecified unspecified unspecified  	O	null
8 ב ב בכריתת preposition unspecified unspecified unspecified unspecified unspecified 0 
8 כריתת כריתה בכריתת noun feminine singular construct unspecified unspecified  	O	null
9 עצים עץ עצים noun masculine plural absolute unspecified unspecified  	O	null
10 וכו וכו וכו preposition unspecified unspecified unspecified unspecified unspecified  	O	null
11 ' ' ' punctuation unspecified unspecified unspecified unspecified unspecified  	O	null
12 , , , punctuation unspecified unspecified unspecified unspecified unspecified  	O	null
13 ו ו ושם conjunction unspecified unspecified unspecified unspecified unspecified 0 
13 שם שם ושם adverb unspecified unspecified unspecified unspecified unspecified  	O	null
14 גם גם גם conjunction unspecified unspecified unspecified unspecified unspecified  	O	null
15 התנסה התנסה התנסה verb masculine singular unspecified 3 past  	O	null
16 לראשונה לראשונה לראשונה adverb unspecified unspecified unspecified unspecified unspecified  	O	null
17 ב ב בכתיבת preposition unspecified unspecified unspecified unspecified unspecified 0 
17 כתיבת כתיבה בכתיבת noun feminine singular construct unspecified unspecified  	O	null
18 שירים שיר שירים noun masculine plural absolute unspecified unspecified  	O	null
19 . . . punctuation unspecified unspecified unspecified unspecified unspecified  	O	null

0 לאחר לאחר לאחר conjunction unspecified unspecified unspecified unspecified unspecified  	O	null
1 ה ה המלחמה definiteArticle unspecified unspecified unspecified unspecified unspecified 0 
1 המלחמה מלחמה המלחמה noun feminine singular absolute unspecified unspecified  	O	null
2 שהו שהה שהו verb masculine-and-feminine plural unspecified 3 past  	O	null
3 בני בן בני noun masculine plural construct unspecified unspecified  	O	null
4 ה ה המשפחה definiteArticle unspecified unspecified unspecified unspecified unspecified 0 
4 המשפחה משפחה המשפחה noun feminine singular absolute unspecified unspecified  	O	null
5 זמן זמן זמן noun masculine singular absolute unspecified unspecified  	O	null
6 קצר קצר קצר adjective masculine singular absolute unspecified unspecified  	O	null
7 ב ב בגרמניה preposition unspecified unspecified unspecified unspecified unspecified 0 
7 גרמניה גרמני בגרמניה properName unspecified unspecified unspecified unspecified unspecified  	I_LOC	null
8 , , , punctuation unspecified unspecified unspecified unspecified unspecified  	O	null
9 ו ו ובילו conjunction unspecified unspecified unspecified unspecified unspecified 0 
9 בילו בייל ובילו verb masculine-and-feminine plural unspecified 3 past  	O	null
10 כ כ כשלוש preposition unspecified unspecified unspecified unspecified unspecified 0 
10 שלוש CARD3 כשלוש numeral feminine singular absolute unspecified unspecified  	O	null
11 שנים שנה שנים noun feminine plural absolute unspecified unspecified  	O	null
12 של של של shel-preposition unspecified unspecified unspecified unspecified unspecified  	O	null
13 המתנה המתנה המתנה noun feminine singular absolute unspecified unspecified  	O	null
14 קשה קשה קשה adjective feminine singular absolute unspecified unspecified  	O	null
15 ב ב במחנות preposition unspecified unspecified unspecified unspecified unspecified 0 
15 מחנות מחנה במחנות noun masculine plural construct unspecified unspecified  	O	null
16 פליטים פליט פליטים noun masculine plural absolute unspecified unspecified  	O	null
17 ב ב באוסטריה preposition unspecified unspecified unspecified unspecified unspecified 0 
17 אוסטריה אוסטריה באוסטריה properName unspecified unspecified unspecified unspecified unspecified  	I_LOC	null
18 ו ו ובאיטליה conjunction unspecified unspecified unspecified unspecified unspecified 0 
18 ב ב ובאיטליה preposition unspecified unspecified unspecified unspecified unspecified 0 
18 איטליה איטליה ובאיטליה properName unspecified unspecified unspecified unspecified unspecified  	B_LOC	null
19 . . . punctuation unspecified unspecified unspecified unspecified unspecified  	O	null

0 ב ב במסגרת preposition unspecified unspecified unspecified unspecified unspecified 0 
0 מסגרת מסגרת במסגרת noun feminine singular absolute unspecified unspecified  	O	null
1 זו זו זו pronoun feminine singular unspecified 3 unspecified  	O	null
2 עבר עבר עבר verb masculine singular unspecified 3 past  	O	null
3 הכשרה הכשרה הכשרה noun feminine singular absolute unspecified unspecified  	O	null
4 חברתית חברתי חברתית adjective feminine singular absolute unspecified unspecified  	O	null
5 - - - punctuation unspecified unspecified unspecified unspecified unspecified  	O	null
6 מקצועית מקצועי מקצועית adjective feminine singular absolute unspecified unspecified  	O	null
7 ב ב ברוח preposition unspecified unspecified unspecified unspecified unspecified 0 
7 רוח רוח ברוח noun feminine singular absolute unspecified unspecified  	O	null
8 סוציאליסטית סוציאליסטי סוציאליסטית adjective feminine singular absolute unspecified unspecified  	O	null
9 ש ש שכונתה relativizer/subordinatingConjunction unspecified unspecified unspecified unspecified unspecified 0 
9 כונתה כונה שכונתה verb feminine singular unspecified 3 past  	O	null
10 " " " punctuation unspecified unspecified unspecified unspecified unspecified  	O	null
11 ה ה הקיבוץ definiteArticle unspecified unspecified unspecified unspecified unspecified 0 
11 הקיבוץ קיבוץ הקיבוץ noun masculine singular absolute unspecified unspecified  	O	null
12 ש ש שבדרך relativizer/subordinatingConjunction unspecified unspecified unspecified unspecified unspecified 0 
12 ב ב שבדרך preposition unspecified unspecified unspecified unspecified unspecified 0 
12 דרך דרך שבדרך noun feminine singular construct unspecified unspecified  	O	null
13 " " " punctuation unspecified unspecified unspecified unspecified unspecified  	O	null
14 , , , punctuation unspecified unspecified unspecified unspecified unspecified  	O	null
15 ו ו והזדמן conjunction unspecified unspecified unspecified unspecified unspecified 0 
15 הזדמן הזדמן והזדמן verb masculine singular unspecified 3 past  	O	null
16 ל ל לו preposition unspecified unspecified unspecified unspecified unspecified  
16 ו ו לו pronomial masculine singular unspecified 3 unspecified 0 	O	null
17 לשוב שב לשוב verb unspecified unspecified unspecified unspecified infinitive  	O	null
18 ל ל לכתיבה preposition unspecified unspecified unspecified unspecified unspecified 0 
18 כתיבה כתיבה לכתיבה noun feminine singular absolute unspecified unspecified  	O	null
19 ספרותית.עם ספרותית.עם ספרותית.עם properName unspecified unspecified unspecified unspecified unspecified  	I_ORG	null
20 הגיעם הגיעם הגיעם verb masculine singular unspecified 3 past  	O	null
21 ל ל לארץ preposition unspecified unspecified unspecified unspecified unspecified 0 
21 ה ה לארץ definiteArticle unspecified unspecified unspecified unspecified unspecified 0 
21 הארץ ארץ לארץ noun feminine singular absolute unspecified unspecified  	O	null
22 , , , punctuation unspecified unspecified unspecified unspecified unspecified  	O	null
23 ב ב בדצמבר preposition unspecified unspecified unspecified unspecified unspecified 0 
23 דצמבר דצמבר בדצמבר properName unspecified unspecified unspecified unspecified unspecified  	I_DATE	null
24 , , , punctuation unspecified unspecified unspecified unspecified unspecified  	O	null
25 ###NUMBER### ###NUMBER### ###NUMBER### numeral unspecified unspecified unspecified unspecified unspecified  	I_DATE	null
26 בעוד בעוד בעוד preposition unspecified unspecified unspecified unspecified unspecified  	O	null
27 הורי הורה הוריו noun masculine plural absolute unspecified unspecified  
27 ו ו הוריו possessive masculine singular unspecified 3 unspecified 0 	O	null
28 שוהים שהה שוהים verb masculine plural unspecified any beinoni  	O	null
29 ב ב במעברה preposition unspecified unspecified unspecified unspecified unspecified 0 
29 מעברה מעברה במעברה noun feminine singular absolute unspecified unspecified  	O	null
30 ב ב בחדרה preposition unspecified unspecified unspecified unspecified unspecified 0 
30 חדרה חדרה בחדרה properName unspecified unspecified unspecified unspecified unspecified  	I_LOC	null
31 , , , punctuation unspecified unspecified unspecified unspecified unspecified  	O	null
32 נשלח נשלח נשלח verb masculine singular unspecified 3 past  	O	null
33 ל ל לבסיס preposition unspecified unspecified unspecified unspecified unspecified 0 
33 בסיס בסיס לבסיס noun masculine singular construct unspecified unspecified  	O	null
34 צה"ל צה"ל צה"ל properName unspecified unspecified unspecified unspecified unspecified  	I_ORG	null
35 ב ב בבית preposition unspecified unspecified unspecified unspecified unspecified 0 
35 ה ה בבית definiteArticle unspecified unspecified unspecified unspecified unspecified 0 
35 הבית בית בבית noun masculine singular absolute unspecified unspecified  	O	null
36 ל ל ליד preposition unspecified unspecified unspecified unspecified unspecified 0 
36 יד יד ליד noun feminine singular absolute unspecified unspecified  	O	null
37 . . . punctuation unspecified unspecified unspecified unspecified unspecified  	O	null

0 ב ב ב preposition unspecified unspecified unspecified unspecified unspecified 0 	I_ORG	null
1 - - - punctuation unspecified unspecified unspecified unspecified unspecified  	I_ORG	null
2 ###NUMBER### ###NUMBER### ###NUMBER### numeral unspecified unspecified unspecified unspecified unspecified  	I_DATE	null
3 עבר עבר עבר verb masculine singular unspecified 3 past  	O	null
4 להתגורר התגורר להתגורר verb unspecified unspecified unspecified unspecified infinitive  	O	null
5 ב ב בעכו preposition unspecified unspecified unspecified unspecified unspecified 0 
5 עכו עכו בעכו properName unspecified unspecified unspecified unspecified unspecified  	I_LOC	null
6 ל ל למשך preposition unspecified unspecified unspecified unspecified unspecified 0 
6 משך משך למשך noun masculine singular construct unspecified unspecified  	O	null
7 כ כ כעשר preposition unspecified unspecified unspecified unspecified unspecified 0 
7 עשר CARD10 כעשר numeral feminine singular absolute unspecified unspecified  	O	null
8 שנים שנה שנים noun feminine plural absolute unspecified unspecified  	O	null
9 . . . punctuation unspecified unspecified unspecified unspecified unspecified  	O	null

0 ל ל לטראומת preposition unspecified unspecified unspecified unspecified unspecified 0 
0 טראומת טראומה לטראומת noun feminine singular construct unspecified unspecified  	O	null
1 ה ה הכיבוש definiteArticle unspecified unspecified unspecified unspecified unspecified 0 
1 הכיבוש כיבוש הכיבוש noun masculine singular absolute unspecified unspecified  	O	null
2 ה ה הנאצי definiteArticle unspecified unspecified unspecified unspecified unspecified 0 
2 הנאצי נאצי הנאצי adjective masculine singular absolute unspecified unspecified  	O	null
3 מ מ מילדותו preposition unspecified unspecified unspecified unspecified unspecified 0 
3 ילדות ילדות מילדותו noun feminine singular absolute unspecified unspecified  
3 ו ו מילדותו possessive masculine singular unspecified 3 unspecified 0 	O	null
4 נוספה נוסף נוספה verb feminine singular unspecified 3 past  	O	null
5 טראומת טראומה טראומת noun feminine singular construct unspecified unspecified  	O	null
6 ה ה הקרב definiteArticle unspecified unspecified unspecified unspecified unspecified 0 
6 הקרב קרב הקרב noun masculine singular absolute unspecified unspecified  	O	null
7 על על על preposition unspecified unspecified unspecified unspecified unspecified  	O	null
8 תל תל תל properName unspecified unspecified unspecified unspecified unspecified  	I_ORG	null
9 - - - punctuation unspecified unspecified unspecified unspecified unspecified  	O	null
10 מוטילה מוטילה מוטילה properName unspecified unspecified unspecified unspecified unspecified  	I_ORG	null
11 ) ) ) punctuation unspecified unspecified unspecified unspecified unspecified  	O	null
12 , , , punctuation unspecified unspecified unspecified unspecified unspecified  	O	null
13 ש ש שממנו relativizer/subordinatingConjunction unspecified unspecified unspecified unspecified unspecified 0 
13 מן מן שממנו preposition unspecified unspecified unspecified unspecified unspecified  
13 ו ו שממנו pronomial masculine singular unspecified 3 unspecified 0 	O	null
14 ###NUMBER### ###NUMBER### ###NUMBER### numeral unspecified unspecified unspecified unspecified unspecified  	I_DATE	null
15 ניצל ניצל ניצל verb masculine singular unspecified 3 past  	O	null
16 ב ב בנס preposition unspecified unspecified unspecified unspecified unspecified 0 
16 נס נס בנס noun masculine singular absolute unspecified unspecified  	O	null
17 כשמסביבו כשמסביבו כשמסביבו properName unspecified unspecified unspecified unspecified unspecified  	I_PERS	null
18 נפלו נפל נפלו verb masculine-and-feminine plural unspecified 3 past  	O	null
19 רבים רב רבים adjective masculine plural absolute unspecified unspecified  	O	null
20 מ מ מחבריו preposition unspecified unspecified unspecified unspecified unspecified 0 
20 חברי חבר מחבריו noun masculine plural absolute unspecified unspecified  
20 ו ו מחבריו possessive masculine singular unspecified 3 unspecified 0 	O	null
21 . . . punctuation unspecified unspecified unspecified unspecified unspecified  	O	null

0 ב ב בשלב preposition unspecified unspecified unspecified unspecified unspecified 0 
0 שלב שלב בשלב noun masculine singular absolute unspecified unspecified  	O	null
1 זה זה זה pronoun masculine singular unspecified 3 unspecified  	O	null
2 עבר עבר עבר verb masculine singular unspecified 3 past  	O	null
3 מ מ מכתיבה preposition unspecified unspecified unspecified unspecified unspecified 0 
3 כתיבה כתיבה מכתיבה noun feminine singular absolute unspecified unspecified  	O	null
4 ב ב ביידיש preposition unspecified unspecified unspecified unspecified unspecified 0 
4 יידיש יידיש ביידיש properName feminine singular unspecified unspecified unspecified  	I_PERS	null
5 ל ל לעברית preposition unspecified unspecified unspecified unspecified unspecified 0 
5 עברית עברית לעברית properName feminine singular unspecified unspecified unspecified  	I_PERS	null
6 . . . punctuation unspecified unspecified unspecified unspecified unspecified  	O	null

0 כ כ כאזרח preposition unspecified unspecified unspecified unspecified unspecified 0 
0 ה ה כאזרח definiteArticle unspecified unspecified unspecified unspecified unspecified 0 
0 האזרח אזרח כאזרח noun masculine singular absolute unspecified unspecified  	O	null
1 עובד עובד עובד properName unspecified unspecified unspecified unspecified unspecified  	I_PERS	null
2 צה"ל צה"ל צה"ל properName unspecified unspecified unspecified unspecified unspecified  	I_ORG	null
3 עסק עסק עסק verb masculine singular unspecified 3 past  	O	null
4 ב ב בריתוך preposition unspecified unspecified unspecified unspecified unspecified 0 
4 ריתוך ריתוך בריתוך noun masculine singular absolute unspecified unspecified  	O	null
5 ו ו ובאינסטלציה conjunction unspecified unspecified unspecified unspecified unspecified 0 
5 ב ב ובאינסטלציה preposition unspecified unspecified unspecified unspecified unspecified 0 
5 אינסטלציה אינסטלציה ובאינסטלציה noun masculine singular absolute unspecified unspecified  	O	null
6 , , , punctuation unspecified unspecified unspecified unspecified unspecified  	O	null
7 ו ו ובמקביל conjunction unspecified unspecified unspecified unspecified unspecified 0 
7 במקביל במקביל ובמקביל adverb unspecified unspecified unspecified unspecified unspecified  	O	null
8 השלים השלים השלים verb masculine singular unspecified 3 past  	O	null
9 את את את at-preposition unspecified unspecified unspecified unspecified unspecified  	O	null
10 לימודי לימוד לימודיו noun masculine plural absolute unspecified unspecified  
10 ו ו לימודיו possessive masculine singular unspecified 3 unspecified 0 	O	null
11 ל ל לתעודת preposition unspecified unspecified unspecified unspecified unspecified 0 
11 תעודת תעודה לתעודת noun feminine singular construct unspecified unspecified  	O	null
12 הוראה הוראה הוראה noun feminine singular absolute unspecified unspecified  	O	null
13 ב ב בבתי preposition unspecified unspecified unspecified unspecified unspecified 0 
13 בתי בית בבתי noun masculine plural construct unspecified unspecified  	O	null
14 ספר ספר ספר noun masculine singular absolute unspecified unspecified  	O	null
15 יסודיים יסודי יסודיים adjective masculine plural absolute unspecified unspecified  	O	null
16 ו ו והתקבל conjunction unspecified unspecified unspecified unspecified unspecified 0 
16 התקבל התקבל והתקבל verb masculine singular unspecified 3 past  	O	null
17 כמורה כמורה כמורה noun feminine singular absolute unspecified unspecified  	O	null
18 ב ב בעכו preposition unspecified unspecified unspecified unspecified unspecified 0 
18 עכו עכו בעכו properName unspecified unspecified unspecified unspecified unspecified  	I_LOC	null
19 ו ו ובבוסתןהגליל conjunction unspecified unspecified unspecified unspecified unspecified 0 
19 בבוסתןהגליל בבוסתןהגליל ובבוסתןהגליל adjective masculine singular construct unspecified unspecified  	O	null
20 . . . punctuation unspecified unspecified unspecified unspecified unspecified  	O	null

0 ב ב בתמיכת preposition unspecified unspecified unspecified unspecified unspecified 0 
0 תמיכת תמיכה בתמיכת noun feminine singular construct unspecified unspecified  	O	null
1 ה ה הצייר definiteArticle unspecified unspecified unspecified unspecified unspecified 0 
1 הצייר צייר הצייר noun masculine singular absolute unspecified unspecified  	O	null
2 אבשלום אבשלום אבשלום properName masculine singular unspecified unspecified unspecified  	I_PERS	null
3 עוקשי עוקשי עוקשי noun masculine singular absolute unspecified unspecified  	O	null
4 ו ו ובעידודו conjunction unspecified unspecified unspecified unspecified unspecified 0 
4 ב ב ובעידודו preposition unspecified unspecified unspecified unspecified unspecified 0 
4 עידוד עידוד ובעידודו noun masculine singular absolute unspecified unspecified  
4 ו ו ובעידודו possessive masculine singular unspecified 3 unspecified 0 	O	null
5 התחיל התחיל התחיל verb masculine singular unspecified 3 past  	O	null
6 גם גם גם conjunction unspecified unspecified unspecified unspecified unspecified  	O	null
7 את את את at-preposition unspecified unspecified unspecified unspecified unspecified  	O	null
8 דרך דרך דרכו noun feminine singular absolute unspecified unspecified  
8 ו ו דרכו possessive masculine singular unspecified 3 unspecified 0 	O	null
9 כ כ כצייר preposition unspecified unspecified unspecified unspecified unspecified 0 
9 ה ה כצייר definiteArticle unspecified unspecified unspecified unspecified unspecified 0 
9 הצייר צייר כצייר noun masculine singular absolute unspecified unspecified  	O	null
10 , , , punctuation unspecified unspecified unspecified unspecified unspecified  	O	null
11 ו ו ולא conjunction unspecified unspecified unspecified unspecified unspecified 0 
11 לא לא ולא negation unspecified unspecified unspecified unspecified unspecified  	O	null
12 חדל חדל חדל verb masculine singular unspecified 3 past  	O	null
13 לצייר צייר לצייר verb unspecified unspecified unspecified unspecified infinitive  	O	null
14 עד עד עד preposition unspecified unspecified unspecified unspecified unspecified  	O	null
15 אחרית אחרית אחרית noun feminine singular construct unspecified unspecified  	O	null
16 ימי יום ימיו noun masculine plural absolute unspecified unspecified  
16 ו ו ימיו possessive masculine singular unspecified 3 unspecified 0 	O	null
17 . . . punctuation unspecified unspecified unspecified unspecified unspecified  	O	null

0 תערוכות תערוכה תערוכות noun feminine plural absolute unspecified unspecified  	O	null
1 יחיד יחיד יחיד adjective masculine singular absolute unspecified unspecified  	O	null
2 של של שלו shel-preposition unspecified unspecified unspecified unspecified unspecified  
2 ו ו שלו pronomial masculine singular unspecified 3 unspecified 0 	O	null
3 הוצגו הוצג הוצגו verb masculine-and-feminine plural unspecified 3 past  	O	null
4 ב ב במוזיאונים preposition unspecified unspecified unspecified unspecified unspecified 0 
4 מוזיאונים מוזיאון במוזיאונים noun masculine plural absolute unspecified unspecified  	O	null
5 שונים שונה שונים adjective masculine plural absolute unspecified unspecified  	O	null
6 , , , punctuation unspecified unspecified unspecified unspecified unspecified  	O	null
7 ו ו ולאחר conjunction unspecified unspecified unspecified unspecified unspecified 0 
7 לאחר לאחר ולאחר conjunction unspecified unspecified unspecified unspecified unspecified  	O	null
8 מות מוות מותו noun masculine singular absolute unspecified unspecified  
8 ו ו מותו possessive masculine singular unspecified 3 unspecified 0 	O	null
9 הוצגו הוצג הוצגו verb masculine-and-feminine plural unspecified 3 past  	O	null
10 אחרוני אחרון אחרוני adjective masculine plural construct unspecified unspecified  	O	null
11 ציורי ציור ציוריו noun masculine plural absolute unspecified unspecified  
11 ו ו ציוריו possessive masculine singular unspecified 3 unspecified 0 	O	null
12 ב ב ב preposition unspecified unspecified unspecified unspecified unspecified 0 	O	null
13 " " " punctuation unspecified unspecified unspecified unspecified unspecified  	O	null
14 משכן משכן משכן verb masculine singular unspecified 2 imperative  	O	null
15 ל ל לאמנות preposition unspecified unspecified unspecified unspecified unspecified 0 
15 ה ה לאמנות definiteArticle unspecified unspecified unspecified unspecified unspecified 0 
15 האמנות אמנות לאמנות noun feminine singular absolute unspecified unspecified  	O	null
16 " " " punctuation unspecified unspecified unspecified unspecified unspecified  	O	null
17 ב ב בעין preposition unspecified unspecified unspecified unspecified unspecified 0 
17 עין עין בעין noun feminine singular construct unspecified unspecified  	O	null
18 חרוד חרוד חרוד noun masculine singular absolute unspecified unspecified  	O	null
19 ) ) ) punctuation unspecified unspecified unspecified unspecified unspecified  	O	null
20 . . . punctuation unspecified unspecified unspecified unspecified unspecified  	O	null
21 ###NUMBER### ###NUMBER### ###NUMBER### numeral unspecified unspecified unspecified unspecified unspecified  	I_DATE	null
22 ב ב בשנות preposition unspecified unspecified unspecified unspecified unspecified 0 
22 שנות שנה בשנות noun feminine plural construct unspecified unspecified  	I_DATE	null
23 ה ה השישים definiteArticle unspecified unspecified unspecified unspecified unspecified 0 
23 השישים ORD-CARD60 השישים numeral masculine-and-feminine plural absolute unspecified unspecified  	I_DATE	null
24 למד למד למד verb masculine singular unspecified 3 past  	O	null
25 היסטוריה היסטוריה היסטוריה noun feminine singular absolute unspecified unspecified  	O	null
26 כללית כללי כללית adjective feminine singular absolute unspecified unspecified  	O	null
27 וסוציולוגיה וסוציולוגיה וסוציולוגיה adjective feminine singular absolute unspecified unspecified  	O	null
28 ב ב באוניברסיטת preposition unspecified unspecified unspecified unspecified unspecified 0 
28 אוניברסיטת אוניברסיטה באוניברסיטת noun feminine singular construct unspecified unspecified  	I_ORG	null
29 חיפה חיפה חיפה properName unspecified unspecified unspecified unspecified unspecified  	I_ORG	null
30 ו ו ובאוניברסיטה conjunction unspecified unspecified unspecified unspecified unspecified 0 
30 ב ב ובאוניברסיטה preposition unspecified unspecified unspecified unspecified unspecified 0 
30 ה ה ובאוניברסיטה definiteArticle unspecified unspecified unspecified unspecified unspecified 0 
30 האוניברסיטה אוניברסיטה ובאוניברסיטה noun feminine singular absolute unspecified unspecified  	O	null
31 ה ה העברית definiteArticle unspecified unspecified unspecified unspecified unspecified 0 
31 העברית עברי העברית adjective feminine singular absolute unspecified unspecified  	O	null
32 ב ב בירושלים preposition unspecified unspecified unspecified unspecified unspecified 0 
32 ירושלים ירושלים בירושלים properName unspecified unspecified unspecified unspecified unspecified  	I_LOC	null
33 , , , punctuation unspecified unspecified unspecified unspecified unspecified  	O	null
34 ו ו והוכשר conjunction unspecified unspecified unspecified unspecified unspecified 0 
34 הוכשר הוכשר והוכשר verb masculine singular unspecified 3 past  	O	null
35 גם גם גם conjunction unspecified unspecified unspecified unspecified unspecified  	O	null
36 ל ל להוראת preposition unspecified unspecified unspecified unspecified unspecified 0 
36 הוראת הוראה להוראת noun feminine singular construct unspecified unspecified  	O	null
37 ה ה ההיסטוריה definiteArticle unspecified unspecified unspecified unspecified unspecified 0 
37 ההיסטוריה היסטוריה ההיסטוריה noun feminine singular absolute unspecified unspecified  	O	null
38 ב ב בבתי preposition unspecified unspecified unspecified unspecified unspecified 0 
38 בתי בית בבתי noun masculine plural construct unspecified unspecified  	O	null
39 ספר ספר ספר noun masculine singular absolute unspecified unspecified  	O	null
40 תיכוניים תיכוני תיכוניים adjective masculine plural absolute unspecified unspecified  	O	null
41 ב ב בבית preposition unspecified unspecified unspecified unspecified unspecified 0 
41 בית בית בבית noun masculine singular construct unspecified unspecified  	O	null
42 ה ה הספר definiteArticle unspecified unspecified unspecified unspecified unspecified 0 
42 הספר ספר הספר noun masculine singular absolute unspecified unspecified  	O	null
43 ל ל לחינוך preposition unspecified unspecified unspecified unspecified unspecified 0 
43 ה ה לחינוך definiteArticle unspecified unspecified unspecified unspecified unspecified 0 
43 החינוך חינוך לחינוך noun masculine singular absolute unspecified unspecified  	O	null
44 של של של shel-preposition unspecified unspecified unspecified unspecified unspecified  	O	null
45 ה ה האוניברסיטה definiteArticle unspecified unspecified unspecified unspecified unspecified 0 
45 האוניברסיטה אוניברסיטה האוניברסיטה noun feminine singular absolute unspecified unspecified  	I_ORG	null
46 ה ה העברית definiteArticle unspecified unspecified unspecified unspecified unspecified 0 
46 העברית עברי העברית adjective feminine singular absolute unspecified unspecified  	I_ORG	null
47 . . . punctuation unspecified unspecified unspecified unspecified unspecified  	O	null

0 ה ה המרחק definiteArticle unspecified unspecified unspecified unspecified unspecified 0 
0 המרחק מרחק המרחק noun masculine singular absolute unspecified unspecified  	O	null
1 מ מ מהמרכז preposition unspecified unspecified unspecified unspecified unspecified 0 
1 ה ה מהמרכז definiteArticle unspecified unspecified unspecified unspecified unspecified 0 
1 המרכז מרכז מהמרכז noun masculine singular absolute unspecified unspecified  	O	null
2 ה ה התל definiteArticle unspecified unspecified unspecified unspecified unspecified 0 
2 התל תל התל noun masculine singular absolute unspecified unspecified  	O	null
3 - - - punctuation unspecified unspecified unspecified unspecified unspecified  	O	null
4 אביבי אביבי אביבי adjective masculine singular absolute unspecified unspecified  	O	null
5 ה ה הקשה definiteArticle unspecified unspecified unspecified unspecified unspecified 0 
5 הקשה קשה הקשה adjective masculine singular absolute unspecified unspecified  	O	null
6 על על על preposition unspecified unspecified unspecified unspecified unspecified  	O	null
7 התקבלות התקבלות התקבלותו noun feminine singular absolute unspecified unspecified  
7 ו ו התקבלותו possessive masculine singular unspecified 3 unspecified 0 	O	null
8 כ כ כמשורר preposition unspecified unspecified unspecified unspecified unspecified 0 
8 ה ה כמשורר definiteArticle unspecified unspecified unspecified unspecified unspecified 0 
8 המשורר משורר כמשורר noun masculine singular absolute unspecified unspecified  	O	null
9 ו ו וכצייר conjunction unspecified unspecified unspecified unspecified unspecified 0 
9 כ כ וכצייר preposition unspecified unspecified unspecified unspecified unspecified 0 
9 ה ה וכצייר definiteArticle unspecified unspecified unspecified unspecified unspecified 0 
9 הצייר צייר וכצייר noun masculine singular absolute unspecified unspecified  	O	null
10 , , , punctuation unspecified unspecified unspecified unspecified unspecified  	O	null
11 ו ו ועם conjunction unspecified unspecified unspecified unspecified unspecified 0 
11 עם עם ועם preposition unspecified unspecified unspecified unspecified unspecified  	O	null
12 ה ה המעבר definiteArticle unspecified unspecified unspecified unspecified unspecified 0 
12 המעבר מעבר המעבר noun masculine singular absolute unspecified unspecified  	O	null
13 ל ל לתל preposition unspecified unspecified unspecified unspecified unspecified 0 
13 תל תל לתל noun masculine singular construct unspecified unspecified  	I_LOC	null
14 אביב אביב אביב properName unspecified unspecified unspecified unspecified unspecified  	I_LOC	null
15 ב ב בשנות preposition unspecified unspecified unspecified unspecified unspecified 0 
15 שנות שנה בשנות noun feminine plural construct unspecified unspecified  	O	null
16 ה ה השבעים definiteArticle unspecified unspecified unspecified unspecified unspecified 0 
16 השבעים ORD-CARD70 השבעים numeral masculine-and-feminine plural absolute unspecified unspecified  	O	null
17 החלו החל החלו verb masculine-and-feminine plural unspecified 3 past  	O	null
18 לראות ראה לראות verb unspecified unspecified unspecified unspecified infinitive  	O	null
19 אור אור אור noun masculine singular absolute unspecified unspecified  	O	null
20 פרסומי פרסום פרסומיו noun masculine plural absolute unspecified unspecified  
20 ו ו פרסומיו possessive masculine singular unspecified 3 unspecified 0 	O	null
21 ה ה הראשונים definiteArticle unspecified unspecified unspecified unspecified unspecified 0 
21 הראשונים ראשונים הראשונים noun masculine plural absolute unspecified unspecified  	O	null
22 ב ב במוספי preposition unspecified unspecified unspecified unspecified unspecified 0 
22 מוספי מוסף במוספי noun masculine plural construct unspecified unspecified  	O	null
23 ה ה הספרות definiteArticle unspecified unspecified unspecified unspecified unspecified 0 
23 הספרות ספרות הספרות noun feminine singular absolute unspecified unspecified  	O	null
24 ב ב בעיתונות preposition unspecified unspecified unspecified unspecified unspecified 0 
24 ה ה בעיתונות definiteArticle unspecified unspecified unspecified unspecified unspecified 0 
24 העיתונות עיתונות בעיתונות noun feminine singular absolute unspecified unspecified  	O	null
25 ו ו ובכתבי conjunction unspecified unspecified unspecified unspecified unspecified 0 
25 ב ב ובכתבי preposition unspecified unspecified unspecified unspecified unspecified 0 
25 כתבי כתב ובכתבי noun masculine plural construct unspecified unspecified  	O	null
26 עת עת עת noun feminine singular absolute unspecified unspecified  	O	null
27 . . . punctuation unspecified unspecified unspecified unspecified unspecified  	O	null

0 אז אז אז conjunction unspecified unspecified unspecified unspecified unspecified  	O	null
1 גם גם גם conjunction unspecified unspecified unspecified unspecified unspecified  	O	null
2 השלים השלים השלים verb masculine singular unspecified 3 past  	O	null
3 את את את at-preposition unspecified unspecified unspecified unspecified unspecified  	O	null
4 לימודי לימוד לימודיו noun masculine plural absolute unspecified unspecified  
4 ו ו לימודיו possessive masculine singular unspecified 3 unspecified 0 	O	null
5 ל ל לתואר preposition unspecified unspecified unspecified unspecified unspecified 0 
5 תואר תואר לתואר noun masculine singular construct unspecified unspecified  	O	null
6 שני שני שני noun masculine singular absolute unspecified unspecified  	O	null
7 ב ב בחוג preposition unspecified unspecified unspecified unspecified unspecified 0 
7 ה ה בחוג definiteArticle unspecified unspecified unspecified unspecified unspecified 0 
7 החוג חוג בחוג noun masculine singular absolute unspecified unspecified  	O	null
8 ל ל לספרות preposition unspecified unspecified unspecified unspecified unspecified 0 
8 ספרות ספרות לספרות noun feminine singular absolute unspecified unspecified  	O	null
9 עברית עברי עברית adjective feminine singular absolute unspecified unspecified  	O	null
10 ב ב באוניברסיטת preposition unspecified unspecified unspecified unspecified unspecified 0 
10 אוניברסיטת אוניברסיטה באוניברסיטת noun feminine singular construct unspecified unspecified  	I_ORG	null
11 תל תל תל properName unspecified unspecified unspecified unspecified unspecified  	I_ORG	null
12 אביב אביב אביב properName unspecified unspecified unspecified unspecified unspecified  	I_ORG	null
13 , , , punctuation unspecified unspecified unspecified unspecified unspecified  	O	null
14 ו ו והחל conjunction unspecified unspecified unspecified unspecified unspecified 0 
14 החל החל והחל verb masculine singular unspecified 3 past  	O	null
15 את את את at-preposition unspecified unspecified unspecified unspecified unspecified  	O	null
16 פעילות פעילות פעילותו noun feminine singular absolute unspecified unspecified  
16 ו ו פעילותו possessive masculine singular unspecified 3 unspecified 0 	O	null
17 ב ב במנהל preposition unspecified unspecified unspecified unspecified unspecified 0 
17 מנהל מנהל במנהל noun masculine singular construct unspecified unspecified  	O	null
18 ה ה התרבות definiteArticle unspecified unspecified unspecified unspecified unspecified 0 
18 התרבות תרבות התרבות noun feminine singular absolute unspecified unspecified  	O	null
19 , , , punctuation unspecified unspecified unspecified unspecified unspecified  	O	null
20 ב ב במדרשה preposition unspecified unspecified unspecified unspecified unspecified 0 
20 מדרשה מדרשה במדרשה noun feminine singular absolute unspecified unspecified  	O	null
21 ל ל לאמנות preposition unspecified unspecified unspecified unspecified unspecified 0 
21 ה ה לאמנות definiteArticle unspecified unspecified unspecified unspecified unspecified 0 
21 האמנות אמנות לאמנות noun feminine singular absolute unspecified unspecified  	O	null
22 , , , punctuation unspecified unspecified unspecified unspecified unspecified  	O	null
23 ב ב בחברת preposition unspecified unspecified unspecified unspecified unspecified 0 
23 חברת חבר בחברת noun feminine singular construct unspecified unspecified  	O	null
24 ה ה המתנ definiteArticle unspecified unspecified unspecified unspecified unspecified 0 
24 המתן המתן המתנ noun masculine singular absolute unspecified unspecified  	O	null
25 " " " punctuation unspecified unspecified unspecified unspecified unspecified  	O	null
26 סים סיים סים verb masculine singular unspecified 3 past  	O	null
27 , , , punctuation unspecified unspecified unspecified unspecified unspecified  	O	null
28 ב ב באגודת preposition unspecified unspecified unspecified unspecified unspecified 0 
28 אגודת אגודה באגודת noun feminine singular construct unspecified unspecified  	O	null
29 ה ה הסופרים definiteArticle unspecified unspecified unspecified unspecified unspecified 0 
29 הסופרים סופר הסופרים noun masculine plural absolute unspecified unspecified  	O	null
30 ו ו ובאגודת conjunction unspecified unspecified unspecified unspecified unspecified 0 
30 ב ב ובאגודת preposition unspecified unspecified unspecified unspecified unspecified 0 
30 אגודת אגודה ובאגודת noun feminine singular construct unspecified unspecified  	O	null
31 ה ה הציירים definiteArticle unspecified unspecified unspecified unspecified unspecified 0 
31 הציירים צייר הציירים noun masculine plural absolute unspecified unspecified  	O	null
32 . . . punctuation unspecified unspecified unspecified unspecified unspecified  	O	null

0 ב ב בשנים preposition unspecified unspecified unspecified unspecified unspecified 0 
0 שנים שנה בשנים noun feminine plural absolute unspecified unspecified  	O	null
1 ###NUMBER### ###NUMBER### ###NUMBER### numeral unspecified unspecified unspecified unspecified unspecified  	I_DATE	null
2 - - - punctuation unspecified unspecified unspecified unspecified unspecified  	O	null
3 ###NUMBER### ###NUMBER### ###NUMBER### numeral unspecified unspecified unspecified unspecified unspecified  	I_DATE	null
4 היה הוא היה copula masculine singular unspecified 3 past  	O	null
5 עורך עורך עורך noun masculine singular construct unspecified unspecified  	O	null
6 ה ה הירחון definiteArticle unspecified unspecified unspecified unspecified unspecified 0 
6 הירחון ירחון הירחון noun masculine singular absolute unspecified unspecified  	O	null
7 מאזניים מאזניים מאזניים noun masculine plural absolute unspecified unspecified  	O	null
8 , , , punctuation unspecified unspecified unspecified unspecified unspecified  	O	null
9 תפקיד תפקיד תפקיד noun masculine singular absolute unspecified unspecified  	O	null
10 ש ש שמילא relativizer/subordinatingConjunction unspecified unspecified unspecified unspecified unspecified 0 
10 מילא מילא שמילא verb masculine singular unspecified 3 past  	O	null
11 ארבע CARD4 ארבע numeral feminine singular absolute unspecified unspecified  	O	null
12 קדנציות קדנציה קדנציות noun feminine plural absolute unspecified unspecified  	O	null
13 . . . punctuation unspecified unspecified unspecified unspecified unspecified  	O	null

0 ב ב בספרו preposition unspecified unspecified unspecified unspecified unspecified 0 
0 ספר ספר בספרו noun masculine singular absolute unspecified unspecified  
0 ו ו בספרו possessive masculine singular unspecified 3 unspecified 0 	O	null
1 ה ה הראשון definiteArticle unspecified unspecified unspecified unspecified unspecified 0 
1 הראשון ORD1 הראשון numeral masculine singular absolute unspecified unspecified  	O	null
2 , , , punctuation unspecified unspecified unspecified unspecified unspecified  	O	null
3 סונטת סונטה סונטת noun feminine singular construct unspecified unspecified  	O	null
4 עוף עוף עוף noun masculine singular absolute unspecified unspecified  	O	null
5 נודד נדד נודד verb masculine singular unspecified any beinoni  	O	null
6 ( ( ( punctuation unspecified unspecified unspecified unspecified unspecified  	I_LOC	null
7 נתן-נטע נתן-נטע נתן-נטע properName unspecified unspecified unspecified unspecified unspecified  	I_ORG	null
8 , , , punctuation unspecified unspecified unspecified unspecified unspecified  	O	null
9 ) ) ) punctuation unspecified unspecified unspecified unspecified unspecified  	O	null
10 , , , punctuation unspecified unspecified unspecified unspecified unspecified  	O	null
11 מסתמנת הסתמן מסתמנת verb feminine singular unspecified any beinoni  	O	null
12 ###NUMBER### ###NUMBER### ###NUMBER### numeral unspecified unspecified unspecified unspecified unspecified  	I_DATE	null
13 תנועה תנועה תנועה noun feminine singular absolute unspecified unspecified  	O	null
14 ב ב בזמן preposition unspecified unspecified unspecified unspecified unspecified 0 
14 ה ה בזמן definiteArticle unspecified unspecified unspecified unspecified unspecified 0 
14 הזמן זמן בזמן noun masculine singular absolute unspecified unspecified  	O	null
15 ו ו ובזיכרון conjunction unspecified unspecified unspecified unspecified unspecified 0 
15 ב ב ובזיכרון preposition unspecified unspecified unspecified unspecified unspecified 0 
15 ה ה ובזיכרון definiteArticle unspecified unspecified unspecified unspecified unspecified 0 
15 הזיכרון זיכרון ובזיכרון noun masculine singular absolute unspecified unspecified  	O	null
16 בין בין בין preposition unspecified unspecified unspecified unspecified unspecified  	O	null
17 ארצות ארץ ארצות noun feminine plural construct unspecified unspecified  	O	null
18 ה ה הקור definiteArticle unspecified unspecified unspecified unspecified unspecified 0 
18 הקור קור הקור noun masculine singular absolute unspecified unspecified  	O	null
19 ו ו והעבר conjunction unspecified unspecified unspecified unspecified unspecified 0 
19 ה ה והעבר definiteArticle unspecified unspecified unspecified unspecified unspecified 0 
19 העבר עבר והעבר noun masculine singular absolute unspecified unspecified  	O	null
20 לבין לבין לבין preposition unspecified unspecified unspecified unspecified unspecified  	O	null
21 ארצות ארץ ארצות noun feminine plural construct unspecified unspecified  	O	null
22 ה ה החום definiteArticle unspecified unspecified unspecified unspecified unspecified 0 
22 החום חום החום noun masculine singular absolute unspecified unspecified  	O	null
23 ו ו וההווה conjunction unspecified unspecified unspecified unspecified unspecified 0 
23 ה ה וההווה definiteArticle unspecified unspecified unspecified unspecified unspecified 0 
23 ההווה הווה וההווה noun masculine singular absolute unspecified unspecified  	O	null
24 . . . punctuation unspecified unspecified unspecified unspecified unspecified  	O	null

0 מופיעים הופיע מופיעים verb masculine plural unspecified any beinoni  	O	null
1 ב ב בו preposition unspecified unspecified unspecified unspecified unspecified  
1 ו ו בו pronomial masculine singular unspecified 3 unspecified 0 	O	null
2 מוטיבים מוטיב מוטיבים noun masculine plural absolute unspecified unspecified  	O	null
3 ש ש שיחזרו relativizer/subordinatingConjunction unspecified unspecified unspecified unspecified unspecified 0 
3 יחזרו חזר שיחזרו verb masculine-and-feminine plural unspecified 3 future  	O	null
4 גם גם גם conjunction unspecified unspecified unspecified unspecified unspecified  	O	null
5 ב ב בספריו preposition unspecified unspecified unspecified unspecified unspecified 0 
5 ספרי ספר בספריו noun masculine plural absolute unspecified unspecified  
5 ו ו בספריו possessive masculine singular unspecified 3 unspecified 0 	O	null
6 ה ה הבאים definiteArticle unspecified unspecified unspecified unspecified unspecified 0 
6 הבאים בא הבאים adjective masculine plural absolute unspecified unspecified  	O	null
7 : : : punctuation unspecified unspecified unspecified unspecified unspecified  	O	null
8 ה ה העץ definiteArticle unspecified unspecified unspecified unspecified unspecified 0 
8 העץ עץ העץ noun masculine singular absolute unspecified unspecified  	O	null
9 ו ו והציפור conjunction unspecified unspecified unspecified unspecified unspecified 0 
9 ה ה והציפור definiteArticle unspecified unspecified unspecified unspecified unspecified 0 
9 הציפור ציפור והציפור noun masculine singular absolute unspecified unspecified  	O	null
10 ; ; ; punctuation unspecified unspecified unspecified unspecified unspecified  	O	null
11 ה ה האקלים definiteArticle unspecified unspecified unspecified unspecified unspecified 0 
11 האקלים אקלים האקלים noun masculine singular absolute unspecified unspecified  	O	null
12 ה ה החם definiteArticle unspecified unspecified unspecified unspecified unspecified 0 
12 החם חם החם adjective masculine singular absolute unspecified unspecified  	O	null
13 של של של shel-preposition unspecified unspecified unspecified unspecified unspecified  	O	null
14 ארץ ארץ ארץ noun feminine singular construct unspecified unspecified  	I_LOC	null
15 ישראל ישראל ישראל properName unspecified unspecified unspecified unspecified unspecified  	I_LOC	null
16 ; ; ; punctuation unspecified unspecified unspecified unspecified unspecified  	O	null
17 ו ו ודמויות conjunction unspecified unspecified unspecified unspecified unspecified 0 
17 דמויות דמות ודמויות noun feminine plural construct unspecified unspecified  	O	null
18 ה ה האב definiteArticle unspecified unspecified unspecified unspecified unspecified 0 
18 האב אב האב noun masculine singular absolute unspecified unspecified  	O	null
19 , , , punctuation unspecified unspecified unspecified unspecified unspecified  	O	null
20 ה ה האם definiteArticle unspecified unspecified unspecified unspecified unspecified 0 
20 האם אם האם noun feminine singular absolute unspecified unspecified  	O	null
21 ו ו והסב conjunction unspecified unspecified unspecified unspecified unspecified 0 
21 ה ה והסב definiteArticle unspecified unspecified unspecified unspecified unspecified 0 
21 הסב סב והסב noun masculine singular absolute unspecified unspecified  	O	null
22 . . . punctuation unspecified unspecified unspecified unspecified unspecified  	O	null

0 ב ב בספרו preposition unspecified unspecified unspecified unspecified unspecified 0 
0 ספר ספר בספרו noun masculine singular absolute unspecified unspecified  
0 ו ו בספרו possessive masculine singular unspecified 3 unspecified 0 	O	null
1 ה ה השני definiteArticle unspecified unspecified unspecified unspecified unspecified 0 
1 השני ORD2 השני numeral masculine singular absolute unspecified unspecified  	O	null
2 , , , punctuation unspecified unspecified unspecified unspecified unspecified  	O	null
3 מעט מעט מעט adverb unspecified unspecified unspecified unspecified unspecified  	O	null
4 מ מ מזה preposition unspecified unspecified unspecified unspecified unspecified 0 
4 זה זה מזה pronoun masculine singular unspecified 3 unspecified  	O	null
5 ) ) ) punctuation unspecified unspecified unspecified unspecified unspecified  	O	null
6 , , , punctuation unspecified unspecified unspecified unspecified unspecified  	O	null
7 ###NUMBER### ###NUMBER### ###NUMBER### numeral unspecified unspecified unspecified unspecified unspecified  	I_DATE	null
8 יוצאת יצא יוצאת verb feminine singular unspecified any beinoni  	O	null
9 ציפור ציפור ציפור noun masculine singular construct unspecified unspecified  	O	null
10 ה ה הנפש definiteArticle unspecified unspecified unspecified unspecified unspecified 0 
10 הנפש נפש הנפש noun feminine singular absolute unspecified unspecified  	O	null
11 מ מ מסמליותה preposition unspecified unspecified unspecified unspecified unspecified 0 
11 סמליותה סמליותה מסמליותה noun masculine singular absolute unspecified unspecified  	O	null
12 ו ו ושבה conjunction unspecified unspecified unspecified unspecified unspecified 0 
12 שבה שב ושבה verb feminine singular unspecified 3 past  	O	null
13 ל ל לממשותה preposition unspecified unspecified unspecified unspecified unspecified 0 
13 ממשות ממשות לממשותה noun feminine singular absolute unspecified unspecified  
13 ה ה לממשותה possessive feminine singular unspecified 3 unspecified 0 	O	null
14 : : : punctuation unspecified unspecified unspecified unspecified unspecified  	O	null
15 ציפורי ציפור ציפורי noun masculine plural construct unspecified unspecified  	O	null
16 ה ה הארץ definiteArticle unspecified unspecified unspecified unspecified unspecified 0 
16 הארץ ארץ הארץ noun feminine singular absolute unspecified unspecified  	O	null
17 נצפות נצפה נצפות verb feminine plural unspecified any beinoni  	O	null
18 ב ב בסביבתן preposition unspecified unspecified unspecified unspecified unspecified 0 
18 סביבת סביבה בסביבתן noun feminine singular absolute unspecified unspecified  
18 ן ן בסביבתן possessive feminine plural unspecified 3 unspecified 0 	O	null
19 ה ה הטבעית definiteArticle unspecified unspecified unspecified unspecified unspecified 0 
19 הטבעית טבעי הטבעית adjective feminine singular absolute unspecified unspecified  	O	null
20 מעשה מעשה מעשה noun masculine singular construct unspecified unspecified  	O	null
21 צפר צפר צפר noun masculine singular absolute unspecified unspecified  	O	null
22 . . . punctuation unspecified unspecified unspecified unspecified unspecified  	O	null

0 ב ב במרכז preposition unspecified unspecified unspecified unspecified unspecified 0 
0 מרכז מרכז במרכז noun masculine singular construct unspecified unspecified  	O	null
1 ה ה הספר definiteArticle unspecified unspecified unspecified unspecified unspecified 0 
1 הספר ספר הספר noun masculine singular absolute unspecified unspecified  	O	null
2 פואמה פואמה פואמה noun feminine singular absolute unspecified unspecified  	O	null
3 אוטוביוגרפית אוטוביוגרפי אוטוביוגרפית adjective feminine singular absolute unspecified unspecified  	O	null
4 על על על preposition unspecified unspecified unspecified unspecified unspecified  	O	null
5 ה ה השנים definiteArticle unspecified unspecified unspecified unspecified unspecified 0 
5 השנים שנה השנים noun feminine plural absolute unspecified unspecified  	O	null
6 - - - punctuation unspecified unspecified unspecified unspecified unspecified  	O	null
7 ###NUMBER### ###NUMBER### ###NUMBER### numeral unspecified unspecified unspecified unspecified unspecified  	I_DATE	null
8 , , , punctuation unspecified unspecified unspecified unspecified unspecified  	O	null
9 ###NUMBER### ###NUMBER### ###NUMBER### numeral unspecified unspecified unspecified unspecified unspecified  	I_DATE	null
10 ש ש שתהיה relativizer/subordinatingConjunction unspecified unspecified unspecified unspecified unspecified 0 
10 תהיה תהייה שתהיה noun feminine singular absolute unspecified unspecified  	O	null
11 ל ל לגרעין preposition unspecified unspecified unspecified unspecified unspecified 0 
11 ה ה לגרעין definiteArticle unspecified unspecified unspecified unspecified unspecified 0 
11 הגרעין גרעין לגרעין noun masculine singular absolute unspecified unspecified  	O	null
12 שירתו שירת שירתו verb masculine-and-feminine plural unspecified 3 past  	O	null
13 ב ב בסוף preposition unspecified unspecified unspecified unspecified unspecified 0 
13 סוף סוף בסוף noun masculine singular construct unspecified unspecified  	O	null
14 ימי יום ימיו noun masculine plural absolute unspecified unspecified  
14 ו ו ימיו possessive masculine singular unspecified 3 unspecified 0 	O	null
15 . . . punctuation unspecified unspecified unspecified unspecified unspecified  	O	null

0 יפי יופי יפי noun masculine singular construct unspecified unspecified  	O	null
1 ה ה הארץ definiteArticle unspecified unspecified unspecified unspecified unspecified 0 
1 הארץ ארץ הארץ noun feminine singular absolute unspecified unspecified  	O	null
2 על על על preposition unspecified unspecified unspecified unspecified unspecified  	O	null
3 נופי נוף נופיה noun masculine plural absolute unspecified unspecified  
3 ה ה נופיה possessive feminine singular unspecified 3 unspecified 0 	O	null
4 ו ו וזיקתו conjunction unspecified unspecified unspecified unspecified unspecified 0 
4 זיקת זיקה וזיקתו noun feminine singular absolute unspecified unspecified  
4 ו ו וזיקתו possessive masculine singular unspecified 3 unspecified 0 	O	null
5 ל ל לשירה preposition unspecified unspecified unspecified unspecified unspecified 0 
5 ה ה לשירה definiteArticle unspecified unspecified unspecified unspecified unspecified 0 
5 השירה שירה לשירה noun feminine singular absolute unspecified unspecified  	O	null
6 ה ה העברית definiteArticle unspecified unspecified unspecified unspecified unspecified 0 
6 העברית עברי העברית adjective feminine singular absolute unspecified unspecified  	O	null
7 ל ל לדורותיה preposition unspecified unspecified unspecified unspecified unspecified 0 
7 דורותי דור לדורותיה noun masculine plural absolute unspecified unspecified  
7 ה ה לדורותיה possessive feminine singular unspecified 3 unspecified 0 	O	null
8 מזינים הזין מזינים verb masculine plural unspecified any beinoni  	O	null
9 את את את at-preposition unspecified unspecified unspecified unspecified unspecified  	O	null
10 ספר ספר ספרו noun masculine singular absolute unspecified unspecified  
10 ו ו ספרו possessive masculine singular unspecified 3 unspecified 0 	O	null
11 ה ה השלישי definiteArticle unspecified unspecified unspecified unspecified unspecified 0 
11 השלישי ORD3 השלישי numeral masculine singular absolute unspecified unspecified  	O	null
12 , , , punctuation unspecified unspecified unspecified unspecified unspecified  	O	null
13 כבר כבר כבר adverb unspecified unspecified unspecified unspecified unspecified  	O	null
14 אפשר אפשר אפשר modal unspecified unspecified unspecified unspecified unspecified  	O	null
15 לזוז זז לזוז verb unspecified unspecified unspecified unspecified infinitive  	O	null
16 ) ) ) punctuation unspecified unspecified unspecified unspecified unspecified  	O	null
17 . . . punctuation unspecified unspecified unspecified unspecified unspecified  	O	null
18 ###NUMBER### ###NUMBER### ###NUMBER### numeral unspecified unspecified unspecified unspecified unspecified  	I_DATE	null
19 ספר ספר ספרו noun masculine singular absolute unspecified unspecified  
19 ו ו ספרו possessive masculine singular unspecified 3 unspecified 0 	O	null
20 ה ה הרביעי definiteArticle unspecified unspecified unspecified unspecified unspecified 0 
20 הרביעי ORD4 הרביעי numeral masculine singular absolute unspecified unspecified  	O	null
21 , , , punctuation unspecified unspecified unspecified unspecified unspecified  	O	null
22 הפיך הפיך הפיך adjective masculine singular absolute unspecified unspecified  	O	null
23 ו ו ומרתק conjunction unspecified unspecified unspecified unspecified unspecified 0 
23 מרתק מרתק ומרתק adjective masculine singular absolute unspecified unspecified  	O	null
24 ) ) ) punctuation unspecified unspecified unspecified unspecified unspecified  	O	null
25 , , , punctuation unspecified unspecified unspecified unspecified unspecified  	O	null
26 ###NUMBER### ###NUMBER### ###NUMBER### numeral unspecified unspecified unspecified unspecified unspecified  	I_DATE	null
27 מתרכז התרכז מתרכז verb masculine singular unspecified any beinoni  	O	null
28 ב ב בחוויית preposition unspecified unspecified unspecified unspecified unspecified 0 
28 חוויית חוויה בחוויית noun feminine singular construct unspecified unspecified  	O	null
29 ה ה האבהות definiteArticle unspecified unspecified unspecified unspecified unspecified 0 
29 האבהות אבהות האבהות noun feminine singular absolute unspecified unspecified  	O	null
30 ה ה המתחדשת definiteArticle unspecified unspecified unspecified unspecified unspecified 0 
30 המתחדשת התחדש המתחדשת participle feminine singular absolute any unspecified  	O	null
31 ל ל לתאומיו preposition unspecified unspecified unspecified unspecified unspecified 0 
31 תאומי תאום לתאומיו noun masculine plural absolute unspecified unspecified  
31 ו ו לתאומיו possessive masculine singular unspecified 3 unspecified 0 	O	null
32 , , , punctuation unspecified unspecified unspecified unspecified unspecified  	O	null
33 ש ש שלשמע relativizer/subordinatingConjunction unspecified unspecified unspecified unspecified unspecified 0 
33 ל ל שלשמע preposition unspecified unspecified unspecified unspecified unspecified 0 
33 שמע שמע שלשמע noun masculine singular construct unspecified unspecified  	O	null
34 " " " punctuation unspecified unspecified unspecified unspecified unspecified  	O	null
35 נשימות נשימה נשימות noun feminine plural construct unspecified unspecified  	O	null
36 ה ה השלום definiteArticle unspecified unspecified unspecified unspecified unspecified 0 
36 השלום שלום השלום noun masculine singular absolute unspecified unspecified  	O	null
37 " " " punctuation unspecified unspecified unspecified unspecified unspecified  	O	null
38 של של שלהם shel-preposition unspecified unspecified unspecified unspecified unspecified  
38 הם הם שלהם pronomial masculine plural unspecified 3 unspecified 0 	O	null
39 כתב כתב כתב verb masculine singular unspecified 3 past  	O	null
40 : : : punctuation unspecified unspecified unspecified unspecified unspecified  	O	null
41 " " " punctuation unspecified unspecified unspecified unspecified unspecified  	O	null
42 הַמְצָאַת הַמְצָאַת הַמְצָאַת verb feminine singular unspecified 2 past  	O	null
43 הַדָּאדָא הַדָּאדָא הַדָּאדָא properName unspecified unspecified unspecified unspecified unspecified  	I_PERS	null
44 בְּפִיהֶם בְּפִיהֶם בְּפִיהֶם verb feminine singular unspecified 2 imperative  	O	null
45 " " " punctuation unspecified unspecified unspecified unspecified unspecified  	O	null
46 ( ( ( punctuation unspecified unspecified unspecified unspecified unspecified  	O	null
47 שם שם שם adverb unspecified unspecified unspecified unspecified unspecified  	O	null
48 , , , punctuation unspecified unspecified unspecified unspecified unspecified  	O	null
49 ###NUMBER### ###NUMBER### ###NUMBER### numeral unspecified unspecified unspecified unspecified unspecified  	O	null
50 ) ) ) punctuation unspecified unspecified unspecified unspecified unspecified  	O	null
51 . . . punctuation unspecified unspecified unspecified unspecified unspecified  	O	null

0 רצח רצח רצח noun masculine singular construct unspecified unspecified  	O	null
1 רבין רבין רבין properName unspecified unspecified unspecified unspecified unspecified  	I_PERS	null
2 מעמיד העמיד מעמיד verb masculine singular unspecified any beinoni  	O	null
3 את את את at-preposition unspecified unspecified unspecified unspecified unspecified  	O	null
4 ספר ספר ספר noun masculine singular construct unspecified unspecified  	O	null
5 שירי שיר שיריו noun masculine plural absolute unspecified unspecified  
5 ו ו שיריו possessive masculine singular unspecified 3 unspecified 0 	O	null
6 מפני מפני מפני preposition unspecified unspecified unspecified unspecified unspecified  	O	null
7 ה ה היום definiteArticle unspecified unspecified unspecified unspecified unspecified 0 
7 היום יום היום noun masculine singular absolute unspecified unspecified  	O	null
8 ה ה הזה definiteArticle unspecified unspecified unspecified unspecified unspecified 0 
8 הזה זה הזה pronoun masculine singular unspecified 3 unspecified  	O	null
9 ( ( ( punctuation unspecified unspecified unspecified unspecified unspecified  	O	null
10 ###NUMBER### ###NUMBER### ###NUMBER### numeral unspecified unspecified unspecified unspecified unspecified  	I_DATE	null
11 ) ) ) punctuation unspecified unspecified unspecified unspecified unspecified  	O	null
12 כ כ כקינה preposition unspecified unspecified unspecified unspecified unspecified 0 
12 קינה קינה כקינה noun feminine singular absolute unspecified unspecified  	O	null
13 לאומית לאומי לאומית adjective feminine singular absolute unspecified unspecified  	O	null
14 . . . punctuation unspecified unspecified unspecified unspecified unspecified  	O	null

0 זכרי זכר זכרי noun masculine plural construct unspecified unspecified  	O	null
1 לשון לשון לשון noun feminine singular absolute unspecified unspecified  	O	null
2 מן מן מן preposition unspecified unspecified unspecified unspecified unspecified  	O	null
3 ה ה המקרא definiteArticle unspecified unspecified unspecified unspecified unspecified 0 
3 המקרא מקרא המקרא noun masculine singular absolute unspecified unspecified  	O	null
4 מותכים הותך מותכים verb masculine plural unspecified any beinoni  	O	null
5 עם עם עם preposition unspecified unspecified unspecified unspecified unspecified  	O	null
6 לשון לשון לשונו noun feminine singular absolute unspecified unspecified  
6 ו ו לשונו possessive masculine singular unspecified 3 unspecified 0 	O	null
7 ה ה הפרטית definiteArticle unspecified unspecified unspecified unspecified unspecified 0 
7 הפרטית פרטי הפרטית adjective feminine singular absolute unspecified unspecified  	O	null
8 ב ב בספרו preposition unspecified unspecified unspecified unspecified unspecified 0 
8 ספר ספר בספרו noun masculine singular absolute unspecified unspecified  
8 ו ו בספרו possessive masculine singular unspecified 3 unspecified 0 	O	null
9 ה ה השישי definiteArticle unspecified unspecified unspecified unspecified unspecified 0 
9 השישי ORD6 השישי numeral masculine singular absolute unspecified unspecified  	O	null
10 , , , punctuation unspecified unspecified unspecified unspecified unspecified  	O	null
11 שם שם שם noun masculine singular construct unspecified unspecified  	O	null
12 ה ה המעשה definiteArticle unspecified unspecified unspecified unspecified unspecified 0 
12 המעשה מעשה המעשה noun masculine singular absolute unspecified unspecified  	O	null
13 ) ) ) punctuation unspecified unspecified unspecified unspecified unspecified  	O	null
14 . . . punctuation unspecified unspecified unspecified unspecified unspecified  	O	null
15 ###NUMBER### ###NUMBER### ###NUMBER### numeral unspecified unspecified unspecified unspecified unspecified  	I_DATE	null
16 גם גם גם adverb unspecified unspecified unspecified unspecified unspecified  	O	null
17 ב ב בספרו preposition unspecified unspecified unspecified unspecified unspecified 0 
17 ספר ספר בספרו noun masculine singular absolute unspecified unspecified  
17 ו ו בספרו possessive masculine singular unspecified 3 unspecified 0 	O	null
18 ה ה השביעי definiteArticle unspecified unspecified unspecified unspecified unspecified 0 
18 השביעי ORD7 השביעי numeral masculine singular absolute unspecified unspecified  	O	null
19 , , , punctuation unspecified unspecified unspecified unspecified unspecified  	O	null
20 תולעת תולעת תולעת noun feminine singular construct unspecified unspecified  	O	null
21 בת בת בת noun feminine singular construct unspecified unspecified  	O	null
22 מאה ORD-CARD100 מאה numeral feminine plural absolute unspecified unspecified  	O	null
23 שנה ישן שנה verb feminine plural unspecified 2 imperative  	O	null
24 ) ) ) punctuation unspecified unspecified unspecified unspecified unspecified  	O	null
25 , , , punctuation unspecified unspecified unspecified unspecified unspecified  	O	null
26 ###NUMBER### ###NUMBER### ###NUMBER### numeral unspecified unspecified unspecified unspecified unspecified  	I_DATE	null
27 ניצב ניצב ניצב verb masculine singular unspecified 3 past  	O	null
28 ה ה המשורר definiteArticle unspecified unspecified unspecified unspecified unspecified 0 
28 המשורר משורר המשורר noun masculine singular absolute unspecified unspecified  	O	null
29 כ כ כחוליה preposition unspecified unspecified unspecified unspecified unspecified 0 
29 ה ה כחוליה definiteArticle unspecified unspecified unspecified unspecified unspecified 0 
29 החוליה חוליה כחוליה noun feminine singular absolute unspecified unspecified  	O	null
30 ב ב בשלשלת preposition unspecified unspecified unspecified unspecified unspecified 0 
30 שלשלת שלשלת בשלשלת noun feminine singular absolute unspecified unspecified  	O	null
31 ארוכה ארוך ארוכה adjective feminine singular absolute unspecified unspecified  	O	null
32 של של של shel-preposition unspecified unspecified unspecified unspecified unspecified  	O	null
33 ה ה השירה definiteArticle unspecified unspecified unspecified unspecified unspecified 0 
33 השירה שירה השירה noun feminine singular absolute unspecified unspecified  	O	null
34 ה ה העברית definiteArticle unspecified unspecified unspecified unspecified unspecified 0 
34 העברית עברי העברית adjective feminine singular absolute unspecified unspecified  	O	null
35 , , , punctuation unspecified unspecified unspecified unspecified unspecified  	O	null
36 מ מ מניגוני preposition unspecified unspecified unspecified unspecified unspecified 0 
36 ניגוני ניגון מניגוני noun masculine plural construct unspecified unspecified  	O	null
37 בית בית בית properName unspecified unspecified unspecified unspecified unspecified  	I_ORG	null
38 אבא אבא אבא properName unspecified unspecified unspecified unspecified unspecified  	I_ORG	null
39 - - - properName unspecified unspecified unspecified unspecified unspecified  	I_ORG	null
40 אמא אמא אמא noun feminine singular absolute unspecified unspecified  	O	null
41 , , , punctuation unspecified unspecified unspecified unspecified unspecified  	O	null
42 דרך דרך דרך noun feminine singular construct unspecified unspecified  	O	null
43 פיוטי פיוט פיוטי noun masculine plural construct unspecified unspecified  	O	null
44 ה ה המחזור definiteArticle unspecified unspecified unspecified unspecified unspecified 0 
44 המחזור מחזור המחזור noun masculine singular absolute unspecified unspecified  	O	null
45 ל ל לימים preposition unspecified unspecified unspecified unspecified unspecified 0 
45 ה ה לימים definiteArticle unspecified unspecified unspecified unspecified unspecified 0 
45 הימים יום לימים noun masculine plural absolute unspecified unspecified  	O	null
46 ה ה הנוראים definiteArticle unspecified unspecified unspecified unspecified unspecified 0 
46 הנוראים נורא הנוראים adjective masculine plural absolute unspecified unspecified  	O	null
47 ו ו ועד conjunction unspecified unspecified unspecified unspecified unspecified 0 
47 עד עד ועד preposition unspecified unspecified unspecified unspecified unspecified  	O	null
48 ימין ימין ימינו noun masculine singular absolute unspecified unspecified  
48 ו ו ימינו possessive masculine singular unspecified 3 unspecified 0 	O	null
49 . . . punctuation unspecified unspecified unspecified unspecified unspecified  	O	null

0 ספר ספר ספרו noun masculine singular absolute unspecified unspecified  
0 ו ו ספרו possessive masculine singular unspecified 3 unspecified 0 	O	null
1 ה ה השמיני definiteArticle unspecified unspecified unspecified unspecified unspecified 0 
1 השמיני ORD8 השמיני numeral masculine singular absolute unspecified unspecified  	O	null
2 , , , punctuation unspecified unspecified unspecified unspecified unspecified  	O	null
3 בוז בוז בוז noun masculine singular absolute unspecified unspecified  	O	null
4 , , , punctuation unspecified unspecified unspecified unspecified unspecified  	O	null
5 לא לא לא negation unspecified unspecified unspecified unspecified unspecified  	O	null
6 טיח טיח טיח noun masculine singular absolute unspecified unspecified  	O	null
7 ) ) ) punctuation unspecified unspecified unspecified unspecified unspecified  	O	null
8 , , , punctuation unspecified unspecified unspecified unspecified unspecified  	O	null
9 ###NUMBER### ###NUMBER### ###NUMBER### numeral unspecified unspecified unspecified unspecified unspecified  	I_DATE	null
10 הוא הוא הוא pronoun masculine singular unspecified 3 unspecified  	O	null
11 ה ה האחרון definiteArticle unspecified unspecified unspecified unspecified unspecified 0 
11 האחרון אחרון האחרון adjective masculine singular absolute unspecified unspecified  	O	null
12 ש ש שראה relativizer/subordinatingConjunction unspecified unspecified unspecified unspecified unspecified 0 
12 ראה ראה שראה verb masculine singular unspecified 3 past  	O	null
13 אור אור אור noun masculine singular absolute unspecified unspecified  	O	null
14 ב ב בחייו preposition unspecified unspecified unspecified unspecified unspecified 0 
14 חיי חיים בחייו noun masculine plural absolute unspecified unspecified  
14 ו ו בחייו possessive masculine singular unspecified 3 unspecified 0 	O	null
15 . . . punctuation unspecified unspecified unspecified unspecified unspecified  	O	null

0 הוא הוא הוא pronoun masculine singular unspecified 3 unspecified  	O	null
1 מתפרש התפרש מתפרש verb masculine singular unspecified any beinoni  	O	null
2 על על על preposition unspecified unspecified unspecified unspecified unspecified  	O	null
3 פני פני פני noun masculine singular absolute unspecified unspecified  	O	null
4 חודשים חודש חודשים noun masculine plural absolute unspecified unspecified  	O	null
5 של של של shel-preposition unspecified unspecified unspecified unspecified unspecified  	O	null
6 אימה אימה אימה noun feminine singular absolute unspecified unspecified  	O	null
7 לקראת לקראת לקראת preposition unspecified unspecified unspecified unspecified unspecified  	O	null
8 מלחמת מלחמה מלחמת noun feminine singular construct unspecified unspecified  	O	null
9 ה ה המפרץ definiteArticle unspecified unspecified unspecified unspecified unspecified 0 
9 המפרץ מפרץ המפרץ noun masculine singular absolute unspecified unspecified  	I_LOC	null
10 ה ה השנייה definiteArticle unspecified unspecified unspecified unspecified unspecified 0 
10 השנייה ORD2 השנייה numeral feminine singular absolute unspecified unspecified  	O	null
11 ו ו ובמהלכה conjunction unspecified unspecified unspecified unspecified unspecified 0 
11 ב ב ובמהלכה preposition unspecified unspecified unspecified unspecified unspecified 0 
11 מהלך מהלך ובמהלכה noun masculine singular absolute unspecified unspecified  
11 ה ה ובמהלכה possessive feminine singular unspecified 3 unspecified 0 	O	null
12 . . . punctuation unspecified unspecified unspecified unspecified unspecified  	O	null

0 שירת שירה שירת noun feminine singular construct unspecified unspecified  	O	null
1 חיי חיים חייו noun masculine plural absolute unspecified unspecified  
1 ו ו חייו possessive masculine singular unspecified 3 unspecified 0 	O	null
2 מסתכמת הסתכם מסתכמת verb feminine singular unspecified any beinoni  	O	null
3 ב ב במחזור preposition unspecified unspecified unspecified unspecified unspecified 0 
3 מחזור מחזור במחזור noun masculine singular absolute unspecified unspecified  	O	null
4 אוטוביוגרפי אוטוביוגרפי אוטוביוגרפי adjective masculine singular absolute unspecified unspecified  	O	null
5 שבו ישב שבו verb masculine-and-feminine plural unspecified 2 imperative  	O	null
6 גובר גבר גובר verb masculine singular unspecified any beinoni  	O	null
7 ה ה האידילי definiteArticle unspecified unspecified unspecified unspecified unspecified 0 
7 האידילי האידילי האידילי noun masculine singular absolute unspecified unspecified  	O	null
8 על על על preposition unspecified unspecified unspecified unspecified unspecified  	O	null
9 ה ה הטרגי definiteArticle unspecified unspecified unspecified unspecified unspecified 0 
9 הטרגי טרגי הטרגי adjective masculine singular absolute unspecified unspecified  	O	null
10 , , , punctuation unspecified unspecified unspecified unspecified unspecified  	O	null
11 זמן זמן זמן noun masculine singular absolute unspecified unspecified  	O	null
12 בולע בלע בולע verb masculine singular unspecified any beinoni  	O	null
13 את את את at-preposition unspecified unspecified unspecified unspecified unspecified  	O	null
14 עצמו עצמו עצמו pronoun unspecified unspecified unspecified unspecified unspecified  
14 ו ו עצמו pronomial masculine singular unspecified 3 unspecified 0 	O	null
15 ) ) ) punctuation unspecified unspecified unspecified unspecified unspecified  	O	null
16 , , , punctuation unspecified unspecified unspecified unspecified unspecified  	O	null
17 ###NUMBER### ###NUMBER### ###NUMBER### numeral unspecified unspecified unspecified unspecified unspecified  	I_DATE	null
18 ש ש שראה relativizer/subordinatingConjunction unspecified unspecified unspecified unspecified unspecified 0 
18 ראה ראה שראה verb masculine singular unspecified 3 past  	O	null
19 אור אור אור noun masculine singular absolute unspecified unspecified  	O	null
20 לאחר לאחר לאחר preposition unspecified unspecified unspecified unspecified unspecified  	O	null
21 מות מוות מותו noun masculine singular absolute unspecified unspecified  
21 ו ו מותו possessive masculine singular unspecified 3 unspecified 0 	O	null
22 . . . punctuation unspecified unspecified unspecified unspecified unspecified  	O	null

0 ב ב במחזור preposition unspecified unspecified unspecified unspecified unspecified 0 
0 מחזור מחזור במחזור noun masculine singular construct unspecified unspecified  	O	null
1 שירים שיר שירים noun masculine plural absolute unspecified unspecified  	O	null
2 זה זה זה pronoun masculine singular unspecified 3 unspecified  	O	null
3 הפליג הפליג הפליג verb masculine singular unspecified 3 past  	O	null
4 אל אל אל preposition unspecified unspecified unspecified unspecified unspecified  	O	null
5 ילדות ילדות ילדותו noun feminine singular absolute unspecified unspecified  
5 ו ו ילדותו possessive masculine singular unspecified 3 unspecified 0 	O	null
6 ב ב במסע preposition unspecified unspecified unspecified unspecified unspecified 0 
6 מסע מסע במסע noun masculine singular construct unspecified unspecified  	O	null
7 זיכרונות זיכרון זיכרונות noun masculine plural absolute unspecified unspecified  	O	null
8 ו ו ובמסת conjunction unspecified unspecified unspecified unspecified unspecified 0 
8 ב ב ובמסת preposition unspecified unspecified unspecified unspecified unspecified 0 
8 מסת מסה ובמסת noun feminine singular construct unspecified unspecified  	O	null
9 סיכום סיכום סיכום noun masculine singular absolute unspecified unspecified  	O	null
10 על על על preposition unspecified unspecified unspecified unspecified unspecified  	O	null
11 ה ה הסוסים definiteArticle unspecified unspecified unspecified unspecified unspecified 0 
11 הסוסים סוס הסוסים noun masculine plural absolute unspecified unspecified  	O	null
12 ש ש שמשכו relativizer/subordinatingConjunction unspecified unspecified unspecified unspecified unspecified 0 
12 משכו משך שמשכו verb masculine-and-feminine plural unspecified 3 past  	O	null
13 את את את at-preposition unspecified unspecified unspecified unspecified unspecified  	O	null
14 עגלת עגלה עגלת noun feminine singular construct unspecified unspecified  	O	null
15 חיי חיים חייו noun masculine plural absolute unspecified unspecified  
15 ו ו חייו possessive masculine singular unspecified 3 unspecified 0 	O	null
16 , , , punctuation unspecified unspecified unspecified unspecified unspecified  	O	null
17 כש כש כשהוא temporalSubConj unspecified unspecified unspecified unspecified unspecified 0 
17 הוא הוא כשהוא pronoun masculine singular unspecified 3 unspecified  	O	null
18 מזהה זיהה מזהה verb masculine singular unspecified any beinoni  	O	null
19 את את את at-preposition unspecified unspecified unspecified unspecified unspecified  	O	null
20 מסתורין מסתורין מסתורין noun masculine singular construct unspecified unspecified  	O	null
21 ה ה הסוס definiteArticle unspecified unspecified unspecified unspecified unspecified 0 
21 הסוס סוס הסוס noun masculine singular absolute unspecified unspecified  	O	null
22 עם עם עם preposition unspecified unspecified unspecified unspecified unspecified  	O	null
23 פלא פלא פלא noun masculine singular construct unspecified unspecified  	O	null
24 ה ה השירה definiteArticle unspecified unspecified unspecified unspecified unspecified 0 
24 השירה שירה השירה noun feminine singular absolute unspecified unspecified  	O	null
25 ו ו ואת conjunction unspecified unspecified unspecified unspecified unspecified 0 
25 את את ואת at-preposition unspecified unspecified unspecified unspecified unspecified  	O	null
26 סוסי סוס סוסי noun masculine plural construct unspecified unspecified  	O	null
27 ה ה הממש definiteArticle unspecified unspecified unspecified unspecified unspecified 0 
27 הממש ממש הממש noun masculine singular absolute unspecified unspecified  	O	null
28 עם עם עם preposition unspecified unspecified unspecified unspecified unspecified  	O	null
29 תולדות תולדה תולדות noun feminine plural construct unspecified unspecified  	O	null
30 חיי חיים חייו noun masculine plural absolute unspecified unspecified  
30 ו ו חייו possessive masculine singular unspecified 3 unspecified 0 	O	null
31 . . . punctuation unspecified unspecified unspecified unspecified unspecified  	O	null

0 מבחר מבחר מבחר quantifier unspecified unspecified construct unspecified unspecified  	O	null
1 מ מ משיריו preposition unspecified unspecified unspecified unspecified unspecified 0 
1 שירי שיר משיריו noun masculine plural absolute unspecified unspecified  
1 ו ו משיריו possessive masculine singular unspecified 3 unspecified 0 	O	null
2 פורסם פורסם פורסם verb masculine singular unspecified 3 past  	O	null
3 ב ב בספר preposition unspecified unspecified unspecified unspecified unspecified 0 
3 ספר ספר בספר noun masculine singular construct unspecified unspecified  	O	null
4 שעה שעה שעה noun feminine singular absolute unspecified unspecified  	O	null
5 אחת CARD1 אחת numeral feminine singular absolute unspecified unspecified  	O	null
6 של של של shel-preposition unspecified unspecified unspecified unspecified unspecified  	O	null
7 שמש שמש שמש properName unspecified unspecified unspecified unspecified unspecified  	I_PERS	null
8 ) ) ) punctuation unspecified unspecified unspecified unspecified unspecified  	O	null
9 . . . punctuation unspecified unspecified unspecified unspecified unspecified  	O	null
10 ###NUMBER### ###NUMBER### ###NUMBER### numeral unspecified unspecified unspecified unspecified unspecified  	I_DATE	null
11 זכה זכה זכה verb masculine singular unspecified 2 imperative  	O	null
12 ב ב בפרס preposition unspecified unspecified unspecified unspecified unspecified 0 
12 פרס פרס בפרס noun masculine singular construct unspecified unspecified  	O	null
13 ה ה היצירה definiteArticle unspecified unspecified unspecified unspecified unspecified 0 
13 היצירה יצירה היצירה noun feminine singular absolute unspecified unspecified  	O	null
14 על על על preposition unspecified unspecified unspecified unspecified unspecified  	O	null
15 שם שם שם noun masculine singular construct unspecified unspecified  	O	null
16 ראש ראש ראש noun masculine singular construct unspecified unspecified  	O	null
17 ה ה הממשלה definiteArticle unspecified unspecified unspecified unspecified unspecified 0 
17 הממשלה ממשלה הממשלה noun feminine singular absolute unspecified unspecified  	O	null
18 לוי לוי לוי properName unspecified unspecified unspecified unspecified unspecified  	I_PERS	null
19 אשכול אשכול אשכול properName unspecified unspecified unspecified unspecified unspecified  	I_PERS	null
20 ( ( ( punctuation unspecified unspecified unspecified unspecified unspecified  	O	null
21 ###NUMBER### ###NUMBER### ###NUMBER### numeral unspecified unspecified unspecified unspecified unspecified  	I_DATE	null
22 ) ) ) punctuation unspecified unspecified unspecified unspecified unspecified  	O	null
23 ו ו ובפרס conjunction unspecified unspecified unspecified unspecified unspecified 0 
23 ב ב ובפרס preposition unspecified unspecified unspecified unspecified unspecified 0 
23 פרס פרס ובפרס noun masculine singular construct unspecified unspecified  	O	null
24 אקו"ם אקו"ם אקו"ם properName unspecified unspecified unspecified unspecified unspecified  	I_ORG	null
25 ) ) ) punctuation unspecified unspecified unspecified unspecified unspecified  	O	null
26 . . . punctuation unspecified unspecified unspecified unspecified unspecified  	O	null
27 ###NUMBER### ###NUMBER### ###NUMBER### numeral unspecified unspecified unspecified unspecified unspecified  	I_DATE	null
28 References References References foreign unspecified unspecified unspecified unspecified unspecified  	O	null
29 : : : punctuation unspecified unspecified unspecified unspecified unspecified  	O	null
30 אלקד אלקד אלקד properName unspecified unspecified unspecified unspecified unspecified  	I_ORG	null
31 - - - punctuation unspecified unspecified unspecified unspecified unspecified  	O	null
32 להמן להמן להמן properName unspecified unspecified unspecified unspecified unspecified  	I_PERS	null
33 , , , punctuation unspecified unspecified unspecified unspecified unspecified  	O	null
34 אילנה אילנה אילנה properName unspecified unspecified unspecified unspecified unspecified  	I_PERS	null
35 . . . punctuation unspecified unspecified unspecified unspecified unspecified  	O	null

0 " " " punctuation unspecified unspecified unspecified unspecified unspecified  	O	null
1 תנופת תנופה תנופת noun feminine singular construct unspecified unspecified  	O	null
2 ימים יום ימים noun masculine plural absolute unspecified unspecified  	O	null
3 יפים יפה יפים adjective masculine plural absolute unspecified unspecified  	O	null
4 " " " punctuation unspecified unspecified unspecified unspecified unspecified  	O	null
5 . . . punctuation unspecified unspecified unspecified unspecified unspecified  	O	null

0 מאזניים מאזניים מאזניים noun masculine plural absolute unspecified unspecified  	O	null
1 ס"ה ס"ה ס"ה noun masculine singular absolute unspecified unspecified  	O	null
2 - - - punctuation unspecified unspecified unspecified unspecified unspecified  	O	null
3 ###NUMBER### ###NUMBER### ###NUMBER### numeral unspecified unspecified unspecified unspecified unspecified  	O	null
4 ) ) ) punctuation unspecified unspecified unspecified unspecified unspecified  	O	null
5 . . . punctuation unspecified unspecified unspecified unspecified unspecified  	O	null

0 ###NUMBER### ###NUMBER### ###NUMBER### numeral unspecified unspecified unspecified unspecified unspecified  	O	null
1 ###NUMBER### ###NUMBER### ###NUMBER### numeral unspecified unspecified unspecified unspecified unspecified  	I_DATE	null
2 . . . punctuation unspecified unspecified unspecified unspecified unspecified  	O	null

0 - - - punctuation unspecified unspecified unspecified unspecified unspecified  	O	null
1 ###NUMBER### ###NUMBER### ###NUMBER### numeral unspecified unspecified unspecified unspecified unspecified  	O	null
2 ; ; ; punctuation unspecified unspecified unspecified unspecified unspecified  	O	null
3 ###NUMBER### ###NUMBER### ###NUMBER### numeral unspecified unspecified unspecified unspecified unspecified  	O	null
4 ב ב בן preposition unspecified unspecified unspecified unspecified unspecified  
4 הן הן בן pronomial feminine plural unspecified 3 unspecified 0 	O	null
5 - - - properName unspecified unspecified unspecified unspecified unspecified  	I_ORG	null
6 דוד דוד דוד properName unspecified unspecified unspecified unspecified unspecified  	I_ORG	null
7 , , , punctuation unspecified unspecified unspecified unspecified unspecified  	O	null
8 יערה יערה יערה properName unspecified unspecified unspecified unspecified unspecified  	I_PERS	null
9 . . . punctuation unspecified unspecified unspecified unspecified unspecified  	O	null

0 " " " punctuation unspecified unspecified unspecified unspecified unspecified  	O	null
1 כותב כתב כותב verb masculine singular unspecified any beinoni  	O	null
2 את את את at-preposition unspecified unspecified unspecified unspecified unspecified  	O	null
3 נפש נפש נפשו noun feminine singular absolute unspecified unspecified  
3 ו ו נפשו possessive masculine singular unspecified 3 unspecified 0 	O	null
4 דדלוס דדלוס דדלוס properName unspecified unspecified unspecified unspecified unspecified  	I_ORG	null
5 ציפור ציפור ציפור noun masculine singular absolute unspecified unspecified  	O	null
6 " " " punctuation unspecified unspecified unspecified unspecified unspecified  	O	null
7 . . . punctuation unspecified unspecified unspecified unspecified unspecified  	O	null

0 עתון עיתון עתון noun masculine singular construct unspecified unspecified  	O	null
1 ###NUMBER### ###NUMBER### ###NUMBER### numeral unspecified unspecified unspecified unspecified unspecified  	O	null
2 ###NUMBER### ###NUMBER### ###NUMBER### numeral unspecified unspecified unspecified unspecified unspecified  	O	null
3 . . . punctuation unspecified unspecified unspecified unspecified unspecified  	O	null

0 אוגוסט אוגוסט אוגוסט properName unspecified unspecified unspecified unspecified unspecified  	I_DATE	null
1 ###NUMBER### ###NUMBER### ###NUMBER### numeral unspecified unspecified unspecified unspecified unspecified  	I_DATE	null
2 . . . punctuation unspecified unspecified unspecified unspecified unspecified  	O	null

0 - - - punctuation unspecified unspecified unspecified unspecified unspecified  	O	null
1 ###NUMBER### ###NUMBER### ###NUMBER### numeral unspecified unspecified unspecified unspecified unspecified  	O	null
2 ; ; ; punctuation unspecified unspecified unspecified unspecified unspecified  	O	null
3 ###NUMBER### ###NUMBER### ###NUMBER### numeral unspecified unspecified unspecified unspecified unspecified  	O	null
4 וייכרט וייכרט וייכרט properName unspecified unspecified unspecified unspecified unspecified  	O	null
5 , , , punctuation unspecified unspecified unspecified unspecified unspecified  	O	null
6 רפי רפי רפי properName unspecified unspecified unspecified unspecified unspecified  	I_PERS	null
7 . . . punctuation unspecified unspecified unspecified unspecified unspecified  	O	null

0 " " " punctuation unspecified unspecified unspecified unspecified unspecified  	O	null
1 בלתי בלתי בלתי wPrefix unspecified unspecified unspecified unspecified unspecified  	O	null
2 הפיך הפיך הפיך adjective masculine singular absolute unspecified unspecified  	O	null
3 ו ו ומרתק conjunction unspecified unspecified unspecified unspecified unspecified 0 
3 מרתק מרתק ומרתק adjective masculine singular absolute unspecified unspecified  	O	null
4 " " " punctuation unspecified unspecified unspecified unspecified unspecified  	O	null
5 . . . punctuation unspecified unspecified unspecified unspecified unspecified  	O	null

0 עכשיו עכשיו עכשיו adverb unspecified unspecified unspecified unspecified unspecified  	O	null
1 ###NUMBER### ###NUMBER### ###NUMBER### numeral unspecified unspecified unspecified unspecified unspecified  	O	null
2 . . . punctuation unspecified unspecified unspecified unspecified unspecified  	O	null

0 ###NUMBER### ###NUMBER### ###NUMBER### numeral unspecified unspecified unspecified unspecified unspecified  	I_DATE	null
1 . . . punctuation unspecified unspecified unspecified unspecified unspecified  	O	null

0 - - - punctuation unspecified unspecified unspecified unspecified unspecified  	O	null
1 ###NUMBER### ###NUMBER### ###NUMBER### numeral unspecified unspecified unspecified unspecified unspecified  	O	null
2 ; ; ; punctuation unspecified unspecified unspecified unspecified unspecified  	O	null
3 ###NUMBER### ###NUMBER### ###NUMBER### numeral unspecified unspecified unspecified unspecified unspecified  	O	null
4 פרנקל פרנקל פרנקל properName unspecified unspecified unspecified unspecified unspecified  	I_LOC	null
5 - - - punctuation unspecified unspecified unspecified unspecified unspecified  	O	null
6 מ מ מדן preposition unspecified unspecified unspecified unspecified unspecified 0 
6 דן דן מדן properName unspecified unspecified unspecified unspecified unspecified  	I_ORG	null
7 , , , punctuation unspecified unspecified unspecified unspecified unspecified  	O	null
8 רחל רחל רחל properName unspecified unspecified unspecified unspecified unspecified  	I_PERS	null
9 . . . punctuation unspecified unspecified unspecified unspecified unspecified  	O	null

0 " " " punctuation unspecified unspecified unspecified unspecified unspecified  	O	null
1 ב ב בדרכי preposition unspecified unspecified unspecified unspecified unspecified 0 
1 דרכי דרך בדרכי noun feminine plural construct unspecified unspecified  	O	null
2 ה ה השיר definiteArticle unspecified unspecified unspecified unspecified unspecified 0 
2 השיר שיר השיר noun masculine singular absolute unspecified unspecified  	O	null
3 של של של shel-preposition unspecified unspecified unspecified unspecified unspecified  	O	null
4 עזריאל עזריאל עזריאל properName unspecified unspecified unspecified unspecified unspecified  	I_PERS	null
5 קאופמן קאופמן קאופמן properName unspecified unspecified unspecified unspecified unspecified  	I_PERS	null
6 " " " punctuation unspecified unspecified unspecified unspecified unspecified  	O	null
7 . . . punctuation unspecified unspecified unspecified unspecified unspecified  	O	null

0 שעה שעה שעה noun feminine singular absolute unspecified unspecified  	O	null
1 אחת CARD1 אחת numeral feminine singular absolute unspecified unspecified  	O	null
2 של של של shel-preposition unspecified unspecified unspecified unspecified unspecified  	I_DATE	null
3 שמש שמש שמש properName unspecified unspecified unspecified unspecified unspecified  	I_PERS	null
4 , , , punctuation unspecified unspecified unspecified unspecified unspecified  	O	null
5 מבחר מבחר מבחר quantifier unspecified unspecified construct unspecified unspecified  	O	null
6 שירים שיר שירים noun masculine plural absolute unspecified unspecified  	O	null
7 ###NUMBER### ###NUMBER### ###NUMBER### numeral unspecified unspecified unspecified unspecified unspecified  	I_DATE	null
8 - - - punctuation unspecified unspecified unspecified unspecified unspecified  	O	null
9 ###NUMBER### ###NUMBER### ###NUMBER### numeral unspecified unspecified unspecified unspecified unspecified  	I_DATE	null
10 . . . punctuation unspecified unspecified unspecified unspecified unspecified  	O	null

0 תלאביב תלאביב תלאביב properName unspecified unspecified unspecified unspecified unspecified  	I_PERS	null
1 : : : punctuation unspecified unspecified unspecified unspecified unspecified  	O	null
2 קשב קשב קשב noun masculine singular absolute unspecified unspecified  	O	null
3 ל ל לשירה preposition unspecified unspecified unspecified unspecified unspecified 0 
3 ה ה לשירה definiteArticle unspecified unspecified unspecified unspecified unspecified 0 
3 השירה שירה לשירה noun feminine singular absolute unspecified unspecified  	O	null
4 . . . punctuation unspecified unspecified unspecified unspecified unspecified  	O	null

0 ###NUMBER### ###NUMBER### ###NUMBER### numeral unspecified unspecified unspecified unspecified unspecified  	O	null
1 - - - punctuation unspecified unspecified unspecified unspecified unspecified  	O	null
2 ###NUMBER### ###NUMBER### ###NUMBER### numeral unspecified unspecified unspecified unspecified unspecified  	O	null
3 . . . punctuation unspecified unspecified unspecified unspecified unspecified  	O	null

