0 Name Name Name foreign unspecified unspecified unspecified unspecified unspecified  	O	null
1 : : : punctuation unspecified unspecified unspecified unspecified unspecified  	O	null
2 קופמן קופמן קופמן properName unspecified unspecified unspecified unspecified unspecified  	I_PERS	null
3 , , , punctuation unspecified unspecified unspecified unspecified unspecified  	O	null
4 רנה רנה רנה properName unspecified unspecified unspecified unspecified unspecified  	I_DATE	null
5 ל ל לי preposition unspecified unspecified unspecified unspecified unspecified  
5 י י לי pronomial masculine-and-feminine singular unspecified 1 unspecified 0 	O	null
6 Birth Birth Birth foreign unspecified unspecified unspecified unspecified unspecified  	O	null
7 Year Year Year foreign unspecified unspecified unspecified unspecified unspecified  	O	null
8 : : : punctuation unspecified unspecified unspecified unspecified unspecified  	O	null
9 ###NUMBER### ###NUMBER### ###NUMBER### numeral unspecified unspecified unspecified unspecified unspecified  	I_DATE	null
10 Birth Birth Birth foreign unspecified unspecified unspecified unspecified unspecified  	O	null
11 Place Place Place foreign unspecified unspecified unspecified unspecified unspecified  	O	null
12 : : : punctuation unspecified unspecified unspecified unspecified unspecified  	O	null
13 פולין פולין פולין properName unspecified unspecified unspecified unspecified unspecified  	I_LOC	null
14 ו ו וגדלה conjunction unspecified unspecified unspecified unspecified unspecified 0 
14 גדלה גדל וגדלה verb feminine singular unspecified 3 past  	O	null
15 ב ב בתל preposition unspecified unspecified unspecified unspecified unspecified 0 
15 תל תל בתל properName unspecified unspecified unspecified unspecified unspecified  	O	null
16 Occupation Occupation Occupation foreign unspecified unspecified unspecified unspecified unspecified  	O	null
17 : : : punctuation unspecified unspecified unspecified unspecified unspecified  	O	null
18 משוררת משורר משוררת noun feminine singular absolute unspecified unspecified  	O	null
19 , , , punctuation unspecified unspecified unspecified unspecified unspecified  	O	null
20 סופרת סופר סופרת noun feminine singular absolute unspecified unspecified  	O	null
21 ו ו וחוקרת conjunction unspecified unspecified unspecified unspecified unspecified 0 
21 חוקרת חקר וחוקרת verb feminine singular unspecified any beinoni  	O	null
22 Entry Entry Entry foreign unspecified unspecified unspecified unspecified unspecified  	O	null
23 writer writer writer foreign unspecified unspecified unspecified unspecified unspecified  	O	null
24 : : : punctuation unspecified unspecified unspecified unspecified unspecified  	O	null
25 בתי בית בתיה noun masculine plural absolute unspecified unspecified  
25 ה ה בתיה possessive feminine singular unspecified 3 unspecified 0 	O	null
26 ש ש שמעוני relativizer/subordinatingConjunction unspecified unspecified unspecified unspecified unspecified 0 
26 מ מ שמעוני preposition unspecified unspecified unspecified unspecified unspecified 0 
26 עוני עוני שמעוני noun masculine singular absolute unspecified unspecified  	O	null
27 Entry Entry Entry foreign unspecified unspecified unspecified unspecified unspecified  	O	null
28 Value Value Value foreign unspecified unspecified unspecified unspecified unspecified  	O	null
29 : : : punctuation unspecified unspecified unspecified unspecified unspecified  	O	null
30 נולדה נולד נולדה verb feminine singular unspecified 3 past  	O	null
31 ב ב בפולין preposition unspecified unspecified unspecified unspecified unspecified 0 
31 פולין פולין בפולין properName unspecified unspecified unspecified unspecified unspecified  	I_LOC	null
32 ו ו וגדלה conjunction unspecified unspecified unspecified unspecified unspecified 0 
32 גדלה גדל וגדלה verb feminine singular unspecified 3 past  	O	null
33 ב ב בתל preposition unspecified unspecified unspecified unspecified unspecified 0 
33 תל תל בתל properName unspecified unspecified unspecified unspecified unspecified  	I_LOC	null
34 אביב אביב אביב properName unspecified unspecified unspecified unspecified unspecified  	I_LOC	null
35 . . . punctuation unspecified unspecified unspecified unspecified unspecified  	O	null

0 שם שם שמה noun masculine singular absolute unspecified unspecified  
0 ה ה שמה possessive feminine singular unspecified 3 unspecified 0 	O	null
1 ה ה הספרותי definiteArticle unspecified unspecified unspecified unspecified unspecified 0 
1 הספרותי ספרותי הספרותי adjective masculine singular absolute unspecified unspecified  	O	null
2 הוא הוא הוא pronoun masculine singular unspecified 3 unspecified  	O	null
3 רנה רן רנה verb feminine singular unspecified 3 past  	O	null
4 ל ל לי preposition unspecified unspecified unspecified unspecified unspecified  
4 י י לי pronomial masculine-and-feminine singular unspecified 1 unspecified 0 	O	null
5 . . . punctuation unspecified unspecified unspecified unspecified unspecified  	O	null

0 בעלת בעל בעלת noun feminine singular construct unspecified unspecified  	O	null
1 תואר תואר תואר noun masculine singular absolute unspecified unspecified  	O	null
2 מוסמך הוסמך מוסמך verb masculine singular unspecified any beinoni  	O	null
3 ל ל למשפטים preposition unspecified unspecified unspecified unspecified unspecified 0 
3 ה ה למשפטים definiteArticle unspecified unspecified unspecified unspecified unspecified 0 
3 המשפטים משפט למשפטים noun masculine plural absolute unspecified unspecified  	O	null
4 מ מ מהאוניברסיטה preposition unspecified unspecified unspecified unspecified unspecified 0 
4 ה ה מהאוניברסיטה definiteArticle unspecified unspecified unspecified unspecified unspecified 0 
4 האוניברסיטה אוניברסיטה מהאוניברסיטה noun feminine singular absolute unspecified unspecified  	I_ORG	null
5 ה ה העברית definiteArticle unspecified unspecified unspecified unspecified unspecified 0 
5 העברית עברי העברית adjective feminine singular absolute unspecified unspecified  	I_ORG	null
6 ב ב בירושלים preposition unspecified unspecified unspecified unspecified unspecified 0 
6 ירושלים ירושלים בירושלים properName unspecified unspecified unspecified unspecified unspecified  	I_LOC	null
7 . . . punctuation unspecified unspecified unspecified unspecified unspecified  	O	null

0 חיה חי חיה verb feminine singular unspecified 3 past  	O	null
1 שנים שנה שנים noun feminine plural absolute unspecified unspecified  	O	null
2 אחדות אחדים אחדות adjective feminine plural absolute unspecified unspecified  	O	null
3 ב ב באפריקה preposition unspecified unspecified unspecified unspecified unspecified 0 
3 אפריקה אפריקה באפריקה properName unspecified unspecified unspecified unspecified unspecified  	I_LOC	null
4 ב ב במסגרת preposition unspecified unspecified unspecified unspecified unspecified 0 
4 מסגרת מסגרת במסגרת noun feminine singular construct unspecified unspecified  	O	null
5 עבודת עבודה עבודתו noun feminine singular absolute unspecified unspecified  
5 ו ו עבודתו possessive masculine singular unspecified 3 unspecified 0 	O	null
6 של של של shel-preposition unspecified unspecified unspecified unspecified unspecified  	O	null
7 בעלה בעל בעלה noun feminine singular absolute unspecified unspecified  	O	null
8 כ כ כמהנדס preposition unspecified unspecified unspecified unspecified unspecified 0 
8 ה ה כמהנדס definiteArticle unspecified unspecified unspecified unspecified unspecified 0 
8 המהנדס מהנדס כמהנדס noun masculine singular absolute unspecified unspecified  	O	null
9 , , , punctuation unspecified unspecified unspecified unspecified unspecified  	O	null
10 ו ו ולאחר conjunction unspecified unspecified unspecified unspecified unspecified 0 
10 לאחר לאחר ולאחר conjunction unspecified unspecified unspecified unspecified unspecified  	O	null
11 מכן מיכן מכן verb masculine singular unspecified 2 imperative  	O	null
12 השתקעה השתקע השתקעה verb feminine singular unspecified 3 past  	O	null
13 ה ה המשפחה definiteArticle unspecified unspecified unspecified unspecified unspecified 0 
13 המשפחה משפחה המשפחה noun feminine singular absolute unspecified unspecified  	O	null
14 ב ב בארצות preposition unspecified unspecified unspecified unspecified unspecified 0 
14 ארצות ארץ בארצות properName unspecified unspecified unspecified unspecified unspecified  	I_LOC	null
15 הברית ברית הברית properName unspecified unspecified unspecified unspecified unspecified  	I_LOC	null
16 , , , punctuation unspecified unspecified unspecified unspecified unspecified  	O	null
17 שם שם שם adverb unspecified unspecified unspecified unspecified unspecified  	O	null
18 השלימה השלים השלימה verb feminine singular unspecified 3 past  	O	null
19 דוקטורט דוקטורט דוקטורט noun masculine singular absolute unspecified unspecified  	O	null
20 ב ב בספרות preposition unspecified unspecified unspecified unspecified unspecified 0 
20 ספרות ספרות בספרות noun feminine singular absolute unspecified unspecified  	O	null
21 עברית עברי עברית adjective feminine singular absolute unspecified unspecified  	O	null
22 . . . punctuation unspecified unspecified unspecified unspecified unspecified  	O	null

0 לאחר לאחר לאחר preposition unspecified unspecified unspecified unspecified unspecified  	O	null
1 שנות שנה שנות noun feminine plural construct unspecified unspecified  	O	null
2 הוראה הוראה הוראה noun feminine singular absolute unspecified unspecified  	O	null
3 רבות רב רבות adjective feminine plural absolute unspecified unspecified  	O	null
4 כ כ כפרופסור preposition unspecified unspecified unspecified unspecified unspecified 0 
4 פרופסור פרופסור כפרופסור noun masculine singular absolute unspecified unspecified  	O	null
5 ל ל לעברית preposition unspecified unspecified unspecified unspecified unspecified 0 
5 עברית עברית לעברית properName feminine singular unspecified unspecified unspecified  	I_LOC	null
6 ב ב בקווינס preposition unspecified unspecified unspecified unspecified unspecified 0 
6 קווינס קווינס בקווינס noun masculine singular construct unspecified unspecified  	O	null
7 קולג' קולג' קולג' properName unspecified unspecified unspecified unspecified unspecified  	I_LOC	null
8 בניו בן בניו properName unspecified unspecified unspecified unspecified unspecified  	I_LOC	null
9 יורק הורק יורק properName unspecified unspecified unspecified unspecified unspecified  	I_LOC	null
10 , , , punctuation unspecified unspecified unspecified unspecified unspecified  	O	null
11 היא הוא היא pronoun feminine singular unspecified 3 unspecified  	O	null
12 מקדישה הקדיש מקדישה verb feminine singular unspecified any beinoni  	O	null
13 את את את at-preposition unspecified unspecified unspecified unspecified unspecified  	O	null
14 רוב רוב רוב noun masculine singular construct unspecified unspecified  	O	null
15 זמן זמן זמנה noun masculine singular absolute unspecified unspecified  
15 ה ה זמנה possessive feminine singular unspecified 3 unspecified 0 	O	null
16 ל ל לכתיבה preposition unspecified unspecified unspecified unspecified unspecified 0 
16 ה ה לכתיבה definiteArticle unspecified unspecified unspecified unspecified unspecified 0 
16 הכתיבה כתיבה לכתיבה noun feminine singular absolute unspecified unspecified  	O	null
17 . . . punctuation unspecified unspecified unspecified unspecified unspecified  	O	null

0 יצירת יצירה יצירתה noun feminine singular absolute unspecified unspecified  
0 ה ה יצירתה possessive feminine singular unspecified 3 unspecified 0 	O	null
1 ה ה העשירה definiteArticle unspecified unspecified unspecified unspecified unspecified 0 
1 העשירה עשיר העשירה adjective feminine singular absolute unspecified unspecified  	O	null
2 מונה מונה מונה verb masculine singular unspecified 3 past  	O	null
3 בעיקר בעיקר בעיקר adverb unspecified unspecified unspecified unspecified unspecified  	O	null
4 ספרי ספר ספרי noun masculine plural construct unspecified unspecified  	O	null
5 שירה שירה שירה noun feminine singular absolute unspecified unspecified  	O	null
6 , , , punctuation unspecified unspecified unspecified unspecified unspecified  	O	null
7 ב ב בהם preposition unspecified unspecified unspecified unspecified unspecified  
7 הם הם בהם pronomial masculine plural unspecified 3 unspecified 0 	O	null
8 : : : punctuation unspecified unspecified unspecified unspecified unspecified  	O	null
9 ב ב בשדרה preposition unspecified unspecified unspecified unspecified unspecified 0 
9 שדרה שדרה בשדרה noun feminine singular absolute unspecified unspecified  	O	null
10 לילית לילי לילית adjective feminine singular absolute unspecified unspecified  	O	null
11 ( ( ( punctuation unspecified unspecified unspecified unspecified unspecified  	O	null
12 מ מ מחברות preposition unspecified unspecified unspecified unspecified unspecified 0 
12 חברות חבר מחברות noun feminine plural absolute unspecified unspecified  	O	null
13 ל ל לספרות preposition unspecified unspecified unspecified unspecified unspecified 0 
13 ה ה לספרות definiteArticle unspecified unspecified unspecified unspecified unspecified 0 
13 הספרות ספרות לספרות noun feminine singular absolute unspecified unspecified  	O	null
14 , , , punctuation unspecified unspecified unspecified unspecified unspecified  	O	null
15 ) ) ) punctuation unspecified unspecified unspecified unspecified unspecified  	O	null
16 ; ; ; punctuation unspecified unspecified unspecified unspecified unspecified  	O	null
17 ###NUMBER### ###NUMBER### ###NUMBER### numeral unspecified unspecified unspecified unspecified unspecified  	I_DATE	null
18 אל אל אל preposition unspecified unspecified unspecified unspecified unspecified  	O	null
19 פרוורי פרוור פרוורי noun masculine plural construct unspecified unspecified  	O	null
20 ה ה השמש definiteArticle unspecified unspecified unspecified unspecified unspecified 0 
20 השמש שמש השמש noun feminine singular absolute unspecified unspecified  	O	null
21 ) ) ) punctuation unspecified unspecified unspecified unspecified unspecified  	O	null
22 ; ; ; punctuation unspecified unspecified unspecified unspecified unspecified  	O	null
23 ###NUMBER### ###NUMBER### ###NUMBER### numeral unspecified unspecified unspecified unspecified unspecified  	I_DATE	null
24 הרחק הרחק הרחק adverb unspecified unspecified unspecified unspecified unspecified  	O	null
25 מ מ מכף preposition unspecified unspecified unspecified unspecified unspecified 0 
25 כף כף מכף noun feminine singular construct unspecified unspecified  	O	null
26 ה ה התקוה definiteArticle unspecified unspecified unspecified unspecified unspecified 0 
26 התקוה התקוה התקוה noun feminine singular absolute unspecified unspecified  	O	null
27 ה ה הטובה definiteArticle unspecified unspecified unspecified unspecified unspecified 0 
27 הטובה טוב הטובה adjective feminine singular absolute unspecified unspecified  	O	null
28 ) ) ) punctuation unspecified unspecified unspecified unspecified unspecified  	O	null
29 ; ; ; punctuation unspecified unspecified unspecified unspecified unspecified  	O	null
30 ###NUMBER### ###NUMBER### ###NUMBER### numeral unspecified unspecified unspecified unspecified unspecified  	I_DATE	null
31 שירי שיר שירי noun masculine plural construct unspecified unspecified  	O	null
32 ערער ערער ערער noun masculine singular absolute unspecified unspecified  	O	null
33 ( ( ( punctuation unspecified unspecified unspecified unspecified unspecified  	O	null
34 ) ) ) punctuation unspecified unspecified unspecified unspecified unspecified  	O	null
35 . . . punctuation unspecified unspecified unspecified unspecified unspecified  	O	null
36 ###NUMBER### ###NUMBER### ###NUMBER### numeral unspecified unspecified unspecified unspecified unspecified  	I_DATE	null
37 ספר ספר ספרה noun masculine singular absolute unspecified unspecified  
37 ה ה ספרה possessive feminine singular unspecified 3 unspecified 0 	O	null
38 ו ו והים conjunction unspecified unspecified unspecified unspecified unspecified 0 
38 ה ה והים definiteArticle unspecified unspecified unspecified unspecified unspecified 0 
38 הים ים והים noun masculine singular absolute unspecified unspecified  	O	null
39 אנה אנה אנה properName unspecified unspecified unspecified unspecified unspecified  	I_PERS	null
40 ילך הלך ילך verb masculine singular unspecified 3 future  	O	null
41 ? ? ? punctuation unspecified unspecified unspecified unspecified unspecified  	O	null

0 ( ( ( punctuation unspecified unspecified unspecified unspecified unspecified  	O	null
1 ) ) ) punctuation unspecified unspecified unspecified unspecified unspecified  	O	null
2 ###NUMBER### ###NUMBER### ###NUMBER### numeral unspecified unspecified unspecified unspecified unspecified  	I_DATE	null
3 מקבץ קיבץ מקבץ verb masculine singular unspecified any beinoni  	O	null
4 את את את at-preposition unspecified unspecified unspecified unspecified unspecified  	O	null
5 מבחר מבחר מבחר quantifier unspecified unspecified construct unspecified unspecified  	O	null
6 כתבי כתב כתביה noun masculine plural absolute unspecified unspecified  
6 ה ה כתביה possessive feminine singular unspecified 3 unspecified 0 	O	null
7 . . . punctuation unspecified unspecified unspecified unspecified unspecified  	O	null

0 כמו כמו כמו conjunction unspecified unspecified unspecified unspecified unspecified  	O	null
1 כן כן כן conjunction unspecified unspecified unspecified unspecified unspecified  	O	null
2 פירסמה פרסם פירסמה verb feminine singular unspecified 3 past  	O	null
3 שלושה CARD3 שלושה numeral masculine plural absolute unspecified unspecified  	O	null
4 קובצי קבץ קובצי participle masculine plural construct any unspecified  	O	null
5 סיפורים סיפור סיפורים noun masculine plural absolute unspecified unspecified  	O	null
6 : : : punctuation unspecified unspecified unspecified unspecified unspecified  	O	null
7 מכירה מכירה מכירה noun feminine singular absolute unspecified unspecified  	O	null
8 פומבית פומבי פומבית adjective feminine singular absolute unspecified unspecified  	O	null
9 ( ( ( punctuation unspecified unspecified unspecified unspecified unspecified  	O	null
10 אל"ף אל"ף אל"ף properName unspecified unspecified unspecified unspecified unspecified  	I_PERS	null
11 , , , punctuation unspecified unspecified unspecified unspecified unspecified  	O	null
12 ) ) ) punctuation unspecified unspecified unspecified unspecified unspecified  	O	null
13 ; ; ; punctuation unspecified unspecified unspecified unspecified unspecified  	O	null
14 ###NUMBER### ###NUMBER### ###NUMBER### numeral unspecified unspecified unspecified unspecified unspecified  	I_DATE	null
15 אויב אויב אויבו noun masculine singular absolute unspecified unspecified  
15 ו ו אויבו possessive masculine singular unspecified 3 unspecified 0 	O	null
16 ! ! ! punctuation unspecified unspecified unspecified unspecified unspecified  	O	null

0 אויב אויב אויבו noun masculine singular absolute unspecified unspecified  
0 ו ו אויבו possessive masculine singular unspecified 3 unspecified 0 	O	null
1 ! ! ! punctuation unspecified unspecified unspecified unspecified unspecified  	O	null

0 ) ) ) punctuation unspecified unspecified unspecified unspecified unspecified  	O	null
1 ; ; ; punctuation unspecified unspecified unspecified unspecified unspecified  	O	null
2 עוד עוד עוד adverb unspecified unspecified unspecified unspecified unspecified  	O	null
3 ###NUMBER### ###NUMBER### ###NUMBER### numeral unspecified unspecified unspecified unspecified unspecified  	I_DATE	null
4 רחוק רחוק רחוק adjective masculine singular absolute unspecified unspecified  	O	null
5 מן מן מן preposition unspecified unspecified unspecified unspecified unspecified  	O	null
6 ה ה הבית definiteArticle unspecified unspecified unspecified unspecified unspecified 0 
6 הבית בית הבית noun masculine singular absolute unspecified unspecified  	O	null
7 ) ) ) punctuation unspecified unspecified unspecified unspecified unspecified  	O	null
8 , , , punctuation unspecified unspecified unspecified unspecified unspecified  	O	null
9 ###NUMBER### ###NUMBER### ###NUMBER### numeral unspecified unspecified unspecified unspecified unspecified  	I_DATE	null
10 ו ו ומחקרים conjunction unspecified unspecified unspecified unspecified unspecified 0 
10 מחקרים מחקר ומחקרים noun masculine plural absolute unspecified unspecified  	O	null
11 ספרותיים ספרותי ספרותיים adjective masculine plural absolute unspecified unspecified  	O	null
12 על על על preposition unspecified unspecified unspecified unspecified unspecified  	O	null
13 ש"י ש"י ש"י properName unspecified unspecified unspecified unspecified unspecified  	I_PERS	null
14 עגנון עגנון עגנון properName unspecified unspecified unspecified unspecified unspecified  	I_PERS	null
15 ו ו וחיים conjunction unspecified unspecified unspecified unspecified unspecified 0 
15 חיים חיים וחיים noun masculine plural absolute unspecified unspecified  	O	null
16 הזז הזיז הזז verb masculine singular unspecified 2 imperative  	O	null
17 . . . punctuation unspecified unspecified unspecified unspecified unspecified  	O	null

0 שירת שירה שירתה noun feminine singular absolute unspecified unspecified  
0 ה ה שירתה possessive feminine singular unspecified 3 unspecified 0 	O	null
1 לירית לירי לירית adjective feminine singular absolute unspecified unspecified  	O	null
2 , , , punctuation unspecified unspecified unspecified unspecified unspecified  	O	null
3 רוויה רווי רוויה adjective feminine singular absolute unspecified unspecified  	O	null
4 ב ב בעצב preposition unspecified unspecified unspecified unspecified unspecified 0 
4 עצב עצב בעצב noun masculine singular absolute unspecified unspecified  	O	null
5 נסתר נסתר נסתר adjective masculine singular absolute unspecified unspecified  	O	null
6 ו ו ובגעגועים conjunction unspecified unspecified unspecified unspecified unspecified 0 
6 ב ב ובגעגועים preposition unspecified unspecified unspecified unspecified unspecified 0 
6 געגועים געגוע ובגעגועים noun masculine plural absolute unspecified unspecified  	O	null
7 . . . punctuation unspecified unspecified unspecified unspecified unspecified  	O	null

0 ניכר ניכר ניכר adjective masculine singular absolute unspecified unspecified  	O	null
1 ב ב בה preposition unspecified unspecified unspecified unspecified unspecified  
1 ה ה בה pronomial feminine singular unspecified 3 unspecified 0 	O	null
2 ה ה הקרע definiteArticle unspecified unspecified unspecified unspecified unspecified 0 
2 הקרע קרע הקרע noun masculine singular absolute unspecified unspecified  	O	null
3 ה ה המאפיין definiteArticle unspecified unspecified unspecified unspecified unspecified 0 
3 המאפיין אפיין המאפיין participle masculine singular absolute any unspecified  	O	null
4 את את את at-preposition unspecified unspecified unspecified unspecified unspecified  	O	null
5 חיי חיים חייה noun masculine plural absolute unspecified unspecified  
5 ה ה חייה possessive feminine singular unspecified 3 unspecified 0 	O	null
6 : : : punctuation unspecified unspecified unspecified unspecified unspecified  	O	null
7 למרות למרות למרות conjunction unspecified unspecified unspecified unspecified unspecified  	O	null
8 ישיבת ישיבה ישיבתה noun feminine singular absolute unspecified unspecified  
8 ה ה ישיבתה possessive feminine singular unspecified 3 unspecified 0 	O	null
9 ה ה הממושכת definiteArticle unspecified unspecified unspecified unspecified unspecified 0 
9 הממושכת ממושך הממושכת adjective feminine singular absolute unspecified unspecified  	O	null
10 בניו בן בניו properName unspecified unspecified unspecified unspecified unspecified  	I_LOC	null
11 יורק הורק יורק properName unspecified unspecified unspecified unspecified unspecified  	I_LOC	null
12 , , , punctuation unspecified unspecified unspecified unspecified unspecified  	O	null
13 ישראל ישראל ישראל properName unspecified unspecified unspecified unspecified unspecified  	I_LOC	null
14 היא הוא היא pronoun feminine singular unspecified 3 unspecified  	O	null
15 ה ה העוגן definiteArticle unspecified unspecified unspecified unspecified unspecified 0 
15 העוגן עוגן העוגן noun masculine singular absolute unspecified unspecified  	O	null
16 ה ה הלשוני definiteArticle unspecified unspecified unspecified unspecified unspecified 0 
16 הלשוני לשוני הלשוני adjective masculine singular absolute unspecified unspecified  	O	null
17 ו ו והרגשי conjunction unspecified unspecified unspecified unspecified unspecified 0 
17 ה ה והרגשי definiteArticle unspecified unspecified unspecified unspecified unspecified 0 
17 הרגשי רגשי והרגשי adjective masculine singular absolute unspecified unspecified  	O	null
18 של של שלה shel-preposition unspecified unspecified unspecified unspecified unspecified  
18 ה ה שלה pronomial feminine singular unspecified 3 unspecified 0 	O	null
19 . . . punctuation unspecified unspecified unspecified unspecified unspecified  	O	null

0 שפתההעשירהמשלבת שפתההעשירהמשלבת שפתההעשירהמשלבת participle masculine singular construct any unspecified  	O	null
1 ב ב באופן preposition unspecified unspecified unspecified unspecified unspecified 0 
1 אופן אופן באופן noun masculine singular absolute unspecified unspecified  	O	null
2 הרמוני הרמוני הרמוני adjective masculine singular absolute unspecified unspecified  	O	null
3 בין בין בין preposition unspecified unspecified unspecified unspecified unspecified  	O	null
4 לשון לשון לשון noun feminine singular construct unspecified unspecified  	O	null
5 ה ה היומיום definiteArticle unspecified unspecified unspecified unspecified unspecified 0 
5 היומיום היומיום היומיום noun masculine singular absolute unspecified unspecified  	O	null
6 לבין לבין לבין preposition unspecified unspecified unspecified unspecified unspecified  	O	null
7 לשון לשון לשון noun feminine singular construct unspecified unspecified  	O	null
8 ה ה המקורות definiteArticle unspecified unspecified unspecified unspecified unspecified 0 
8 המקורות מקור המקורות noun masculine plural absolute unspecified unspecified  	O	null
9 ( ( ( punctuation unspecified unspecified unspecified unspecified unspecified  	O	null
10 ה ה המקרא definiteArticle unspecified unspecified unspecified unspecified unspecified 0 
10 המקרא מקרא המקרא noun masculine singular absolute unspecified unspecified  	O	null
11 , , , punctuation unspecified unspecified unspecified unspecified unspecified  	O	null
12 ה ה התלמוד definiteArticle unspecified unspecified unspecified unspecified unspecified 0 
12 התלמוד תלמוד התלמוד noun masculine singular absolute unspecified unspecified  	O	null
13 ו ו והתפילה conjunction unspecified unspecified unspecified unspecified unspecified 0 
13 ה ה והתפילה definiteArticle unspecified unspecified unspecified unspecified unspecified 0 
13 התפילה תפילה והתפילה noun feminine singular absolute unspecified unspecified  	O	null
14 ) ) ) punctuation unspecified unspecified unspecified unspecified unspecified  	O	null
15 . . . punctuation unspecified unspecified unspecified unspecified unspecified  	O	null

0 ב ב בשירתה preposition unspecified unspecified unspecified unspecified unspecified 0 
0 שירת שירה בשירתה noun feminine singular absolute unspecified unspecified  
0 ה ה בשירתה possessive feminine singular unspecified 3 unspecified 0 	O	null
1 היא הוא היא pronoun feminine singular unspecified 3 unspecified  	O	null
2 פורשת פרש פורשת verb feminine singular unspecified any beinoni  	O	null
3 את את את at-preposition unspecified unspecified unspecified unspecified unspecified  	O	null
4 " " " punctuation unspecified unspecified unspecified unspecified unspecified  	O	null
5 ספר ספר ספר noun masculine singular construct unspecified unspecified  	O	null
6 חיי חיים חייה noun masculine plural absolute unspecified unspecified  
6 ה ה חייה possessive feminine singular unspecified 3 unspecified 0 	O	null
7 " " " punctuation unspecified unspecified unspecified unspecified unspecified  	O	null
8 : : : punctuation unspecified unspecified unspecified unspecified unspecified  	O	null
9 נופי נוף נופי noun masculine plural construct unspecified unspecified  	O	null
10 ניו ניו ניו properName unspecified unspecified unspecified unspecified unspecified  	I_LOC	null
11 יורק הורק יורק properName unspecified unspecified unspecified unspecified unspecified  	I_LOC	null
12 מול מול מול preposition unspecified unspecified unspecified unspecified unspecified  	O	null
13 נופי נוף נופי noun masculine plural construct unspecified unspecified  	O	null
14 ה ה הזיכרון definiteArticle unspecified unspecified unspecified unspecified unspecified 0 
14 הזיכרון זיכרון הזיכרון noun masculine singular absolute unspecified unspecified  	O	null
15 של של של shel-preposition unspecified unspecified unspecified unspecified unspecified  	O	null
16 ירושלים ירושלים ירושלים properName unspecified unspecified unspecified unspecified unspecified  	I_LOC	null
17 ו ו ותל conjunction unspecified unspecified unspecified unspecified unspecified 0 
17 תל תל ותל properName unspecified unspecified unspecified unspecified unspecified  	B_LOC	null
18 אביב אביב אביב properName unspecified unspecified unspecified unspecified unspecified  	I_LOC	null
19 , , , punctuation unspecified unspecified unspecified unspecified unspecified  	O	null
20 הוריה הוריה הוריה noun feminine singular absolute unspecified unspecified  	O	null
21 – – – punctuation unspecified unspecified unspecified unspecified unspecified  	O	null
22 חיי חיים חייהם noun masculine plural absolute unspecified unspecified  
22 הם הם חייהם possessive masculine plural unspecified 3 unspecified 0 	O	null
23 ו ו ומותם conjunction unspecified unspecified unspecified unspecified unspecified 0 
23 מות מוות ומותם noun masculine singular absolute unspecified unspecified  
23 ם ם ומותם possessive masculine plural unspecified 3 unspecified 0 	O	null
24 , , , punctuation unspecified unspecified unspecified unspecified unspecified  	O	null
25 הרהורים הרהור הרהורים noun masculine plural absolute unspecified unspecified  	O	null
26 על על על preposition unspecified unspecified unspecified unspecified unspecified  	O	null
27 אהבה אהבה אהבה noun feminine singular absolute unspecified unspecified  	O	null
28 , , , punctuation unspecified unspecified unspecified unspecified unspecified  	O	null
29 על על על preposition unspecified unspecified unspecified unspecified unspecified  	O	null
30 ה ה העצמי definiteArticle unspecified unspecified unspecified unspecified unspecified 0 
30 העצמי עצמי העצמי adjective masculine singular absolute unspecified unspecified  	O	null
31 ו ו ועל conjunction unspecified unspecified unspecified unspecified unspecified 0 
31 על על ועל preposition unspecified unspecified unspecified unspecified unspecified  	O	null
32 ה ה הכתיבה definiteArticle unspecified unspecified unspecified unspecified unspecified 0 
32 הכתיבה כתיבה הכתיבה noun feminine singular absolute unspecified unspecified  	O	null
33 . . . punctuation unspecified unspecified unspecified unspecified unspecified  	O	null

0 גם גם גם conjunction unspecified unspecified unspecified unspecified unspecified  	O	null
1 ב ב בסיפוריה preposition unspecified unspecified unspecified unspecified unspecified 0 
1 סיפורי סיפור בסיפוריה noun masculine plural absolute unspecified unspecified  
1 ה ה בסיפוריה possessive feminine singular unspecified 3 unspecified 0 	O	null
2 בולטות בלט בולטות verb feminine plural unspecified any beinoni  	O	null
3 נימה נימה נימה noun feminine singular absolute unspecified unspecified  	O	null
4 לירית לירי לירית adjective feminine singular absolute unspecified unspecified  	O	null
5 פיוטית פיוטי פיוטית adjective feminine singular absolute unspecified unspecified  	O	null
6 ו ו ולשון conjunction unspecified unspecified unspecified unspecified unspecified 0 
6 לשון לשון ולשון noun feminine singular absolute unspecified unspecified  	O	null
7 ה ה המערבת definiteArticle unspecified unspecified unspecified unspecified unspecified 0 
7 המערבת עירב המערבת participle feminine singular absolute any unspecified  	O	null
8 קודש קודש קודש noun masculine singular absolute unspecified unspecified  	O	null
9 ב ב בחול preposition unspecified unspecified unspecified unspecified unspecified 0 
9 ה ה בחול definiteArticle unspecified unspecified unspecified unspecified unspecified 0 
9 החול חול בחול noun masculine singular absolute unspecified unspecified  	O	null
10 . . . punctuation unspecified unspecified unspecified unspecified unspecified  	O	null

0 היא הוא היא pronoun feminine singular unspecified 3 unspecified  	O	null
1 מציגה הציג מציגה verb feminine singular unspecified any beinoni  	O	null
2 את את את at-preposition unspecified unspecified unspecified unspecified unspecified  	O	null
3 עולם עולם עולמן noun masculine singular absolute unspecified unspecified  
3 ן ן עולמן possessive feminine plural unspecified 3 unspecified 0 	O	null
4 ה ה הפנימי definiteArticle unspecified unspecified unspecified unspecified unspecified 0 
4 הפנימי פנימי הפנימי adjective masculine singular absolute unspecified unspecified  	O	null
5 של של של shel-preposition unspecified unspecified unspecified unspecified unspecified  	O	null
6 נשים איש נשים noun feminine plural absolute unspecified unspecified  	O	null
7 ה ה המתבוננות definiteArticle unspecified unspecified unspecified unspecified unspecified 0 
7 המתבוננות התבונן המתבוננות participle feminine plural absolute any unspecified  	O	null
8 ב ב בעולמן preposition unspecified unspecified unspecified unspecified unspecified 0 
8 עולם עולם בעולמן noun masculine singular absolute unspecified unspecified  
8 ן ן בעולמן possessive feminine plural unspecified 3 unspecified 0 	O	null
9 ב ב במבט preposition unspecified unspecified unspecified unspecified unspecified 0 
9 מבט מבט במבט noun masculine singular absolute unspecified unspecified  	O	null
10 רגיש רגיש רגיש adjective masculine singular absolute unspecified unspecified  	O	null
11 ו ו ומפוכח conjunction unspecified unspecified unspecified unspecified unspecified 0 
11 מפוכח מפוכח ומפוכח adjective masculine singular absolute unspecified unspecified  	O	null
12 . . . punctuation unspecified unspecified unspecified unspecified unspecified  	O	null

0 היא הוא היא pronoun feminine singular unspecified 3 unspecified  	O	null
1 משכילה השכיל משכילה verb feminine singular unspecified any beinoni  	O	null
2 להעביר העביר להעביר verb unspecified unspecified unspecified unspecified infinitive  	O	null
3 את את את at-preposition unspecified unspecified unspecified unspecified unspecified  	O	null
4 גוני גוני גוני adjective masculine singular absolute unspecified unspecified  	O	null
5 ה ה הרגשות definiteArticle unspecified unspecified unspecified unspecified unspecified 0 
5 הרגשות רגש הרגשות noun masculine plural absolute unspecified unspecified  	O	null
6 ה ה המעודנים definiteArticle unspecified unspecified unspecified unspecified unspecified 0 
6 המעודנים מעודן המעודנים adjective masculine plural absolute unspecified unspecified  	O	null
7 ו ו ואת conjunction unspecified unspecified unspecified unspecified unspecified 0 
7 את את ואת at-preposition unspecified unspecified unspecified unspecified unspecified  	O	null
8 ה ה התובנות definiteArticle unspecified unspecified unspecified unspecified unspecified 0 
8 התובנות תובנה התובנות noun masculine plural absolute unspecified unspecified  	O	null
9 ה ה המדויקות definiteArticle unspecified unspecified unspecified unspecified unspecified 0 
9 המדויקות מדויק המדויקות adjective feminine plural absolute unspecified unspecified  	O	null
10 ש ש שחוות relativizer/subordinatingConjunction unspecified unspecified unspecified unspecified unspecified 0 
10 חוות חווה שחוות noun feminine singular construct unspecified unspecified  	O	null
11 נשים איש נשים noun feminine plural absolute unspecified unspecified  	O	null
12 ה ה המצויות definiteArticle unspecified unspecified unspecified unspecified unspecified 0 
12 המצויות מצא המצויות participle feminine plural absolute any unspecified  	O	null
13 ב ב במשבר preposition unspecified unspecified unspecified unspecified unspecified 0 
13 ה ה במשבר definiteArticle unspecified unspecified unspecified unspecified unspecified 0 
13 המשבר משבר במשבר noun masculine singular absolute unspecified unspecified  	O	null
14 , , , punctuation unspecified unspecified unspecified unspecified unspecified  	O	null
15 ה ה המשתוקקות definiteArticle unspecified unspecified unspecified unspecified unspecified 0 
15 המשתוקקות השתוקק המשתוקקות participle feminine plural absolute any unspecified  	O	null
16 ל ל לאהבה preposition unspecified unspecified unspecified unspecified unspecified 0 
16 אהבה אהבה לאהבה noun feminine singular absolute unspecified unspecified  	O	null
17 , , , punctuation unspecified unspecified unspecified unspecified unspecified  	O	null
18 ה ה הכמהות definiteArticle unspecified unspecified unspecified unspecified unspecified 0 
18 הכמהות כמה הכמהות participle feminine plural absolute any unspecified  	O	null
19 אל אל אל preposition unspecified unspecified unspecified unspecified unspecified  	O	null
20 עבר עבר עברן noun masculine singular absolute unspecified unspecified  
20 ן ן עברן possessive feminine plural unspecified 3 unspecified 0 	O	null
21 . . . punctuation unspecified unspecified unspecified unspecified unspecified  	O	null

0 קיבלה קיבל קיבלה verb feminine singular unspecified 3 past  	O	null
1 את את את at-preposition unspecified unspecified unspecified unspecified unspecified  	O	null
2 פרס פרס פרס properName unspecified unspecified unspecified unspecified unspecified  	I_PERS	null
3 אברהם אברהם אברהם properName unspecified unspecified unspecified unspecified unspecified  	I_PERS	null
4 פרידמן פרידמן פרידמן properName unspecified unspecified unspecified unspecified unspecified  	I_PERS	null
5 ל ל לקידום preposition unspecified unspecified unspecified unspecified unspecified 0 
5 קידום קידום לקידום noun masculine singular construct unspecified unspecified  	O	null
6 ה ה התרבות definiteArticle unspecified unspecified unspecified unspecified unspecified 0 
6 התרבות תרבות התרבות noun feminine singular absolute unspecified unspecified  	O	null
7 ה ה העברית definiteArticle unspecified unspecified unspecified unspecified unspecified 0 
7 העברית עברי העברית adjective feminine singular absolute unspecified unspecified  	O	null
8 ב ב באמריקה preposition unspecified unspecified unspecified unspecified unspecified 0 
8 אמריקה אמריקה באמריקה properName unspecified unspecified unspecified unspecified unspecified  	I_LOC	null
9 ל ל לשנת preposition unspecified unspecified unspecified unspecified unspecified 0 
9 שנת שינה לשנת noun feminine singular construct unspecified unspecified  	O	null
10 ###NUMBER### ###NUMBER### ###NUMBER### numeral unspecified unspecified unspecified unspecified unspecified  	I_DATE	null
11 . . . punctuation unspecified unspecified unspecified unspecified unspecified  	O	null

0 References References References foreign unspecified unspecified unspecified unspecified unspecified  	O	null
1 : : : punctuation unspecified unspecified unspecified unspecified unspecified  	O	null
2 עזר עזר עזר properName unspecified unspecified unspecified unspecified unspecified  	I_PERS	null
3 , , , punctuation unspecified unspecified unspecified unspecified unspecified  	O	null
4 ננסי ננסי ננסי adjective masculine singular absolute unspecified unspecified  	O	null
5 . . . punctuation unspecified unspecified unspecified unspecified unspecified  	O	null

0 " " " punctuation unspecified unspecified unspecified unspecified unspecified  	I_ORG	null
1 פרוזהפיוטית–עלסיפוריההקצריםשלרנהלי פרוזהפיוטית–עלסיפוריההקצריםשלרנהלי פרוזהפיוטית–עלסיפוריההקצריםשלרנהלי properName unspecified unspecified unspecified unspecified unspecified  	I_ORG	null
2 " " " punctuation unspecified unspecified unspecified unspecified unspecified  	O	null
3 . . . punctuation unspecified unspecified unspecified unspecified unspecified  	O	null

0 הדאר הדאר הדאר properName unspecified unspecified unspecified unspecified unspecified  	O	null
1 ###NUMBER### ###NUMBER### ###NUMBER### numeral unspecified unspecified unspecified unspecified unspecified  	I_LOC	null
2 ) ) ) punctuation unspecified unspecified unspecified unspecified unspecified  	O	null
3 . . . punctuation unspecified unspecified unspecified unspecified unspecified  	O	null
4 ###NUMBER### ###NUMBER### ###NUMBER### numeral unspecified unspecified unspecified unspecified unspecified  	O	null
5 ###NUMBER### ###NUMBER### ###NUMBER### numeral unspecified unspecified unspecified unspecified unspecified  	I_DATE	null
6 . . . punctuation unspecified unspecified unspecified unspecified unspecified  	O	null

0 - - - punctuation unspecified unspecified unspecified unspecified unspecified  	O	null
1 ###NUMBER### ###NUMBER### ###NUMBER### numeral unspecified unspecified unspecified unspecified unspecified  	O	null
2 ; ; ; punctuation unspecified unspecified unspecified unspecified unspecified  	O	null
3 ###NUMBER### ###NUMBER### ###NUMBER### numeral unspecified unspecified unspecified unspecified unspecified  	O	null
4 שקד שקד שקד properName unspecified unspecified unspecified unspecified unspecified  	I_PERS	null
5 , , , punctuation unspecified unspecified unspecified unspecified unspecified  	O	null
6 מלכה מלך מלכה verb feminine singular unspecified 3 past  	O	null
7 . . . punctuation unspecified unspecified unspecified unspecified unspecified  	O	null

0 " " " punctuation unspecified unspecified unspecified unspecified unspecified  	O	null
1 על על על preposition unspecified unspecified unspecified unspecified unspecified  	O	null
2 שירי שיר שירי properName unspecified unspecified unspecified unspecified unspecified  	I_PERS	null
3 רנה רנה רנה properName unspecified unspecified unspecified unspecified unspecified  	I_PERS	null
4 ל ל לי preposition unspecified unspecified unspecified unspecified unspecified  
4 י י לי pronomial masculine-and-feminine singular unspecified 1 unspecified 0 	O	null
5 ו ו והים conjunction unspecified unspecified unspecified unspecified unspecified 0 
5 ה ה והים definiteArticle unspecified unspecified unspecified unspecified unspecified 0 
5 הים ים והים noun masculine singular absolute unspecified unspecified  	O	null
6 אנה אנה אנה properName unspecified unspecified unspecified unspecified unspecified  	I_PERS	null
7 ילך הלך ילך verb masculine singular unspecified 3 future  	O	null
8 ? ? ? punctuation unspecified unspecified unspecified unspecified unspecified  	O	null

0 " " " punctuation unspecified unspecified unspecified unspecified unspecified  	O	null
1 . . . punctuation unspecified unspecified unspecified unspecified unspecified  	O	null
2 מ מ מעמקים preposition unspecified unspecified unspecified unspecified unspecified 0 
2 עמקים עמק מעמקים noun masculine plural absolute unspecified unspecified  	O	null
3 : : : punctuation unspecified unspecified unspecified unspecified unspecified  	O	null
4 כתב כתב כתב noun masculine singular construct unspecified unspecified  	O	null
5 עת עת עת noun feminine singular absolute unspecified unspecified  	O	null
6 וירטואלי וירטואלי וירטואלי adjective masculine singular absolute unspecified unspecified  	O	null
7 ל ל לספרות preposition unspecified unspecified unspecified unspecified unspecified 0 
7 ה ה לספרות definiteArticle unspecified unspecified unspecified unspecified unspecified 0 
7 הספרות ספרות לספרות noun feminine singular absolute unspecified unspecified  	O	null
8 ו ו ואמנות conjunction unspecified unspecified unspecified unspecified unspecified 0 
8 אמנות אמנות ואמנות noun feminine singular absolute unspecified unspecified  	O	null
9 . . . punctuation unspecified unspecified unspecified unspecified unspecified  	O	null

0 ###NUMBER### ###NUMBER### ###NUMBER### numeral unspecified unspecified unspecified unspecified unspecified  	I_DATE	null
1 . . . punctuation unspecified unspecified unspecified unspecified unspecified  	O	null

