0 Name Name Name foreign unspecified unspecified unspecified unspecified unspecified  	O	null
1 : : : punctuation unspecified unspecified unspecified unspecified unspecified  	O	null
2 קראוס קראוס קראוס properName unspecified unspecified unspecified unspecified unspecified  	I_ORG	null
3 - - - properName unspecified unspecified unspecified unspecified unspecified  	I_ORG	null
4 ויינר ויינר ויינר properName unspecified unspecified unspecified unspecified unspecified  	I_ORG	null
5 , , , punctuation unspecified unspecified unspecified unspecified unspecified  	O	null
6 אורלי אורלי אורלי properName unspecified unspecified unspecified unspecified unspecified  	I_PERS	null
7 Birth Birth Birth foreign unspecified unspecified unspecified unspecified unspecified  	O	null
8 Year Year Year foreign unspecified unspecified unspecified unspecified unspecified  	O	null
9 : : : punctuation unspecified unspecified unspecified unspecified unspecified  	O	null
10 ###NUMBER### ###NUMBER### ###NUMBER### numeral unspecified unspecified unspecified unspecified unspecified  	I_DATE	null
11 Birth Birth Birth foreign unspecified unspecified unspecified unspecified unspecified  	I_ORG	null
12 Place Place Place foreign unspecified unspecified unspecified unspecified unspecified  	I_ORG	null
13 : : : punctuation unspecified unspecified unspecified unspecified unspecified  	I_LOC	null
14 רמת רמה רמת noun feminine singular construct unspecified unspecified  	I_LOC	null
15 השרון שרון השרון properName unspecified unspecified unspecified unspecified unspecified  	I_LOC	null
16 Occupation Occupation Occupation foreign unspecified unspecified unspecified unspecified unspecified  	O	null
17 : : : punctuation unspecified unspecified unspecified unspecified unspecified  	O	null
18 סופרת סופר סופרת noun feminine singular construct unspecified unspecified  	O	null
19 Entry Entry Entry foreign unspecified unspecified unspecified unspecified unspecified  	O	null
20 writer writer writer foreign unspecified unspecified unspecified unspecified unspecified  	O	null
21 : : : punctuation unspecified unspecified unspecified unspecified unspecified  	O	null
22 אמנון אמנון אמנון properName unspecified unspecified unspecified unspecified unspecified  	I_PERS	null
23 ז'קונט ז'קונט ז'קונט properName unspecified unspecified unspecified unspecified unspecified  	I_PERS	null
24 Entry Entry Entry foreign unspecified unspecified unspecified unspecified unspecified  	O	null
25 Value Value Value foreign unspecified unspecified unspecified unspecified unspecified  	O	null
26 : : : punctuation unspecified unspecified unspecified unspecified unspecified  	O	null
27 נולדה נולד נולדה verb feminine singular unspecified 3 past  	I_LOC	null
28 ב ב ברמת preposition unspecified unspecified unspecified unspecified unspecified 0 
28 רמת רמה ברמת noun feminine singular construct unspecified unspecified  	I_LOC	null
29 השרון שרון השרון properName unspecified unspecified unspecified unspecified unspecified  	I_LOC	null
30 . . . punctuation unspecified unspecified unspecified unspecified unspecified  	O	null

0 ב ב בגיל preposition unspecified unspecified unspecified unspecified unspecified 0 
0 גיל גיל בגיל noun masculine singular absolute unspecified unspecified  	O	null
1 ש ש שמונה relativizer/subordinatingConjunction unspecified unspecified unspecified unspecified unspecified 0 
1 מונה מונה שמונה verb masculine singular unspecified 3 past  	O	null
2 עברה עבר עברה verb feminine singular unspecified 3 past  	O	null
3 עם עם עם preposition unspecified unspecified unspecified unspecified unspecified  	O	null
4 משפחת משפחה משפחתה noun feminine singular absolute unspecified unspecified  
4 ה ה משפחתה possessive feminine singular unspecified 3 unspecified 0 	O	null
5 לפתח פיתח לפתח verb unspecified unspecified unspecified unspecified infinitive  	O	null
6 תקווה תקווה תקווה properName unspecified unspecified unspecified unspecified unspecified  	I_LOC	null
7 . . . punctuation unspecified unspecified unspecified unspecified unspecified  	O	null

0 ב ב ב preposition unspecified unspecified unspecified unspecified unspecified 0 	O	null
1 - - - punctuation unspecified unspecified unspecified unspecified unspecified  	O	null
2 ###NUMBER### ###NUMBER### ###NUMBER### numeral unspecified unspecified unspecified unspecified unspecified  	I_DATE	null
3 נסעה נסע נסעה verb feminine singular unspecified 3 past  	O	null
4 עם עם עם preposition unspecified unspecified unspecified unspecified unspecified  	O	null
5 בעלה בעל בעלה noun feminine singular absolute unspecified unspecified  	O	null
6 ל ל לשליחות preposition unspecified unspecified unspecified unspecified unspecified 0 
6 שליחות שליחות לשליחות noun feminine singular absolute unspecified unspecified  	O	null
7 ב ב בארצות preposition unspecified unspecified unspecified unspecified unspecified 0 
7 ארצות ארץ בארצות properName unspecified unspecified unspecified unspecified unspecified  	I_LOC	null
8 הברית ברית הברית properName unspecified unspecified unspecified unspecified unspecified  	I_LOC	null
9 , , , punctuation unspecified unspecified unspecified unspecified unspecified  	O	null
10 חזרה חזר חזרה verb feminine singular unspecified 3 past  	O	null
11 כעבור כעבור כעבור preposition unspecified unspecified unspecified unspecified unspecified  	O	null
12 שנתיים שנתי שנתיים adjective masculine plural absolute unspecified unspecified  	O	null
13 ל ל לישראל preposition unspecified unspecified unspecified unspecified unspecified 0 
13 ישראל ישראל לישראל properName unspecified unspecified unspecified unspecified unspecified  	I_LOC	null
14 , , , punctuation unspecified unspecified unspecified unspecified unspecified  	O	null
15 התגרשה התגרש התגרשה verb feminine singular unspecified 3 past  	O	null
16 ו ו ועבדה conjunction unspecified unspecified unspecified unspecified unspecified 0 
16 עבדה עבד ועבדה verb feminine singular unspecified 3 past  	O	null
17 ב ב בבר preposition unspecified unspecified unspecified unspecified unspecified 0 
17 בר בר בבר properName unspecified unspecified unspecified unspecified unspecified  	I_PERS	null
18 עד עד עד preposition unspecified unspecified unspecified unspecified unspecified  	O	null
19 ###NUMBER### ###NUMBER### ###NUMBER### numeral unspecified unspecified unspecified unspecified unspecified  	I_DATE	null
20 . . . punctuation unspecified unspecified unspecified unspecified unspecified  	O	null

0 אז אז אז conjunction unspecified unspecified unspecified unspecified unspecified  	O	null
1 החלה החל החלה verb feminine singular unspecified 3 past  	O	null
2 לעבוד עבד לעבוד verb unspecified unspecified unspecified unspecified infinitive  	O	null
3 כ כ כדיילת preposition unspecified unspecified unspecified unspecified unspecified 0 
3 דיילת דייל כדיילת noun feminine singular construct unspecified unspecified  	O	null
4 אוויר אוויר אוויר noun masculine singular absolute unspecified unspecified  	O	null
5 ב ב ב preposition unspecified unspecified unspecified unspecified unspecified 0 	I_ORG	null
6 " " " punctuation unspecified unspecified unspecified unspecified unspecified  	I_ORG	null
7 אלעל אלעל אלעל properName unspecified unspecified unspecified unspecified unspecified  	I_ORG	null
8 " " " punctuation unspecified unspecified unspecified unspecified unspecified  	O	null
9 . . . punctuation unspecified unspecified unspecified unspecified unspecified  	O	null

0 במקביל במקביל במקביל adverb unspecified unspecified unspecified unspecified unspecified  	O	null
1 למדה למד למדה verb feminine singular unspecified 3 past  	O	null
2 ב ב באוניברסיטת preposition unspecified unspecified unspecified unspecified unspecified 0 
2 אוניברסיטת אוניברסיטה באוניברסיטת noun feminine singular construct unspecified unspecified  	I_ORG	null
3 תלאביב תלאביב תלאביב properName unspecified unspecified unspecified unspecified unspecified  	I_ORG	null
4 ב ב במסגרת preposition unspecified unspecified unspecified unspecified unspecified 0 
4 מסגרת מסגרת במסגרת noun feminine singular construct unspecified unspecified  	O	null
5 תוכנית תוכנייה תוכנית noun feminine singular construct unspecified unspecified  	O	null
6 ה ה הלימודים definiteArticle unspecified unspecified unspecified unspecified unspecified 0 
6 הלימודים לימוד הלימודים noun masculine plural absolute unspecified unspecified  	O	null
7 ה ה הכלליים definiteArticle unspecified unspecified unspecified unspecified unspecified 0 
7 הכלליים כללי הכלליים adjective masculine plural absolute unspecified unspecified  	O	null
8 ב ב במדעי preposition unspecified unspecified unspecified unspecified unspecified 0 
8 מדעי מדע במדעי noun masculine plural construct unspecified unspecified  	O	null
9 ה ה הרוח definiteArticle unspecified unspecified unspecified unspecified unspecified 0 
9 הרוח רוח הרוח noun feminine singular absolute unspecified unspecified  	O	null
10 , , , punctuation unspecified unspecified unspecified unspecified unspecified  	O	null
11 ו ו וקיבלה conjunction unspecified unspecified unspecified unspecified unspecified 0 
11 קיבלה קיבל וקיבלה verb feminine singular unspecified 3 past  	O	null
12 תואר תואר תואר noun masculine singular absolute unspecified unspecified  	O	null
13 ראשון ORD1 ראשון numeral masculine singular absolute unspecified unspecified  	O	null
14 ב ב ב preposition unspecified unspecified unspecified unspecified unspecified 0 	O	null
15 - - - punctuation unspecified unspecified unspecified unspecified unspecified  	O	null
16 ###NUMBER### ###NUMBER### ###NUMBER### numeral unspecified unspecified unspecified unspecified unspecified  	I_DATE	null
17 . . . punctuation unspecified unspecified unspecified unspecified unspecified  	O	null

0 ב ב ב preposition unspecified unspecified unspecified unspecified unspecified 0 	O	null
1 - - - punctuation unspecified unspecified unspecified unspecified unspecified  	O	null
2 ###NUMBER### ###NUMBER### ###NUMBER### numeral unspecified unspecified unspecified unspecified unspecified  	I_DATE	null
3 נישאה נישא נישאה verb feminine singular unspecified 3 past  	O	null
4 שנית שנית שנית adverb unspecified unspecified unspecified unspecified unspecified  	O	null
5 , , , punctuation unspecified unspecified unspecified unspecified unspecified  	O	null
6 ו ו והוסיפה conjunction unspecified unspecified unspecified unspecified unspecified 0 
6 הוסיפה הוסיף והוסיפה verb feminine singular unspecified 3 past  	O	null
7 לעבוד עבד לעבוד verb unspecified unspecified unspecified unspecified infinitive  	O	null
8 כ כ כדיילת preposition unspecified unspecified unspecified unspecified unspecified 0 
8 דיילת דייל כדיילת noun feminine singular absolute unspecified unspecified  	O	null
9 עד עד עד preposition unspecified unspecified unspecified unspecified unspecified  	O	null
10 ###NUMBER### ###NUMBER### ###NUMBER### numeral unspecified unspecified unspecified unspecified unspecified  	I_DATE	null
11 . . . punctuation unspecified unspecified unspecified unspecified unspecified  	O	null

0 ב ב ב preposition unspecified unspecified unspecified unspecified unspecified 0 	O	null
1 - - - punctuation unspecified unspecified unspecified unspecified unspecified  	O	null
2 ###NUMBER### ###NUMBER### ###NUMBER### numeral unspecified unspecified unspecified unspecified unspecified  	I_DATE	null
3 נולדה נולד נולדה verb feminine singular unspecified 3 past  	O	null
4 בת בת בתה noun feminine singular absolute unspecified unspecified  
4 ה ה בתה possessive feminine singular unspecified 3 unspecified 0 	O	null
5 , , , punctuation unspecified unspecified unspecified unspecified unspecified  	O	null
6 ולאחרמכן ולאחרמכן ולאחרמכן properName unspecified unspecified unspecified unspecified unspecified  	I_PERS	null
7 החלה החל החלה verb feminine singular unspecified 3 past  	O	null
8 לעבוד עבד לעבוד verb unspecified unspecified unspecified unspecified infinitive  	O	null
9 כ כ כעיתונאית preposition unspecified unspecified unspecified unspecified unspecified 0 
9 ה ה כעיתונאית definiteArticle unspecified unspecified unspecified unspecified unspecified 0 
9 העיתונאית עיתונאית כעיתונאית noun feminine singular absolute unspecified unspecified  	O	null
10 ב ב בעיתונים preposition unspecified unspecified unspecified unspecified unspecified 0 
10 עיתונים עיתון בעיתונים noun masculine plural absolute unspecified unspecified  	O	null
11 שונים שונה שונים adjective masculine plural absolute unspecified unspecified  	O	null
12 . . . punctuation unspecified unspecified unspecified unspecified unspecified  	O	null

0 כמו כמו כמו conjunction unspecified unspecified unspecified unspecified unspecified  	O	null
1 כן כן כן conjunction unspecified unspecified unspecified unspecified unspecified  	O	null
2 כתבה כתב כתבה verb feminine singular unspecified 3 past  	O	null
3 סיפורים סיפור סיפורים noun masculine plural absolute unspecified unspecified  	O	null
4 קצרים קצר קצרים adjective masculine plural absolute unspecified unspecified  	O	null
5 ל ל למעריב preposition unspecified unspecified unspecified unspecified unspecified 0 
5 מעריב מעריב למעריב properName unspecified unspecified unspecified unspecified unspecified  	I_ORG	null
6 , , , punctuation unspecified unspecified unspecified unspecified unspecified  	O	null
7 עולם עולם עולם noun masculine singular construct unspecified unspecified  	O	null
8 ה ה האישה definiteArticle unspecified unspecified unspecified unspecified unspecified 0 
8 האישה איש האישה noun feminine singular absolute unspecified unspecified  	O	null
9 ו ו ולאישה conjunction unspecified unspecified unspecified unspecified unspecified 0 
9 ל ל ולאישה preposition unspecified unspecified unspecified unspecified unspecified 0 
9 ה ה ולאישה definiteArticle unspecified unspecified unspecified unspecified unspecified 0 
9 האישה איש ולאישה noun feminine singular absolute unspecified unspecified  	O	null
10 . . . punctuation unspecified unspecified unspecified unspecified unspecified  	O	null

0 ספר ספר ספרה noun masculine singular absolute unspecified unspecified  
0 ה ה ספרה possessive feminine singular unspecified 3 unspecified 0 	O	null
1 ה ה הראשון definiteArticle unspecified unspecified unspecified unspecified unspecified 0 
1 הראשון ORD1 הראשון numeral masculine singular absolute unspecified unspecified  	O	null
2 , , , punctuation unspecified unspecified unspecified unspecified unspecified  	O	null
3 התרוממות התרוממות התרוממות noun feminine singular absolute unspecified unspecified  	O	null
4 ( ( ( punctuation unspecified unspecified unspecified unspecified unspecified  	O	null
5 ידיעות ידיעה ידיעות noun feminine plural absolute unspecified unspecified  	O	null
6 אחרונות אחרון אחרונות adjective feminine plural absolute unspecified unspecified  	O	null
7 , , , punctuation unspecified unspecified unspecified unspecified unspecified  	O	null
8 ) ) ) punctuation unspecified unspecified unspecified unspecified unspecified  	O	null
9 , , , punctuation unspecified unspecified unspecified unspecified unspecified  	O	null
10 ###NUMBER### ###NUMBER### ###NUMBER### numeral unspecified unspecified unspecified unspecified unspecified  	I_DATE	null
11 עסק עסק עסק noun masculine singular absolute unspecified unspecified  	O	null
12 ב ב בהרפתקאותיהן preposition unspecified unspecified unspecified unspecified unspecified 0 
12 הרפתקאות הרפתקה בהרפתקאותיהן noun feminine plural absolute unspecified unspecified  
12 הן הן בהרפתקאותיהן possessive feminine plural unspecified 3 unspecified 0 	O	null
13 של של של shel-preposition unspecified unspecified unspecified unspecified unspecified  	O	null
14 שלוש CARD3 שלוש numeral feminine singular absolute unspecified unspecified  	O	null
15 דיילות דייל דיילות noun feminine plural absolute unspecified unspecified  	O	null
16 חדשות חדש חדשות adjective feminine plural absolute unspecified unspecified  	O	null
17 ב ב בחברת preposition unspecified unspecified unspecified unspecified unspecified 0 
17 חברת חבר בחברת noun feminine singular construct unspecified unspecified  	O	null
18 תעופה תעופה תעופה noun feminine singular absolute unspecified unspecified  	O	null
19 בדיונית בדיוני בדיונית adjective feminine singular absolute unspecified unspecified  	O	null
20 ו ו והתבסס conjunction unspecified unspecified unspecified unspecified unspecified 0 
20 התבסס התבסס והתבסס verb masculine singular unspecified 3 past  	O	null
21 על על על preposition unspecified unspecified unspecified unspecified unspecified  	O	null
22 חוויות חוויה חוויותיה noun feminine plural absolute unspecified unspecified  
22 ה ה חוויותיה possessive feminine singular unspecified 3 unspecified 0 	O	null
23 מ מ מעבודתה preposition unspecified unspecified unspecified unspecified unspecified 0 
23 עבודת עבודה מעבודתה noun feminine singular absolute unspecified unspecified  
23 ה ה מעבודתה possessive feminine singular unspecified 3 unspecified 0 	O	null
24 כ כ כדיילת preposition unspecified unspecified unspecified unspecified unspecified 0 
24 ה ה כדיילת definiteArticle unspecified unspecified unspecified unspecified unspecified 0 
24 הדיילת דייל כדיילת noun feminine singular absolute unspecified unspecified  	O	null
25 . . . punctuation unspecified unspecified unspecified unspecified unspecified  	O	null

0 ה ה הספר definiteArticle unspecified unspecified unspecified unspecified unspecified 0 
0 הספר ספר הספר noun masculine singular absolute unspecified unspecified  	O	null
1 זכה זכה זכה verb masculine singular unspecified 3 past  	O	null
2 ל ל להצלחה preposition unspecified unspecified unspecified unspecified unspecified 0 
2 הצלחה הצלחה להצלחה noun feminine singular absolute unspecified unspecified  	O	null
3 רבה רב רבה adjective feminine singular absolute unspecified unspecified  	O	null
4 ו ו ובעקבותיו conjunction unspecified unspecified unspecified unspecified unspecified 0 
4 בעקבות בעקבות ובעקבותיו preposition unspecified unspecified unspecified unspecified unspecified  
4 ו ו ובעקבותיו pronomial masculine singular unspecified 3 unspecified 0 	O	null
5 ראה ראה ראה verb masculine singular unspecified 3 past  	O	null
6 אור אור אור noun masculine singular construct unspecified unspecified  	O	null
7 ספר ספר ספרה noun masculine singular absolute unspecified unspecified  
7 ה ה ספרה possessive feminine singular unspecified 3 unspecified 0 	O	null
8 ה ה השני definiteArticle unspecified unspecified unspecified unspecified unspecified 0 
8 השני ORD2 השני numeral masculine singular absolute unspecified unspecified  	O	null
9 , , , punctuation unspecified unspecified unspecified unspecified unspecified  	O	null
10 מלכת מלך מלכת noun feminine singular construct unspecified unspecified  	O	null
11 ה ה הלבבות definiteArticle unspecified unspecified unspecified unspecified unspecified 0 
11 הלבבות לב הלבבות noun masculine plural absolute unspecified unspecified  	O	null
12 ) ) ) punctuation unspecified unspecified unspecified unspecified unspecified  	O	null
13 , , , punctuation unspecified unspecified unspecified unspecified unspecified  	O	null
14 ###NUMBER### ###NUMBER### ###NUMBER### numeral unspecified unspecified unspecified unspecified unspecified  	I_DATE	null
15 סיפור סיפור סיפור noun masculine singular absolute unspecified unspecified  	O	null
16 התבגרות התבגרות התבגרות noun feminine singular absolute unspecified unspecified  	O	null
17 של של של shel-preposition unspecified unspecified unspecified unspecified unspecified  	O	null
18 חבורת חבורה חבורת noun feminine singular construct unspecified unspecified  	O	null
19 נערים נוער נערים noun masculine plural absolute unspecified unspecified  	O	null
20 ו ו ונערות conjunction unspecified unspecified unspecified unspecified unspecified 0 
20 נערות נער ונערות noun feminine plural absolute unspecified unspecified  	O	null
21 ב ב בישראל preposition unspecified unspecified unspecified unspecified unspecified 0 
21 ישראל ישראל בישראל properName unspecified unspecified unspecified unspecified unspecified  	I_LOC	null
22 של של של shel-preposition unspecified unspecified unspecified unspecified unspecified  	O	null
23 שנות שנה שנות noun feminine plural construct unspecified unspecified  	O	null
24 ה ה השבעים definiteArticle unspecified unspecified unspecified unspecified unspecified 0 
24 השבעים ORD-CARD70 השבעים numeral masculine-and-feminine plural absolute unspecified unspecified  	O	null
25 , , , punctuation unspecified unspecified unspecified unspecified unspecified  	O	null
26 ש ש שחלקים relativizer/subordinatingConjunction unspecified unspecified unspecified unspecified unspecified 0 
26 חלקים חלק שחלקים noun masculine plural absolute unspecified unspecified  	O	null
27 רבים רב רבים adjective masculine plural absolute unspecified unspecified  	O	null
28 ב ב בו preposition unspecified unspecified unspecified unspecified unspecified  
28 ו ו בו pronomial masculine singular unspecified 3 unspecified 0 	O	null
29 ש ש שאובים relativizer/subordinatingConjunction unspecified unspecified unspecified unspecified unspecified 0 
29 אובים אבה שאובים verb masculine plural unspecified any beinoni  	O	null
30 מ מ מחוויות preposition unspecified unspecified unspecified unspecified unspecified 0 
30 חוויות חוויה מחוויות noun feminine plural construct unspecified unspecified  	O	null
31 ה ה הנעורים definiteArticle unspecified unspecified unspecified unspecified unspecified 0 
31 הנעורים נעורים הנעורים noun masculine plural absolute unspecified unspecified  	O	null
32 של של של shel-preposition unspecified unspecified unspecified unspecified unspecified  	O	null
33 ה ה המחברת definiteArticle unspecified unspecified unspecified unspecified unspecified 0 
33 המחברת מחברת המחברת noun feminine singular absolute unspecified unspecified  	O	null
34 . . . punctuation unspecified unspecified unspecified unspecified unspecified  	O	null

0 ב ב ב preposition unspecified unspecified unspecified unspecified unspecified 0 	I_ORG	null
1 - - - punctuation unspecified unspecified unspecified unspecified unspecified  	I_ORG	null
2 ###NUMBER### ###NUMBER### ###NUMBER### numeral unspecified unspecified unspecified unspecified unspecified  	I_DATE	null
3 התפרסם התפרסם התפרסם verb masculine singular unspecified 3 past  	O	null
4 ספר ספר ספרה noun masculine singular absolute unspecified unspecified  
4 ה ה ספרה possessive feminine singular unspecified 3 unspecified 0 	O	null
5 ה ה השלישי definiteArticle unspecified unspecified unspecified unspecified unspecified 0 
5 השלישי ORD3 השלישי numeral masculine singular absolute unspecified unspecified  	O	null
6 , , , punctuation unspecified unspecified unspecified unspecified unspecified  	O	null
7 אהבה אהבה אהבה noun feminine singular absolute unspecified unspecified  	O	null
8 ל ל לפי preposition unspecified unspecified unspecified unspecified unspecified 0 
8 פי פה לפי noun masculine singular construct unspecified unspecified  	O	null
9 ה ה הספר definiteArticle unspecified unspecified unspecified unspecified unspecified 0 
9 הספר ספר הספר noun masculine singular absolute unspecified unspecified  	O	null
10 , , , punctuation unspecified unspecified unspecified unspecified unspecified  	O	null
11 ש ש שתיאר relativizer/subordinatingConjunction unspecified unspecified unspecified unspecified unspecified 0 
11 תיאר תיאר שתיאר verb masculine singular unspecified 3 past  	O	null
12 סיפור סיפור סיפור noun masculine singular absolute unspecified unspecified  	O	null
13 של של של shel-preposition unspecified unspecified unspecified unspecified unspecified  	O	null
14 נערה נער נערה noun feminine singular absolute unspecified unspecified  	O	null
15 יהודייה יהודי יהודייה adjective feminine singular absolute unspecified unspecified  	O	null
16 אמריקנית אמריקני אמריקנית adjective feminine singular absolute unspecified unspecified  	O	null
17 ה ה העולה definiteArticle unspecified unspecified unspecified unspecified unspecified 0 
17 העולה עלה העולה participle feminine singular absolute any unspecified  	O	null
18 ל ל לארץ preposition unspecified unspecified unspecified unspecified unspecified 0 
18 ארץ ארץ לארץ noun feminine singular construct unspecified unspecified  	O	null
19 מטעמים מטעם מטעמים noun masculine plural absolute unspecified unspecified  	O	null
20 אידיאולוגיים אידיאולוגי אידיאולוגיים adjective masculine plural absolute unspecified unspecified  	O	null
21 , , , punctuation unspecified unspecified unspecified unspecified unspecified  	O	null
22 נישאת נישא נישאת verb feminine singular unspecified any beinoni  	O	null
23 ל ל לגבר preposition unspecified unspecified unspecified unspecified unspecified 0 
23 גבר גבר לגבר noun masculine singular absolute unspecified unspecified  	O	null
24 ש ש שהוא relativizer/subordinatingConjunction unspecified unspecified unspecified unspecified unspecified 0 
24 הוא הוא שהוא pronoun masculine singular unspecified 3 unspecified  	O	null
25 " " " punctuation unspecified unspecified unspecified unspecified unspecified  	O	null
26 מלח מלח מלח noun masculine singular absolute unspecified unspecified  	I_ORG	null
27 הארץ ארץ הארץ properName unspecified unspecified unspecified unspecified unspecified  	I_ORG	null
28 " " " punctuation unspecified unspecified unspecified unspecified unspecified  	O	null
29 ו ו ומגלה conjunction unspecified unspecified unspecified unspecified unspecified 0 
29 מגלה הגלה ומגלה verb masculine singular unspecified any beinoni  	O	null
30 ל ל לאכזבתה preposition unspecified unspecified unspecified unspecified unspecified 0 
30 אכזבת אכזבה לאכזבתה noun feminine singular absolute unspecified unspecified  
30 ה ה לאכזבתה possessive feminine singular unspecified 3 unspecified 0 	O	null
31 ש ש שנישואיה relativizer/subordinatingConjunction unspecified unspecified unspecified unspecified unspecified 0 
31 נישואי נישואין שנישואיה noun masculine plural absolute unspecified unspecified  
31 ה ה שנישואיה possessive feminine singular unspecified 3 unspecified 0 	O	null
32 מסתאבים הסתאב מסתאבים verb masculine plural unspecified any beinoni  	O	null
33 ו ו ומתפרקים conjunction unspecified unspecified unspecified unspecified unspecified 0 
33 מתפרקים התפרק ומתפרקים verb masculine plural unspecified any beinoni  	O	null
34 במקביל במקביל במקביל adverb unspecified unspecified unspecified unspecified unspecified  	O	null
35 ל ל להסתאבות preposition unspecified unspecified unspecified unspecified unspecified 0 
35 ה ה להסתאבות definiteArticle unspecified unspecified unspecified unspecified unspecified 0 
35 ההסתאבות הסתאבות להסתאבות noun feminine singular absolute unspecified unspecified  	O	null
36 ו ו ולהתפוררות conjunction unspecified unspecified unspecified unspecified unspecified 0 
36 ל ל ולהתפוררות preposition unspecified unspecified unspecified unspecified unspecified 0 
36 התפוררות התפוררות ולהתפוררות noun feminine singular construct unspecified unspecified  	O	null
37 ה ה האידיאלים definiteArticle unspecified unspecified unspecified unspecified unspecified 0 
37 האידיאלים אידיאל האידיאלים noun masculine plural absolute unspecified unspecified  	O	null
38 של של של shel-preposition unspecified unspecified unspecified unspecified unspecified  	O	null
39 ארץ ארץ ארץ noun feminine singular construct unspecified unspecified  	I_LOC	null
40 ישראל ישראל ישראל properName unspecified unspecified unspecified unspecified unspecified  	I_LOC	null
41 ה ה הישנה definiteArticle unspecified unspecified unspecified unspecified unspecified 0 
41 הישנה ישן הישנה adjective feminine singular absolute unspecified unspecified  	O	null
42 ו ו והטובה conjunction unspecified unspecified unspecified unspecified unspecified 0 
42 ה ה והטובה definiteArticle unspecified unspecified unspecified unspecified unspecified 0 
42 הטובה טוב והטובה adjective feminine singular absolute unspecified unspecified  	O	null
43 . . . punctuation unspecified unspecified unspecified unspecified unspecified  	O	null

0 ספר ספר ספרה noun masculine singular absolute unspecified unspecified  
0 ה ה ספרה possessive feminine singular unspecified 3 unspecified 0 	O	null
1 ה ה הרביעי definiteArticle unspecified unspecified unspecified unspecified unspecified 0 
1 הרביעי ORD4 הרביעי numeral masculine singular absolute unspecified unspecified  	O	null
2 , , , punctuation unspecified unspecified unspecified unspecified unspecified  	O	null
3 מחול מחול מחול noun masculine singular absolute unspecified unspecified  	O	null
4 ה ה הפלמינגו definiteArticle unspecified unspecified unspecified unspecified unspecified 0 
4 הפלמינגו הפלמינגו הפלמינגו properName unspecified unspecified unspecified unspecified unspecified  	I_PERS	null
5 ) ) ) punctuation unspecified unspecified unspecified unspecified unspecified  	O	null
6 , , , punctuation unspecified unspecified unspecified unspecified unspecified  	O	null
7 ###NUMBER### ###NUMBER### ###NUMBER### numeral unspecified unspecified unspecified unspecified unspecified  	I_DATE	null
8 מגולל גולל מגולל verb masculine singular unspecified any beinoni  	O	null
9 את את את at-preposition unspecified unspecified unspecified unspecified unspecified  	O	null
10 סיפור סיפור סיפור noun masculine singular construct unspecified unspecified  	O	null
11 חיי חיים חייה noun masculine plural absolute unspecified unspecified  
11 ה ה חייה possessive feminine singular unspecified 3 unspecified 0 	O	null
12 של של של shel-preposition unspecified unspecified unspecified unspecified unspecified  	O	null
13 דוקטורנטית דוקטורנטית דוקטורנטית noun feminine singular absolute unspecified unspecified  	O	null
14 ה ה החוקרת definiteArticle unspecified unspecified unspecified unspecified unspecified 0 
14 החוקרת חקר החוקרת participle feminine singular absolute any unspecified  	O	null
15 את את את at-preposition unspecified unspecified unspecified unspecified unspecified  	O	null
16 גן גן גן noun masculine singular construct unspecified unspecified  	O	null
17 ה ה הנאמנות definiteArticle unspecified unspecified unspecified unspecified unspecified 0 
17 הנאמנות נאמנות הנאמנות noun feminine singular absolute unspecified unspecified  	O	null
18 על על על preposition unspecified unspecified unspecified unspecified unspecified  	O	null
19 רקע רקע רקע noun masculine singular construct unspecified unspecified  	O	null
20 סיפורי סיפור סיפורי noun masculine plural construct unspecified unspecified  	O	null
21 משפחת משפחה משפחתה noun feminine singular absolute unspecified unspecified  
21 ה ה משפחתה possessive feminine singular unspecified 3 unspecified 0 	O	null
22 ה ה הרצופים definiteArticle unspecified unspecified unspecified unspecified unspecified 0 
22 הרצופים רצוף הרצופים adjective masculine plural absolute unspecified unspecified  	O	null
23 בגידות בגידה בגידות noun feminine plural absolute unspecified unspecified  	O	null
24 , , , punctuation unspecified unspecified unspecified unspecified unspecified  	O	null
25 נטישות נטישה נטישות noun feminine plural absolute unspecified unspecified  	O	null
26 ו ו ומשברי conjunction unspecified unspecified unspecified unspecified unspecified 0 
26 משברי משבר ומשברי noun masculine plural construct unspecified unspecified  	O	null
27 אמון אמון אמון noun masculine singular absolute unspecified unspecified  	O	null
28 . . . punctuation unspecified unspecified unspecified unspecified unspecified  	O	null

0 כעבור כעבור כעבור preposition unspecified unspecified unspecified unspecified unspecified  	O	null
1 שנה שנה שנה noun feminine singular absolute unspecified unspecified  	O	null
2 התפרסם התפרסם התפרסם verb masculine singular unspecified 3 past  	O	null
3 ספר ספר ספרה noun masculine singular absolute unspecified unspecified  
3 ה ה ספרה possessive feminine singular unspecified 3 unspecified 0 	O	null
4 ה ה החמישי definiteArticle unspecified unspecified unspecified unspecified unspecified 0 
4 החמישי ORD5 החמישי numeral masculine singular absolute unspecified unspecified  	O	null
5 , , , punctuation unspecified unspecified unspecified unspecified unspecified  	O	null
6 ה ה המערבולת definiteArticle unspecified unspecified unspecified unspecified unspecified 0 
6 המערבולת מערבולת המערבולת noun feminine singular absolute unspecified unspecified  	O	null
7 , , , punctuation unspecified unspecified unspecified unspecified unspecified  	O	null
8 ספר ספר ספר noun masculine singular construct unspecified unspecified  	O	null
9 מתח מתח מתח noun masculine singular absolute unspecified unspecified  	O	null
10 על על על preposition unspecified unspecified unspecified unspecified unspecified  	O	null
11 חיפוש חיפוש חיפוש noun masculine singular absolute unspecified unspecified  	O	null
12 אוצר אוצר אוצר noun masculine singular absolute unspecified unspecified  	O	null
13 משפחתי משפחתי משפחתי adjective masculine singular absolute unspecified unspecified  	O	null
14 ש ש שנגזל relativizer/subordinatingConjunction unspecified unspecified unspecified unspecified unspecified 0 
14 נגזל נגזל שנגזל verb masculine singular unspecified 3 past  	O	null
15 על על על preposition unspecified unspecified unspecified unspecified unspecified  	O	null
16 ידי יד ידי noun feminine plural construct unspecified unspecified  	O	null
17 ה ה הנאצים definiteArticle unspecified unspecified unspecified unspecified unspecified 0 
17 הנאצים נאצי הנאצים noun masculine plural absolute unspecified unspecified  	O	null
18 ב ב במלחמת preposition unspecified unspecified unspecified unspecified unspecified 0 
18 מלחמת מלחמה במלחמת noun feminine singular construct unspecified unspecified  	O	null
19 ה ה העולם definiteArticle unspecified unspecified unspecified unspecified unspecified 0 
19 העולם עולם העולם noun masculine singular absolute unspecified unspecified  	O	null
20 ה ה השנייה definiteArticle unspecified unspecified unspecified unspecified unspecified 0 
20 השנייה ORD2 השנייה numeral feminine singular absolute unspecified unspecified  	O	null
21 . . . punctuation unspecified unspecified unspecified unspecified unspecified  	O	null

0 ב ב ב preposition unspecified unspecified unspecified unspecified unspecified 0 	I_ORG	null
1 - - - punctuation unspecified unspecified unspecified unspecified unspecified  	I_ORG	null
2 ###NUMBER### ###NUMBER### ###NUMBER### numeral unspecified unspecified unspecified unspecified unspecified  	I_DATE	null
3 יצא יצא יצא verb masculine singular unspecified 3 past  	O	null
4 לאור לאור לאור preposition unspecified unspecified unspecified unspecified unspecified  	O	null
5 ספר ספר ספרה noun masculine singular absolute unspecified unspecified  
5 ה ה ספרה possessive feminine singular unspecified 3 unspecified 0 	O	null
6 ה ה השישי definiteArticle unspecified unspecified unspecified unspecified unspecified 0 
6 השישי ORD6 השישי numeral masculine singular absolute unspecified unspecified  	O	null
7 , , , punctuation unspecified unspecified unspecified unspecified unspecified  	O	null
8 דיוקן דיוקן דיוקן noun masculine singular absolute unspecified unspecified  	O	null
9 הונגרי הונגרי הונגרי adjective masculine singular absolute unspecified unspecified  	O	null
10 , , , punctuation unspecified unspecified unspecified unspecified unspecified  	O	null
11 רומן רומן רומן noun masculine singular absolute unspecified unspecified  	O	null
12 היסטורי היסטורי היסטורי adjective masculine singular absolute unspecified unspecified  	O	null
13 - - - punctuation unspecified unspecified unspecified unspecified unspecified  	O	null
14 משפחתי משפחתי משפחתי adjective masculine singular absolute unspecified unspecified  	O	null
15 ה ה העוסק definiteArticle unspecified unspecified unspecified unspecified unspecified 0 
15 העוסק עסק העוסק participle masculine singular absolute any unspecified  	O	null
16 ב ב בקורותיה preposition unspecified unspecified unspecified unspecified unspecified 0 
16 קורות קורה בקורותיה noun feminine plural absolute unspecified unspecified  
16 ה ה בקורותיה possessive feminine singular unspecified 3 unspecified 0 	O	null
17 של של של shel-preposition unspecified unspecified unspecified unspecified unspecified  	O	null
18 משפחה משפחה משפחה noun feminine singular absolute unspecified unspecified  	O	null
19 הונגרית הונגרי הונגרית adjective feminine singular absolute unspecified unspecified  	O	null
20 - - - punctuation unspecified unspecified unspecified unspecified unspecified  	O	null
21 יהודית יהודי יהודית adjective feminine singular absolute unspecified unspecified  	O	null
22 סוערת סוער סוערת adjective feminine singular absolute unspecified unspecified  	O	null
23 ו ו ותוססת conjunction unspecified unspecified unspecified unspecified unspecified 0 
23 תוססת תוסס ותוססת adjective feminine singular absolute unspecified unspecified  	O	null
24 מ מ ממלחמת preposition unspecified unspecified unspecified unspecified unspecified 0 
24 מלחמת מלחמה ממלחמת noun feminine singular construct unspecified unspecified  	O	null
25 ה ה העולם definiteArticle unspecified unspecified unspecified unspecified unspecified 0 
25 העולם עולם העולם noun masculine singular absolute unspecified unspecified  	O	null
26 ה ה הראשונה definiteArticle unspecified unspecified unspecified unspecified unspecified 0 
26 הראשונה ORD1 הראשונה numeral feminine singular absolute unspecified unspecified  	O	null
27 ו ו ועד conjunction unspecified unspecified unspecified unspecified unspecified 0 
27 עד עד ועד preposition unspecified unspecified unspecified unspecified unspecified  	O	null
28 שנות שנה שנות noun feminine plural construct unspecified unspecified  	I_DATE	null
29 ה ה האלפיים definiteArticle unspecified unspecified unspecified unspecified unspecified 0 
29 האלפיים ORD-CARD2000 האלפיים numeral masculine-and-feminine dual absolute unspecified unspecified  	I_DATE	null
30 ב ב בישראל preposition unspecified unspecified unspecified unspecified unspecified 0 
30 ישראל ישראל בישראל properName unspecified unspecified unspecified unspecified unspecified  	I_LOC	null
31 . . . punctuation unspecified unspecified unspecified unspecified unspecified  	O	null

0 ספר ספר ספרה noun masculine singular absolute unspecified unspecified  
0 ה ה ספרה possessive feminine singular unspecified 3 unspecified 0 	O	null
1 ה ה השביעי definiteArticle unspecified unspecified unspecified unspecified unspecified 0 
1 השביעי ORD7 השביעי numeral masculine singular absolute unspecified unspecified  	O	null
2 , , , punctuation unspecified unspecified unspecified unspecified unspecified  	O	null
3 נחיתת נחיתה נחיתת noun feminine singular construct unspecified unspecified  	O	null
4 חירום חירום חירום noun masculine singular absolute unspecified unspecified  	O	null
5 ) ) ) punctuation unspecified unspecified unspecified unspecified unspecified  	O	null
6 , , , punctuation unspecified unspecified unspecified unspecified unspecified  	O	null
7 ###NUMBER### ###NUMBER### ###NUMBER### numeral unspecified unspecified unspecified unspecified unspecified  	I_DATE	null
8 חוזר חזר חוזר verb masculine singular unspecified any beinoni  	O	null
9 אל אל אל preposition unspecified unspecified unspecified unspecified unspecified  	O	null
10 שלוש CARD3 שלוש numeral feminine singular absolute unspecified unspecified  	O	null
11 ה ה הדיילות definiteArticle unspecified unspecified unspecified unspecified unspecified 0 
11 הדיילות דייל הדיילות noun feminine plural absolute unspecified unspecified  	O	null
12 ה ה הזכורות definiteArticle unspecified unspecified unspecified unspecified unspecified 0 
12 הזכורות זכר הזכורות participle feminine plural absolute any unspecified  	O	null
13 מ מ מהתרוממות preposition unspecified unspecified unspecified unspecified unspecified 0 
13 התרוממות התרוממות מהתרוממות noun feminine singular absolute unspecified unspecified  	O	null
14 ו ו ומתאר conjunction unspecified unspecified unspecified unspecified unspecified 0 
14 מתאר תיאר ומתאר verb masculine singular unspecified any beinoni  	O	null
15 את את את at-preposition unspecified unspecified unspecified unspecified unspecified  	O	null
16 חוויות חוויה חוויותיהן noun feminine plural absolute unspecified unspecified  
16 הן הן חוויותיהן possessive feminine plural unspecified 3 unspecified 0 	O	null
17 ו ו והסתבכויותיהן conjunction unspecified unspecified unspecified unspecified unspecified 0 
17 הסתבכויות הסתבכות והסתבכויותיהן noun feminine plural absolute unspecified unspecified  
17 הן הן והסתבכויותיהן possessive feminine plural unspecified 3 unspecified 0 	O	null
18 ב ב בדרמת preposition unspecified unspecified unspecified unspecified unspecified 0 
18 דרמת דרמה בדרמת noun feminine singular construct unspecified unspecified  	O	null
19 מתח מתח מתח noun masculine singular absolute unspecified unspecified  	O	null
20 רומנטית רומנטי רומנטית adjective feminine singular absolute unspecified unspecified  	O	null
21 ה ה המתרחשת definiteArticle unspecified unspecified unspecified unspecified unspecified 0 
21 המתרחשת התרחש המתרחשת participle feminine singular absolute any unspecified  	O	null
22 על על על preposition unspecified unspecified unspecified unspecified unspecified  	O	null
23 רקע רקע רקע noun masculine singular construct unspecified unspecified  	O	null
24 אירועי אירוע אירועי noun masculine plural construct unspecified unspecified  	O	null
25 ###NUMBER### ###NUMBER### ###NUMBER### numeral unspecified unspecified unspecified unspecified unspecified  	I_DATE	null
26 ב ב בספטמבר preposition unspecified unspecified unspecified unspecified unspecified 0 
26 ספטמבר ספטמבר בספטמבר properName unspecified unspecified unspecified unspecified unspecified  	I_DATE	null
27 ב ב בארצות preposition unspecified unspecified unspecified unspecified unspecified 0 
27 ארצות ארץ בארצות properName unspecified unspecified unspecified unspecified unspecified  	I_LOC	null
28 הברית ברית הברית properName unspecified unspecified unspecified unspecified unspecified  	I_LOC	null
29 . . . punctuation unspecified unspecified unspecified unspecified unspecified  	O	null

0 ב ב בספרה preposition unspecified unspecified unspecified unspecified unspecified 0 
0 ספר ספר בספרה noun masculine singular absolute unspecified unspecified  
0 ה ה בספרה possessive feminine singular unspecified 3 unspecified 0 	O	null
1 ה ה השמיני definiteArticle unspecified unspecified unspecified unspecified unspecified 0 
1 השמיני ORD8 השמיני numeral masculine singular absolute unspecified unspecified  	O	null
2 , , , punctuation unspecified unspecified unspecified unspecified unspecified  	O	null
3 זאבים זאב זאבים noun masculine plural absolute unspecified unspecified  	O	null
4 ב ב בשלג preposition unspecified unspecified unspecified unspecified unspecified 0 
4 שלג שלג בשלג noun masculine singular absolute unspecified unspecified  	O	null
5 ) ) ) punctuation unspecified unspecified unspecified unspecified unspecified  	O	null
6 , , , punctuation unspecified unspecified unspecified unspecified unspecified  	O	null
7 ###NUMBER### ###NUMBER### ###NUMBER### numeral unspecified unspecified unspecified unspecified unspecified  	I_DATE	null
8 שבה שב שבה verb feminine singular unspecified 3 past  	O	null
9 קראוס קראוס קראוס properName unspecified unspecified unspecified unspecified unspecified  	I_PERS	null
10 - - - properName unspecified unspecified unspecified unspecified unspecified  	I_PERS	null
11 ויינר ויינר ויינר properName unspecified unspecified unspecified unspecified unspecified  	I_PERS	null
12 אל אל אל properName unspecified unspecified unspecified unspecified unspecified  	I_PERS	null
13 הונגריה הונגריה הונגריה properName unspecified unspecified unspecified unspecified unspecified  	I_LOC	null
14 ו ו ומגוללת conjunction unspecified unspecified unspecified unspecified unspecified 0 
14 מגוללת גולל ומגוללת verb feminine singular unspecified any beinoni  	O	null
15 את את את at-preposition unspecified unspecified unspecified unspecified unspecified  	O	null
16 עלילות עלילה עלילותיה noun feminine plural absolute unspecified unspecified  
16 ה ה עלילותיה possessive feminine singular unspecified 3 unspecified 0 	O	null
17 של של של shel-preposition unspecified unspecified unspecified unspecified unspecified  	O	null
18 קבוצת קבוצה קבוצת noun feminine singular construct unspecified unspecified  	O	null
19 פרטיזנים פרטיזן פרטיזנים noun masculine plural absolute unspecified unspecified  	O	null
20 יהודים יהודי יהודים adjective masculine plural absolute unspecified unspecified  	O	null
21 , , , punctuation unspecified unspecified unspecified unspecified unspecified  	O	null
22 ש ש שהקימה relativizer/subordinatingConjunction unspecified unspecified unspecified unspecified unspecified 0 
22 הקימה הקים שהקימה verb feminine singular unspecified 3 past  	O	null
23 ב ב באחד preposition unspecified unspecified unspecified unspecified unspecified 0 
23 אחד CARD1 באחד numeral masculine singular absolute unspecified unspecified  	O	null
24 ה ה היערות definiteArticle unspecified unspecified unspecified unspecified unspecified 0 
24 היערות יער היערות noun masculine plural absolute unspecified unspecified  	O	null
25 מחנה מחנה מחנה noun masculine singular absolute unspecified unspecified  	O	null
26 ש ש ששימש relativizer/subordinatingConjunction unspecified unspecified unspecified unspecified unspecified 0 
26 שימש שימש ששימש verb masculine singular unspecified 3 past  	O	null
27 מקום מקום מקום noun masculine singular construct unspecified unspecified  	O	null
28 מפלט מפלט מפלט noun masculine singular absolute unspecified unspecified  	O	null
29 ל ל ליהודים preposition unspecified unspecified unspecified unspecified unspecified 0 
29 יהודים יהודי ליהודים noun masculine plural absolute unspecified unspecified  	O	null
30 . . . punctuation unspecified unspecified unspecified unspecified unspecified  	O	null

0 לאחר לאחר לאחר conjunction unspecified unspecified unspecified unspecified unspecified  	O	null
1 מכן מיכן מכן verb masculine singular unspecified 2 imperative  	O	null
2 הוציאה הוציא הוציאה verb feminine singular unspecified 3 past  	O	null
3 את את את at-preposition unspecified unspecified unspecified unspecified unspecified  	O	null
4 ה ה הספרים definiteArticle unspecified unspecified unspecified unspecified unspecified 0 
4 הספרים ספר הספרים noun masculine plural absolute unspecified unspecified  	O	null
5 מה מה מה interrogative unspecified unspecified unspecified unspecified unspecified  	O	null
6 ש ש שצריך relativizer/subordinatingConjunction unspecified unspecified unspecified unspecified unspecified 0 
6 צריך צריך שצריך modal masculine singular unspecified any unspecified  	O	null
7 לקרות קרה לקרות verb unspecified unspecified unspecified unspecified infinitive  	O	null
8 ) ) ) punctuation unspecified unspecified unspecified unspecified unspecified  	O	null
9 , , , punctuation unspecified unspecified unspecified unspecified unspecified  	O	null
10 כמעט כמעט כמעט adverb unspecified unspecified unspecified unspecified unspecified  	O	null
11 ###NUMBER### ###NUMBER### ###NUMBER### numeral unspecified unspecified unspecified unspecified unspecified  	I_DATE	null
12 מושלם מושלם מושלם adjective masculine singular absolute unspecified unspecified  	O	null
13 ( ( ( punctuation unspecified unspecified unspecified unspecified unspecified  	O	null
14 ###NUMBER### ###NUMBER### ###NUMBER### numeral unspecified unspecified unspecified unspecified unspecified  	I_DATE	null
15 ) ) ) punctuation unspecified unspecified unspecified unspecified unspecified  	O	null
16 ו ו ומאושרת conjunction unspecified unspecified unspecified unspecified unspecified 0 
16 מאושרת אושר ומאושרת verb feminine singular unspecified any beinoni  	O	null
17 ב ב בדרכה preposition unspecified unspecified unspecified unspecified unspecified 0 
17 דרך דרך בדרכה noun feminine singular absolute unspecified unspecified  
17 ה ה בדרכה possessive feminine singular unspecified 3 unspecified 0 	O	null
18 ) ) ) punctuation unspecified unspecified unspecified unspecified unspecified  	O	null
19 . . . punctuation unspecified unspecified unspecified unspecified unspecified  	O	null
20 ###NUMBER### ###NUMBER### ###NUMBER### numeral unspecified unspecified unspecified unspecified unspecified  	I_DATE	null
21 שייכת שייך שייכת adjective feminine singular absolute unspecified unspecified  	O	null
22 ל ל לקבוצה preposition unspecified unspecified unspecified unspecified unspecified 0 
22 ה ה לקבוצה definiteArticle unspecified unspecified unspecified unspecified unspecified 0 
22 הקבוצה קבוצה לקבוצה noun feminine singular absolute unspecified unspecified  	O	null
23 גדלה גדל גדלה verb feminine singular unspecified 3 past  	O	null
24 ו ו והולכת conjunction unspecified unspecified unspecified unspecified unspecified 0 
24 הולכת הלך והולכת verb feminine singular unspecified any beinoni  	O	null
25 של של של shel-preposition unspecified unspecified unspecified unspecified unspecified  	O	null
26 סופרים סופר סופרים noun masculine plural absolute unspecified unspecified  	O	null
27 ו ו וסופרות conjunction unspecified unspecified unspecified unspecified unspecified 0 
27 סופרות סופר וסופרות noun feminine plural absolute unspecified unspecified  	O	null
28 ישראליים ישראלי ישראליים adjective masculine plural absolute unspecified unspecified  	O	null
29 ה ה הכותבים definiteArticle unspecified unspecified unspecified unspecified unspecified 0 
29 הכותבים כתב הכותבים participle masculine plural absolute any unspecified  	O	null
30 ספרות ספרות ספרות noun feminine singular construct unspecified unspecified  	O	null
31 פנאי פנאי פנאי noun masculine singular absolute unspecified unspecified  	O	null
32 בידורית בידורי בידורית adjective feminine singular absolute unspecified unspecified  	O	null
33 קלה קל קלה adjective feminine singular absolute unspecified unspecified  	O	null
34 . . . punctuation unspecified unspecified unspecified unspecified unspecified  	O	null

0 עלילות עלילה עלילותיה noun feminine plural absolute unspecified unspecified  
0 ה ה עלילותיה possessive feminine singular unspecified 3 unspecified 0 	O	null
1 ה ה הריאליסטיות definiteArticle unspecified unspecified unspecified unspecified unspecified 0 
1 הריאליסטיות ריאליסטי הריאליסטיות adjective feminine plural absolute unspecified unspecified  	O	null
2 זורמות זרם זורמות verb feminine plural unspecified any beinoni  	O	null
3 ו ו ומלאות conjunction unspecified unspecified unspecified unspecified unspecified 0 
3 מלאות מלא ומלאות adjective feminine plural absolute unspecified unspecified  	O	null
4 תפניות תפנית תפניות noun feminine plural absolute unspecified unspecified  	O	null
5 , , , punctuation unspecified unspecified unspecified unspecified unspecified  	O	null
6 ו ו והן conjunction unspecified unspecified unspecified unspecified unspecified 0 
6 הן הוא והן pronoun feminine plural unspecified 3 unspecified  	O	null
7 מעוגנות עוגן מעוגנות verb feminine plural unspecified any beinoni  	O	null
8 ב ב בהוויה preposition unspecified unspecified unspecified unspecified unspecified 0 
8 ה ה בהוויה definiteArticle unspecified unspecified unspecified unspecified unspecified 0 
8 ההוויה הוויה בהוויה noun feminine singular absolute unspecified unspecified  	O	null
9 ה ה הישראלית definiteArticle unspecified unspecified unspecified unspecified unspecified 0 
9 הישראלית ישראלי הישראלית adjective feminine singular absolute unspecified unspecified  	O	null
10 של של של shel-preposition unspecified unspecified unspecified unspecified unspecified  	O	null
11 תקופת תקופה תקופתנו noun feminine singular absolute unspecified unspecified  
11 נו נו תקופתנו possessive masculine-and-feminine plural unspecified 1 unspecified 0 	O	null
12 . . . punctuation unspecified unspecified unspecified unspecified unspecified  	O	null

0 ה ה הדמויות definiteArticle unspecified unspecified unspecified unspecified unspecified 0 
0 הדמויות דמות הדמויות noun feminine plural absolute unspecified unspecified  	O	null
1 מפותחות מפותח מפותחות adjective feminine plural absolute unspecified unspecified  	O	null
2 , , , punctuation unspecified unspecified unspecified unspecified unspecified  	O	null
3 מערכות מערכה מערכות noun feminine plural construct unspecified unspecified  	O	null
4 ה ה היחסים definiteArticle unspecified unspecified unspecified unspecified unspecified 0 
4 היחסים יחס היחסים noun masculine plural absolute unspecified unspecified  	O	null
5 אמינות אמינות אמינות noun feminine singular absolute unspecified unspecified  	O	null
6 ו ו ושפת conjunction unspecified unspecified unspecified unspecified unspecified 0 
6 שפת שפה ושפת noun feminine singular construct unspecified unspecified  	O	null
7 ה ה הכתיבה definiteArticle unspecified unspecified unspecified unspecified unspecified 0 
7 הכתיבה כתיבה הכתיבה noun feminine singular absolute unspecified unspecified  	O	null
8 תקנית תקני תקנית adjective feminine singular absolute unspecified unspecified  	O	null
9 , , , punctuation unspecified unspecified unspecified unspecified unspecified  	O	null
10 אך אך אך conjunction unspecified unspecified unspecified unspecified unspecified  	O	null
11 לא לא לא negation unspecified unspecified unspecified unspecified unspecified  	O	null
12 גבוהה גבוה גבוהה adjective feminine singular absolute unspecified unspecified  	O	null
13 מדי מדי מדי adverb unspecified unspecified unspecified unspecified unspecified  	O	null
14 . . . punctuation unspecified unspecified unspecified unspecified unspecified  	O	null

0 References References References foreign unspecified unspecified unspecified unspecified unspecified  	O	null
1 : : : punctuation unspecified unspecified unspecified unspecified unspecified  	O	null
2 בורובסקי בורובסקי בורובסקי properName unspecified unspecified unspecified unspecified unspecified  	I_ORG	null
3 , , , punctuation unspecified unspecified unspecified unspecified unspecified  	O	null
4 דגנית דגנית דגנית properName feminine singular unspecified unspecified unspecified  	I_PERS	null
5 . . . punctuation unspecified unspecified unspecified unspecified unspecified  	O	null

0 " " " punctuation unspecified unspecified unspecified unspecified unspecified  	O	null
1 איזי איזי איזי properName unspecified unspecified unspecified unspecified unspecified  	I_PERS	null
2 הוא הוא הוא pronoun masculine singular unspecified 3 unspecified  	O	null
3 גבר גבר גבר noun masculine singular absolute unspecified unspecified  	O	null
4 ו ו והוא conjunction unspecified unspecified unspecified unspecified unspecified 0 
4 הוא הוא והוא pronoun masculine singular unspecified 3 unspecified  	O	null
5 צודק צדק צודק verb masculine singular unspecified any beinoni  	O	null
6 תמיד תמיד תמיד adverb unspecified unspecified unspecified unspecified unspecified  	O	null
7 " " " punctuation unspecified unspecified unspecified unspecified unspecified  	O	null
8 . . . punctuation unspecified unspecified unspecified unspecified unspecified  	O	null

0 מעריב מעריב מעריב properName unspecified unspecified unspecified unspecified unspecified  	I_ORG	null
1 ספרות ספרות ספרות noun feminine singular absolute unspecified unspecified  	O	null
2 . . . punctuation unspecified unspecified unspecified unspecified unspecified  	O	null

0 ###NUMEXP### ###NUMEXP### ###NUMEXP### numberExpression unspecified unspecified unspecified unspecified unspecified  	I_DATE	null
1 . . . punctuation unspecified unspecified unspecified unspecified unspecified  	O	null

0 ; ; ; punctuation unspecified unspecified unspecified unspecified unspecified  	O	null
1 ###NUMBER### ###NUMBER### ###NUMBER### numeral unspecified unspecified unspecified unspecified unspecified  	O	null
2 גלסנר גלסנר גלסנר properName unspecified unspecified unspecified unspecified unspecified  	O	null
3 , , , punctuation unspecified unspecified unspecified unspecified unspecified  	O	null
4 אריק אריק אריק properName unspecified unspecified unspecified unspecified unspecified  	I_PERS	null
5 . . . punctuation unspecified unspecified unspecified unspecified unspecified  	O	null

0 " " " punctuation unspecified unspecified unspecified unspecified unspecified  	O	null
1 צאצא צאצא צאצא noun masculine singular absolute unspecified unspecified  	O	null
2 לא לא לא negation unspecified unspecified unspecified unspecified unspecified  	O	null
3 חוקי חוקי חוקי adjective masculine singular absolute unspecified unspecified  	O	null
4 " " " punctuation unspecified unspecified unspecified unspecified unspecified  	O	null
5 . . . punctuation unspecified unspecified unspecified unspecified unspecified  	O	null
6 מעריב מעריב מעריב properName unspecified unspecified unspecified unspecified unspecified  	I_ORG	null
7 ספרות ספרות ספרות noun feminine singular absolute unspecified unspecified  	O	null
8 . . . punctuation unspecified unspecified unspecified unspecified unspecified  	O	null

0 ###NUMEXP### ###NUMEXP### ###NUMEXP### numberExpression unspecified unspecified unspecified unspecified unspecified  	I_DATE	null
1 . . . punctuation unspecified unspecified unspecified unspecified unspecified  	O	null

0 ; ; ; punctuation unspecified unspecified unspecified unspecified unspecified  	O	null
1 ###NUMBER### ###NUMBER### ###NUMBER### numeral unspecified unspecified unspecified unspecified unspecified  	O	null
2 הנדלזלץ הנדלזלץ הנדלזלץ properName unspecified unspecified unspecified unspecified unspecified  	O	null
3 , , , punctuation unspecified unspecified unspecified unspecified unspecified  	O	null
4 מיכאל מיכאל מיכאל properName unspecified unspecified unspecified unspecified unspecified  	I_PERS	null
5 . . . punctuation unspecified unspecified unspecified unspecified unspecified  	O	null

0 " " " punctuation unspecified unspecified unspecified unspecified unspecified  	O	null
1 פרופסורים פרופסור פרופסורים noun masculine plural absolute unspecified unspecified  	O	null
2 , , , punctuation unspecified unspecified unspecified unspecified unspecified  	O	null
3 פסיכולוגים פסיכולוג פסיכולוגים noun masculine plural absolute unspecified unspecified  	O	null
4 , , , punctuation unspecified unspecified unspecified unspecified unspecified  	O	null
5 עורכי עורך עורכי noun masculine plural construct unspecified unspecified  	O	null
6 דין דין דין noun masculine singular absolute unspecified unspecified  	O	null
7 ו ו ודיילות conjunction unspecified unspecified unspecified unspecified unspecified 0 
7 דיילות דיילות ודיילות noun feminine singular absolute unspecified unspecified  	O	null
8 " " " punctuation unspecified unspecified unspecified unspecified unspecified  	O	null
9 . . . punctuation unspecified unspecified unspecified unspecified unspecified  	O	null

0 ה ה הארץ definiteArticle unspecified unspecified unspecified unspecified unspecified 0 
0 הארץ ארץ הארץ noun feminine singular absolute unspecified unspecified  	O	null
1 ספרים ספר ספרים noun masculine plural absolute unspecified unspecified  	O	null
2 . . . punctuation unspecified unspecified unspecified unspecified unspecified  	O	null

0 ###NUMEXP### ###NUMEXP### ###NUMEXP### numberExpression unspecified unspecified unspecified unspecified unspecified  	I_DATE	null
1 . . . punctuation unspecified unspecified unspecified unspecified unspecified  	O	null

0 , , , punctuation unspecified unspecified unspecified unspecified unspecified  	O	null
1 ###NUMBER### ###NUMBER### ###NUMBER### numeral unspecified unspecified unspecified unspecified unspecified  	O	null
2 ###NUMBER### ###NUMBER### ###NUMBER### numeral unspecified unspecified unspecified unspecified unspecified  	O	null
3 . . . punctuation unspecified unspecified unspecified unspecified unspecified  	O	null

