0 Name Name Name foreign unspecified unspecified unspecified unspecified unspecified  	O	null
1 : : : punctuation unspecified unspecified unspecified unspecified unspecified  	O	null
2 ש ש שפינקה relativizer/subordinatingConjunction unspecified unspecified unspecified unspecified unspecified 0 
2 פינקה פינק שפינקה verb feminine singular unspecified 3 past  	O	null
3 , , , punctuation unspecified unspecified unspecified unspecified unspecified  	O	null
4 דרור דרור דרור noun masculine singular absolute unspecified unspecified  	O	null
5 Birth Birth Birth foreign unspecified unspecified unspecified unspecified unspecified  	O	null
6 Year Year Year foreign unspecified unspecified unspecified unspecified unspecified  	O	null
7 : : : punctuation unspecified unspecified unspecified unspecified unspecified  	O	null
8 ###NUMBER### ###NUMBER### ###NUMBER### numeral unspecified unspecified unspecified unspecified unspecified  	I_DATE	null
9 Birth Birth Birth foreign unspecified unspecified unspecified unspecified unspecified  	O	null
10 Place Place Place foreign unspecified unspecified unspecified unspecified unspecified  	O	null
11 : : : punctuation unspecified unspecified unspecified unspecified unspecified  	O	null
12 Occupation Occupation Occupation foreign unspecified unspecified unspecified unspecified unspecified  	O	null
13 : : : punctuation unspecified unspecified unspecified unspecified unspecified  	O	null
14 סופר סופר סופר noun masculine singular absolute unspecified unspecified  	O	null
15 Entry Entry Entry foreign unspecified unspecified unspecified unspecified unspecified  	O	null
16 writer writer writer foreign unspecified unspecified unspecified unspecified unspecified  	O	null
17 : : : punctuation unspecified unspecified unspecified unspecified unspecified  	O	null
18 גלי גלי גלי properName unspecified unspecified unspecified unspecified unspecified  	I_PERS	null
19 דרוקר דרוקר דרוקר properName unspecified unspecified unspecified unspecified unspecified  	I_PERS	null
20 בר בר בר properName unspecified unspecified unspecified unspecified unspecified  	I_PERS	null
21 - - - properName unspecified unspecified unspecified unspecified unspecified  	O	null
22 עם עם עם preposition unspecified unspecified unspecified unspecified unspecified  	O	null
23 Entry Entry Entry foreign unspecified unspecified unspecified unspecified unspecified  	O	null
24 Value Value Value foreign unspecified unspecified unspecified unspecified unspecified  	O	null
25 : : : punctuation unspecified unspecified unspecified unspecified unspecified  	O	null
26 גדל גדל גדל verb masculine singular unspecified 3 past  	I_LOC	null
27 ב ב בבת preposition unspecified unspecified unspecified unspecified unspecified 0 
27 בת בת בבת noun feminine singular construct unspecified unspecified  	I_LOC	null
28 ים ים ים properName unspecified unspecified unspecified unspecified unspecified  	I_LOC	null
29 . . . punctuation unspecified unspecified unspecified unspecified unspecified  	O	null

0 עסק עסק עסק verb masculine singular unspecified 3 past  	O	null
1 ב ב בציור preposition unspecified unspecified unspecified unspecified unspecified 0 
1 ה ה בציור definiteArticle unspecified unspecified unspecified unspecified unspecified 0 
1 הציור ציור בציור noun masculine singular absolute unspecified unspecified  	O	null
2 ו ו ועבד conjunction unspecified unspecified unspecified unspecified unspecified 0 
2 עבד עבד ועבד verb masculine singular unspecified 3 past  	O	null
3 כאר כאר כארט noun masculine singular absolute unspecified unspecified  
3 י י כארט possessive masculine-and-feminine singular unspecified 1 unspecified 0 	O	null
4 - - - punctuation unspecified unspecified unspecified unspecified unspecified  	O	null
5 דירקטור דירקטור דירקטור noun masculine singular absolute unspecified unspecified  	O	null
6 . . . punctuation unspecified unspecified unspecified unspecified unspecified  	O	null

0 החל החל החל verb masculine singular unspecified 3 past  	O	null
1 לכתוב כתב לכתוב verb unspecified unspecified unspecified unspecified infinitive  	O	null
2 ב ב בגיל preposition unspecified unspecified unspecified unspecified unspecified 0 
2 גיל גיל בגיל noun masculine singular construct unspecified unspecified  	O	null
3 עשרים ORD-CARD20 עשרים numeral masculine-and-feminine plural construct unspecified unspecified  	O	null
4 ו ו וארבע conjunction unspecified unspecified unspecified unspecified unspecified 0 
4 ארבע CARD4 וארבע numeral feminine singular absolute unspecified unspecified  	O	null
5 . . . punctuation unspecified unspecified unspecified unspecified unspecified  	O	null

0 פירסם פרסם פירסם verb masculine singular unspecified 3 past  	O	null
1 עד עד עד preposition unspecified unspecified unspecified unspecified unspecified  	O	null
2 כה כה כה adverb unspecified unspecified unspecified unspecified unspecified  	O	null
3 שני CARD2 שני numeral masculine dual construct unspecified unspecified  	O	null
4 ספרים ספר ספרים noun masculine plural absolute unspecified unspecified  	O	null
5 . . . punctuation unspecified unspecified unspecified unspecified unspecified  	O	null

0 ה ה הרומן definiteArticle unspecified unspecified unspecified unspecified unspecified 0 
0 הרומן רומן הרומן noun masculine singular absolute unspecified unspecified  	O	null
1 גוּדוֹג גוּדוֹג גוּדוֹג properName unspecified unspecified unspecified unspecified unspecified  	I_PERS	null
2 ( ( ( punctuation unspecified unspecified unspecified unspecified unspecified  	O	null
3 חלונות חלון חלונות noun masculine plural absolute unspecified unspecified  	O	null
4 , , , punctuation unspecified unspecified unspecified unspecified unspecified  	O	null
5 גוונים גוון גוונים noun masculine plural absolute unspecified unspecified  	O	null
6 , , , punctuation unspecified unspecified unspecified unspecified unspecified  	O	null
7 ) ) ) punctuation unspecified unspecified unspecified unspecified unspecified  	O	null
8 , , , punctuation unspecified unspecified unspecified unspecified unspecified  	O	null
9 ###NUMBER### ###NUMBER### ###NUMBER### numeral unspecified unspecified unspecified unspecified unspecified  	I_DATE	null
10 ש ש שהוגדר relativizer/subordinatingConjunction unspecified unspecified unspecified unspecified unspecified 0 
10 הוגדר הוגדר שהוגדר verb masculine singular unspecified 3 past  	O	null
11 כ כ כ preposition unspecified unspecified unspecified unspecified unspecified 0 	O	null
12 " " " punctuation unspecified unspecified unspecified unspecified unspecified  	O	null
13 ספר ספר ספר noun masculine singular absolute unspecified unspecified  	O	null
14 ה ה היפ-הופ definiteArticle unspecified unspecified unspecified unspecified unspecified 0 
14 היפ-הוף היפ-הוף היפ-הופ adjective masculine singular absolute unspecified unspecified  	O	null
15 " " " punctuation unspecified unspecified unspecified unspecified unspecified  	O	null
16 , , , punctuation unspecified unspecified unspecified unspecified unspecified  	O	null
17 כתוב כתוב כתוב adjective masculine singular absolute unspecified unspecified  	O	null
18 ב ב בשפה preposition unspecified unspecified unspecified unspecified unspecified 0 
18 ה ה בשפה definiteArticle unspecified unspecified unspecified unspecified unspecified 0 
18 השפה שפה בשפה noun feminine singular absolute unspecified unspecified  	O	null
19 ה ה המשלבת definiteArticle unspecified unspecified unspecified unspecified unspecified 0 
19 המשלבת שילב המשלבת participle feminine singular absolute any unspecified  	I_ORG	null
20 סלנג סלנג סלנג properName unspecified unspecified unspecified unspecified unspecified  	I_PERS	null
21 , , , punctuation unspecified unspecified unspecified unspecified unspecified  	O	null
22 בדיחות בדיחות בדיחות noun feminine singular construct unspecified unspecified  	O	null
23 מהווי היווה מהווי participle masculine plural construct any unspecified  	O	null
24 מקומי מקומי מקומי adjective masculine singular absolute unspecified unspecified  	O	null
25 ו ו והרהורים conjunction unspecified unspecified unspecified unspecified unspecified 0 
25 הרהורים הרהור והרהורים noun masculine plural absolute unspecified unspecified  	O	null
26 פילוסופיים פילוסופיים פילוסופיים adjective masculine plural absolute unspecified unspecified  	O	null
27 . . . punctuation unspecified unspecified unspecified unspecified unspecified  	O	null

0 גיבור גיבור גיבור noun masculine singular construct unspecified unspecified  	O	null
1 ה ה הרומן definiteArticle unspecified unspecified unspecified unspecified unspecified 0 
1 הרומן רומן הרומן noun masculine singular absolute unspecified unspecified  	O	null
2 , , , punctuation unspecified unspecified unspecified unspecified unspecified  	O	null
3 רפי רפי רפי properName masculine singular unspecified unspecified unspecified  	I_PERS	null
4 צו צו צול noun masculine singular absolute unspecified unspecified  
4 ו ו צול possessive masculine singular unspecified 3 unspecified 0 	O	null
5 , , , punctuation unspecified unspecified unspecified unspecified unspecified  	O	null
6 מבלה בילה מבלה verb masculine singular unspecified any beinoni  	O	null
7 את את את at-preposition unspecified unspecified unspecified unspecified unspecified  	O	null
8 ימי יום ימיו noun masculine plural absolute unspecified unspecified  
8 ו ו ימיו possessive masculine singular unspecified 3 unspecified 0 	O	null
9 ו ו ולילותיו conjunction unspecified unspecified unspecified unspecified unspecified 0 
9 לילותי לילה ולילותיו noun masculine plural absolute unspecified unspecified  
9 ו ו ולילותיו possessive masculine singular unspecified 3 unspecified 0 	O	null
10 עם עם עם preposition unspecified unspecified unspecified unspecified unspecified  	O	null
11 חברי חבר חבריו noun masculine plural absolute unspecified unspecified  
11 ו ו חבריו possessive masculine singular unspecified 3 unspecified 0 	O	null
12 ה ה המשונים definiteArticle unspecified unspecified unspecified unspecified unspecified 0 
12 המשונים שונה המשונים participle masculine plural absolute any unspecified  	O	null
13 ו ו ומנסה conjunction unspecified unspecified unspecified unspecified unspecified 0 
13 מנסה ניסה ומנסה verb masculine singular unspecified any beinoni  	O	null
14 לפרוץ פרץ לפרוץ verb unspecified unspecified unspecified unspecified infinitive  	O	null
15 גבולות גבול גבולות noun masculine plural absolute unspecified unspecified  	O	null
16 ב ב בדיבור preposition unspecified unspecified unspecified unspecified unspecified 0 
16 ה ה בדיבור definiteArticle unspecified unspecified unspecified unspecified unspecified 0 
16 הדיבור דיבור בדיבור noun masculine singular absolute unspecified unspecified  	O	null
17 ו ו ובמעשה conjunction unspecified unspecified unspecified unspecified unspecified 0 
17 ב ב ובמעשה preposition unspecified unspecified unspecified unspecified unspecified 0 
17 מעשה מעשה ובמעשה noun masculine singular absolute unspecified unspecified  	O	null
18 . . . punctuation unspecified unspecified unspecified unspecified unspecified  	O	null

0 ספר ספר ספרו noun masculine singular absolute unspecified unspecified  
0 ו ו ספרו possessive masculine singular unspecified 3 unspecified 0 	O	null
1 ה ה השני definiteArticle unspecified unspecified unspecified unspecified unspecified 0 
1 השני ORD2 השני numeral masculine singular absolute unspecified unspecified  	O	null
2 , , , punctuation unspecified unspecified unspecified unspecified unspecified  	O	null
3 סימפוניית סימפוניית סימפוניית noun feminine singular construct unspecified unspecified  	O	null
4 ה ה החולים definiteArticle unspecified unspecified unspecified unspecified unspecified 0 
4 החולים חולה החולים adjective masculine plural absolute unspecified unspecified  	O	null
5 ) ) ) punctuation unspecified unspecified unspecified unspecified unspecified  	O	null
6 , , , punctuation unspecified unspecified unspecified unspecified unspecified  	O	null
7 ###NUMBER### ###NUMBER### ###NUMBER### numeral unspecified unspecified unspecified unspecified unspecified  	I_DATE	null
8 ש ש שיצא relativizer/subordinatingConjunction unspecified unspecified unspecified unspecified unspecified 0 
8 יצא יצא שיצא verb masculine singular unspecified 3 past  	O	null
9 ב ב בהוצאה preposition unspecified unspecified unspecified unspecified unspecified 0 
9 הוצאה הוצאה בהוצאה noun feminine singular absolute unspecified unspecified  	O	null
10 עצמית עצמי עצמית adjective feminine singular absolute unspecified unspecified  	O	null
11 , , , punctuation unspecified unspecified unspecified unspecified unspecified  	O	null
12 מחזיק החזיק מחזיק verb masculine singular unspecified any beinoni  	O	null
13 שנים שנה שנים noun feminine plural absolute unspecified unspecified  	O	null
14 - - - punctuation unspecified unspecified unspecified unspecified unspecified  	O	null
15 עשר CARD10 עשר numeral feminine singular absolute unspecified unspecified  	O	null
16 סיפורים סיפור סיפורים noun masculine plural absolute unspecified unspecified  	O	null
17 קצרים קצר קצרים adjective masculine plural absolute unspecified unspecified  	O	null
18 ו ו ושיר conjunction unspecified unspecified unspecified unspecified unspecified 0 
18 שיר שיר ושיר properName unspecified unspecified unspecified unspecified unspecified  	I_PERS	null
19 , , , punctuation unspecified unspecified unspecified unspecified unspecified  	O	null
20 ה ה המוגדרים definiteArticle unspecified unspecified unspecified unspecified unspecified 0 
20 המוגדרים הוגדר המוגדרים participle masculine plural absolute any unspecified  	O	null
21 על על על preposition unspecified unspecified unspecified unspecified unspecified  	O	null
22 עטיפת עטיפה עטיפתו noun feminine singular absolute unspecified unspecified  
22 ו ו עטיפתו possessive masculine singular unspecified 3 unspecified 0 	O	null
23 כ כ כ preposition unspecified unspecified unspecified unspecified unspecified 0 	I_ORG	null
24 " " " punctuation unspecified unspecified unspecified unspecified unspecified  	I_ORG	null
25 גותיים גותיים גותיים adjective masculine plural absolute unspecified unspecified  	I_ORG	null
26 " " " punctuation unspecified unspecified unspecified unspecified unspecified  	O	null
27 , , , punctuation unspecified unspecified unspecified unspecified unspecified  	O	null
28 ו ו וככאלה conjunction unspecified unspecified unspecified unspecified unspecified 0 
28 כ כ וככאלה adverb unspecified unspecified unspecified unspecified unspecified 0 
28 כ כ וככאלה preposition unspecified unspecified unspecified unspecified unspecified 0 
28 אלה אל וככאלה noun feminine singular absolute unspecified unspecified  	O	null
29 מ מ מרבים preposition unspecified unspecified unspecified unspecified unspecified 0 
29 רבים רב מרבים adjective masculine plural absolute unspecified unspecified  	O	null
30 לעסוק עסק לעסוק verb unspecified unspecified unspecified unspecified infinitive  	O	null
31 ב ב במוות preposition unspecified unspecified unspecified unspecified unspecified 0 
31 ה ה במוות definiteArticle unspecified unspecified unspecified unspecified unspecified 0 
31 המוות מוות במוות noun masculine singular absolute unspecified unspecified  	O	null
32 , , , punctuation unspecified unspecified unspecified unspecified unspecified  	O	null
33 ב ב באפל preposition unspecified unspecified unspecified unspecified unspecified 0 
33 אפל אפל באפל adjective masculine singular absolute unspecified unspecified  	O	null
34 ו ו ובמסתורי conjunction unspecified unspecified unspecified unspecified unspecified 0 
34 ב ב ובמסתורי preposition unspecified unspecified unspecified unspecified unspecified 0 
34 מסתורי מסתורי ובמסתורי adjective masculine singular absolute unspecified unspecified  	O	null
35 . . . punctuation unspecified unspecified unspecified unspecified unspecified  	O	null

0 כל כול כל quantifier unspecified unspecified construct unspecified unspecified  	O	null
1 סיפור סיפור סיפור noun masculine singular absolute unspecified unspecified  	O	null
2 משקף שיקף משקף verb masculine singular unspecified any beinoni  	O	null
3 מצב מצב מצב noun masculine singular absolute unspecified unspecified  	O	null
4 נפשי נפשי נפשי adjective masculine singular absolute unspecified unspecified  	O	null
5 קיצוני קיצוני קיצוני adjective masculine singular absolute unspecified unspecified  	O	null
6 אחר אחר אחר adjective masculine singular absolute unspecified unspecified  	O	null
7 . . . punctuation unspecified unspecified unspecified unspecified unspecified  	O	null

0 כך כך כך adverb unspecified unspecified unspecified unspecified unspecified  	O	null
1 ל ל לדוגמה preposition unspecified unspecified unspecified unspecified unspecified 0 
1 דוגמה דוגמה לדוגמה noun feminine singular absolute unspecified unspecified  	O	null
2 , , , punctuation unspecified unspecified unspecified unspecified unspecified  	O	null
3 " " " punctuation unspecified unspecified unspecified unspecified unspecified  	O	null
4 חולות חול חולות noun masculine plural absolute unspecified unspecified  	O	null
5 פועמים פעם פועמים verb masculine plural unspecified any beinoni  	O	null
6 " " " punctuation unspecified unspecified unspecified unspecified unspecified  	O	null
7 נקרא נקרא נקרא verb masculine singular unspecified 3 past  	O	null
8 כ כ כהזיה preposition unspecified unspecified unspecified unspecified unspecified 0 
8 הזיה הזיה כהזיה noun feminine singular absolute unspecified unspecified  	O	null
9 מורבידית מורבידית מורבידית adjective feminine singular absolute unspecified unspecified  	O	null
10 ה ה הקושרת definiteArticle unspecified unspecified unspecified unspecified unspecified 0 
10 הקושרת קשר הקושרת participle feminine singular absolute any unspecified  	O	null
11 בין בין בין preposition unspecified unspecified unspecified unspecified unspecified  	O	null
12 ה ה החול definiteArticle unspecified unspecified unspecified unspecified unspecified 0 
12 החול חול החול noun masculine singular absolute unspecified unspecified  	O	null
13 על על על preposition unspecified unspecified unspecified unspecified unspecified  	O	null
14 שפת שפה שפת noun feminine singular construct unspecified unspecified  	O	null
15 ה ה הים definiteArticle unspecified unspecified unspecified unspecified unspecified 0 
15 הים ים הים noun masculine singular absolute unspecified unspecified  	O	null
16 ל ל לחול preposition unspecified unspecified unspecified unspecified unspecified 0 
16 חול חול לחול noun masculine singular construct unspecified unspecified  	O	null
17 ה ה המכסה definiteArticle unspecified unspecified unspecified unspecified unspecified 0 
17 המכסה מכסה המכסה noun feminine singular absolute unspecified unspecified  	O	null
18 גופות גופה גופות noun feminine plural absolute unspecified unspecified  	O	null
19 ב ב בקבריהן preposition unspecified unspecified unspecified unspecified unspecified 0 
19 קברי קבר בקבריהן noun masculine plural absolute unspecified unspecified  
19 הן הן בקבריהן possessive feminine plural unspecified 3 unspecified 0 	O	null
20 . . . punctuation unspecified unspecified unspecified unspecified unspecified  	O	null

0 אחדהסיפורים אחדהסיפורים אחדהסיפורים properName unspecified unspecified unspecified unspecified unspecified  	I_PERS	null
1 ה ה המוצלחים definiteArticle unspecified unspecified unspecified unspecified unspecified 0 
1 המוצלחים מוצלח המוצלחים adjective masculine plural absolute unspecified unspecified  	O	null
2 יותר יותר יותר adverb unspecified unspecified unspecified unspecified unspecified  	O	null
3 ב ב בקובץ preposition unspecified unspecified unspecified unspecified unspecified 0 
3 ה ה בקובץ definiteArticle unspecified unspecified unspecified unspecified unspecified 0 
3 הקובץ קובץ בקובץ noun masculine singular absolute unspecified unspecified  	O	null
4 הוא הוא הוא pronoun masculine singular unspecified 3 unspecified  	O	null
5 " " " punctuation unspecified unspecified unspecified unspecified unspecified  	O	null
6 חדר חדר חדר noun masculine singular absolute unspecified unspecified  	I_ORG	null
7 א א א properName unspecified unspecified unspecified unspecified unspecified  	I_ORG	null
8 ' ' ' punctuation unspecified unspecified unspecified unspecified unspecified  	O	null
9 " " " punctuation unspecified unspecified unspecified unspecified unspecified  	O	null
10 , , , punctuation unspecified unspecified unspecified unspecified unspecified  	O	null
11 ###NUMBER### ###NUMBER### ###NUMBER### numeral unspecified unspecified unspecified unspecified unspecified  	O	null
12 ה ה המתאר definiteArticle unspecified unspecified unspecified unspecified unspecified 0 
12 המתאר תיאר המתאר participle masculine singular absolute any unspecified  	O	null
13 צעיר צעיר צעיר noun masculine singular absolute unspecified unspecified  	O	null
14 ה ה המסתגר definiteArticle unspecified unspecified unspecified unspecified unspecified 0 
14 המסתגר הסתגר המסתגר participle masculine singular absolute any unspecified  	O	null
15 ב ב בחדרו preposition unspecified unspecified unspecified unspecified unspecified 0 
15 חדר חדר בחדרו noun masculine singular absolute unspecified unspecified  
15 ו ו בחדרו possessive masculine singular unspecified 3 unspecified 0 	O	null
16 כדי כדי כדי conjunction unspecified unspecified unspecified unspecified unspecified  	O	null
17 להינתק ניתק להינתק verb unspecified unspecified unspecified unspecified infinitive  	O	null
18 מ מ מהעולם preposition unspecified unspecified unspecified unspecified unspecified 0 
18 ה ה מהעולם definiteArticle unspecified unspecified unspecified unspecified unspecified 0 
18 העולם עולם מהעולם noun masculine singular absolute unspecified unspecified  	O	null
19 , , , punctuation unspecified unspecified unspecified unspecified unspecified  	O	null
20 עד עד עד preposition unspecified unspecified unspecified unspecified unspecified  	O	null
21 ל ל למותו preposition unspecified unspecified unspecified unspecified unspecified 0 
21 מות מוות למותו noun masculine singular absolute unspecified unspecified  
21 ו ו למותו possessive masculine singular unspecified 3 unspecified 0 	O	null
22 ה ה הבלתי definiteArticle unspecified unspecified unspecified unspecified unspecified 0 
22 הבלתי בלתי הבלתי wPrefix unspecified unspecified unspecified unspecified unspecified  	I_ORG	null
23 - - - punctuation unspecified unspecified unspecified unspecified unspecified  	I_ORG	null
24 צפוי צפוי צפוי adjective masculine singular absolute unspecified unspecified  	I_ORG	null
25 . . . punctuation unspecified unspecified unspecified unspecified unspecified  	O	null

0 References References References foreign unspecified unspecified unspecified unspecified unspecified  	O	null
1 : : : punctuation unspecified unspecified unspecified unspecified unspecified  	O	null

