0 Name Name Name foreign unspecified unspecified unspecified unspecified unspecified  	O	null
1 : : : punctuation unspecified unspecified unspecified unspecified unspecified  	O	null
2 ש ש שרון relativizer/subordinatingConjunction unspecified unspecified unspecified unspecified unspecified 0 
2 רון רון שרון properName unspecified unspecified unspecified unspecified unspecified  	I_LOC	null
3 , , , punctuation unspecified unspecified unspecified unspecified unspecified  	O	null
4 יוסף יוסף יוסף properName unspecified unspecified unspecified unspecified unspecified  	I_PERS	null
5 Birth Birth Birth foreign unspecified unspecified unspecified unspecified unspecified  	O	null
6 Year Year Year foreign unspecified unspecified unspecified unspecified unspecified  	O	null
7 : : : punctuation unspecified unspecified unspecified unspecified unspecified  	O	null
8 ###NUMBER### ###NUMBER### ###NUMBER### numeral unspecified unspecified unspecified unspecified unspecified  	I_DATE	null
9 Birth Birth Birth foreign unspecified unspecified unspecified unspecified unspecified  	O	null
10 Place Place Place foreign unspecified unspecified unspecified unspecified unspecified  	O	null
11 : : : punctuation unspecified unspecified unspecified unspecified unspecified  	O	null
12 גדל גדל גדל verb masculine singular unspecified 3 past  	O	null
13 ב ב ברמת preposition unspecified unspecified unspecified unspecified unspecified 0 
13 רמת רמה ברמת properName unspecified unspecified unspecified unspecified unspecified  	I_LOC	null
14 גן גן גן properName unspecified unspecified unspecified unspecified unspecified  	I_LOC	null
15 Occupation Occupation Occupation foreign unspecified unspecified unspecified unspecified unspecified  	O	null
16 : : : punctuation unspecified unspecified unspecified unspecified unspecified  	O	null
17 משורר משורר משורר noun masculine singular absolute unspecified unspecified  	O	null
18 ו ו ומבקר conjunction unspecified unspecified unspecified unspecified unspecified 0 
18 מבקר מבקר ומבקר noun masculine singular construct unspecified unspecified  	O	null
19 Entry Entry Entry foreign unspecified unspecified unspecified unspecified unspecified  	O	null
20 writer writer writer foreign unspecified unspecified unspecified unspecified unspecified  	O	null
21 : : : punctuation unspecified unspecified unspecified unspecified unspecified  	O	null
22 חנן חנן חנן properName unspecified unspecified unspecified unspecified unspecified  	I_ORG	null
23 חבר חיבר חבר verb masculine singular unspecified 2 imperative  	O	null
24 Entry Entry Entry foreign unspecified unspecified unspecified unspecified unspecified  	O	null
25 Value Value Value foreign unspecified unspecified unspecified unspecified unspecified  	O	null
26 : : : punctuation unspecified unspecified unspecified unspecified unspecified  	O	null
27 נולד נולד נולד verb masculine singular unspecified 3 past  	O	null
28 ו ו וגדל conjunction unspecified unspecified unspecified unspecified unspecified 0 
28 גדל גדל וגדל verb masculine singular unspecified 3 past  	I_LOC	null
29 ב ב ברמת preposition unspecified unspecified unspecified unspecified unspecified 0 
29 רמת רמה ברמת noun feminine singular construct unspecified unspecified  	I_LOC	null
30 גן גן גן properName unspecified unspecified unspecified unspecified unspecified  	I_LOC	null
31 . . . punctuation unspecified unspecified unspecified unspecified unspecified  	O	null

0 בן בן בן properName unspecified unspecified unspecified unspecified unspecified  	I_PERS	null
1 ש ש שמונה relativizer/subordinatingConjunction unspecified unspecified unspecified unspecified unspecified 0 
1 מונה מונה שמונה verb masculine singular unspecified 3 past  	O	null
2 הגיע הגיע הגיע verb masculine singular unspecified 3 past  	O	null
3 עם עם עם preposition unspecified unspecified unspecified unspecified unspecified  	O	null
4 משפחת משפחה משפחתו noun feminine singular absolute unspecified unspecified  
4 ו ו משפחתו possessive masculine singular unspecified 3 unspecified 0 	O	null
5 ל ל להוואנה preposition unspecified unspecified unspecified unspecified unspecified 0 
5 הוואנה הוואנה להוואנה properName unspecified unspecified unspecified unspecified unspecified  	I_LOC	null
6 , , , punctuation unspecified unspecified unspecified unspecified unspecified  	O	null
7 קובה קובה קובה properName unspecified unspecified unspecified unspecified unspecified  	I_LOC	null
8 , , , punctuation unspecified unspecified unspecified unspecified unspecified  	O	null
9 לשהות שהה לשהות verb unspecified unspecified unspecified unspecified infinitive  	O	null
10 בת בת בת noun feminine singular absolute unspecified unspecified  	O	null
11 שנתיים שנתי שנתיים adjective masculine plural absolute unspecified unspecified  	O	null
12 . . . punctuation unspecified unspecified unspecified unspecified unspecified  	O	null

0 ב ב בשובם preposition unspecified unspecified unspecified unspecified unspecified 0 
0 שוב שוב בשובם noun masculine singular absolute unspecified unspecified  
0 ם ם בשובם possessive masculine plural unspecified 3 unspecified 0 	O	null
1 ל ל לישראל preposition unspecified unspecified unspecified unspecified unspecified 0 
1 ישראל ישראל לישראל properName unspecified unspecified unspecified unspecified unspecified  	I_LOC	null
2 עברו עבר עברו verb masculine-and-feminine plural unspecified 3 past  	O	null
3 ל ל לתל preposition unspecified unspecified unspecified unspecified unspecified 0 
3 תל תל לתל properName unspecified unspecified unspecified unspecified unspecified  	I_LOC	null
4 אביב אביב אביב properName unspecified unspecified unspecified unspecified unspecified  	I_LOC	null
5 . . . punctuation unspecified unspecified unspecified unspecified unspecified  	O	null

0 התגייס התגייס התגייס verb masculine singular unspecified 3 past  	O	null
1 ל ל לצה"ל preposition unspecified unspecified unspecified unspecified unspecified 0 
1 צה"ל צה"ל לצה"ל properName unspecified unspecified unspecified unspecified unspecified  	I_ORG	null
2 ב ב ב preposition unspecified unspecified unspecified unspecified unspecified 0 	O	null
3 - - - punctuation unspecified unspecified unspecified unspecified unspecified  	O	null
4 ###NUMBER### ###NUMBER### ###NUMBER### numeral unspecified unspecified unspecified unspecified unspecified  	I_DATE	null
5 ו ו ושירת conjunction unspecified unspecified unspecified unspecified unspecified 0 
5 שירת שירת ושירת verb masculine singular unspecified 3 past  	O	null
6 כ כ כחובש preposition unspecified unspecified unspecified unspecified unspecified 0 
6 חובש חובש כחובש noun masculine singular absolute unspecified unspecified  	O	null
7 קרבי קרבי קרבי adjective masculine singular absolute unspecified unspecified  	O	null
8 ב ב בגרעין preposition unspecified unspecified unspecified unspecified unspecified 0 
8 גרעין גרעין בגרעין noun masculine singular construct unspecified unspecified  	O	null
9 נח"ל נח"ל נח"ל noun masculine singular absolute unspecified unspecified  	O	null
10 ב ב בקיבוץ preposition unspecified unspecified unspecified unspecified unspecified 0 
10 קיבוץ קיבוץ בקיבוץ noun masculine singular construct unspecified unspecified  	I_LOC	null
11 כרם כרם כרם properName unspecified unspecified unspecified unspecified unspecified  	I_LOC	null
12 שלום שלום שלום noun masculine singular absolute unspecified unspecified  	O	null
13 . . . punctuation unspecified unspecified unspecified unspecified unspecified  	O	null

0 למד למד למד verb masculine singular unspecified 3 past  	O	null
1 פילוסופיה פילוסופיה פילוסופיה noun feminine singular absolute unspecified unspecified  	O	null
2 כללית כללי כללית adjective feminine singular absolute unspecified unspecified  	O	null
3 ו ו ופילוסופיה conjunction unspecified unspecified unspecified unspecified unspecified 0 
3 פילוסופיה פילוסופיה ופילוסופיה noun feminine singular absolute unspecified unspecified  	O	null
4 יהודית יהודי יהודית adjective feminine singular absolute unspecified unspecified  	O	null
5 ל ל לתואר preposition unspecified unspecified unspecified unspecified unspecified 0 
5 תואר תואר לתואר noun masculine singular absolute unspecified unspecified  	O	null
6 ראשון ORD1 ראשון numeral masculine singular absolute unspecified unspecified  	O	null
7 ב ב באוניברסיטת preposition unspecified unspecified unspecified unspecified unspecified 0 
7 אוניברסיטת אוניברסיטה באוניברסיטת noun feminine singular construct unspecified unspecified  	I_ORG	null
8 תל תל תל properName unspecified unspecified unspecified unspecified unspecified  	I_ORG	null
9 אביב אביב אביב properName unspecified unspecified unspecified unspecified unspecified  	I_ORG	null
10 . . . punctuation unspecified unspecified unspecified unspecified unspecified  	O	null

0 לימד לימד לימד verb masculine singular unspecified 3 past  	O	null
1 שירה שירה שירה noun feminine singular absolute unspecified unspecified  	O	null
2 עברית עברי עברית adjective feminine singular absolute unspecified unspecified  	O	null
3 ו ו וביקורת conjunction unspecified unspecified unspecified unspecified unspecified 0 
3 ביקורת ביקורת וביקורת noun feminine singular construct unspecified unspecified  	O	null
4 ספרות ספרות ספרות noun feminine singular absolute unspecified unspecified  	O	null
5 ב ב באוניברסיטת preposition unspecified unspecified unspecified unspecified unspecified 0 
5 אוניברסיטת אוניברסיטה באוניברסיטת noun feminine singular construct unspecified unspecified  	I_ORG	null
6 בן בן בן properName unspecified unspecified unspecified unspecified unspecified  	I_ORG	null
7 - - - properName unspecified unspecified unspecified unspecified unspecified  	I_ORG	null
8 גוריון גוריון גוריון properName unspecified unspecified unspecified unspecified unspecified  	I_ORG	null
9 ו ו ובאוניברסיטת conjunction unspecified unspecified unspecified unspecified unspecified 0 
9 ב ב ובאוניברסיטת preposition unspecified unspecified unspecified unspecified unspecified 0 
9 אוניברסיטת אוניברסיטה ובאוניברסיטת noun feminine singular construct unspecified unspecified  	B_ORG	null
10 חיפה חיפה חיפה properName unspecified unspecified unspecified unspecified unspecified  	I_ORG	null
11 . . . punctuation unspecified unspecified unspecified unspecified unspecified  	O	null

0 השתתף השתתף השתתף verb masculine singular unspecified 3 past  	O	null
1 ב ב בפסטיבלים preposition unspecified unspecified unspecified unspecified unspecified 0 
1 פסטיבלים פסטיבל בפסטיבלים noun masculine plural absolute unspecified unspecified  	O	null
2 ב ב בארץ preposition unspecified unspecified unspecified unspecified unspecified 0 
2 ה ה בארץ definiteArticle unspecified unspecified unspecified unspecified unspecified 0 
2 הארץ ארץ בארץ noun feminine singular absolute unspecified unspecified  	O	null
3 ו ו ובעולם conjunction unspecified unspecified unspecified unspecified unspecified 0 
3 ב ב ובעולם preposition unspecified unspecified unspecified unspecified unspecified 0 
3 ה ה ובעולם definiteArticle unspecified unspecified unspecified unspecified unspecified 0 
3 העולם עולם ובעולם noun masculine singular absolute unspecified unspecified  	O	null
4 . . . punctuation unspecified unspecified unspecified unspecified unspecified  	O	null

0 שירי שיר שיריו noun masculine plural absolute unspecified unspecified  
0 ו ו שיריו possessive masculine singular unspecified 3 unspecified 0 	O	null
1 הופיעו הופיע הופיעו verb masculine-and-feminine plural unspecified 3 past  	O	null
2 ב ב בכמה preposition unspecified unspecified unspecified unspecified unspecified 0 
2 כמה כמה בכמה quantifier unspecified unspecified construct unspecified unspecified  	O	null
3 אנתולוגיות אנתולוגיות אנתולוגיות noun feminine plural absolute unspecified unspecified  	O	null
4 ו ו ותורגמו conjunction unspecified unspecified unspecified unspecified unspecified 0 
4 תורגמו תורגם ותורגמו verb masculine-and-feminine plural unspecified 3 past  	O	null
5 ל ל לכמה preposition unspecified unspecified unspecified unspecified unspecified 0 
5 כמה כמה לכמה quantifier unspecified unspecified construct unspecified unspecified  	O	null
6 שפות שפה שפות noun feminine plural absolute unspecified unspecified  	O	null
7 אירופיות אירופי אירופיות adjective feminine plural absolute unspecified unspecified  	O	null
8 . . . punctuation unspecified unspecified unspecified unspecified unspecified  	O	null

0 ב ב בשנים preposition unspecified unspecified unspecified unspecified unspecified 0 
0 שנים שנה בשנים noun feminine plural absolute unspecified unspecified  	O	null
1 ###NUMBER### ###NUMBER### ###NUMBER### numeral unspecified unspecified unspecified unspecified unspecified  	I_DATE	null
2 - - - punctuation unspecified unspecified unspecified unspecified unspecified  	O	null
3 ###NUMBER### ###NUMBER### ###NUMBER### numeral unspecified unspecified unspecified unspecified unspecified  	I_DATE	null
4 ייסד ייסד ייסד verb masculine singular unspecified 3 past  	O	null
5 את את את at-preposition unspecified unspecified unspecified unspecified unspecified  	O	null
6 כתב כתב כתב noun masculine singular construct unspecified unspecified  	O	null
7 ה ה העת definiteArticle unspecified unspecified unspecified unspecified unspecified 0 
7 העת עת העת noun feminine singular absolute unspecified unspecified  	O	null
8 רחוב רחוב רחוב noun masculine singular construct unspecified unspecified  	O	null
9 , , , punctuation unspecified unspecified unspecified unspecified unspecified  	O	null
10 תחילה תחילה תחילה adverb unspecified unspecified unspecified unspecified unspecified  	O	null
11 כ כ כעורך preposition unspecified unspecified unspecified unspecified unspecified 0 
11 עורך עורך כעורך noun masculine singular construct unspecified unspecified  	O	null
12 יחיד יחיד יחיד adjective masculine singular absolute unspecified unspecified  	O	null
13 ו ו ובהמשך conjunction unspecified unspecified unspecified unspecified unspecified 0 
13 ב ב ובהמשך preposition unspecified unspecified unspecified unspecified unspecified 0 
13 המשך המשך ובהמשך noun masculine singular absolute unspecified unspecified  	O	null
14 עם עם עם preposition unspecified unspecified unspecified unspecified unspecified  	O	null
15 נסים נסים נסים properName unspecified unspecified unspecified unspecified unspecified  	I_PERS	null
16 קלדרון קלדרון קלדרון properName unspecified unspecified unspecified unspecified unspecified  	I_PERS	null
17 ו ו וגדי conjunction unspecified unspecified unspecified unspecified unspecified 0 
17 גדי גדי וגדי properName unspecified unspecified unspecified unspecified unspecified  	B_PERS	null
18 טאוב טאוב טאוב properName unspecified unspecified unspecified unspecified unspecified  	I_PERS	null
19 . . . punctuation unspecified unspecified unspecified unspecified unspecified  	O	null

0 כמו כמו כמו conjunction unspecified unspecified unspecified unspecified unspecified  	O	null
1 כן כן כן conjunction unspecified unspecified unspecified unspecified unspecified  	O	null
2 ערך ערך ערך noun masculine singular construct unspecified unspecified  	O	null
3 חוברות חוברת חוברות noun feminine plural absolute unspecified unspecified  	O	null
4 מיוחדות מיוחד מיוחדות adjective feminine plural absolute unspecified unspecified  	O	null
5 של של של shel-preposition unspecified unspecified unspecified unspecified unspecified  	O	null
6 כתבי כתב כתבי noun masculine plural construct unspecified unspecified  	O	null
7 ה ה העת definiteArticle unspecified unspecified unspecified unspecified unspecified 0 
7 העת עת העת noun feminine singular absolute unspecified unspecified  	O	null
8 סימן סימן סימן verb masculine singular unspecified 3 past  	O	null
9 קריאה קריאה קריאה noun feminine singular absolute unspecified unspecified  	O	null
10 ו ו ופרוזה conjunction unspecified unspecified unspecified unspecified unspecified 0 
10 פרוזה פרוזה ופרוזה noun feminine singular absolute unspecified unspecified  	O	null
11 . . . punctuation unspecified unspecified unspecified unspecified unspecified  	O	null

0 תירגם תרגם תירגם verb masculine singular unspecified 3 past  	O	null
1 מ מ משירי preposition unspecified unspecified unspecified unspecified unspecified 0 
1 שירי שיר משירי noun masculine plural construct unspecified unspecified  	O	null
2 ו ו וולאס conjunction unspecified unspecified unspecified unspecified unspecified 0 
2 ולא ולא וולאס punctuation masculine singular absolute unspecified unspecified  	O	null
3 סטיבנס סטיבנס סטיבנס properName unspecified unspecified unspecified unspecified unspecified  	I_PERS	null
4 , , , punctuation unspecified unspecified unspecified unspecified unspecified  	O	null
5 עזרא עזרא עזרא properName unspecified unspecified unspecified unspecified unspecified  	I_PERS	null
6 פאונד פאונד פאונד properName unspecified unspecified unspecified unspecified unspecified  	I_PERS	null
7 , , , punctuation unspecified unspecified unspecified unspecified unspecified  	O	null
8 גיום גיום גיום properName unspecified unspecified unspecified unspecified unspecified  	I_PERS	null
9 אפולינר אפולינר אפולינר properName unspecified unspecified unspecified unspecified unspecified  	I_PERS	null
10 , , , punctuation unspecified unspecified unspecified unspecified unspecified  	O	null
11 רוברט רוברט רוברט properName unspecified unspecified unspecified unspecified unspecified  	I_PERS	null
12 לואל לואל לואל properName unspecified unspecified unspecified unspecified unspecified  	I_PERS	null
13 ו ו ואחרים conjunction unspecified unspecified unspecified unspecified unspecified 0 
13 אחרים אחר ואחרים adjective masculine plural absolute unspecified unspecified  	O	null
14 . . . punctuation unspecified unspecified unspecified unspecified unspecified  	O	null

0 ל ל לצד preposition unspecified unspecified unspecified unspecified unspecified 0 
0 צד צד לצד noun masculine singular construct unspecified unspecified  	O	null
1 ה ה הכתיבה definiteArticle unspecified unspecified unspecified unspecified unspecified 0 
1 הכתיבה כתיבה הכתיבה noun feminine singular absolute unspecified unspecified  	O	null
2 עוסק עסק עוסק verb masculine singular unspecified any beinoni  	O	null
3 ב ב בעריכת preposition unspecified unspecified unspecified unspecified unspecified 0 
3 עריכת עריכה בעריכת noun feminine singular construct unspecified unspecified  	O	null
4 עבודות עבודה עבודות noun feminine plural absolute unspecified unspecified  	O	null
5 ו ו ומחקרים conjunction unspecified unspecified unspecified unspecified unspecified 0 
5 מחקרים מחקר ומחקרים noun masculine plural absolute unspecified unspecified  	O	null
6 אקדמיים אקדמי אקדמיים adjective masculine plural absolute unspecified unspecified  	O	null
7 . . . punctuation unspecified unspecified unspecified unspecified unspecified  	O	null

0 פרסום פרסום פרסומו noun masculine singular absolute unspecified unspecified  
0 ו ו פרסומו possessive masculine singular unspecified 3 unspecified 0 	O	null
1 ה ה הראשון definiteArticle unspecified unspecified unspecified unspecified unspecified 0 
1 הראשון ORD1 הראשון numeral masculine singular absolute unspecified unspecified  	O	null
2 היה הוא היה copula masculine singular unspecified 3 past  	O	null
3 קובץ קובץ קובץ noun masculine singular construct unspecified unspecified  	O	null
4 שירים שיר שירים noun masculine plural absolute unspecified unspecified  	O	null
5 ב ב ב preposition unspecified unspecified unspecified unspecified unspecified 0 	O	null
6 " " " punctuation unspecified unspecified unspecified unspecified unspecified  	O	null
7 משא משא משא noun masculine singular absolute unspecified unspecified  	O	null
8 " " " punctuation unspecified unspecified unspecified unspecified unspecified  	O	null
9 ( ( ( punctuation unspecified unspecified unspecified unspecified unspecified  	O	null
10 דבר דבר דבר noun masculine singular absolute unspecified unspecified  	O	null
11 , , , punctuation unspecified unspecified unspecified unspecified unspecified  	O	null
12 ###NUMBER### ###NUMBER### ###NUMBER### numeral unspecified unspecified unspecified unspecified unspecified  	I_DATE	null
13 ) ) ) punctuation unspecified unspecified unspecified unspecified unspecified  	O	null
14 . . . punctuation unspecified unspecified unspecified unspecified unspecified  	O	null

0 ספר ספר ספרו noun masculine singular absolute unspecified unspecified  
0 ו ו ספרו possessive masculine singular unspecified 3 unspecified 0 	O	null
1 ה ה הראשון definiteArticle unspecified unspecified unspecified unspecified unspecified 0 
1 הראשון ORD1 הראשון numeral masculine singular absolute unspecified unspecified  	O	null
2 , , , punctuation unspecified unspecified unspecified unspecified unspecified  	O	null
3 דיבור דיבור דיבור noun masculine singular absolute unspecified unspecified  	O	null
4 ( ( ( punctuation unspecified unspecified unspecified unspecified unspecified  	O	null
5 ה ה הקיבוץ definiteArticle unspecified unspecified unspecified unspecified unspecified 0 
5 הקיבוץ קיבוץ הקיבוץ noun masculine singular absolute unspecified unspecified  	O	null
6 ה ה המאוחד definiteArticle unspecified unspecified unspecified unspecified unspecified 0 
6 המאוחד מאוחד המאוחד adjective masculine singular absolute unspecified unspecified  	O	null
7 , , , punctuation unspecified unspecified unspecified unspecified unspecified  	O	null
8 ) ) ) punctuation unspecified unspecified unspecified unspecified unspecified  	O	null
9 , , , punctuation unspecified unspecified unspecified unspecified unspecified  	O	null
10 ###NUMBER### ###NUMBER### ###NUMBER### numeral unspecified unspecified unspecified unspecified unspecified  	I_DATE	null
11 מיקם מיקם מיקם verb masculine singular unspecified 3 past  	O	null
12 את את אותו at-preposition unspecified unspecified unspecified unspecified unspecified  
12 ו ו אותו pronomial masculine singular unspecified 3 unspecified 0 	O	null
13 בין בין בין preposition unspecified unspecified unspecified unspecified unspecified  	O	null
14 ה ה המשוררים definiteArticle unspecified unspecified unspecified unspecified unspecified 0 
14 המשוררים משורר המשוררים noun masculine plural absolute unspecified unspecified  	O	null
15 ה ה הבולטים definiteArticle unspecified unspecified unspecified unspecified unspecified 0 
15 הבולטים בולט הבולטים adjective masculine plural absolute unspecified unspecified  	O	null
16 של של של shel-preposition unspecified unspecified unspecified unspecified unspecified  	O	null
17 סוף סוף סוף noun masculine singular construct unspecified unspecified  	O	null
18 שנות שנה שנות noun feminine plural construct unspecified unspecified  	O	null
19 ה ה השבעים definiteArticle unspecified unspecified unspecified unspecified unspecified 0 
19 השבעים ORD-CARD70 השבעים numeral masculine-and-feminine plural absolute unspecified unspecified  	O	null
20 ו ו ותחילת conjunction unspecified unspecified unspecified unspecified unspecified 0 
20 תחילת תחילה ותחילת noun feminine singular construct unspecified unspecified  	O	null
21 שנות שנה שנות noun feminine plural construct unspecified unspecified  	I_DATE	null
22 ה ה השמונים definiteArticle unspecified unspecified unspecified unspecified unspecified 0 
22 השמונים ORD-CARD80 השמונים numeral masculine-and-feminine plural absolute unspecified unspecified  	I_DATE	null
23 . . . punctuation unspecified unspecified unspecified unspecified unspecified  	O	null

0 ב ב במרכז preposition unspecified unspecified unspecified unspecified unspecified 0 
0 מרכז מרכז במרכז noun masculine singular construct unspecified unspecified  	O	null
1 שירי שיר שיריו noun masculine plural absolute unspecified unspecified  
1 ו ו שיריו possessive masculine singular unspecified 3 unspecified 0 	O	null
2 ה ה הראשונים definiteArticle unspecified unspecified unspecified unspecified unspecified 0 
2 הראשונים ראשונים הראשונים noun masculine plural absolute unspecified unspecified  	O	null
3 הודגשה הודגש הודגשה verb feminine singular unspecified 3 past  	O	null
4 ה ה המחויבות definiteArticle unspecified unspecified unspecified unspecified unspecified 0 
4 המחויבות מחויבות המחויבות noun feminine singular absolute unspecified unspecified  	O	null
5 ה ה העמוקה definiteArticle unspecified unspecified unspecified unspecified unspecified 0 
5 העמוקה עמוק העמוקה adjective feminine singular absolute unspecified unspecified  	O	null
6 של של שלו shel-preposition unspecified unspecified unspecified unspecified unspecified  
6 ו ו שלו pronomial masculine singular unspecified 3 unspecified 0 	O	null
7 ל ל לאדם preposition unspecified unspecified unspecified unspecified unspecified 0 
7 ה ה לאדם definiteArticle unspecified unspecified unspecified unspecified unspecified 0 
7 האדם אדם לאדם noun masculine singular absolute unspecified unspecified  	O	null
8 ה ה הקונקרטי definiteArticle unspecified unspecified unspecified unspecified unspecified 0 
8 הקונקרטי קונקרטי הקונקרטי adjective masculine singular absolute unspecified unspecified  	O	null
9 , , , punctuation unspecified unspecified unspecified unspecified unspecified  	O	null
10 תוך תוך תוך preposition unspecified unspecified unspecified unspecified unspecified  	O	null
11 הבעת הבעה הבעת noun feminine singular construct unspecified unspecified  	O	null
12 אמפתיה אמפתיה אמפתיה properName unspecified unspecified unspecified unspecified unspecified  	O	null
13 ו ו וחמלה conjunction unspecified unspecified unspecified unspecified unspecified 0 
13 חמלה חמלה וחמלה noun feminine singular absolute unspecified unspecified  	O	null
14 ב ב במה preposition unspecified unspecified unspecified unspecified unspecified 0 
14 מה מה במה interrogative unspecified unspecified unspecified unspecified unspecified  	O	null
15 ש ש שנראה relativizer/subordinatingConjunction unspecified unspecified unspecified unspecified unspecified 0 
15 נראה נראה שנראה verb masculine singular unspecified 3 past  	O	null
16 כ כ כדבקות preposition unspecified unspecified unspecified unspecified unspecified 0 
16 דבקות דבקות כדבקות noun feminine singular absolute unspecified unspecified  	O	null
17 ב ב בהומניזם preposition unspecified unspecified unspecified unspecified unspecified 0 
17 ה ה בהומניזם definiteArticle unspecified unspecified unspecified unspecified unspecified 0 
17 ההומניזם הומניזם בהומניזם noun masculine singular absolute unspecified unspecified  	O	null
18 ה ה המודרני definiteArticle unspecified unspecified unspecified unspecified unspecified 0 
18 המודרני מודרני המודרני adjective masculine singular absolute unspecified unspecified  	O	null
19 . . . punctuation unspecified unspecified unspecified unspecified unspecified  	O	null

0 תקופה תקופה תקופה noun feminine singular absolute unspecified unspecified  	O	null
1 ב ב בעיר preposition unspecified unspecified unspecified unspecified unspecified 0 
1 ה ה בעיר definiteArticle unspecified unspecified unspecified unspecified unspecified 0 
1 העיר עיר בעיר noun feminine singular absolute unspecified unspecified  	O	null
2 ( ( ( punctuation unspecified unspecified unspecified unspecified unspecified  	O	null
3 ###NUMBER### ###NUMBER### ###NUMBER### numeral unspecified unspecified unspecified unspecified unspecified  	I_DATE	null
4 ) ) ) punctuation unspecified unspecified unspecified unspecified unspecified  	O	null
5 הוא הוא הוא pronoun masculine singular unspecified 3 unspecified  	O	null
6 ספר ספר ספרו noun masculine singular absolute unspecified unspecified  
6 ו ו ספרו possessive masculine singular unspecified 3 unspecified 0 	O	null
7 ה ה השני definiteArticle unspecified unspecified unspecified unspecified unspecified 0 
7 השני ORD2 השני numeral masculine singular absolute unspecified unspecified  	O	null
8 , , , punctuation unspecified unspecified unspecified unspecified unspecified  	O	null
9 שבו ישב שבו verb masculine-and-feminine plural unspecified 2 imperative  	O	null
10 מבקש ביקש מבקש verb masculine singular unspecified any beinoni  	O	null
11 ה ה הדובר definiteArticle unspecified unspecified unspecified unspecified unspecified 0 
11 הדובר דובר הדובר noun masculine singular absolute unspecified unspecified  	O	null
12 להקפיא הקפיא להקפיא verb unspecified unspecified unspecified unspecified infinitive  	O	null
13 רגעים רגע רגעים noun masculine plural absolute unspecified unspecified  	O	null
14 של של של shel-preposition unspecified unspecified unspecified unspecified unspecified  	O	null
15 חסד חסד חסד noun masculine singular absolute unspecified unspecified  	O	null
16 על על על preposition unspecified unspecified unspecified unspecified unspecified  	O	null
17 רקע רקע רקע noun masculine singular construct unspecified unspecified  	O	null
18 מציאות מציאות מציאות noun feminine singular absolute unspecified unspecified  	O	null
19 עירונית עירוני עירונית adjective feminine singular absolute unspecified unspecified  	O	null
20 של של של shel-preposition unspecified unspecified unspecified unspecified unspecified  	O	null
21 ניכור ניכור ניכור noun masculine singular absolute unspecified unspecified  	O	null
22 ועריריות ועריריות ועריריות adjective feminine plural absolute unspecified unspecified  	O	null
23 . . . punctuation unspecified unspecified unspecified unspecified unspecified  	O	null

0 ה ה המתח definiteArticle unspecified unspecified unspecified unspecified unspecified 0 
0 המתח מתח המתח noun masculine singular absolute unspecified unspecified  	O	null
1 בין בין בין conjunction unspecified unspecified unspecified unspecified unspecified  	O	null
2 ה ה הבית definiteArticle unspecified unspecified unspecified unspecified unspecified 0 
2 הבית בית הבית noun masculine singular absolute unspecified unspecified  	O	null
3 , , , punctuation unspecified unspecified unspecified unspecified unspecified  	O	null
4 כ כ כמקום preposition unspecified unspecified unspecified unspecified unspecified 0 
4 מקום מקום כמקום noun masculine singular construct unspecified unspecified  	O	null
5 ה ה המכיל definiteArticle unspecified unspecified unspecified unspecified unspecified 0 
5 המכיל הכיל המכיל participle masculine singular absolute any unspecified  	O	null
6 חפצים חפץ חפצים noun masculine plural absolute unspecified unspecified  	O	null
7 נשכחים נשכח נשכחים verb masculine plural unspecified any beinoni  	O	null
8 ו ו וזיכרונות conjunction unspecified unspecified unspecified unspecified unspecified 0 
8 זיכרונות זיכרון וזיכרונות noun masculine plural construct unspecified unspecified  	O	null
9 מתוקים מתוק מתוקים adjective masculine plural absolute unspecified unspecified  	O	null
10 , , , punctuation unspecified unspecified unspecified unspecified unspecified  	O	null
11 ל ל לבין preposition unspecified unspecified unspecified unspecified unspecified 0 
11 ה ה לבין definiteArticle unspecified unspecified unspecified unspecified unspecified 0 
11 הבין בין לבין wPrefix unspecified unspecified unspecified unspecified unspecified  	O	null
12 ה ה החוץ definiteArticle unspecified unspecified unspecified unspecified unspecified 0 
12 החוץ חוץ החוץ noun masculine singular absolute unspecified unspecified  	O	null
13 ה ה המאופיין definiteArticle unspecified unspecified unspecified unspecified unspecified 0 
13 המאופיין אופיין המאופיין participle masculine singular absolute any unspecified  	O	null
14 ב ב בעליבותו preposition unspecified unspecified unspecified unspecified unspecified 0 
14 עליבות עליבות בעליבותו noun feminine singular absolute unspecified unspecified  
14 ו ו בעליבותו possessive masculine singular unspecified 3 unspecified 0 	O	null
15 , , , punctuation unspecified unspecified unspecified unspecified unspecified  	O	null
16 מעורר עורר מעורר verb masculine singular unspecified any beinoni  	O	null
17 את את את at-preposition unspecified unspecified unspecified unspecified unspecified  	O	null
18 ה ה האדם definiteArticle unspecified unspecified unspecified unspecified unspecified 0 
18 האדם אדם האדם noun masculine singular absolute unspecified unspecified  	O	null
19 ל ל לחשבון preposition unspecified unspecified unspecified unspecified unspecified 0 
19 חשבון חשבון לחשבון noun masculine singular construct unspecified unspecified  	O	null
20 נפש נפש נפש noun feminine singular construct unspecified unspecified  	O	null
21 , , , punctuation unspecified unspecified unspecified unspecified unspecified  	O	null
22 ש ש שמזמן relativizer/subordinatingConjunction unspecified unspecified unspecified unspecified unspecified 0 
22 מזמן מזמן שמזמן adverb unspecified unspecified unspecified unspecified unspecified  	O	null
23 לו לו לו conjunction unspecified unspecified unspecified unspecified unspecified  	O	null
24 אפשרות אפשרות אפשרות noun feminine singular construct unspecified unspecified  	O	null
25 להדליק הדליק להדליק verb unspecified unspecified unspecified unspecified infinitive  	O	null
26 מחדש מחדש מחדש adverb unspecified unspecified unspecified unspecified unspecified  	O	null
27 את את את at-preposition unspecified unspecified unspecified unspecified unspecified  	O	null
28 זיק זיק זיק properName masculine singular unspecified unspecified unspecified  	I_PERS	null
29 חיי חיים חייו noun masculine plural absolute unspecified unspecified  
29 ו ו חייו possessive masculine singular unspecified 3 unspecified 0 	O	null
30 : : : punctuation unspecified unspecified unspecified unspecified unspecified  	O	null
31 " " " punctuation unspecified unspecified unspecified unspecified unspecified  	O	null
32 ... ... ... punctuation unspecified unspecified unspecified unspecified unspecified  	O	null
33 צְרוֹר צְרוֹר צְרוֹר noun masculine singular absolute unspecified unspecified  	O	null
34 מ מ מַפְתְּחוֹת preposition unspecified unspecified unspecified unspecified unspecified 0 
34 ַפְתְּחוֹת ַפְתְּחוֹת מַפְתְּחוֹת noun masculine singular absolute unspecified unspecified  	O	null
35 יָשָׁן יָשָׁן יָשָׁן properName unspecified unspecified unspecified unspecified unspecified  	I_PERS	null
36 , , , punctuation unspecified unspecified unspecified unspecified unspecified  	O	null
37 / / / punctuation unspecified unspecified unspecified unspecified unspecified  	O	null
38 ש ש שָׁמוּר relativizer/subordinatingConjunction unspecified unspecified unspecified unspecified unspecified 0 
38 ָׁמוּר ָׁמוּר שָׁמוּר noun masculine singular absolute unspecified unspecified  	O	null
39 מֵהַרְבֵּה מֵהַרְבֵּה מֵהַרְבֵּה noun feminine singular absolute unspecified unspecified  	O	null
40 ב ב בָּתֵּי preposition unspecified unspecified unspecified unspecified unspecified 0 
40 ה ה בָּתֵּי definiteArticle unspecified unspecified unspecified unspecified unspecified 0 
40 הָּתֵּי הָּתֵּי בָּתֵּי noun masculine singular absolute unspecified unspecified  	O	null
41 מ מ מְגוּרִים preposition unspecified unspecified unspecified unspecified unspecified 0 
41 ְגוּרִים ְגוּרִים מְגוּרִים adjective masculine plural absolute unspecified unspecified  	O	null
42 ש ש שֶׁחָיִית relativizer/subordinatingConjunction unspecified unspecified unspecified unspecified unspecified 0 
42 ֶׁחָיִית ֶׁחָיִית שֶׁחָיִית noun feminine singular construct unspecified unspecified  	O	null
43 ָ ָ ָ punctuation unspecified unspecified unspecified unspecified unspecified  	O	null
44 ב ב בָּהֶם preposition unspecified unspecified unspecified unspecified unspecified 0 
44 ה ה בָּהֶם definiteArticle unspecified unspecified unspecified unspecified unspecified 0 
44 הָּהֶם הָּהֶם בָּהֶם noun masculine singular absolute unspecified unspecified  	O	null
45 , , , punctuation unspecified unspecified unspecified unspecified unspecified  	O	null
46 אוֹמֵר אוֹמֵר אוֹמֵר properName masculine singular unspecified unspecified unspecified  	I_PERS	null
47 לְך לְך לְך properName unspecified unspecified unspecified unspecified unspecified  	I_PERS	null
48 ָ ָ ָ punctuation unspecified unspecified unspecified unspecified unspecified  	O	null
49 / / / punctuation unspecified unspecified unspecified unspecified unspecified  	O	null
50 ש ש שֶׁעֲדַיִן relativizer/subordinatingConjunction unspecified unspecified unspecified unspecified unspecified 0 
50 ֶׁעֲדַיִן ֶׁעֲדַיִן שֶׁעֲדַיִן noun masculine singular absolute unspecified unspecified  	O	null
51 לֹא לֹא לֹא noun masculine singular absolute unspecified unspecified  	O	null
52 נִתְפַּכַּחְת נִתְפַּכַּחְת נִתְפַּכַּחְת properName unspecified unspecified unspecified unspecified unspecified  	I_PERS	null
53 ּ ּ ּ punctuation unspecified unspecified unspecified unspecified unspecified  	O	null
54 ָ ָ ָ punctuation unspecified unspecified unspecified unspecified unspecified  	O	null
55 ל ל לְגַמְרֵי preposition unspecified unspecified unspecified unspecified unspecified 0 
55 ְגַמְרֵי ְגַמְרֵי לְגַמְרֵי properName unspecified unspecified unspecified unspecified unspecified  	I_PERS	null
56 , , , punctuation unspecified unspecified unspecified unspecified unspecified  	O	null
57 / / / punctuation unspecified unspecified unspecified unspecified unspecified  	O	null
58 שֶׁעוֹד שֶׁעוֹד שֶׁעוֹד noun masculine singular absolute unspecified unspecified  	O	null
59 יֵש יֵש יֵש properName unspecified unspecified unspecified unspecified unspecified  	I_PERS	null
60 ׁ ׁ ׁ punctuation unspecified unspecified unspecified unspecified unspecified  	O	null
61 ב ב בְּך preposition unspecified unspecified unspecified unspecified unspecified 0 
61 ְּך ְּך בְּך properName unspecified unspecified unspecified unspecified unspecified  	I_LOC	null
62 ָ ָ ָ punctuation unspecified unspecified unspecified unspecified unspecified  	O	null
63 נְכוֹנוּת נְכוֹנוּת נְכוֹנוּת properName unspecified unspecified unspecified unspecified unspecified  	O	null
64 לְהִתְחַבֵּב לְהִתְחַבֵּב לְהִתְחַבֵּב preposition unspecified unspecified unspecified unspecified unspecified  	O	null
65 " " " punctuation unspecified unspecified unspecified unspecified unspecified  	O	null
66 ( ( ( punctuation unspecified unspecified unspecified unspecified unspecified  	O	null
67 ללא ללא ללא preposition unspecified unspecified unspecified unspecified unspecified  	O	null
68 כותרת כותרת כותרת noun feminine singular construct unspecified unspecified  	O	null
69 , , , punctuation unspecified unspecified unspecified unspecified unspecified  	O	null
70 ###NUMBER### ###NUMBER### ###NUMBER### numeral unspecified unspecified unspecified unspecified unspecified  	O	null
71 ) ) ) punctuation unspecified unspecified unspecified unspecified unspecified  	O	null
72 . . . punctuation unspecified unspecified unspecified unspecified unspecified  	O	null

0 ב ב בספרו preposition unspecified unspecified unspecified unspecified unspecified 0 
0 ספר ספר בספרו noun masculine singular absolute unspecified unspecified  
0 ו ו בספרו possessive masculine singular unspecified 3 unspecified 0 	O	null
1 סיפור סיפור סיפור noun masculine singular absolute unspecified unspecified  	O	null
2 איטי איטי איטי adjective masculine singular absolute unspecified unspecified  	O	null
3 ( ( ( punctuation unspecified unspecified unspecified unspecified unspecified  	O	null
4 ###NUMBER### ###NUMBER### ###NUMBER### numeral unspecified unspecified unspecified unspecified unspecified  	I_DATE	null
5 ) ) ) punctuation unspecified unspecified unspecified unspecified unspecified  	O	null
6 הוא הוא הוא pronoun masculine singular unspecified 3 unspecified  	O	null
7 משרטט שרטט משרטט verb masculine singular unspecified any beinoni  	O	null
8 אתרים אתר אתרים noun masculine plural absolute unspecified unspecified  	O	null
9 ב ב במציאות preposition unspecified unspecified unspecified unspecified unspecified 0 
9 מציאות מציאות במציאות noun feminine singular absolute unspecified unspecified  	O	null
10 עירונית עירוני עירונית adjective feminine singular absolute unspecified unspecified  	O	null
11 ו ו ודיוקנאות conjunction unspecified unspecified unspecified unspecified unspecified 0 
11 דיוקנאות דיוקן ודיוקנאות noun masculine plural absolute unspecified unspecified  	O	null
12 מדוקדקים מדוקדק מדוקדקים adjective masculine plural absolute unspecified unspecified  	O	null
13 של של של shel-preposition unspecified unspecified unspecified unspecified unspecified  	O	null
14 משוררים משורר משוררים noun masculine plural absolute unspecified unspecified  	O	null
15 , , , punctuation unspecified unspecified unspecified unspecified unspecified  	O	null
16 סופרים סופר סופרים noun masculine plural absolute unspecified unspecified  	O	null
17 ו ו וציירים conjunction unspecified unspecified unspecified unspecified unspecified 0 
17 ציירים צייר וציירים noun masculine plural absolute unspecified unspecified  	O	null
18 , , , punctuation unspecified unspecified unspecified unspecified unspecified  	O	null
19 תוך תוך תוך preposition unspecified unspecified unspecified unspecified unspecified  	O	null
20 מתן מתן מתן noun masculine singular construct unspecified unspecified  	O	null
21 ביטוי ביטוי ביטוי noun masculine singular absolute unspecified unspecified  	O	null
22 ל ל לרגישות preposition unspecified unspecified unspecified unspecified unspecified 0 
22 רגישות רגישות לרגישות noun feminine singular construct unspecified unspecified  	O	null
23 ה ה השירה definiteArticle unspecified unspecified unspecified unspecified unspecified 0 
23 השירה שירה השירה noun feminine singular absolute unspecified unspecified  	O	null
24 ל ל לאמנות preposition unspecified unspecified unspecified unspecified unspecified 0 
24 ה ה לאמנות definiteArticle unspecified unspecified unspecified unspecified unspecified 0 
24 האמנות אמנות לאמנות noun feminine singular absolute unspecified unspecified  	O	null
25 ה ה הפלסטית definiteArticle unspecified unspecified unspecified unspecified unspecified 0 
25 הפלסטית פלסטי הפלסטית adjective feminine singular absolute unspecified unspecified  	O	null
26 . . . punctuation unspecified unspecified unspecified unspecified unspecified  	O	null

0 " " " punctuation unspecified unspecified unspecified unspecified unspecified  	O	null
1 ה ה הסיפורים definiteArticle unspecified unspecified unspecified unspecified unspecified 0 
1 הסיפורים סיפור הסיפורים noun masculine plural absolute unspecified unspecified  	O	null
2 ה ה האיטיים definiteArticle unspecified unspecified unspecified unspecified unspecified 0 
2 האיטיים איטי האיטיים adjective masculine plural absolute unspecified unspecified  	O	null
3 " " " punctuation unspecified unspecified unspecified unspecified unspecified  	O	null
4 ש ש שמאחורי relativizer/subordinatingConjunction unspecified unspecified unspecified unspecified unspecified 0 
4 מאחורי מאחורי שמאחורי preposition unspecified unspecified unspecified unspecified unspecified  	O	null
5 ה ה השירים definiteArticle unspecified unspecified unspecified unspecified unspecified 0 
5 השירים שיר השירים noun masculine plural absolute unspecified unspecified  	O	null
6 עוקבים עקב עוקבים verb masculine plural unspecified any beinoni  	O	null
7 אחר אחר אחר preposition unspecified unspecified unspecified unspecified unspecified  	O	null
8 דמויות דמות דמויות noun feminine plural absolute unspecified unspecified  	O	null
9 שונות שונה שונות adjective feminine plural absolute unspecified unspecified  	O	null
10 מ מ מהמעגל preposition unspecified unspecified unspecified unspecified unspecified 0 
10 ה ה מהמעגל definiteArticle unspecified unspecified unspecified unspecified unspecified 0 
10 המעגל מעגל מהמעגל noun masculine singular absolute unspecified unspecified  	O	null
11 ה ה המשפחתי definiteArticle unspecified unspecified unspecified unspecified unspecified 0 
11 המשפחתי משפחתי המשפחתי adjective masculine singular absolute unspecified unspecified  	O	null
12 , , , punctuation unspecified unspecified unspecified unspecified unspecified  	O	null
13 לצד לצד לצד preposition unspecified unspecified unspecified unspecified unspecified  	O	null
14 דמויות דמות דמויות noun feminine plural absolute unspecified unspecified  	O	null
15 מזדמנות הזדמן מזדמנות verb feminine plural unspecified any beinoni  	O	null
16 , , , punctuation unspecified unspecified unspecified unspecified unspecified  	O	null
17 ב ב ברגעים preposition unspecified unspecified unspecified unspecified unspecified 0 
17 ה ה ברגעים definiteArticle unspecified unspecified unspecified unspecified unspecified 0 
17 הרגעים רגע ברגעים noun masculine plural absolute unspecified unspecified  	O	null
18 ה ה הקטנים definiteArticle unspecified unspecified unspecified unspecified unspecified 0 
18 הקטנים קטן הקטנים adjective masculine plural absolute unspecified unspecified  	O	null
19 של של של shel-preposition unspecified unspecified unspecified unspecified unspecified  	O	null
20 חיי חיים חייהן noun masculine plural absolute unspecified unspecified  
20 הן הן חייהן possessive feminine plural unspecified 3 unspecified 0 	O	null
21 . . . punctuation unspecified unspecified unspecified unspecified unspecified  	O	null

0 מתוך מתוך מתוך preposition unspecified unspecified unspecified unspecified unspecified  	O	null
1 התקרבות התקרבות התקרבות noun feminine singular absolute unspecified unspecified  	O	null
2 זהירה זהיר זהירה adjective feminine singular absolute unspecified unspecified  	O	null
3 מרכיב מרכיב מרכיב noun masculine singular construct unspecified unspecified  	O	null
4 ה ה הדובר definiteArticle unspecified unspecified unspecified unspecified unspecified 0 
4 הדובר דובר הדובר noun masculine singular absolute unspecified unspecified  	O	null
5 סיפור סיפור סיפור noun masculine singular absolute unspecified unspecified  	O	null
6 ו ו ועולם conjunction unspecified unspecified unspecified unspecified unspecified 0 
6 עולם עולם ועולם noun masculine singular absolute unspecified unspecified  	O	null
7 , , , punctuation unspecified unspecified unspecified unspecified unspecified  	O	null
8 ש ש שבאמצעותם relativizer/subordinatingConjunction unspecified unspecified unspecified unspecified unspecified 0 
8 באמצעות באמצעות שבאמצעותם preposition unspecified unspecified unspecified unspecified unspecified  
8 הם הם שבאמצעותם pronomial masculine plural unspecified 3 unspecified 0 	O	null
9 הוא הוא הוא pronoun masculine singular unspecified 3 unspecified  	O	null
10 שח שח שח verb masculine singular unspecified 3 past  	O	null
11 עם עם עם preposition unspecified unspecified unspecified unspecified unspecified  	O	null
12 ה ה הדמויות definiteArticle unspecified unspecified unspecified unspecified unspecified 0 
12 הדמויות דמות הדמויות noun feminine plural absolute unspecified unspecified  	O	null
13 ב ב במה preposition unspecified unspecified unspecified unspecified unspecified 0 
13 מה מה במה interrogative unspecified unspecified unspecified unspecified unspecified  	O	null
14 ש ש שהופך relativizer/subordinatingConjunction unspecified unspecified unspecified unspecified unspecified 0 
14 הופך הפך שהופך verb masculine singular unspecified any beinoni  	O	null
15 ל ל לדיבור preposition unspecified unspecified unspecified unspecified unspecified 0 
15 ה ה לדיבור definiteArticle unspecified unspecified unspecified unspecified unspecified 0 
15 הדיבור דיבור לדיבור noun masculine singular absolute unspecified unspecified  	O	null
16 עם עם עם preposition unspecified unspecified unspecified unspecified unspecified  	O	null
17 עצמו עצמו עצמו pronoun unspecified unspecified unspecified unspecified unspecified  
17 ו ו עצמו pronomial masculine singular unspecified 3 unspecified 0 	O	null
18 . . . punctuation unspecified unspecified unspecified unspecified unspecified  	O	null

0 ה ה היורשים definiteArticle unspecified unspecified unspecified unspecified unspecified 0 
0 היורשים יורש היורשים noun masculine plural absolute unspecified unspecified  	O	null
1 ) ) ) punctuation unspecified unspecified unspecified unspecified unspecified  	O	null
2 , , , punctuation unspecified unspecified unspecified unspecified unspecified  	O	null
3 ###NUMBER### ###NUMBER### ###NUMBER### numeral unspecified unspecified unspecified unspecified unspecified  	I_DATE	null
4 ספר ספר ספרו noun masculine singular absolute unspecified unspecified  
4 ו ו ספרו possessive masculine singular unspecified 3 unspecified 0 	O	null
5 ה ה הרביעי definiteArticle unspecified unspecified unspecified unspecified unspecified 0 
5 הרביעי ORD4 הרביעי numeral masculine singular absolute unspecified unspecified  	O	null
6 , , , punctuation unspecified unspecified unspecified unspecified unspecified  	O	null
7 כתוב כתוב כתוב adjective masculine singular absolute unspecified unspecified  	O	null
8 כ כ כפואמה preposition unspecified unspecified unspecified unspecified unspecified 0 
8 ה ה כפואמה definiteArticle unspecified unspecified unspecified unspecified unspecified 0 
8 הפואמה פואמה כפואמה noun feminine singular absolute unspecified unspecified  	O	null
9 מחולקת חולק מחולקת verb feminine singular unspecified any beinoni  	O	null
10 ל ל לפרקים preposition unspecified unspecified unspecified unspecified unspecified 0 
10 פרקים פארק לפרקים noun masculine plural absolute unspecified unspecified  	O	null
11 , , , punctuation unspecified unspecified unspecified unspecified unspecified  	O	null
12 ו ו ובה conjunction unspecified unspecified unspecified unspecified unspecified 0 
12 ב ב ובה preposition unspecified unspecified unspecified unspecified unspecified  
12 ה ה ובה pronomial feminine singular unspecified 3 unspecified 0 	O	null
13 הוא הוא הוא pronoun masculine singular unspecified 3 unspecified  	O	null
14 משחזר שחזר משחזר verb masculine singular unspecified any beinoni  	O	null
15 קולות קול קולות noun masculine plural absolute unspecified unspecified  	O	null
16 של של של shel-preposition unspecified unspecified unspecified unspecified unspecified  	O	null
17 בני בן בני noun masculine plural construct unspecified unspecified  	O	null
18 ה ה המשפחה definiteArticle unspecified unspecified unspecified unspecified unspecified 0 
18 המשפחה משפחה המשפחה noun feminine singular absolute unspecified unspecified  	O	null
19 , , , punctuation unspecified unspecified unspecified unspecified unspecified  	O	null
20 על על על preposition unspecified unspecified unspecified unspecified unspecified  	O	null
21 ה ה הפרספקטיבות definiteArticle unspecified unspecified unspecified unspecified unspecified 0 
21 הפרספקטיבות פרספקטיבה הפרספקטיבות noun feminine plural absolute unspecified unspecified  	O	null
22 ה ה השונות definiteArticle unspecified unspecified unspecified unspecified unspecified 0 
22 השונות שונה השונות adjective feminine plural absolute unspecified unspecified  	O	null
23 של של שלהם shel-preposition unspecified unspecified unspecified unspecified unspecified  
23 הם הם שלהם pronomial masculine plural unspecified 3 unspecified 0 	O	null
24 . . . punctuation unspecified unspecified unspecified unspecified unspecified  	O	null

0 ה ה המציאות definiteArticle unspecified unspecified unspecified unspecified unspecified 0 
0 המציאות מציאות המציאות noun feminine singular absolute unspecified unspecified  	O	null
1 ה ה הישראלית definiteArticle unspecified unspecified unspecified unspecified unspecified 0 
1 הישראלית ישראלי הישראלית adjective feminine singular absolute unspecified unspecified  	O	null
2 משתברת השתבר משתברת participle feminine singular construct any unspecified  	O	null
3 ב ב בקול preposition unspecified unspecified unspecified unspecified unspecified 0 
3 ה ה בקול definiteArticle unspecified unspecified unspecified unspecified unspecified 0 
3 הקול קול בקול noun masculine singular absolute unspecified unspecified  	O	null
4 ה ה הפרטי definiteArticle unspecified unspecified unspecified unspecified unspecified 0 
4 הפרטי פרטי הפרטי adjective masculine singular absolute unspecified unspecified  	O	null
5 , , , punctuation unspecified unspecified unspecified unspecified unspecified  	O	null
6 ו ו ונוצרת conjunction unspecified unspecified unspecified unspecified unspecified 0 
6 נוצרת נצר ונוצרת verb feminine singular unspecified any beinoni  	O	null
7 מציאות מציאות מציאות noun feminine singular absolute unspecified unspecified  	O	null
8 שירית שירי שירית adjective feminine singular absolute unspecified unspecified  	O	null
9 של של של shel-preposition unspecified unspecified unspecified unspecified unspecified  	O	null
10 זיכרון זיכרון זיכרון noun masculine singular absolute unspecified unspecified  	O	null
11 . . . punctuation unspecified unspecified unspecified unspecified unspecified  	O	null

0 ה ה המשורר definiteArticle unspecified unspecified unspecified unspecified unspecified 0 
0 המשורר משורר המשורר noun masculine singular absolute unspecified unspecified  	O	null
1 אורי אורי אורי properName unspecified unspecified unspecified unspecified unspecified  	I_PERS	null
2 ברנשטיין ברנשטיין ברנשטיין properName unspecified unspecified unspecified unspecified unspecified  	I_PERS	null
3 ( ( ( punctuation unspecified unspecified unspecified unspecified unspecified  	O	null
4 ###NUMBER### ###NUMBER### ###NUMBER### numeral unspecified unspecified unspecified unspecified unspecified  	I_DATE	null
5 - - - punctuation unspecified unspecified unspecified unspecified unspecified  	O	null
6 ###NUMBER### ###NUMBER### ###NUMBER### numeral unspecified unspecified unspecified unspecified unspecified  	I_DATE	null
7 ) ) ) punctuation unspecified unspecified unspecified unspecified unspecified  	O	null
8 הגדיר הגדיר הגדיר verb masculine singular unspecified 3 past  	O	null
9 את את את at-preposition unspecified unspecified unspecified unspecified unspecified  	O	null
10 שירת שירה שירתו noun feminine singular absolute unspecified unspecified  
10 ו ו שירתו possessive masculine singular unspecified 3 unspecified 0 	O	null
11 כ כ כשירה preposition unspecified unspecified unspecified unspecified unspecified 0 
11 שירה שירה כשירה noun feminine singular absolute unspecified unspecified  	O	null
12 של של של shel-preposition unspecified unspecified unspecified unspecified unspecified  	O	null
13 התבוננות התבוננות התבוננות noun feminine singular absolute unspecified unspecified  	O	null
14 ו ו וכקול conjunction unspecified unspecified unspecified unspecified unspecified 0 
14 כ כ וכקול preposition unspecified unspecified unspecified unspecified unspecified 0 
14 קול קול וכקול noun masculine singular construct unspecified unspecified  	O	null
15 " " " punctuation unspecified unspecified unspecified unspecified unspecified  	O	null
16 אישי אישי אישי adjective masculine singular absolute unspecified unspecified  	O	null
17 מאד מאוד מאד adverb unspecified unspecified unspecified unspecified unspecified  	O	null
18 , , , punctuation unspecified unspecified unspecified unspecified unspecified  	O	null
19 שקול שקול שקול adjective masculine singular absolute unspecified unspecified  	O	null
20 , , , punctuation unspecified unspecified unspecified unspecified unspecified  	O	null
21 מצוי מצוי מצוי adjective masculine singular absolute unspecified unspecified  	O	null
22 בתוך בתוך בתוך preposition unspecified unspecified unspecified unspecified unspecified  	O	null
23 עולם עולם עולם noun masculine singular absolute unspecified unspecified  	O	null
24 מסוים מסוים מסוים adjective masculine singular absolute unspecified unspecified  	O	null
25 של של של shel-preposition unspecified unspecified unspecified unspecified unspecified  	O	null
26 עצמים עצם עצמים noun masculine plural absolute unspecified unspecified  	O	null
27 , , , punctuation unspecified unspecified unspecified unspecified unspecified  	O	null
28 של של של shel-preposition unspecified unspecified unspecified unspecified unspecified  	O	null
29 תחושות תחושה תחושות noun feminine plural absolute unspecified unspecified  	O	null
30 ו ו ואירועים conjunction unspecified unspecified unspecified unspecified unspecified 0 
30 אירועים אירוע ואירועים noun masculine plural absolute unspecified unspecified  	O	null
31 מוגדרים מוגדר מוגדרים adjective masculine plural absolute unspecified unspecified  	O	null
32 . . . punctuation unspecified unspecified unspecified unspecified unspecified  	O	null

0 ה ה המלים definiteArticle unspecified unspecified unspecified unspecified unspecified 0 
0 המלים מל המלים participle masculine plural absolute any unspecified  	O	null
1 ש ש שהוא relativizer/subordinatingConjunction unspecified unspecified unspecified unspecified unspecified 0 
1 הוא הוא שהוא pronoun masculine singular unspecified 3 unspecified  	O	null
2 עושה עשה עושה verb masculine singular unspecified any beinoni  	O	null
3 ב ב בהן preposition unspecified unspecified unspecified unspecified unspecified 0 
3 הן הוא בהן pronoun feminine plural unspecified 3 unspecified  	O	null
4 שימוש שימוש שימוש noun masculine singular absolute unspecified unspecified  	O	null
5 אינן הוא אינן copula feminine plural unspecified 3 beinoni  	O	null
6 עוד עוד עוד adverb unspecified unspecified unspecified unspecified unspecified  	O	null
7 שעשוע שעשוע שעשוע noun masculine singular absolute unspecified unspecified  	O	null
8 מילולי מילולי מילולי adjective masculine singular absolute unspecified unspecified  	O	null
9 ו ו ועקר conjunction unspecified unspecified unspecified unspecified unspecified 0 
9 עקר עקר ועקר adjective masculine singular absolute unspecified unspecified  	O	null
10 , , , punctuation unspecified unspecified unspecified unspecified unspecified  	O	null
11 אלא אלא אלא conjunction unspecified unspecified unspecified unspecified unspecified  	O	null
12 אמצעי אמצעי אמצעי noun masculine singular absolute unspecified unspecified  	O	null
13 ל ל לעריכת preposition unspecified unspecified unspecified unspecified unspecified 0 
13 עריכת עריכה לעריכת noun feminine singular construct unspecified unspecified  	O	null
14 מחקר מחקר מחקר noun masculine singular absolute unspecified unspecified  	O	null
15 ממושך ממושך ממושך adjective masculine singular absolute unspecified unspecified  	O	null
16 ו ו וקשה... conjunction unspecified unspecified unspecified unspecified unspecified 0 
16 קשה... קשה... וקשה... adjective masculine singular construct unspecified unspecified  	O	null
17 שירי שיר שיריו noun masculine plural absolute unspecified unspecified  
17 ו ו שיריו possessive masculine singular unspecified 3 unspecified 0 	O	null
18 של של של shel-preposition unspecified unspecified unspecified unspecified unspecified  	O	null
19 יוסף יוסף יוסף properName unspecified unspecified unspecified unspecified unspecified  	I_PERS	null
20 שרון שרון שרון properName unspecified unspecified unspecified unspecified unspecified  	I_PERS	null
21 הם הוא הם pronoun masculine plural unspecified 3 unspecified  	O	null
22 ב ב בראש preposition unspecified unspecified unspecified unspecified unspecified 0 
22 ראש ראש בראש noun masculine singular absolute unspecified unspecified  	O	null
23 ו ו ובראשונה conjunction unspecified unspecified unspecified unspecified unspecified 0 
23 בראשונה בראשונה ובראשונה adverb unspecified unspecified unspecified unspecified unspecified  	O	null
24 שירי שיר שירי properName unspecified unspecified unspecified unspecified unspecified  	I_PERS	null
25 שיחה שיחה שיחה noun feminine singular absolute unspecified unspecified  	O	null
26 , , , punctuation unspecified unspecified unspecified unspecified unspecified  	O	null
27 שיחה שיחה שיחה noun feminine singular absolute unspecified unspecified  	O	null
28 עם עם עם preposition unspecified unspecified unspecified unspecified unspecified  	O	null
29 אדם אדם אדם noun masculine singular absolute unspecified unspecified  	O	null
30 מסוים מסוים מסוים adjective masculine singular absolute unspecified unspecified  	O	null
31 ה ה המדבר definiteArticle unspecified unspecified unspecified unspecified unspecified 0 
31 המדבר מדבר המדבר noun masculine singular absolute unspecified unspecified  	O	null
32 ב ב בקול preposition unspecified unspecified unspecified unspecified unspecified 0 
32 קול קול בקול noun masculine singular construct unspecified unspecified  	O	null
33 עצור עצור עצור noun masculine singular absolute unspecified unspecified  	O	null
34 ו ו ורגיש conjunction unspecified unspecified unspecified unspecified unspecified 0 
34 רגיש רגיש ורגיש adjective masculine singular absolute unspecified unspecified  	O	null
35 , , , punctuation unspecified unspecified unspecified unspecified unspecified  	O	null
36 ה ה הבוחן definiteArticle unspecified unspecified unspecified unspecified unspecified 0 
36 הבוחן בחן הבוחן participle masculine singular absolute any unspecified  	O	null
37 ב ב בדייקנות preposition unspecified unspecified unspecified unspecified unspecified 0 
37 דייקנות דייקנות בדייקנות noun feminine singular absolute unspecified unspecified  	O	null
38 מפתיעה מפתיע מפתיעה adjective feminine singular absolute unspecified unspecified  	O	null
39 את את את at-preposition unspecified unspecified unspecified unspecified unspecified  	O	null
40 סביביו סביביו סביביו properName unspecified unspecified unspecified unspecified unspecified  	I_PERS	null
41 . . . punctuation unspecified unspecified unspecified unspecified unspecified  	O	null

0 שיחה שיחה שיחה noun feminine singular absolute unspecified unspecified  	O	null
1 ה ה התוהה definiteArticle unspecified unspecified unspecified unspecified unspecified 0 
1 התוהה תהה התוהה participle feminine singular absolute any unspecified  	O	null
2 על על על preposition unspecified unspecified unspecified unspecified unspecified  	O	null
3 ה ה המשוחח definiteArticle unspecified unspecified unspecified unspecified unspecified 0 
3 המשוחח שוחח המשוחח participle masculine singular absolute any unspecified  	O	null
4 ו ו ועל conjunction unspecified unspecified unspecified unspecified unspecified 0 
4 על על ועל preposition unspecified unspecified unspecified unspecified unspecified  	O	null
5 בן בן בן noun masculine singular construct unspecified unspecified  	O	null
6 - - - punctuation unspecified unspecified unspecified unspecified unspecified  	O	null
7 שיח שיח שיחו noun masculine singular absolute unspecified unspecified  
7 ו ו שיחו possessive masculine singular unspecified 3 unspecified 0 	O	null
8 , , , punctuation unspecified unspecified unspecified unspecified unspecified  	O	null
9 ו ו ואינה conjunction unspecified unspecified unspecified unspecified unspecified 0 
9 אינה הוא ואינה copula feminine singular unspecified 3 beinoni  	O	null
10 מתעלמת התעלם מתעלמת verb feminine singular unspecified any beinoni  	O	null
11 אף אף אף conjunction unspecified unspecified unspecified unspecified unspecified  	O	null
12 ב ב בדקויותיה preposition unspecified unspecified unspecified unspecified unspecified 0 
12 דקויות דקות בדקויותיה noun feminine plural absolute unspecified unspecified  
12 ה ה בדקויותיה possessive feminine singular unspecified 3 unspecified 0 	O	null
13 מ מ מזה preposition unspecified unspecified unspecified unspecified unspecified 0 
13 זה זה מזה pronoun masculine singular unspecified 3 unspecified  	O	null
14 ו ו וגם conjunction unspecified unspecified unspecified unspecified unspecified 0 
14 גם גם וגם conjunction unspecified unspecified unspecified unspecified unspecified  	O	null
15 מ מ מזה preposition unspecified unspecified unspecified unspecified unspecified 0 
15 זה זה מזה pronoun masculine singular unspecified 3 unspecified  	O	null
16 . . . punctuation unspecified unspecified unspecified unspecified unspecified  	O	null

0 פתאום פתאום פתאום adverb unspecified unspecified unspecified unspecified unspecified  	O	null
1 מופיע הופיע מופיע verb masculine singular unspecified any beinoni  	O	null
2 משורר משורר משורר noun masculine singular construct unspecified unspecified  	O	null
3 ה ה האחראי definiteArticle unspecified unspecified unspecified unspecified unspecified 0 
3 האחראי אחראי האחראי noun masculine singular absolute unspecified unspecified  	O	null
4 ל ל למעשיו preposition unspecified unspecified unspecified unspecified unspecified 0 
4 מעשי מעשה למעשיו noun masculine plural absolute unspecified unspecified  
4 ו ו למעשיו possessive masculine singular unspecified 3 unspecified 0 	O	null
5 . . . punctuation unspecified unspecified unspecified unspecified unspecified  	O	null

0 ב ב בבת preposition unspecified unspecified unspecified unspecified unspecified 0 
0 בת בת בבת noun feminine singular absolute unspecified unspecified  	O	null
1 אחת CARD1 אחת numeral feminine singular absolute unspecified unspecified  	O	null
2 אין אין אין negation unspecified unspecified unspecified unspecified unspecified  	O	null
3 עוד עוד עוד adverb unspecified unspecified unspecified unspecified unspecified  	O	null
4 מלאכת מלאכה מלאכת noun feminine singular construct unspecified unspecified  	O	null
5 ה ה השיר definiteArticle unspecified unspecified unspecified unspecified unspecified 0 
5 השיר שיר השיר noun masculine singular absolute unspecified unspecified  	O	null
6 או או או conjunction unspecified unspecified unspecified unspecified unspecified  	O	null
7 ה ה האפקט definiteArticle unspecified unspecified unspecified unspecified unspecified 0 
7 האפקט אפקט האפקט noun masculine singular absolute unspecified unspecified  	O	null
8 ה ה המילולי definiteArticle unspecified unspecified unspecified unspecified unspecified 0 
8 המילולי מילולי המילולי adjective masculine singular absolute unspecified unspecified  	O	null
9 עיקר עיקר עיקר verb masculine singular unspecified 3 past  	O	null
10 , , , punctuation unspecified unspecified unspecified unspecified unspecified  	O	null
11 אלא אלא אלא conjunction unspecified unspecified unspecified unspecified unspecified  	O	null
12 ה ה השיר definiteArticle unspecified unspecified unspecified unspecified unspecified 0 
12 השיר שיר השיר noun masculine singular absolute unspecified unspecified  	O	null
13 עצמו עצמו עצמו pronoun unspecified unspecified unspecified unspecified unspecified  
13 ו ו עצמו pronomial masculine singular unspecified 3 unspecified 0 	O	null
14 , , , punctuation unspecified unspecified unspecified unspecified unspecified  	O	null
15 ה ה השיר definiteArticle unspecified unspecified unspecified unspecified unspecified 0 
15 השיר שיר השיר noun masculine singular absolute unspecified unspecified  	O	null
16 כ כ כמכשיר preposition unspecified unspecified unspecified unspecified unspecified 0 
16 ה ה כמכשיר definiteArticle unspecified unspecified unspecified unspecified unspecified 0 
16 המכשיר מכשיר כמכשיר noun masculine singular absolute unspecified unspecified  	O	null
17 לתאר תיאר לתאר verb unspecified unspecified unspecified unspecified infinitive  	O	null
18 באמצעות באמצעות באמצעותו preposition unspecified unspecified unspecified unspecified unspecified  
18 ו ו באמצעותו pronomial masculine singular unspecified 3 unspecified 0 	O	null
19 – – – punctuation unspecified unspecified unspecified unspecified unspecified  	O	null
20 ב ב בכלים preposition unspecified unspecified unspecified unspecified unspecified 0 
20 כלים כלי בכלים noun masculine plural absolute unspecified unspecified  	O	null
21 מבוגרים מבוגר מבוגרים adjective masculine plural absolute unspecified unspecified  	O	null
22 ו ו ורבי conjunction unspecified unspecified unspecified unspecified unspecified 0 
22 רבי רבי ורבי noun masculine singular construct unspecified unspecified  	O	null
23 - - - punctuation unspecified unspecified unspecified unspecified unspecified  	O	null
24 כוח כוח כוח noun masculine singular construct unspecified unspecified  	O	null
25 – – – punctuation unspecified unspecified unspecified unspecified unspecified  	O	null
26 את את את at-preposition unspecified unspecified unspecified unspecified unspecified  	O	null
27 ה ה החוץ definiteArticle unspecified unspecified unspecified unspecified unspecified 0 
27 החוץ חוץ החוץ noun masculine singular absolute unspecified unspecified  	O	null
28 : : : punctuation unspecified unspecified unspecified unspecified unspecified  	O	null
29 את את את at-preposition unspecified unspecified unspecified unspecified unspecified  	O	null
30 ה ה הריאליה definiteArticle unspecified unspecified unspecified unspecified unspecified 0 
30 הריאליה הריאליה הריאליה noun feminine singular absolute unspecified unspecified  	O	null
31 על על על preposition unspecified unspecified unspecified unspecified unspecified  	O	null
32 כל כול כל quantifier unspecified unspecified construct unspecified unspecified  	O	null
33 פרטי פרט פרטיה noun masculine plural absolute unspecified unspecified  
33 ה ה פרטיה possessive feminine singular unspecified 3 unspecified 0 	O	null
34 . . . punctuation unspecified unspecified unspecified unspecified unspecified  	O	null

0 שירים שיר שירים noun masculine plural absolute unspecified unspecified  	O	null
1 ש ש שלא relativizer/subordinatingConjunction unspecified unspecified unspecified unspecified unspecified 0 
1 לא לא שלא negation unspecified unspecified unspecified unspecified unspecified  	O	null
2 ה ה הכאב definiteArticle unspecified unspecified unspecified unspecified unspecified 0 
2 הכאב כאב הכאב noun masculine singular absolute unspecified unspecified  	O	null
3 עיקר עיקר עיקר verb masculine singular unspecified 3 past  	O	null
4 ב ב בם preposition unspecified unspecified unspecified unspecified unspecified  
4 הם הם בם pronomial masculine plural unspecified 3 unspecified 0 	O	null
5 , , , punctuation unspecified unspecified unspecified unspecified unspecified  	O	null
6 אלא אלא אלא conjunction unspecified unspecified unspecified unspecified unspecified  	O	null
7 התחקות התחקות התחקות noun feminine singular absolute unspecified unspecified  	O	null
8 אחר אחר אחר preposition unspecified unspecified unspecified unspecified unspecified  	O	null
9 שורש שורש שורשו noun masculine singular absolute unspecified unspecified  
9 ו ו שורשו possessive masculine singular unspecified 3 unspecified 0 	O	null
10 . . . punctuation unspecified unspecified unspecified unspecified unspecified  	O	null

0 בקצרה בקצרה בקצרה adverb unspecified unspecified unspecified unspecified unspecified  	O	null
1 : : : punctuation unspecified unspecified unspecified unspecified unspecified  	O	null
2 שירה שירה שירה noun feminine singular absolute unspecified unspecified  	O	null
3 ש ש שהיא relativizer/subordinatingConjunction unspecified unspecified unspecified unspecified unspecified 0 
3 היא הוא שהיא pronoun feminine singular unspecified 3 unspecified  	O	null
4 כלי כלי כלי noun masculine singular absolute unspecified unspecified  	O	null
5 להתחקות התחקה להתחקות verb unspecified unspecified unspecified unspecified infinitive  	O	null
6 בעזרת בעזרת בעזרתו preposition unspecified unspecified unspecified unspecified unspecified  
6 ו ו בעזרתו pronomial masculine singular unspecified 3 unspecified 0 	O	null
7 , , , punctuation unspecified unspecified unspecified unspecified unspecified  	O	null
8 לגלות גלה לגלות verb unspecified unspecified unspecified unspecified infinitive  	O	null
9 , , , punctuation unspecified unspecified unspecified unspecified unspecified  	O	null
10 לפענח פענח לפענח verb unspecified unspecified unspecified unspecified infinitive  	O	null
11 אולי אולי אולי adverb unspecified unspecified unspecified unspecified unspecified  	O	null
12 " " " punctuation unspecified unspecified unspecified unspecified unspecified  	O	null
13 . . . punctuation unspecified unspecified unspecified unspecified unspecified  	O	null

0 שירת שירה שירתו noun feminine singular absolute unspecified unspecified  
0 ו ו שירתו possessive masculine singular unspecified 3 unspecified 0 	O	null
1 מתאפיינת התאפיין מתאפיינת verb feminine singular unspecified any beinoni  	O	null
2 ב ב במתח preposition unspecified unspecified unspecified unspecified unspecified 0 
2 מתח מתח במתח noun masculine singular absolute unspecified unspecified  	O	null
3 אינטלקטואלי אינטלקטואלי אינטלקטואלי adjective masculine singular absolute unspecified unspecified  	O	null
4 חריף חריף חריף adjective masculine singular absolute unspecified unspecified  	O	null
5 ו ו ובמאמץ conjunction unspecified unspecified unspecified unspecified unspecified 0 
5 ב ב ובמאמץ preposition unspecified unspecified unspecified unspecified unspecified 0 
5 מאמץ מאמץ ובמאמץ noun masculine singular absolute unspecified unspecified  	O	null
6 עקבי עקבי עקבי adjective masculine singular absolute unspecified unspecified  	O	null
7 לייצר ייצר לייצר verb unspecified unspecified unspecified unspecified infinitive  	O	null
8 את את את at-preposition unspecified unspecified unspecified unspecified unspecified  	O	null
9 ה ה הטור definiteArticle unspecified unspecified unspecified unspecified unspecified 0 
9 הטור טור הטור noun masculine singular absolute unspecified unspecified  	O	null
10 ה ה השירי definiteArticle unspecified unspecified unspecified unspecified unspecified 0 
10 השירי שירי השירי adjective masculine singular absolute unspecified unspecified  	O	null
11 כ כ כנענה preposition unspecified unspecified unspecified unspecified unspecified 0 
11 נענה נענה כנענה participle masculine singular absolute any unspecified  	O	null
12 ל ל לריתמוס preposition unspecified unspecified unspecified unspecified unspecified 0 
12 ה ה לריתמוס definiteArticle unspecified unspecified unspecified unspecified unspecified 0 
12 הריתמוס הריתמוס לריתמוס noun masculine singular absolute unspecified unspecified  	O	null
13 של של של shel-preposition unspecified unspecified unspecified unspecified unspecified  	O	null
14 לשון לשון לשון noun feminine singular construct unspecified unspecified  	O	null
15 ה ה הדיבור definiteArticle unspecified unspecified unspecified unspecified unspecified 0 
15 הדיבור דיבור הדיבור noun masculine singular absolute unspecified unspecified  	O	null
16 . . . punctuation unspecified unspecified unspecified unspecified unspecified  	O	null

0 ה ה המבט definiteArticle unspecified unspecified unspecified unspecified unspecified 0 
0 המבט מבט המבט noun masculine singular absolute unspecified unspecified  	O	null
1 של של של shel-preposition unspecified unspecified unspecified unspecified unspecified  	O	null
2 ה ה הדובר definiteArticle unspecified unspecified unspecified unspecified unspecified 0 
2 הדובר דובר הדובר noun masculine singular absolute unspecified unspecified  	O	null
3 מכתיב הכתיב מכתיב verb masculine singular unspecified any beinoni  	O	null
4 ב ב באופן preposition unspecified unspecified unspecified unspecified unspecified 0 
4 אופן אופן באופן noun masculine singular absolute unspecified unspecified  	O	null
5 שיטתי שיטתי שיטתי adjective masculine singular absolute unspecified unspecified  	O	null
6 את את את at-preposition unspecified unspecified unspecified unspecified unspecified  	O	null
7 לשון לשון לשון noun feminine singular construct unspecified unspecified  	O	null
8 ה ה השיר definiteArticle unspecified unspecified unspecified unspecified unspecified 0 
8 השיר שיר השיר noun masculine singular absolute unspecified unspecified  	O	null
9 ו ו ואת conjunction unspecified unspecified unspecified unspecified unspecified 0 
9 את את ואת at-preposition unspecified unspecified unspecified unspecified unspecified  	O	null
10 ה ה המבנה definiteArticle unspecified unspecified unspecified unspecified unspecified 0 
10 המבנה מבנה המבנה noun masculine singular absolute unspecified unspecified  	O	null
11 של של שלו shel-preposition unspecified unspecified unspecified unspecified unspecified  
11 ו ו שלו pronomial masculine singular unspecified 3 unspecified 0 	O	null
12 . . . punctuation unspecified unspecified unspecified unspecified unspecified  	O	null

0 ב ב בשירו preposition unspecified unspecified unspecified unspecified unspecified 0 
0 שיר שיר בשירו noun masculine singular absolute unspecified unspecified  
0 ו ו בשירו possessive masculine singular unspecified 3 unspecified 0 	O	null
1 ה ה הנודע definiteArticle unspecified unspecified unspecified unspecified unspecified 0 
1 הנודע נודע הנודע adjective masculine singular absolute unspecified unspecified  	O	null
2 " " " punctuation unspecified unspecified unspecified unspecified unspecified  	O	null
3 ו ו ומה conjunction unspecified unspecified unspecified unspecified unspecified 0 
3 מה מה ומה interrogative unspecified unspecified unspecified unspecified unspecified  	O	null
4 נגיד נגיד נגיד properName unspecified unspecified unspecified unspecified unspecified  	I_PERS	null
5 ל ל לסוס preposition unspecified unspecified unspecified unspecified unspecified 0 
5 סוס סוס לסוס noun masculine singular absolute unspecified unspecified  	O	null
6 ב ב במלחמה preposition unspecified unspecified unspecified unspecified unspecified 0 
6 ה ה במלחמה definiteArticle unspecified unspecified unspecified unspecified unspecified 0 
6 המלחמה מלחמה במלחמה noun feminine singular absolute unspecified unspecified  	O	null
7 ה ה הבאה definiteArticle unspecified unspecified unspecified unspecified unspecified 0 
7 הבאה בא הבאה adjective feminine singular absolute unspecified unspecified  	O	null
8 ? ? ? punctuation unspecified unspecified unspecified unspecified unspecified  	O	null
9 " " " punctuation unspecified unspecified unspecified unspecified unspecified  	O	null
10 ( ( ( punctuation unspecified unspecified unspecified unspecified unspecified  	O	null
11 דיבור דיבור דיבור noun masculine singular absolute unspecified unspecified  	O	null
12 ) ) ) punctuation unspecified unspecified unspecified unspecified unspecified  	O	null
13 , , , punctuation unspecified unspecified unspecified unspecified unspecified  	O	null
14 הוא הוא הוא pronoun masculine singular unspecified 3 unspecified  	O	null
15 מפתח פיתח מפתח verb masculine singular unspecified any beinoni  	O	null
16 אמירה אמירה אמירה noun feminine singular absolute unspecified unspecified  	O	null
17 פוליטית פוליטי פוליטית adjective feminine singular absolute unspecified unspecified  	O	null
18 מורכבת מורכב מורכבת adjective feminine singular absolute unspecified unspecified  	O	null
19 , , , punctuation unspecified unspecified unspecified unspecified unspecified  	O	null
20 ה ה המתעמתת definiteArticle unspecified unspecified unspecified unspecified unspecified 0 
20 המתעמתת התעמת המתעמתת participle feminine singular absolute any unspecified  	O	null
21 עם עם עם preposition unspecified unspecified unspecified unspecified unspecified  	O	null
22 טקסטים טקסט טקסטים noun masculine plural absolute unspecified unspecified  	O	null
23 בולטים בולט בולטים adjective masculine plural absolute unspecified unspecified  	O	null
24 ב ב בשירה preposition unspecified unspecified unspecified unspecified unspecified 0 
24 ה ה בשירה definiteArticle unspecified unspecified unspecified unspecified unspecified 0 
24 השירה שירה בשירה noun feminine singular absolute unspecified unspecified  	O	null
25 ה ה העברית definiteArticle unspecified unspecified unspecified unspecified unspecified 0 
25 העברית עברי העברית adjective feminine singular absolute unspecified unspecified  	O	null
26 . . . punctuation unspecified unspecified unspecified unspecified unspecified  	O	null

0 יכולת יכולת יכולת noun feminine singular construct unspecified unspecified  	O	null
1 ה ה הדיוק definiteArticle unspecified unspecified unspecified unspecified unspecified 0 
1 הדיוק דיוק הדיוק noun masculine singular absolute unspecified unspecified  	O	null
2 של של שלו shel-preposition unspecified unspecified unspecified unspecified unspecified  
2 ו ו שלו pronomial masculine singular unspecified 3 unspecified 0 	O	null
3 ניכרת ניכר ניכרת adjective feminine singular absolute unspecified unspecified  	O	null
4 , , , punctuation unspecified unspecified unspecified unspecified unspecified  	O	null
5 למשל למשל למשל conjunction unspecified unspecified unspecified unspecified unspecified  	O	null
6 , , , punctuation unspecified unspecified unspecified unspecified unspecified  	O	null
7 ב ב בשירו preposition unspecified unspecified unspecified unspecified unspecified 0 
7 שיר שיר בשירו noun masculine singular absolute unspecified unspecified  
7 ו ו בשירו possessive masculine singular unspecified 3 unspecified 0 	O	null
8 ה ה הארוך definiteArticle unspecified unspecified unspecified unspecified unspecified 0 
8 הארוך ארוך הארוך adjective masculine singular absolute unspecified unspecified  	O	null
9 " " " punctuation unspecified unspecified unspecified unspecified unspecified  	O	null
10 חורף חורף חורף noun masculine singular absolute unspecified unspecified  	O	null
11 ב ב בבית preposition unspecified unspecified unspecified unspecified unspecified 0 
11 בית בית בבית noun masculine singular construct unspecified unspecified  	I_ORG	null
12 קפה קפה קפה noun masculine singular absolute unspecified unspecified  	I_ORG	null
13 בבוגרשוב בבוגרשוב בבוגרשוב properName unspecified unspecified unspecified unspecified unspecified  	I_ORG	null
14 " " " punctuation unspecified unspecified unspecified unspecified unspecified  	O	null
15 ( ( ( punctuation unspecified unspecified unspecified unspecified unspecified  	O	null
16 תקופה תקופה תקופה noun feminine singular absolute unspecified unspecified  	O	null
17 ב ב בעיר preposition unspecified unspecified unspecified unspecified unspecified 0 
17 ה ה בעיר definiteArticle unspecified unspecified unspecified unspecified unspecified 0 
17 העיר עיר בעיר noun feminine singular absolute unspecified unspecified  	O	null
18 ) ) ) punctuation unspecified unspecified unspecified unspecified unspecified  	O	null
19 . . . punctuation unspecified unspecified unspecified unspecified unspecified  	O	null

0 יצירת יצירה יצירתו noun feminine singular absolute unspecified unspecified  
0 ו ו יצירתו possessive masculine singular unspecified 3 unspecified 0 	O	null
1 מטשטשת טשטש מטשטשת verb feminine singular unspecified any beinoni  	O	null
2 את את את at-preposition unspecified unspecified unspecified unspecified unspecified  	O	null
3 ה ה הגבולות definiteArticle unspecified unspecified unspecified unspecified unspecified 0 
3 הגבולות גבול הגבולות noun masculine plural absolute unspecified unspecified  	O	null
4 בין בין בין preposition unspecified unspecified unspecified unspecified unspecified  	O	null
5 שירה שירה שירה noun feminine singular absolute unspecified unspecified  	O	null
6 ל ל לפרוזה preposition unspecified unspecified unspecified unspecified unspecified 0 
6 פרוזה פרוזה לפרוזה noun feminine singular absolute unspecified unspecified  	O	null
7 ו ו ובין conjunction unspecified unspecified unspecified unspecified unspecified 0 
7 בין בין ובין preposition unspecified unspecified unspecified unspecified unspecified  	O	null
8 ה ה הקונקרטי definiteArticle unspecified unspecified unspecified unspecified unspecified 0 
8 הקונקרטי קונקרטי הקונקרטי adjective masculine singular absolute unspecified unspecified  	O	null
9 ל ל למה preposition unspecified unspecified unspecified unspecified unspecified 0 
9 מה מה למה interrogative unspecified unspecified unspecified unspecified unspecified  	O	null
10 ש ש שהוא relativizer/subordinatingConjunction unspecified unspecified unspecified unspecified unspecified 0 
10 הוא הוא שהוא pronoun masculine singular unspecified 3 unspecified  	O	null
11 מעבר עיבר מעבר verb masculine singular unspecified any beinoni  	O	null
12 ל ל לו preposition unspecified unspecified unspecified unspecified unspecified  
12 ו ו לו pronomial masculine singular unspecified 3 unspecified 0 	O	null
13 . . . punctuation unspecified unspecified unspecified unspecified unspecified  	O	null

0 שירים שיר שירים noun masculine plural absolute unspecified unspecified  	O	null
1 רבים רב רבים adjective masculine plural absolute unspecified unspecified  	O	null
2 משרטטים שרטט משרטטים verb masculine plural unspecified any beinoni  	O	null
3 דיוקן דיוקן דיוקן noun masculine singular absolute unspecified unspecified  	O	null
4 של של של shel-preposition unspecified unspecified unspecified unspecified unspecified  	O	null
5 אנשים איש אנשים noun masculine plural absolute unspecified unspecified  	O	null
6 ה ה הנמצאים definiteArticle unspecified unspecified unspecified unspecified unspecified 0 
6 הנמצאים נמצא הנמצאים participle masculine plural absolute any unspecified  	O	null
7 ב ב בתנועה preposition unspecified unspecified unspecified unspecified unspecified 0 
7 ה ה בתנועה definiteArticle unspecified unspecified unspecified unspecified unspecified 0 
7 התנועה תנועה בתנועה noun feminine singular absolute unspecified unspecified  	O	null
8 , , , punctuation unspecified unspecified unspecified unspecified unspecified  	O	null
9 ב ב במעבר preposition unspecified unspecified unspecified unspecified unspecified 0 
9 מעבר מעבר במעבר noun masculine singular absolute unspecified unspecified  	O	null
10 מ מ ממצב preposition unspecified unspecified unspecified unspecified unspecified 0 
10 מצב מצב ממצב noun masculine singular absolute unspecified unspecified  	O	null
11 ממשי ממשי ממשי adjective masculine singular absolute unspecified unspecified  	O	null
12 או או או conjunction unspecified unspecified unspecified unspecified unspecified  	O	null
13 תודעתי תודעתי תודעתי adjective masculine singular absolute unspecified unspecified  	O	null
14 אחד איחד אחד verb masculine singular unspecified 3 past  	O	null
15 לאחר לאחר לאחר conjunction unspecified unspecified unspecified unspecified unspecified  	O	null
16 , , , punctuation unspecified unspecified unspecified unspecified unspecified  	O	null
17 או או או conjunction unspecified unspecified unspecified unspecified unspecified  	O	null
18 מ מ ממעשה preposition unspecified unspecified unspecified unspecified unspecified 0 
18 מעשה מעשה ממעשה noun masculine singular absolute unspecified unspecified  	O	null
19 למעשה למעשה למעשה adverb unspecified unspecified unspecified unspecified unspecified  	I_LOC	null
20 . . . punctuation unspecified unspecified unspecified unspecified unspecified  	O	null

0 רוב רוב רובם noun masculine singular absolute unspecified unspecified  
0 ם ם רובם possessive masculine plural unspecified 3 unspecified 0 	O	null
1 מתרחשים התרחש מתרחשים verb masculine plural unspecified any beinoni  	O	null
2 ב ב במציאות preposition unspecified unspecified unspecified unspecified unspecified 0 
2 מציאות מציאות במציאות noun feminine singular absolute unspecified unspecified  	O	null
3 עירונית עירוני עירונית adjective feminine singular absolute unspecified unspecified  	O	null
4 של של של shel-preposition unspecified unspecified unspecified unspecified unspecified  	O	null
5 חיי חיים חיי noun masculine plural construct unspecified unspecified  	O	null
6 יומיום יומיום יומיום properName unspecified unspecified unspecified unspecified unspecified  	I_PERS	null
7 , , , punctuation unspecified unspecified unspecified unspecified unspecified  	O	null
8 מתוך מתוך מתוך preposition unspecified unspecified unspecified unspecified unspecified  	O	null
9 דיון דיון דיון noun masculine singular absolute unspecified unspecified  	O	null
10 ביקורתי ביקורתי ביקורתי adjective masculine singular absolute unspecified unspecified  	O	null
11 ב ב במצבה preposition unspecified unspecified unspecified unspecified unspecified 0 
11 מצב מצב במצבה noun masculine singular absolute unspecified unspecified  
11 ה ה במצבה possessive feminine singular unspecified 3 unspecified 0 	O	null
12 של של של shel-preposition unspecified unspecified unspecified unspecified unspecified  	O	null
13 ה ה החברה definiteArticle unspecified unspecified unspecified unspecified unspecified 0 
13 החברה חבר החברה noun feminine singular absolute unspecified unspecified  	O	null
14 ה ה הישראלית definiteArticle unspecified unspecified unspecified unspecified unspecified 0 
14 הישראלית ישראלי הישראלית adjective feminine singular absolute unspecified unspecified  	O	null
15 . . . punctuation unspecified unspecified unspecified unspecified unspecified  	O	null

0 זכה זכה זכה verb masculine singular unspecified 3 past  	O	null
1 פעמיים פעמיים פעמיים adverb unspecified unspecified unspecified unspecified unspecified  	O	null
2 ב ב בפרס preposition unspecified unspecified unspecified unspecified unspecified 0 
2 פרס פרס בפרס noun masculine singular absolute unspecified unspecified  	O	null
3 על על על preposition unspecified unspecified unspecified unspecified unspecified  	O	null
4 שם שם שם noun masculine singular construct unspecified unspecified  	O	null
5 ראש ראש ראש noun masculine singular construct unspecified unspecified  	O	null
6 ה ה הממשלה definiteArticle unspecified unspecified unspecified unspecified unspecified 0 
6 הממשלה ממשלה הממשלה noun feminine singular absolute unspecified unspecified  	O	null
7 לוי לוי לוי properName unspecified unspecified unspecified unspecified unspecified  	I_PERS	null
8 אשכול אשכול אשכול properName unspecified unspecified unspecified unspecified unspecified  	I_PERS	null
9 , , , punctuation unspecified unspecified unspecified unspecified unspecified  	O	null
10 ###NUMBER### ###NUMBER### ###NUMBER### numeral unspecified unspecified unspecified unspecified unspecified  	I_DATE	null
11 ) ) ) punctuation unspecified unspecified unspecified unspecified unspecified  	O	null
12 ###NUMBER### ###NUMBER### ###NUMBER### numeral unspecified unspecified unspecified unspecified unspecified  	I_DATE	null
13 ו ו ובפרס conjunction unspecified unspecified unspecified unspecified unspecified 0 
13 ב ב ובפרס preposition unspecified unspecified unspecified unspecified unspecified 0 
13 פרס פרס ובפרס noun masculine singular construct unspecified unspecified  	O	null
14 ברנשטיין ברנשטיין ברנשטיין properName unspecified unspecified unspecified unspecified unspecified  	O	null
15 ל ל לשירה preposition unspecified unspecified unspecified unspecified unspecified 0 
15 שירה שירה לשירה noun feminine singular absolute unspecified unspecified  	O	null
16 מטעם מטעם מטעם preposition unspecified unspecified unspecified unspecified unspecified  	O	null
17 התאחדות התאחדות התאחדות noun feminine singular construct unspecified unspecified  	O	null
18 המו המה המו verb masculine-and-feminine plural unspecified 3 past  	O	null
19 " " " punctuation unspecified unspecified unspecified unspecified unspecified  	O	null
20 ל ל לים preposition unspecified unspecified unspecified unspecified unspecified 0 
20 ים ים לים noun masculine singular absolute unspecified unspecified  	O	null
21 ) ) ) punctuation unspecified unspecified unspecified unspecified unspecified  	O	null
22 . . . punctuation unspecified unspecified unspecified unspecified unspecified  	O	null
23 ###NUMBER### ###NUMBER### ###NUMBER### numeral unspecified unspecified unspecified unspecified unspecified  	I_DATE	null
24 References References References foreign unspecified unspecified unspecified unspecified unspecified  	O	null
25 : : : punctuation unspecified unspecified unspecified unspecified unspecified  	O	null
26 ב ב בהר preposition unspecified unspecified unspecified unspecified unspecified 0 
26 ה ה בהר definiteArticle unspecified unspecified unspecified unspecified unspecified 0 
26 ההר הר בהר noun masculine singular absolute unspecified unspecified  	O	null
27 , , , punctuation unspecified unspecified unspecified unspecified unspecified  	I_LOC	null
28 עוזי עוזי עוזי properName unspecified unspecified unspecified unspecified unspecified  	I_PERS	null
29 . . . punctuation unspecified unspecified unspecified unspecified unspecified  	O	null

0 " " " punctuation unspecified unspecified unspecified unspecified unspecified  	O	null
1 יתרון יתרון יתרון noun masculine singular absolute unspecified unspecified  	O	null
2 ה ה הדברים definiteArticle unspecified unspecified unspecified unspecified unspecified 0 
2 הדברים דבר הדברים noun masculine plural absolute unspecified unspecified  	O	null
3 " " " punctuation unspecified unspecified unspecified unspecified unspecified  	O	null
4 . . . punctuation unspecified unspecified unspecified unspecified unspecified  	O	null

0 ה ה הארץ definiteArticle unspecified unspecified unspecified unspecified unspecified 0 
0 הארץ ארץ הארץ noun feminine singular absolute unspecified unspecified  	O	null
1 תרבות תרבות תרבות noun feminine singular absolute unspecified unspecified  	O	null
2 ו ו וספרות conjunction unspecified unspecified unspecified unspecified unspecified 0 
2 ספרות ספרות וספרות noun feminine singular absolute unspecified unspecified  	O	null
3 . . . punctuation unspecified unspecified unspecified unspecified unspecified  	O	null

0 ###NUMEXP### ###NUMEXP### ###NUMEXP### numberExpression unspecified unspecified unspecified unspecified unspecified  	I_DATE	null
1 ; ; ; punctuation unspecified unspecified unspecified unspecified unspecified  	O	null
2 ברנשטיין ברנשטיין ברנשטיין properName unspecified unspecified unspecified unspecified unspecified  	I_PERS	null
3 , , , punctuation unspecified unspecified unspecified unspecified unspecified  	O	null
4 אורי אורי אורי properName unspecified unspecified unspecified unspecified unspecified  	I_PERS	null
5 . . . punctuation unspecified unspecified unspecified unspecified unspecified  	O	null

0 " " " punctuation unspecified unspecified unspecified unspecified unspecified  	O	null
1 חילוף חילוף חילוף noun masculine singular construct unspecified unspecified  	O	null
2 משמרות משמרת משמרות noun feminine plural absolute unspecified unspecified  	O	null
3 ב ב בשירה preposition unspecified unspecified unspecified unspecified unspecified 0 
3 שירה שירה בשירה noun feminine singular absolute unspecified unspecified  	O	null
4 " " " punctuation unspecified unspecified unspecified unspecified unspecified  	O	null
5 . . . punctuation unspecified unspecified unspecified unspecified unspecified  	O	null

0 חדרים חדר חדרים noun masculine plural absolute unspecified unspecified  	O	null
1 ###NUMBER### ###NUMBER### ###NUMBER### numeral unspecified unspecified unspecified unspecified unspecified  	O	null
2 . . . punctuation unspecified unspecified unspecified unspecified unspecified  	O	null

0 ###NUMBER### ###NUMBER### ###NUMBER### numeral unspecified unspecified unspecified unspecified unspecified  	I_DATE	null
1 - - - punctuation unspecified unspecified unspecified unspecified unspecified  	O	null
2 ###NUMBER### ###NUMBER### ###NUMBER### numeral unspecified unspecified unspecified unspecified unspecified  	I_DATE	null
3 . . . punctuation unspecified unspecified unspecified unspecified unspecified  	O	null

0 - - - punctuation unspecified unspecified unspecified unspecified unspecified  	O	null
1 ###NUMBER### ###NUMBER### ###NUMBER### numeral unspecified unspecified unspecified unspecified unspecified  	O	null
2 ; ; ; punctuation unspecified unspecified unspecified unspecified unspecified  	O	null
3 ###NUMBER### ###NUMBER### ###NUMBER### numeral unspecified unspecified unspecified unspecified unspecified  	O	null
4 זנדבנק זנדבנק זנדבנק properName unspecified unspecified unspecified unspecified unspecified  	O	null
5 , , , punctuation unspecified unspecified unspecified unspecified unspecified  	O	null
6 שמעון שמעון שמעון properName unspecified unspecified unspecified unspecified unspecified  	I_PERS	null
7 . . . punctuation unspecified unspecified unspecified unspecified unspecified  	O	null

0 " " " punctuation unspecified unspecified unspecified unspecified unspecified  	O	null
1 ה ה הסכנה definiteArticle unspecified unspecified unspecified unspecified unspecified 0 
1 הסכנה סכנה הסכנה noun feminine singular absolute unspecified unspecified  	O	null
2 ש ש שבעובדות relativizer/subordinatingConjunction unspecified unspecified unspecified unspecified unspecified 0 
2 ב ב שבעובדות preposition unspecified unspecified unspecified unspecified unspecified 0 
2 ה ה שבעובדות definiteArticle unspecified unspecified unspecified unspecified unspecified 0 
2 העובדות עובד שבעובדות noun feminine plural absolute unspecified unspecified  	O	null
3 " " " punctuation unspecified unspecified unspecified unspecified unspecified  	O	null
4 . . . punctuation unspecified unspecified unspecified unspecified unspecified  	O	null

0 דבר דבר דבר noun masculine singular construct unspecified unspecified  	O	null
1 משא משא משא noun masculine singular absolute unspecified unspecified  	O	null
2 . . . punctuation unspecified unspecified unspecified unspecified unspecified  	O	null

0 ###NUMEXP### ###NUMEXP### ###NUMEXP### numberExpression unspecified unspecified unspecified unspecified unspecified  	I_DATE	null
1 ; ; ; punctuation unspecified unspecified unspecified unspecified unspecified  	O	null
2 חבר חבר חבר noun masculine singular absolute unspecified unspecified  	O	null
3 , , , punctuation unspecified unspecified unspecified unspecified unspecified  	O	null
4 חנן חנן חנן properName unspecified unspecified unspecified unspecified unspecified  	I_PERS	null
5 . . . punctuation unspecified unspecified unspecified unspecified unspecified  	O	null

0 " " " punctuation unspecified unspecified unspecified unspecified unspecified  	O	null
1 מבטים מבט מבטים noun masculine plural absolute unspecified unspecified  	O	null
2 מחושבים מחושב מחושבים adjective masculine plural absolute unspecified unspecified  	O	null
3 ( ( ( punctuation unspecified unspecified unspecified unspecified unspecified  	O	null
4 יוסף יוסף יוסף properName unspecified unspecified unspecified unspecified unspecified  	I_PERS	null
5 שרון שרון שרון properName unspecified unspecified unspecified unspecified unspecified  	I_PERS	null
6 ) ) ) punctuation unspecified unspecified unspecified unspecified unspecified  	O	null
7 " " " punctuation unspecified unspecified unspecified unspecified unspecified  	O	null
8 . . . punctuation unspecified unspecified unspecified unspecified unspecified  	O	null

0 קורא קרא קורא verb masculine singular unspecified any beinoni  	O	null
1 שירה שירה שירה noun feminine singular absolute unspecified unspecified  	O	null
2 : : : punctuation unspecified unspecified unspecified unspecified unspecified  	O	null
3 רשימות רשימה רשימות noun feminine plural absolute unspecified unspecified  	O	null
4 , , , punctuation unspecified unspecified unspecified unspecified unspecified  	O	null
5 מסות מסה מסות noun feminine plural absolute unspecified unspecified  	O	null
6 ו ו ומחקרים conjunction unspecified unspecified unspecified unspecified unspecified 0 
6 מחקרים מחקר ומחקרים noun masculine plural absolute unspecified unspecified  	O	null
7 על על על preposition unspecified unspecified unspecified unspecified unspecified  	O	null
8 שירה שירה שירה noun feminine singular absolute unspecified unspecified  	O	null
9 עברית עברי עברית adjective feminine singular absolute unspecified unspecified  	O	null
10 . . . punctuation unspecified unspecified unspecified unspecified unspecified  	O	null

0 תל תל תל properName unspecified unspecified unspecified unspecified unspecified  	I_LOC	null
1 אביב אביב אביב properName unspecified unspecified unspecified unspecified unspecified  	I_LOC	null
2 : : : punctuation unspecified unspecified unspecified unspecified unspecified  	O	null
3 קשב קשב קשב noun masculine singular absolute unspecified unspecified  	O	null
4 ל ל לשירה preposition unspecified unspecified unspecified unspecified unspecified 0 
4 ה ה לשירה definiteArticle unspecified unspecified unspecified unspecified unspecified 0 
4 השירה שירה לשירה noun feminine singular absolute unspecified unspecified  	O	null
5 . . . punctuation unspecified unspecified unspecified unspecified unspecified  	O	null

0 ###NUMBER### ###NUMBER### ###NUMBER### numeral unspecified unspecified unspecified unspecified unspecified  	I_DATE	null
1 . . . punctuation unspecified unspecified unspecified unspecified unspecified  	O	null

0 - - - punctuation unspecified unspecified unspecified unspecified unspecified  	O	null
1 ###NUMBER### ###NUMBER### ###NUMBER### numeral unspecified unspecified unspecified unspecified unspecified  	O	null
2 ; ; ; punctuation unspecified unspecified unspecified unspecified unspecified  	O	null
3 ###NUMBER### ###NUMBER### ###NUMBER### numeral unspecified unspecified unspecified unspecified unspecified  	O	null
4 קלדרון קלדרון קלדרון properName unspecified unspecified unspecified unspecified unspecified  	I_PERS	null
5 , , , punctuation unspecified unspecified unspecified unspecified unspecified  	O	null
6 נסים נסים נסים properName unspecified unspecified unspecified unspecified unspecified  	I_PERS	null
7 . . . punctuation unspecified unspecified unspecified unspecified unspecified  	O	null

0 " " " punctuation unspecified unspecified unspecified unspecified unspecified  	O	null
1 ה ה הקול definiteArticle unspecified unspecified unspecified unspecified unspecified 0 
1 הקול קול הקול noun masculine singular absolute unspecified unspecified  	O	null
2 ה ה החם definiteArticle unspecified unspecified unspecified unspecified unspecified 0 
2 החם חם החם adjective masculine singular absolute unspecified unspecified  	O	null
3 " " " punctuation unspecified unspecified unspecified unspecified unspecified  	O	null
4 . . . punctuation unspecified unspecified unspecified unspecified unspecified  	O	null

0 הרגשה הרגשה הרגשה noun feminine singular absolute unspecified unspecified  	O	null
1 של של של shel-preposition unspecified unspecified unspecified unspecified unspecified  	O	null
2 מקום מקום מקום noun masculine singular absolute unspecified unspecified  	O	null
3 . . . punctuation unspecified unspecified unspecified unspecified unspecified  	O	null

0 תל תל תל properName unspecified unspecified unspecified unspecified unspecified  	I_LOC	null
1 אביב אביב אביב properName unspecified unspecified unspecified unspecified unspecified  	I_LOC	null
2 : : : punctuation unspecified unspecified unspecified unspecified unspecified  	O	null
3 ה ה הקיבוץ definiteArticle unspecified unspecified unspecified unspecified unspecified 0 
3 הקיבוץ קיבוץ הקיבוץ noun masculine singular absolute unspecified unspecified  	O	null
4 ה ה המאוחד definiteArticle unspecified unspecified unspecified unspecified unspecified 0 
4 המאוחד מאוחד המאוחד adjective masculine singular absolute unspecified unspecified  	O	null
5 . . . punctuation unspecified unspecified unspecified unspecified unspecified  	O	null

0 ###NUMBER### ###NUMBER### ###NUMBER### numeral unspecified unspecified unspecified unspecified unspecified  	I_DATE	null
1 . . . punctuation unspecified unspecified unspecified unspecified unspecified  	O	null

0 ###NUMBER### ###NUMBER### ###NUMBER### numeral unspecified unspecified unspecified unspecified unspecified  	O	null
1 - - - punctuation unspecified unspecified unspecified unspecified unspecified  	O	null
2 ###NUMBER### ###NUMBER### ###NUMBER### numeral unspecified unspecified unspecified unspecified unspecified  	O	null
3 . . . punctuation unspecified unspecified unspecified unspecified unspecified  	O	null

