0 Name Name Name foreign unspecified unspecified unspecified unspecified unspecified  	O	null
1 : : : punctuation unspecified unspecified unspecified unspecified unspecified  	O	null
2 אריכא אריכא אריכא properName unspecified unspecified unspecified unspecified unspecified  	I_PERS	null
3 , , , punctuation unspecified unspecified unspecified unspecified unspecified  	O	null
4 עמוס עמוס עמוס properName unspecified unspecified unspecified unspecified unspecified  	I_PERS	null
5 Birth Birth Birth foreign unspecified unspecified unspecified unspecified unspecified  	O	null
6 Year Year Year foreign unspecified unspecified unspecified unspecified unspecified  	O	null
7 : : : punctuation unspecified unspecified unspecified unspecified unspecified  	O	null
8 ###NUMBER### ###NUMBER### ###NUMBER### numeral unspecified unspecified unspecified unspecified unspecified  	I_DATE	null
9 Birth Birth Birth foreign unspecified unspecified unspecified unspecified unspecified  	O	null
10 Place Place Place foreign unspecified unspecified unspecified unspecified unspecified  	O	null
11 : : : punctuation unspecified unspecified unspecified unspecified unspecified  	O	null
12 תל תל תל properName unspecified unspecified unspecified unspecified unspecified  	I_LOC	null
13 אביב אביב אביב properName unspecified unspecified unspecified unspecified unspecified  	B_LOC	null
14 Occupation Occupation Occupation foreign unspecified unspecified unspecified unspecified unspecified  	O	null
15 : : : punctuation unspecified unspecified unspecified unspecified unspecified  	O	null
16 סופר סופר סופר noun masculine singular absolute unspecified unspecified  	O	null
17 ו ו ומחזאי conjunction unspecified unspecified unspecified unspecified unspecified 0 
17 מחזאי מחזאי ומחזאי noun masculine singular absolute unspecified unspecified  	O	null
18 Entry Entry Entry foreign unspecified unspecified unspecified unspecified unspecified  	O	null
19 writer writer writer foreign unspecified unspecified unspecified unspecified unspecified  	O	null
20 : : : punctuation unspecified unspecified unspecified unspecified unspecified  	O	null
21 משה משה משה properName unspecified unspecified unspecified unspecified unspecified  	I_ORG	null
22 גרנות גורן גרנות noun feminine plural absolute unspecified unspecified  	O	null
23 Entry Entry Entry foreign unspecified unspecified unspecified unspecified unspecified  	O	null
24 Value Value Value foreign unspecified unspecified unspecified unspecified unspecified  	O	null
25 : : : punctuation unspecified unspecified unspecified unspecified unspecified  	O	null
26 נולד נולד נולד verb masculine singular unspecified 3 past  	O	null
27 ב ב בתל preposition unspecified unspecified unspecified unspecified unspecified 0 
27 תל תל בתל properName unspecified unspecified unspecified unspecified unspecified  	I_LOC	null
28 אביב אביב אביב properName unspecified unspecified unspecified unspecified unspecified  	I_LOC	null
29 . . . punctuation unspecified unspecified unspecified unspecified unspecified  	O	null

0 בן בן בנו noun masculine singular absolute unspecified unspecified  
0 ו ו בנו possessive masculine singular unspecified 3 unspecified 0 	O	null
1 של של של shel-preposition unspecified unspecified unspecified unspecified unspecified  	O	null
2 ה ה הסופר definiteArticle unspecified unspecified unspecified unspecified unspecified 0 
2 הסופר סופר הסופר noun masculine singular absolute unspecified unspecified  	O	null
3 יוסף יוסף יוסף properName unspecified unspecified unspecified unspecified unspecified  	I_PERS	null
4 אריכא אריכא אריכא properName unspecified unspecified unspecified unspecified unspecified  	I_PERS	null
5 . . . punctuation unspecified unspecified unspecified unspecified unspecified  	O	null

0 למד למד למד verb masculine singular unspecified 3 past  	O	null
1 ב ב בתיכון preposition unspecified unspecified unspecified unspecified unspecified 0 
1 ה ה בתיכון definiteArticle unspecified unspecified unspecified unspecified unspecified 0 
1 התיכון תיכון בתיכון noun masculine singular absolute unspecified unspecified  	O	null
2 " " " punctuation unspecified unspecified unspecified unspecified unspecified  	O	null
3 שלווה שלווה שלווה properName unspecified unspecified unspecified unspecified unspecified  	I_ORG	null
4 " " " punctuation unspecified unspecified unspecified unspecified unspecified  	O	null
5 , , , punctuation unspecified unspecified unspecified unspecified unspecified  	O	null
6 ו ו ואחר conjunction unspecified unspecified unspecified unspecified unspecified 0 
6 אחר אחר ואחר preposition unspecified unspecified unspecified unspecified unspecified  	O	null
7 כך כך כך pronoun unspecified unspecified unspecified unspecified unspecified  	O	null
8 למד למד למד verb masculine singular unspecified 3 past  	O	null
9 ציור ציור ציור noun masculine singular absolute unspecified unspecified  	O	null
10 ב ב בתל preposition unspecified unspecified unspecified unspecified unspecified 0 
10 תל תל בתל properName unspecified unspecified unspecified unspecified unspecified  	I_LOC	null
11 אביב אביב אביב properName unspecified unspecified unspecified unspecified unspecified  	I_LOC	null
12 ו ו ובאקדמיה conjunction unspecified unspecified unspecified unspecified unspecified 0 
12 ב ב ובאקדמיה preposition unspecified unspecified unspecified unspecified unspecified 0 
12 ה ה ובאקדמיה definiteArticle unspecified unspecified unspecified unspecified unspecified 0 
12 האקדמיה אקדמיה ובאקדמיה noun feminine singular absolute unspecified unspecified  	O	null
13 ל ל לאמנויות preposition unspecified unspecified unspecified unspecified unspecified 0 
13 ה ה לאמנויות definiteArticle unspecified unspecified unspecified unspecified unspecified 0 
13 האמנויות אמנות לאמנויות noun feminine plural absolute unspecified unspecified  	O	null
14 ב ב בראוונה preposition unspecified unspecified unspecified unspecified unspecified 0 
14 ה ה בראוונה definiteArticle unspecified unspecified unspecified unspecified unspecified 0 
14 הראוונה הראוונה בראוונה noun feminine singular absolute unspecified unspecified  	O	null
15 , , , punctuation unspecified unspecified unspecified unspecified unspecified  	O	null
16 איטליה איטליה איטליה properName unspecified unspecified unspecified unspecified unspecified  	I_LOC	null
17 . . . punctuation unspecified unspecified unspecified unspecified unspecified  	O	null

0 הופיע הופיע הופיע verb masculine singular unspecified 3 past  	O	null
1 על על על preposition unspecified unspecified unspecified unspecified unspecified  	O	null
2 בימות בימה בימות noun feminine plural absolute unspecified unspecified  	O	null
3 כ כ כשחקן preposition unspecified unspecified unspecified unspecified unspecified 0 
3 שחקן שחקן כשחקן noun masculine singular absolute unspecified unspecified  	O	null
4 מ מ מגיל preposition unspecified unspecified unspecified unspecified unspecified 0 
4 גיל גיל מגיל noun masculine singular construct unspecified unspecified  	O	null
5 שש שש שש noun masculine singular construct unspecified unspecified  	O	null
6 - - - punctuation unspecified unspecified unspecified unspecified unspecified  	O	null
7 עשרה CARD10 עשרה numeral masculine plural absolute unspecified unspecified  	O	null
8 . . . punctuation unspecified unspecified unspecified unspecified unspecified  	O	null

0 למד למד למד verb masculine singular unspecified 3 past  	I_LOC	null
1 משחק משחק משחק noun masculine singular absolute unspecified unspecified  	I_LOC	null
2 בניויורק בניויורק בניויורק properName unspecified unspecified unspecified unspecified unspecified  	I_LOC	null
3 ב ב בסטודיו preposition unspecified unspecified unspecified unspecified unspecified 0 
3 סטודיו סטודיו בסטודיו noun masculine singular absolute unspecified unspecified  	O	null
4 של של של shel-preposition unspecified unspecified unspecified unspecified unspecified  	O	null
5 ל ל לי preposition unspecified unspecified unspecified unspecified unspecified  
5 י י לי pronomial masculine-and-feminine singular unspecified 1 unspecified 0 	O	null
6 שטרסברג שטרסברג שטרסברג properName unspecified unspecified unspecified unspecified unspecified  	I_PERS	null
7 . . . punctuation unspecified unspecified unspecified unspecified unspecified  	O	null

0 שיחק שיחק שיחק verb masculine singular unspecified 3 past  	O	null
1 ב ב ב preposition unspecified unspecified unspecified unspecified unspecified 0 	O	null
2 " " " punctuation unspecified unspecified unspecified unspecified unspecified  	O	null
3 ה ה הבימה definiteArticle unspecified unspecified unspecified unspecified unspecified 0 
3 הבימה בימה הבימה noun feminine singular absolute unspecified unspecified  	O	null
4 " " " punctuation unspecified unspecified unspecified unspecified unspecified  	O	null
5 , , , punctuation unspecified unspecified unspecified unspecified unspecified  	O	null
6 " " " punctuation unspecified unspecified unspecified unspecified unspecified  	O	null
7 האהל האהיל האהל verb masculine singular unspecified 2 imperative  	O	null
8 " " " punctuation unspecified unspecified unspecified unspecified unspecified  	O	null
9 , , , punctuation unspecified unspecified unspecified unspecified unspecified  	O	null
10 " " " punctuation unspecified unspecified unspecified unspecified unspecified  	O	null
11 ה ה הקאמרי definiteArticle unspecified unspecified unspecified unspecified unspecified 0 
11 הקאמרי קאמרי הקאמרי adjective masculine singular absolute unspecified unspecified  	O	null
12 " " " punctuation unspecified unspecified unspecified unspecified unspecified  	O	null
13 ו ו ו conjunction unspecified unspecified unspecified unspecified unspecified 0 	O	null
14 " " " punctuation unspecified unspecified unspecified unspecified unspecified  	O	null
15 זירה זירה זירה noun feminine singular absolute unspecified unspecified  	O	null
16 " " " punctuation unspecified unspecified unspecified unspecified unspecified  	O	null
17 . . . punctuation unspecified unspecified unspecified unspecified unspecified  	O	null

0 ייסד ייסד ייסד verb masculine singular unspecified 3 past  	O	null
1 עם עם עם preposition unspecified unspecified unspecified unspecified unspecified  	O	null
2 שייקה שייקה שייקה properName unspecified unspecified unspecified unspecified unspecified  	I_PERS	null
3 אופיר אופיר אופיר properName unspecified unspecified unspecified unspecified unspecified  	I_PERS	null
4 ו ו וזיוה conjunction unspecified unspecified unspecified unspecified unspecified 0 
4 זיוה זיוה וזיוה properName unspecified unspecified unspecified unspecified unspecified  	I_PERS	null
5 רודן רודן רודן noun masculine singular absolute unspecified unspecified  	O	null
6 את את את at-preposition unspecified unspecified unspecified unspecified unspecified  	O	null
7 " " " punctuation unspecified unspecified unspecified unspecified unspecified  	O	null
8 תיאטרון תיאטרון תיאטרון noun masculine singular construct unspecified unspecified  	O	null
9 ה ה הפנטומימה definiteArticle unspecified unspecified unspecified unspecified unspecified 0 
9 הפנטומימה פנטומימה הפנטומימה noun feminine singular absolute unspecified unspecified  	O	null
10 " " " punctuation unspecified unspecified unspecified unspecified unspecified  	O	null
11 ב ב במסגרת preposition unspecified unspecified unspecified unspecified unspecified 0 
11 מסגרת מסגרת במסגרת noun feminine singular construct unspecified unspecified  	O	null
12 תיאטרון תיאטרון תיאטרון noun masculine singular absolute unspecified unspecified  	O	null
13 " " " punctuation unspecified unspecified unspecified unspecified unspecified  	O	null
14 ה ה הקאמרי definiteArticle unspecified unspecified unspecified unspecified unspecified 0 
14 הקאמרי קאמרי הקאמרי adjective masculine singular absolute unspecified unspecified  	O	null
15 " " " punctuation unspecified unspecified unspecified unspecified unspecified  	O	null
16 . . . punctuation unspecified unspecified unspecified unspecified unspecified  	O	null

0 שירת שירת שירת verb masculine singular unspecified 3 past  	O	null
1 כ כ כקצין preposition unspecified unspecified unspecified unspecified unspecified 0 
1 קצין קצין כקצין noun masculine singular absolute unspecified unspecified  	O	null
2 ב ב במשטרת preposition unspecified unspecified unspecified unspecified unspecified 0 
2 משטרת משטרה במשטרת noun feminine singular construct unspecified unspecified  	I_ORG	null
3 ישראל ישראל ישראל properName unspecified unspecified unspecified unspecified unspecified  	I_ORG	null
4 , , , punctuation unspecified unspecified unspecified unspecified unspecified  	O	null
5 מילא מילא מילא verb masculine singular unspecified 3 past  	O	null
6 שורה שורה שורה noun feminine singular absolute unspecified unspecified  	O	null
7 של של של shel-preposition unspecified unspecified unspecified unspecified unspecified  	O	null
8 תפקידי תפקיד תפקידי noun masculine plural construct unspecified unspecified  	O	null
9 הדרכה הדרכה הדרכה noun feminine singular absolute unspecified unspecified  	O	null
10 , , , punctuation unspecified unspecified unspecified unspecified unspecified  	O	null
11 עריכה עריכה עריכה noun feminine singular absolute unspecified unspecified  	O	null
12 , , , punctuation unspecified unspecified unspecified unspecified unspecified  	O	null
13 פרסומים פרסום פרסומים noun masculine plural absolute unspecified unspecified  	O	null
14 ו ו ודוברות conjunction unspecified unspecified unspecified unspecified unspecified 0 
14 דוברות דובר ודוברות noun feminine plural absolute unspecified unspecified  	O	null
15 ו ו והגיע conjunction unspecified unspecified unspecified unspecified unspecified 0 
15 הגיע הגיע והגיע verb masculine singular unspecified 3 past  	O	null
16 ל ל לדרגת preposition unspecified unspecified unspecified unspecified unspecified 0 
16 דרגת דרגה לדרגת noun feminine singular construct unspecified unspecified  	O	null
17 סגן סגן סגן noun masculine singular construct unspecified unspecified  	O	null
18 - - - punctuation unspecified unspecified unspecified unspecified unspecified  	O	null
19 ניצב ניצב ניצב noun masculine singular absolute unspecified unspecified  	O	null
20 . . . punctuation unspecified unspecified unspecified unspecified unspecified  	O	null

0 ב ב בתקופה preposition unspecified unspecified unspecified unspecified unspecified 0 
0 ה ה בתקופה definiteArticle unspecified unspecified unspecified unspecified unspecified 0 
0 התקופה תקופה בתקופה noun feminine singular absolute unspecified unspecified  	O	null
1 ה ה הזאת definiteArticle unspecified unspecified unspecified unspecified unspecified 0 
1 הזאת זאת הזאת pronoun feminine singular unspecified 3 unspecified  	O	null
2 חיבר חיבר חיבר verb masculine singular unspecified 3 past  	O	null
3 ב ב בשמות preposition unspecified unspecified unspecified unspecified unspecified 0 
3 שמות שם בשמות noun masculine plural absolute unspecified unspecified  	O	null
4 בדויים בדוי בדויים adjective masculine plural absolute unspecified unspecified  	O	null
5 כ כ כשלושים preposition unspecified unspecified unspecified unspecified unspecified 0 
5 שלושים ORD-CARD30 כשלושים numeral masculine-and-feminine plural construct unspecified unspecified  	O	null
6 ספרים ספר ספרים noun masculine plural absolute unspecified unspecified  	O	null
7 ב ב בסדרת preposition unspecified unspecified unspecified unspecified unspecified 0 
7 סדרת סדרה בסדרת noun feminine singular construct unspecified unspecified  	O	null
8 ה ה הריגול definiteArticle unspecified unspecified unspecified unspecified unspecified 0 
8 הריגול ריגול הריגול noun masculine singular absolute unspecified unspecified  	O	null
9 ה ה הפופולרית definiteArticle unspecified unspecified unspecified unspecified unspecified 0 
9 הפופולרית פופולרי הפופולרית adjective feminine singular absolute unspecified unspecified  	O	null
10 פטריק פטריק פטריק properName unspecified unspecified unspecified unspecified unspecified  	I_PERS	null
11 קים קים קים properName unspecified unspecified unspecified unspecified unspecified  	I_PERS	null
12 - - - punctuation unspecified unspecified unspecified unspecified unspecified  	O	null
13 ###NUMBER### ###NUMBER### ###NUMBER### numeral unspecified unspecified unspecified unspecified unspecified  	I_DATE	null
14 ) ) ) punctuation unspecified unspecified unspecified unspecified unspecified  	O	null
15 . . . punctuation unspecified unspecified unspecified unspecified unspecified  	O	null

0 ###NUMBER### ###NUMBER### ###NUMBER### numeral unspecified unspecified unspecified unspecified unspecified  	I_DATE	null
1 שמות שם שמות noun masculine plural construct unspecified unspecified  	O	null
2 ה ה העט definiteArticle unspecified unspecified unspecified unspecified unspecified 0 
2 העט עט העט noun masculine singular absolute unspecified unspecified  	O	null
3 ש ש שבהם relativizer/subordinatingConjunction unspecified unspecified unspecified unspecified unspecified 0 
3 ב ב שבהם preposition unspecified unspecified unspecified unspecified unspecified  
3 הם הם שבהם pronomial masculine plural unspecified 3 unspecified 0 	O	null
4 השתמש השתמש השתמש verb masculine singular unspecified 3 past  	O	null
5 : : : punctuation unspecified unspecified unspecified unspecified unspecified  	O	null
6 ניגל ניגל ניגל noun masculine singular construct unspecified unspecified  	O	null
7 דון דון דון noun masculine singular absolute unspecified unspecified  	O	null
8 כיארי כיארי כיארי properName unspecified unspecified unspecified unspecified unspecified  	I_PERS	null
9 , , , punctuation unspecified unspecified unspecified unspecified unspecified  	O	null
10 א"ל א"ל א"ל noun masculine singular construct unspecified unspecified  	O	null
11 האנטר האנטר האנטר properName unspecified unspecified unspecified unspecified unspecified  	I_LOC	null
12 . . . punctuation unspecified unspecified unspecified unspecified unspecified  	O	null

0 ספר ספר ספרו noun masculine singular absolute unspecified unspecified  
0 ו ו ספרו possessive masculine singular unspecified 3 unspecified 0 	O	null
1 ה ה הראשון definiteArticle unspecified unspecified unspecified unspecified unspecified 0 
1 הראשון ORD1 הראשון numeral masculine singular absolute unspecified unspecified  	O	null
2 , , , punctuation unspecified unspecified unspecified unspecified unspecified  	O	null
3 ה ה הכומתות definiteArticle unspecified unspecified unspecified unspecified unspecified 0 
3 הכומתות כומתה הכומתות noun feminine plural absolute unspecified unspecified  	O	null
4 ה ה השחורות definiteArticle unspecified unspecified unspecified unspecified unspecified 0 
4 השחורות שחור השחורות adjective feminine plural absolute unspecified unspecified  	O	null
5 ( ( ( punctuation unspecified unspecified unspecified unspecified unspecified  	O	null
6 עמיחי עמיחי עמיחי properName unspecified unspecified unspecified unspecified unspecified  	I_PERS	null
7 , , , punctuation unspecified unspecified unspecified unspecified unspecified  	O	null
8 ) ) ) punctuation unspecified unspecified unspecified unspecified unspecified  	O	null
9 , , , punctuation unspecified unspecified unspecified unspecified unspecified  	O	null
10 ###NUMBER### ###NUMBER### ###NUMBER### numeral unspecified unspecified unspecified unspecified unspecified  	I_DATE	null
11 העלה העלה העלה verb masculine singular unspecified 3 past  	O	null
12 ל ל לדיון preposition unspecified unspecified unspecified unspecified unspecified 0 
12 דיון דיון לדיון noun masculine singular absolute unspecified unspecified  	O	null
13 ציבורי ציבורי ציבורי adjective masculine singular absolute unspecified unspecified  	O	null
14 את את את at-preposition unspecified unspecified unspecified unspecified unspecified  	O	null
15 בעיית בעיה בעיית noun feminine singular construct unspecified unspecified  	O	null
16 ה ה ה numeral unspecified unspecified unspecified unspecified unspecified  	O	null
17 " " " punctuation unspecified unspecified unspecified unspecified unspecified  	O	null
18 טרטורים טרטור טרטורים noun masculine plural absolute unspecified unspecified  	O	null
19 " " " punctuation unspecified unspecified unspecified unspecified unspecified  	O	null
20 ב ב בצה"ל preposition unspecified unspecified unspecified unspecified unspecified 0 
20 צה"ל צה"ל בצה"ל properName unspecified unspecified unspecified unspecified unspecified  	I_ORG	null
21 . . . punctuation unspecified unspecified unspecified unspecified unspecified  	O	null

0 ב ב ברומנים preposition unspecified unspecified unspecified unspecified unspecified 0 
0 ה ה ברומנים definiteArticle unspecified unspecified unspecified unspecified unspecified 0 
0 הרומנים רומן ברומנים noun masculine plural absolute unspecified unspecified  	O	null
1 ש ש שחיבר relativizer/subordinatingConjunction unspecified unspecified unspecified unspecified unspecified 0 
1 חיבר חיבר שחיבר verb masculine singular unspecified 3 past  	O	null
2 יש יש יש existential unspecified unspecified unspecified unspecified unspecified  	O	null
3 לפחות לפחות לפחות adverb unspecified unspecified unspecified unspecified unspecified  	O	null
4 שניים ORD2 שניים numeral masculine plural absolute unspecified unspecified  	I_DATE	null
5 , , , punctuation unspecified unspecified unspecified unspecified unspecified  	O	null
6 ה ה המסך definiteArticle unspecified unspecified unspecified unspecified unspecified 0 
6 המסך מסך המסך noun masculine singular absolute unspecified unspecified  	O	null
7 עולה עלה עולה verb masculine singular unspecified any beinoni  	O	null
8 ( ( ( punctuation unspecified unspecified unspecified unspecified unspecified  	O	null
9 ###NUMBER### ###NUMBER### ###NUMBER### numeral unspecified unspecified unspecified unspecified unspecified  	I_DATE	null
10 ) ) ) punctuation unspecified unspecified unspecified unspecified unspecified  	O	null
11 ו ו ונשף conjunction unspecified unspecified unspecified unspecified unspecified 0 
11 נשף נשף ונשף noun masculine singular construct unspecified unspecified  	O	null
12 חברים חבר חברים noun masculine plural absolute unspecified unspecified  	O	null
13 ) ) ) punctuation unspecified unspecified unspecified unspecified unspecified  	O	null
14 , , , punctuation unspecified unspecified unspecified unspecified unspecified  	O	null
15 ###NUMBER### ###NUMBER### ###NUMBER### numeral unspecified unspecified unspecified unspecified unspecified  	I_DATE	null
16 ה ה הנחשבים definiteArticle unspecified unspecified unspecified unspecified unspecified 0 
16 הנחשבים נחשב הנחשבים participle masculine plural absolute any unspecified  	O	null
17 ל ל ל preposition unspecified unspecified unspecified unspecified unspecified 0 	O	null
18 " " " punctuation unspecified unspecified unspecified unspecified unspecified  	O	null
19 ספרי ספר ספרי noun masculine plural construct unspecified unspecified  	O	null
20 מפתח מפתח מפתח noun masculine singular absolute unspecified unspecified  	O	null
21 " " " punctuation unspecified unspecified unspecified unspecified unspecified  	O	null
22 , , , punctuation unspecified unspecified unspecified unspecified unspecified  	O	null
23 ו ו והם conjunction unspecified unspecified unspecified unspecified unspecified 0 
23 הם הוא והם pronoun masculine plural unspecified 3 unspecified  	O	null
24 מאזכרים אזכר מאזכרים verb masculine plural unspecified any beinoni  	O	null
25 אישי אישים אישי noun masculine plural construct unspecified unspecified  	O	null
26 תיאטרון תיאטרון תיאטרון noun masculine singular absolute unspecified unspecified  	O	null
27 ידועים ידוע ידועים adjective masculine plural absolute unspecified unspecified  	O	null
28 כמו כמו כמו preposition unspecified unspecified unspecified unspecified unspecified  	O	null
29 חנה חנה חנה properName unspecified unspecified unspecified unspecified unspecified  	I_PERS	null
30 רובינא רובינא רובינא properName unspecified unspecified unspecified unspecified unspecified  	I_PERS	null
31 , , , punctuation unspecified unspecified unspecified unspecified unspecified  	O	null
32 אלכסנדר אלכסנדר אלכסנדר properName unspecified unspecified unspecified unspecified unspecified  	I_PERS	null
33 פן פן פן noun masculine singular absolute unspecified unspecified  	O	null
34 , , , punctuation unspecified unspecified unspecified unspecified unspecified  	O	null
35 יוסף יוסף יוסף properName unspecified unspecified unspecified unspecified unspecified  	I_PERS	null
36 מילוא מילוא מילוא properName unspecified unspecified unspecified unspecified unspecified  	I_PERS	null
37 ו ו ואחרים conjunction unspecified unspecified unspecified unspecified unspecified 0 
37 אחרים אחר ואחרים adjective masculine plural absolute unspecified unspecified  	O	null
38 . . . punctuation unspecified unspecified unspecified unspecified unspecified  	O	null

0 כתב כתב כתב noun masculine singular construct unspecified unspecified  	O	null
1 ספר ספר ספר noun masculine singular construct unspecified unspecified  	O	null
2 מדע מדע מדע noun masculine singular absolute unspecified unspecified  	O	null
3 בדיוני בדיוני בדיוני adjective masculine singular absolute unspecified unspecified  	O	null
4 ל ל לנוער preposition unspecified unspecified unspecified unspecified unspecified 0 
4 ה ה לנוער definiteArticle unspecified unspecified unspecified unspecified unspecified 0 
4 הנוער נוער לנוער noun masculine singular absolute unspecified unspecified  	O	null
5 , , , punctuation unspecified unspecified unspecified unspecified unspecified  	O	null
6 ה ה הטיסה definiteArticle unspecified unspecified unspecified unspecified unspecified 0 
6 הטיסה טיסה הטיסה noun feminine singular absolute unspecified unspecified  	O	null
7 ל ל לירח preposition unspecified unspecified unspecified unspecified unspecified 0 
7 ירח ירח לירח noun masculine singular absolute unspecified unspecified  	O	null
8 ) ) ) punctuation unspecified unspecified unspecified unspecified unspecified  	O	null
9 , , , punctuation unspecified unspecified unspecified unspecified unspecified  	O	null
10 ###NUMBER### ###NUMBER### ###NUMBER### numeral unspecified unspecified unspecified unspecified unspecified  	I_DATE	null
11 ו ו והמחיז conjunction unspecified unspecified unspecified unspecified unspecified 0 
11 המחיז המחיז והמחיז verb masculine singular unspecified 3 past  	O	null
12 את את אותו at-preposition unspecified unspecified unspecified unspecified unspecified  
12 ו ו אותו pronomial masculine singular unspecified 3 unspecified 0 	O	null
13 . . . punctuation unspecified unspecified unspecified unspecified unspecified  	O	null

0 דידי דידי דידי properName unspecified unspecified unspecified unspecified unspecified  	I_PERS	null
1 מנוסי מנוסה מנוסי adjective masculine plural construct unspecified unspecified  	O	null
2 חיבר חיבר חיבר verb masculine singular unspecified 3 past  	O	null
3 לו לו לו conjunction unspecified unspecified unspecified unspecified unspecified  	O	null
4 את את את at-preposition unspecified unspecified unspecified unspecified unspecified  	O	null
5 ה ה הפזמונים definiteArticle unspecified unspecified unspecified unspecified unspecified 0 
5 הפזמונים פזמון הפזמונים noun masculine plural absolute unspecified unspecified  	O	null
6 . . . punctuation unspecified unspecified unspecified unspecified unspecified  	O	null

0 המחיז המחיז המחיז verb masculine singular unspecified 3 past  	O	null
1 גם גם גם conjunction unspecified unspecified unspecified unspecified unspecified  	O	null
2 מחזות מחזה מחזות noun masculine plural absolute unspecified unspecified  	O	null
3 אחרים אחר אחרים adjective masculine plural absolute unspecified unspecified  	O	null
4 ל ל לילדים preposition unspecified unspecified unspecified unspecified unspecified 0 
4 ילדים ילד לילדים noun masculine plural absolute unspecified unspecified  	O	null
5 על על על preposition unspecified unspecified unspecified unspecified unspecified  	O	null
6 פי פה פי noun masculine singular construct unspecified unspecified  	O	null
7 נושאים נושא נושאים noun masculine plural absolute unspecified unspecified  	O	null
8 קלאסיים קלאסי קלאסיים adjective masculine plural absolute unspecified unspecified  	O	null
9 ( ( ( punctuation unspecified unspecified unspecified unspecified unspecified  	O	null
10 גוליבר גוליבר גוליבר properName unspecified unspecified unspecified unspecified unspecified  	I_ORG	null
11 ב ב במדינת preposition unspecified unspecified unspecified unspecified unspecified 0 
11 מדינת מדינה במדינת noun feminine singular construct unspecified unspecified  	B_ORG	null
12 ה ה הגמדים definiteArticle unspecified unspecified unspecified unspecified unspecified 0 
12 הגמדים גמד הגמדים noun masculine plural absolute unspecified unspecified  	I_ORG	null
13 , , , punctuation unspecified unspecified unspecified unspecified unspecified  	O	null
14 דוד דוד דוד properName unspecified unspecified unspecified unspecified unspecified  	I_PERS	null
15 ו ו וגולית conjunction unspecified unspecified unspecified unspecified unspecified 0 
15 גולית גולה וגולית verb feminine singular unspecified 2 past  	O	null
16 ) ) ) punctuation unspecified unspecified unspecified unspecified unspecified  	O	null
17 . . . punctuation unspecified unspecified unspecified unspecified unspecified  	O	null

0 כתב כתב כתב noun masculine singular construct unspecified unspecified  	O	null
1 טרילוגיה טרילוגיה טרילוגיה properName unspecified unspecified unspecified unspecified unspecified  	I_ORG	null
2 ל ל לנוער preposition unspecified unspecified unspecified unspecified unspecified 0 
2 ה ה לנוער definiteArticle unspecified unspecified unspecified unspecified unspecified 0 
2 הנוער נוער לנוער noun masculine singular absolute unspecified unspecified  	O	null
3 ש ש שעניינה relativizer/subordinatingConjunction unspecified unspecified unspecified unspecified unspecified 0 
3 עניינה עניין שעניינה verb feminine singular unspecified 3 past  	O	null
4 עלילות עלילה עלילות noun feminine plural absolute unspecified unspecified  	O	null
5 " " " punctuation unspecified unspecified unspecified unspecified unspecified  	O	null
6 השומר שומר השומר properName unspecified unspecified unspecified unspecified unspecified  	I_ORG	null
7 " " " punctuation unspecified unspecified unspecified unspecified unspecified  	O	null
8 - - - punctuation unspecified unspecified unspecified unspecified unspecified  	O	null
9 ###NUMBER### ###NUMBER### ###NUMBER### numeral unspecified unspecified unspecified unspecified unspecified  	I_DATE	null
10 ) ) ) punctuation unspecified unspecified unspecified unspecified unspecified  	O	null
11 , , , punctuation unspecified unspecified unspecified unspecified unspecified  	O	null
12 ###NUMBER### ###NUMBER### ###NUMBER### numeral unspecified unspecified unspecified unspecified unspecified  	I_DATE	null
13 ו ו וטרילוגיה conjunction unspecified unspecified unspecified unspecified unspecified 0 
13 טרילוגיה טרילוגיה וטרילוגיה noun feminine singular absolute unspecified unspecified  	O	null
14 נוספת נוסף נוספת adjective feminine singular absolute unspecified unspecified  	O	null
15 ש ש שעניינה relativizer/subordinatingConjunction unspecified unspecified unspecified unspecified unspecified 0 
15 עניינה עניין שעניינה verb feminine singular unspecified 3 past  	O	null
16 שודדי שודד שודדי noun masculine plural construct unspecified unspecified  	O	null
17 ה ה העתיקות definiteArticle unspecified unspecified unspecified unspecified unspecified 0 
17 העתיקות עתיקה העתיקות noun feminine plural absolute unspecified unspecified  	O	null
18 ב ב במעמקי preposition unspecified unspecified unspecified unspecified unspecified 0 
18 מעמקי מעמקים במעמקי noun masculine plural construct unspecified unspecified  	O	null
19 ה ה הים definiteArticle unspecified unspecified unspecified unspecified unspecified 0 
19 הים ים הים noun masculine singular absolute unspecified unspecified  	O	null
20 - - - punctuation unspecified unspecified unspecified unspecified unspecified  	O	null
21 ###NUMBER### ###NUMBER### ###NUMBER### numeral unspecified unspecified unspecified unspecified unspecified  	I_DATE	null
22 ) ) ) punctuation unspecified unspecified unspecified unspecified unspecified  	O	null
23 . . . punctuation unspecified unspecified unspecified unspecified unspecified  	O	null

0 ###NUMBER### ###NUMBER### ###NUMBER### numeral unspecified unspecified unspecified unspecified unspecified  	I_DATE	null
1 את את את at-preposition unspecified unspecified unspecified unspecified unspecified  	O	null
2 סיפורי סיפור סיפורי noun masculine plural construct unspecified unspecified  	O	null
3 ה ה המתח definiteArticle unspecified unspecified unspecified unspecified unspecified 0 
3 המתח מתח המתח noun masculine singular absolute unspecified unspecified  	O	null
4 של של שלו shel-preposition unspecified unspecified unspecified unspecified unspecified  
4 ו ו שלו pronomial masculine singular unspecified 3 unspecified 0 	O	null
5 ( ( ( punctuation unspecified unspecified unspecified unspecified unspecified  	O	null
6 ה ה הסדרה definiteArticle unspecified unspecified unspecified unspecified unspecified 0 
6 הסדרה סדרה הסדרה noun feminine singular absolute unspecified unspecified  	O	null
7 אספלט אספלט אספלט noun masculine singular absolute unspecified unspecified  	O	null
8 ו ו וניאון conjunction unspecified unspecified unspecified unspecified unspecified 0 
8 ניאון ניאון וניאון noun masculine singular absolute unspecified unspecified  	O	null
9 ) ) ) punctuation unspecified unspecified unspecified unspecified unspecified  	O	null
10 החל החל החל verb masculine singular unspecified 3 past  	O	null
11 לכתוב כתב לכתוב verb unspecified unspecified unspecified unspecified infinitive  	O	null
12 כבר כבר כבר adverb unspecified unspecified unspecified unspecified unspecified  	O	null
13 באמצע באמצע באמצע adverb unspecified unspecified unspecified unspecified unspecified  	O	null
14 שנות שנה שנות noun feminine plural construct unspecified unspecified  	I_DATE	null
15 ה ה החמישים definiteArticle unspecified unspecified unspecified unspecified unspecified 0 
15 החמישים ORD-CARD50 החמישים numeral masculine plural absolute unspecified unspecified  	I_DATE	null
16 של של של shel-preposition unspecified unspecified unspecified unspecified unspecified  	O	null
17 ה ה המאה definiteArticle unspecified unspecified unspecified unspecified unspecified 0 
17 המאה ORD-CARD100 המאה numeral feminine plural absolute unspecified unspecified  	I_DATE	null
18 ה ה העשרים definiteArticle unspecified unspecified unspecified unspecified unspecified 0 
18 העשרים ORD-CARD20 העשרים numeral masculine-and-feminine plural absolute unspecified unspecified  	O	null
19 ב ב בעולם preposition unspecified unspecified unspecified unspecified unspecified 0 
19 עולם עולם בעולם noun masculine singular construct unspecified unspecified  	O	null
20 ה ה האישה definiteArticle unspecified unspecified unspecified unspecified unspecified 0 
20 האישה איש האישה noun feminine singular absolute unspecified unspecified  	O	null
21 , , , punctuation unspecified unspecified unspecified unspecified unspecified  	O	null
22 ו ו והוא conjunction unspecified unspecified unspecified unspecified unspecified 0 
22 הוא הוא והוא pronoun masculine singular unspecified 3 unspecified  	O	null
23 הפך הפך הפך verb masculine singular unspecified 3 past  	O	null
24 במשך במשך במשך preposition unspecified unspecified unspecified unspecified unspecified  	O	null
25 ה ה השנים definiteArticle unspecified unspecified unspecified unspecified unspecified 0 
25 השנים שנה השנים noun feminine plural absolute unspecified unspecified  	O	null
26 ל ל למומחה preposition unspecified unspecified unspecified unspecified unspecified 0 
26 מומחה מומחה למומחה noun masculine singular construct unspecified unspecified  	O	null
27 מספר מספר מספר noun masculine singular construct unspecified unspecified  	O	null
28 אחת CARD1 אחת numeral feminine singular absolute unspecified unspecified  	O	null
29 ב ב בתחום preposition unspecified unspecified unspecified unspecified unspecified 0 
29 תחום תחום בתחום noun masculine singular construct unspecified unspecified  	O	null
30 זה זה זה pronoun masculine singular unspecified 3 unspecified  	O	null
31 . . . punctuation unspecified unspecified unspecified unspecified unspecified  	O	null

0 ה ה השותפות definiteArticle unspecified unspecified unspecified unspecified unspecified 0 
0 השותפות שותפות השותפות noun feminine singular absolute unspecified unspecified  	O	null
1 עם עם עם preposition unspecified unspecified unspecified unspecified unspecified  	O	null
2 אלי אל אלי properName unspecified unspecified unspecified unspecified unspecified  	I_PERS	null
3 לנדאו לנדאו לנדאו properName unspecified unspecified unspecified unspecified unspecified  	I_PERS	null
4 , , , punctuation unspecified unspecified unspecified unspecified unspecified  	O	null
5 ש ש שהיה relativizer/subordinatingConjunction unspecified unspecified unspecified unspecified unspecified 0 
5 היה הוא שהיה copula masculine singular unspecified 3 past  	O	null
6 ה ה המו"ל definiteArticle unspecified unspecified unspecified unspecified unspecified 0 
6 המו"ל מו"ל המו"ל noun masculine singular absolute unspecified unspecified  	O	null
7 של של שלו shel-preposition unspecified unspecified unspecified unspecified unspecified  
7 ו ו שלו pronomial masculine singular unspecified 3 unspecified 0 	O	null
8 , , , punctuation unspecified unspecified unspecified unspecified unspecified  	O	null
9 ה ה המפיץ definiteArticle unspecified unspecified unspecified unspecified unspecified 0 
9 המפיץ מפיץ המפיץ noun masculine singular absolute unspecified unspecified  	O	null
10 ו ו ומספק conjunction unspecified unspecified unspecified unspecified unspecified 0 
10 מספק סיפק ומספק verb masculine singular unspecified any beinoni  	O	null
11 ה ה המידע definiteArticle unspecified unspecified unspecified unspecified unspecified 0 
11 המידע מידע המידע noun masculine singular absolute unspecified unspecified  	O	null
12 , , , punctuation unspecified unspecified unspecified unspecified unspecified  	O	null
13 הניבה הניב הניבה verb feminine singular unspecified 3 past  	O	null
14 שלושה CARD3 שלושה numeral masculine plural absolute unspecified unspecified  	O	null
15 רומנים רומן רומנים noun masculine plural absolute unspecified unspecified  	O	null
16 , , , punctuation unspecified unspecified unspecified unspecified unspecified  	O	null
17 ש ש שהיו relativizer/subordinatingConjunction unspecified unspecified unspecified unspecified unspecified 0 
17 היו הוא שהיו copula masculine plural unspecified 2 imperative  	O	null
18 רבי רבי רבי noun masculine singular construct unspecified unspecified  	O	null
19 - - - punctuation unspecified unspecified unspecified unspecified unspecified  	O	null
20 מכר מכר מכר noun masculine singular absolute unspecified unspecified  	O	null
21 ב ב בארצות preposition unspecified unspecified unspecified unspecified unspecified 0 
21 ארצות ארץ בארצות properName unspecified unspecified unspecified unspecified unspecified  	I_LOC	null
22 הברית ברית הברית properName unspecified unspecified unspecified unspecified unspecified  	I_LOC	null
23 ו ו ובאירופה conjunction unspecified unspecified unspecified unspecified unspecified 0 
23 ב ב ובאירופה preposition unspecified unspecified unspecified unspecified unspecified 0 
23 אירופה אירופה ובאירופה properName unspecified unspecified unspecified unspecified unspecified  	B_LOC	null
24 : : : punctuation unspecified unspecified unspecified unspecified unspecified  	O	null
25 נפט נפט נפט noun masculine singular absolute unspecified unspecified  	O	null
26 – – – punctuation unspecified unspecified unspecified unspecified unspecified  	O	null
27 ה ה האל definiteArticle unspecified unspecified unspecified unspecified unspecified 0 
27 האל אל האל noun masculine singular absolute unspecified unspecified  	O	null
28 ה ה החדש definiteArticle unspecified unspecified unspecified unspecified unspecified 0 
28 החדש חדש החדש adjective masculine singular absolute unspecified unspecified  	O	null
29 ; ; ; punctuation unspecified unspecified unspecified unspecified unspecified  	O	null
30 קרלוס קרלוס קרלוס properName unspecified unspecified unspecified unspecified unspecified  	I_PERS	null
31 – – – punctuation unspecified unspecified unspecified unspecified unspecified  	O	null
32 טרור טרור טרור noun masculine singular absolute unspecified unspecified  	O	null
33 בעל בעל בעל noun masculine singular construct unspecified unspecified  	O	null
34 ###NUMBER### ###NUMBER### ###NUMBER### numeral unspecified unspecified unspecified unspecified unspecified  	I_DATE	null
35 פרצופים פרצוף פרצופים noun masculine plural absolute unspecified unspecified  	O	null
36 ; ; ; punctuation unspecified unspecified unspecified unspecified unspecified  	O	null
37 ו ו ופניקס conjunction unspecified unspecified unspecified unspecified unspecified 0 
37 פניקס פניקס ופניקס properName unspecified unspecified unspecified unspecified unspecified  	I_ORG	null
38 ( ( ( punctuation unspecified unspecified unspecified unspecified unspecified  	O	null
39 ה ה האחרון definiteArticle unspecified unspecified unspecified unspecified unspecified 0 
39 האחרון אחרון האחרון adjective masculine singular absolute unspecified unspecified  	O	null
40 לא לא לא negation unspecified unspecified unspecified unspecified unspecified  	O	null
41 ראה ראה ראה verb masculine singular unspecified 3 past  	O	null
42 אור אור אור noun masculine singular absolute unspecified unspecified  	O	null
43 ב ב בעברית preposition unspecified unspecified unspecified unspecified unspecified 0 
43 עברית עברית בעברית properName feminine singular unspecified unspecified unspecified  	I_LOC	null
44 ) ) ) punctuation unspecified unspecified unspecified unspecified unspecified  	O	null
45 . . . punctuation unspecified unspecified unspecified unspecified unspecified  	O	null

0 על על עליהם preposition unspecified unspecified unspecified unspecified unspecified  
0 הם הם עליהם pronomial masculine plural unspecified 3 unspecified 0 	O	null
1 הוסיף הוסיף הוסיף verb masculine singular unspecified 3 past  	O	null
2 עוד עוד עוד adverb unspecified unspecified unspecified unspecified unspecified  	O	null
3 שלושה CARD3 שלושה numeral masculine plural absolute unspecified unspecified  	O	null
4 מותחנים מותחן מותחנים noun masculine plural absolute unspecified unspecified  	O	null
5 ש ש שפורסמו relativizer/subordinatingConjunction unspecified unspecified unspecified unspecified unspecified 0 
5 פורסמו פורסם שפורסמו verb masculine-and-feminine plural unspecified 3 past  	O	null
6 ב ב במקור preposition unspecified unspecified unspecified unspecified unspecified 0 
6 מקור מקור במקור noun masculine singular absolute unspecified unspecified  	O	null
7 ב ב באנגלית preposition unspecified unspecified unspecified unspecified unspecified 0 
7 אנגלית אנגלית באנגלית properName feminine singular unspecified unspecified unspecified  	O	null
8 : : : punctuation unspecified unspecified unspecified unspecified unspecified  	O	null
9 שעת שעה שעת noun feminine singular construct unspecified unspecified  	O	null
10 ה ה הליצן definiteArticle unspecified unspecified unspecified unspecified unspecified 0 
10 הליצן ליצן הליצן noun masculine singular absolute unspecified unspecified  	O	null
11 ; ; ; punctuation unspecified unspecified unspecified unspecified unspecified  	O	null
12 מסע מסע מסע noun masculine singular construct unspecified unspecified  	O	null
13 אל אל אל noun masculine singular construct unspecified unspecified  	O	null
14 ה ה המוות definiteArticle unspecified unspecified unspecified unspecified unspecified 0 
14 המוות מוות המוות noun masculine singular absolute unspecified unspecified  	O	null
15 ; ; ; punctuation unspecified unspecified unspecified unspecified unspecified  	O	null
16 ו ו והגמל conjunction unspecified unspecified unspecified unspecified unspecified 0 
16 ה ה והגמל definiteArticle unspecified unspecified unspecified unspecified unspecified 0 
16 הגמל גמל והגמל noun masculine singular absolute unspecified unspecified  	O	null
17 ה ה המעופף definiteArticle unspecified unspecified unspecified unspecified unspecified 0 
17 המעופף עופף המעופף participle masculine singular absolute any unspecified  	O	null
18 , , , punctuation unspecified unspecified unspecified unspecified unspecified  	O	null
19 ש ש שהיו relativizer/subordinatingConjunction unspecified unspecified unspecified unspecified unspecified 0 
19 היו הוא שהיו copula masculine plural unspecified 2 imperative  	O	null
20 גם גם גם conjunction unspecified unspecified unspecified unspecified unspecified  	O	null
21 הם הוא הם pronoun masculine plural unspecified 3 unspecified  	O	null
22 ל ל לרבי preposition unspecified unspecified unspecified unspecified unspecified 0 
22 רבי רבי לרבי noun masculine singular construct unspecified unspecified  	O	null
23 - - - punctuation unspecified unspecified unspecified unspecified unspecified  	O	null
24 מכר מכר מכר noun masculine singular absolute unspecified unspecified  	O	null
25 עולמיים עולמי עולמיים adjective masculine plural absolute unspecified unspecified  	O	null
26 . . . punctuation unspecified unspecified unspecified unspecified unspecified  	O	null

0 לצד לצד לצד preposition unspecified unspecified unspecified unspecified unspecified  	O	null
1 רומנים רומן רומנים noun masculine plural absolute unspecified unspecified  	O	null
2 נוספים נוסף נוספים adjective masculine plural absolute unspecified unspecified  	O	null
3 , , , punctuation unspecified unspecified unspecified unspecified unspecified  	O	null
4 ש ש שעניינם relativizer/subordinatingConjunction unspecified unspecified unspecified unspecified unspecified 0 
4 עניין עניין שעניינם noun masculine singular absolute unspecified unspecified  
4 ם ם שעניינם possessive masculine plural unspecified 3 unspecified 0 	O	null
5 ב ב ביון preposition unspecified unspecified unspecified unspecified unspecified 0 
5 יון יון ביון noun masculine singular absolute unspecified unspecified  	O	null
6 ו ו ומתח conjunction unspecified unspecified unspecified unspecified unspecified 0 
6 מתח מתח ומתח noun masculine singular absolute unspecified unspecified  	O	null
7 , , , punctuation unspecified unspecified unspecified unspecified unspecified  	O	null
8 כמו כמו כמו preposition unspecified unspecified unspecified unspecified unspecified  	O	null
9 עלמה עלמה עלמה noun feminine singular absolute unspecified unspecified  	O	null
10 ב ב בקצה preposition unspecified unspecified unspecified unspecified unspecified 0 
10 קצה קצה בקצה noun masculine singular construct unspecified unspecified  	O	null
11 ה ה הכפר definiteArticle unspecified unspecified unspecified unspecified unspecified 0 
11 הכפר כפר הכפר noun masculine singular absolute unspecified unspecified  	O	null
12 ( ( ( punctuation unspecified unspecified unspecified unspecified unspecified  	O	null
13 ) ) ) punctuation unspecified unspecified unspecified unspecified unspecified  	O	null
14 ###NUMBER### ###NUMBER### ###NUMBER### numeral unspecified unspecified unspecified unspecified unspecified  	I_DATE	null
15 ו ו ואש conjunction unspecified unspecified unspecified unspecified unspecified 0 
15 אש אש ואש noun feminine singular absolute unspecified unspecified  	O	null
16 זרה זר זרה adjective feminine singular absolute unspecified unspecified  	O	null
17 ) ) ) punctuation unspecified unspecified unspecified unspecified unspecified  	O	null
18 , , , punctuation unspecified unspecified unspecified unspecified unspecified  	O	null
19 ###NUMBER### ###NUMBER### ###NUMBER### numeral unspecified unspecified unspecified unspecified unspecified  	I_DATE	null
20 כתב כתב כתב verb masculine singular unspecified 3 past  	O	null
21 גם גם גם conjunction unspecified unspecified unspecified unspecified unspecified  	O	null
22 רומן רומן רומן noun masculine singular absolute unspecified unspecified  	O	null
23 נוסטלגי נוסטלגי נוסטלגי adjective masculine singular absolute unspecified unspecified  	O	null
24 על על על preposition unspecified unspecified unspecified unspecified unspecified  	O	null
25 תל תל תל properName unspecified unspecified unspecified unspecified unspecified  	I_LOC	null
26 אביב אביב אביב properName unspecified unspecified unspecified unspecified unspecified  	I_LOC	null
27 הקטנה הקטנה הקטנה noun feminine singular absolute unspecified unspecified  	O	null
28 ( ( ( punctuation unspecified unspecified unspecified unspecified unspecified  	O	null
29 תופס תפס תופס participle masculine singular construct any unspecified  	O	null
30 ה ה הגלים definiteArticle unspecified unspecified unspecified unspecified unspecified 0 
30 הגלים גל הגלים noun masculine plural absolute unspecified unspecified  	O	null
31 , , , punctuation unspecified unspecified unspecified unspecified unspecified  	O	null
32 ###NUMBER### ###NUMBER### ###NUMBER### numeral unspecified unspecified unspecified unspecified unspecified  	I_DATE	null
33 ) ) ) punctuation unspecified unspecified unspecified unspecified unspecified  	O	null
34 . . . punctuation unspecified unspecified unspecified unspecified unspecified  	O	null

0 הוא הוא הוא pronoun masculine singular unspecified 3 unspecified  	O	null
1 מבקש ביקש מבקש verb masculine singular unspecified any beinoni  	O	null
2 להאיר האיר להאיר verb unspecified unspecified unspecified unspecified infinitive  	O	null
3 ב ב בסיפורת preposition unspecified unspecified unspecified unspecified unspecified 0 
3 ה ה בסיפורת definiteArticle unspecified unspecified unspecified unspecified unspecified 0 
3 הסיפורת סיפורת בסיפורת noun feminine singular absolute unspecified unspecified  	O	null
4 של של שלו shel-preposition unspecified unspecified unspecified unspecified unspecified  
4 ו ו שלו pronomial masculine singular unspecified 3 unspecified 0 	O	null
5 את את את at-preposition unspecified unspecified unspecified unspecified unspecified  	O	null
6 ה ה המציאות definiteArticle unspecified unspecified unspecified unspecified unspecified 0 
6 המציאות מציאות המציאות noun feminine singular absolute unspecified unspecified  	O	null
7 ב ב בארץ preposition unspecified unspecified unspecified unspecified unspecified 0 
7 ה ה בארץ definiteArticle unspecified unspecified unspecified unspecified unspecified 0 
7 הארץ ארץ בארץ noun feminine singular absolute unspecified unspecified  	O	null
8 ש ש שנופיה relativizer/subordinatingConjunction unspecified unspecified unspecified unspecified unspecified 0 
8 נופי נוף שנופיה noun masculine plural absolute unspecified unspecified  
8 ה ה שנופיה possessive feminine singular unspecified 3 unspecified 0 	O	null
9 ו ו ואנשיה conjunction unspecified unspecified unspecified unspecified unspecified 0 
9 אנשי איש ואנשיה noun masculine plural absolute unspecified unspecified  
9 ה ה ואנשיה possessive feminine singular unspecified 3 unspecified 0 	O	null
10 משתנים השתנה משתנים verb masculine plural unspecified any beinoni  	O	null
11 עד עד עד preposition unspecified unspecified unspecified unspecified unspecified  	O	null
12 כדי כדי כדי conjunction unspecified unspecified unspecified unspecified unspecified  	O	null
13 ניכור ניכור ניכור noun masculine singular absolute unspecified unspecified  	O	null
14 . . . punctuation unspecified unspecified unspecified unspecified unspecified  	O	null

0 עלילות עלילה עלילותיו noun feminine plural absolute unspecified unspecified  
0 ו ו עלילותיו possessive masculine singular unspecified 3 unspecified 0 	O	null
1 רבות רב רבות adjective feminine plural absolute unspecified unspecified  	O	null
2 משעולים משעול משעולים noun masculine plural absolute unspecified unspecified  	O	null
3 ו ו ותפניות conjunction unspecified unspecified unspecified unspecified unspecified 0 
3 תפניות תפנית ותפניות noun feminine plural absolute unspecified unspecified  	O	null
4 , , , punctuation unspecified unspecified unspecified unspecified unspecified  	O	null
5 תוך תוך תוך preposition unspecified unspecified unspecified unspecified unspecified  	O	null
6 ש ש שהוא relativizer/subordinatingConjunction unspecified unspecified unspecified unspecified unspecified 0 
6 הוא הוא שהוא pronoun masculine singular unspecified 3 unspecified  	O	null
7 מחפש חיפש מחפש verb masculine singular unspecified any beinoni  	O	null
8 את את את at-preposition unspecified unspecified unspecified unspecified unspecified  	O	null
9 ה ה האיזון definiteArticle unspecified unspecified unspecified unspecified unspecified 0 
9 האיזון איזון האיזון noun masculine singular absolute unspecified unspecified  	O	null
10 בין בין בין preposition unspecified unspecified unspecified unspecified unspecified  	O	null
11 ציר ציר ציר noun masculine singular construct unspecified unspecified  	O	null
12 ה ה המעשים definiteArticle unspecified unspecified unspecified unspecified unspecified 0 
12 המעשים מעשה המעשים noun masculine plural absolute unspecified unspecified  	O	null
13 ל ל לציר preposition unspecified unspecified unspecified unspecified unspecified 0 
13 ה ה לציר definiteArticle unspecified unspecified unspecified unspecified unspecified 0 
13 הציר ציר לציר noun masculine singular absolute unspecified unspecified  	O	null
14 ה ה הנפשי definiteArticle unspecified unspecified unspecified unspecified unspecified 0 
14 הנפשי נפשי הנפשי adjective masculine singular absolute unspecified unspecified  	O	null
15 . . . punctuation unspecified unspecified unspecified unspecified unspecified  	O	null

0 ספרי ספר ספריו noun masculine plural absolute unspecified unspecified  
0 ו ו ספריו possessive masculine singular unspecified 3 unspecified 0 	O	null
1 תורגמו תורגם תורגמו verb masculine-and-feminine plural unspecified 3 past  	O	null
2 ל ל לכמה preposition unspecified unspecified unspecified unspecified unspecified 0 
2 כמה כמה לכמה quantifier unspecified unspecified construct unspecified unspecified  	O	null
3 שפות שפה שפות noun feminine plural absolute unspecified unspecified  	O	null
4 אירופיות אירופי אירופיות adjective feminine plural absolute unspecified unspecified  	O	null
5 , , , punctuation unspecified unspecified unspecified unspecified unspecified  	O	null
6 ל ל ליפנית preposition unspecified unspecified unspecified unspecified unspecified 0 
6 ה ה ליפנית definiteArticle unspecified unspecified unspecified unspecified unspecified 0 
6 היפנית יפני ליפנית adjective feminine singular absolute unspecified unspecified  	O	null
7 ו ו ולקוריאנית conjunction unspecified unspecified unspecified unspecified unspecified 0 
7 ל ל ולקוריאנית preposition unspecified unspecified unspecified unspecified unspecified 0 
7 ה ה ולקוריאנית definiteArticle unspecified unspecified unspecified unspecified unspecified 0 
7 הקוריאנית קוריאני ולקוריאנית adjective feminine singular absolute unspecified unspecified  	O	null
8 . . . punctuation unspecified unspecified unspecified unspecified unspecified  	O	null

0 את את את at-preposition unspecified unspecified unspecified unspecified unspecified  	O	null
1 רישומי רישום רישומיו noun masculine plural absolute unspecified unspecified  
1 ו ו רישומיו possessive masculine singular unspecified 3 unspecified 0 	O	null
2 ו ו וציוריו conjunction unspecified unspecified unspecified unspecified unspecified 0 
2 ציורי ציור וציוריו noun masculine plural absolute unspecified unspecified  
2 ו ו וציוריו possessive masculine singular unspecified 3 unspecified 0 	O	null
3 הציג הציג הציג verb masculine singular unspecified 3 past  	O	null
4 ב ב בתערוכות preposition unspecified unspecified unspecified unspecified unspecified 0 
4 תערוכות תערוכה בתערוכות noun feminine plural absolute unspecified unspecified  	O	null
5 יחיד יחיד יחיד adjective masculine singular absolute unspecified unspecified  	O	null
6 ( ( ( punctuation unspecified unspecified unspecified unspecified unspecified  	O	null
7 מוזיאון מוזיאון מוזיאון noun masculine singular construct unspecified unspecified  	O	null
8 הרצליה הרצליה הרצליה properName unspecified unspecified unspecified unspecified unspecified  	I_LOC	null
9 , , , punctuation unspecified unspecified unspecified unspecified unspecified  	O	null
10 בית בית בית properName unspecified unspecified unspecified unspecified unspecified  	I_PERS	null
11 ביאליק ביאליק ביאליק properName unspecified unspecified unspecified unspecified unspecified  	I_PERS	null
12 ב ב בתל preposition unspecified unspecified unspecified unspecified unspecified 0 
12 תל תל בתל properName unspecified unspecified unspecified unspecified unspecified  	I_LOC	null
13 אביב אביב אביב properName unspecified unspecified unspecified unspecified unspecified  	I_LOC	null
14 ו ו ומשכן conjunction unspecified unspecified unspecified unspecified unspecified 0 
14 משכן משכן ומשכן noun masculine singular construct unspecified unspecified  	O	null
15 ה ה האמנים definiteArticle unspecified unspecified unspecified unspecified unspecified 0 
15 האמנים אמן האמנים noun masculine plural absolute unspecified unspecified  	O	null
16 ב ב בהרצליה preposition unspecified unspecified unspecified unspecified unspecified 0 
16 הרצליה הרצליה בהרצליה properName unspecified unspecified unspecified unspecified unspecified  	I_LOC	null
17 – – – punctuation unspecified unspecified unspecified unspecified unspecified  	O	null
18 , , , punctuation unspecified unspecified unspecified unspecified unspecified  	O	null
19 ###NUMBER### ###NUMBER### ###NUMBER### numeral unspecified unspecified unspecified unspecified unspecified  	I_DATE	null
20 ) ) ) punctuation unspecified unspecified unspecified unspecified unspecified  	O	null
21 , , , punctuation unspecified unspecified unspecified unspecified unspecified  	O	null
22 ###NUMBER### ###NUMBER### ###NUMBER### numeral unspecified unspecified unspecified unspecified unspecified  	I_DATE	null
23 ה ה התערוכות definiteArticle unspecified unspecified unspecified unspecified unspecified 0 
23 התערוכות תערוכה התערוכות noun feminine plural absolute unspecified unspecified  	O	null
24 לוו לווה לוו verb masculine-and-feminine plural unspecified 3 past  	O	null
25 ב ב בקטלוגים preposition unspecified unspecified unspecified unspecified unspecified 0 
25 קטלוגים קטלוג בקטלוגים noun masculine plural absolute unspecified unspecified  	O	null
26 . . . punctuation unspecified unspecified unspecified unspecified unspecified  	O	null

0 פרסים פרס פרסים noun masculine plural absolute unspecified unspecified  	O	null
1 : : : punctuation unspecified unspecified unspecified unspecified unspecified  	O	null
2 ספר ספר ספר noun masculine singular construct unspecified unspecified  	O	null
3 ה ה השנה definiteArticle unspecified unspecified unspecified unspecified unspecified 0 
3 השנה שנה השנה noun feminine singular absolute unspecified unspecified  	O	null
4 מטעם מטעם מטעם preposition unspecified unspecified unspecified unspecified unspecified  	O	null
5 ה ה העולם definiteArticle unspecified unspecified unspecified unspecified unspecified 0 
5 העולם עולם העולם noun masculine singular absolute unspecified unspecified  	O	null
6 ה ה הזה definiteArticle unspecified unspecified unspecified unspecified unspecified 0 
6 הזה זה הזה pronoun masculine singular unspecified 3 unspecified  	O	null
7 ( ( ( punctuation unspecified unspecified unspecified unspecified unspecified  	O	null
8 ###NUMBER### ###NUMBER### ###NUMBER### numeral unspecified unspecified unspecified unspecified unspecified  	I_DATE	null
9 ) ) ) punctuation unspecified unspecified unspecified unspecified unspecified  	O	null
10 ו ו ופרס conjunction unspecified unspecified unspecified unspecified unspecified 0 
10 פרס פרס ופרס properName unspecified unspecified unspecified unspecified unspecified  	I_DATE	null
11 אשר אישר אשר verb masculine singular unspecified 3 past  	O	null
12 ב ב ברש preposition unspecified unspecified unspecified unspecified unspecified 0 
12 ה ה ברש definiteArticle unspecified unspecified unspecified unspecified unspecified 0 
12 הרש רש ברש adjective masculine singular absolute unspecified unspecified  	O	null
13 ) ) ) punctuation unspecified unspecified unspecified unspecified unspecified  	O	null
14 . . . punctuation unspecified unspecified unspecified unspecified unspecified  	O	null
15 ###NUMBER### ###NUMBER### ###NUMBER### numeral unspecified unspecified unspecified unspecified unspecified  	I_DATE	null
16 References References References foreign unspecified unspecified unspecified unspecified unspecified  	O	null
17 : : : punctuation unspecified unspecified unspecified unspecified unspecified  	O	null
18 ירדני ירדני ירדני adjective masculine singular absolute unspecified unspecified  	O	null
19 , , , punctuation unspecified unspecified unspecified unspecified unspecified  	O	null
20 גלי גל גליה noun masculine plural absolute unspecified unspecified  
20 ה ה גליה possessive feminine singular unspecified 3 unspecified 0 	O	null
21 . . . punctuation unspecified unspecified unspecified unspecified unspecified  	O	null

0 " " " punctuation unspecified unspecified unspecified unspecified unspecified  	O	null
1 חמש CARD5 חמש numeral feminine singular absolute unspecified unspecified  	O	null
2 שאלות שאלה שאלות noun feminine plural absolute unspecified unspecified  	O	null
3 ו ו וסוף conjunction unspecified unspecified unspecified unspecified unspecified 0 
3 סוף סוף וסוף noun masculine singular construct unspecified unspecified  	O	null
4 דבר דבר דבר noun masculine singular absolute unspecified unspecified  	O	null
5 " " " punctuation unspecified unspecified unspecified unspecified unspecified  	O	null
6 . . . punctuation unspecified unspecified unspecified unspecified unspecified  	O	null

0 ל ל למרחב preposition unspecified unspecified unspecified unspecified unspecified 0 
0 מרחב מרחב למרחב noun masculine singular construct unspecified unspecified  	O	null
1 משא משא משא noun masculine singular absolute unspecified unspecified  	O	null
2 . . . punctuation unspecified unspecified unspecified unspecified unspecified  	O	null

0 ###NUMEXP### ###NUMEXP### ###NUMEXP### numberExpression unspecified unspecified unspecified unspecified unspecified  	I_DATE	null
1 . . . punctuation unspecified unspecified unspecified unspecified unspecified  	O	null

0 - - - punctuation unspecified unspecified unspecified unspecified unspecified  	O	null
1 ###NUMBER### ###NUMBER### ###NUMBER### numeral unspecified unspecified unspecified unspecified unspecified  	O	null
2 ; ; ; punctuation unspecified unspecified unspecified unspecified unspecified  	O	null
3 ###NUMBER### ###NUMBER### ###NUMBER### numeral unspecified unspecified unspecified unspecified unspecified  	O	null
4 מלמד מלמד מלמד noun masculine singular absolute unspecified unspecified  	O	null
5 , , , punctuation unspecified unspecified unspecified unspecified unspecified  	O	null
6 אריאנה אריאנה אריאנה properName unspecified unspecified unspecified unspecified unspecified  	I_PERS	null
7 . . . punctuation unspecified unspecified unspecified unspecified unspecified  	O	null

0 " " " punctuation unspecified unspecified unspecified unspecified unspecified  	O	null
1 עכבר עכבר עכבר noun masculine singular absolute unspecified unspecified  	O	null
2 מסומם סומם מסומם verb masculine singular unspecified any beinoni  	O	null
3 ב ב בפאב preposition unspecified unspecified unspecified unspecified unspecified 0 
3 ה ה בפאב definiteArticle unspecified unspecified unspecified unspecified unspecified 0 
3 הפאב פאב בפאב noun masculine singular absolute unspecified unspecified  	O	null
4 " " " punctuation unspecified unspecified unspecified unspecified unspecified  	O	null
5 . . . punctuation unspecified unspecified unspecified unspecified unspecified  	O	null

0 חדשות חדשה חדשות noun feminine plural construct unspecified unspecified  	O	null
1 מוסף מוסף מוסף noun masculine singular absolute unspecified unspecified  	O	null
2 . . . punctuation unspecified unspecified unspecified unspecified unspecified  	O	null

0 ###NUMEXP### ###NUMEXP### ###NUMEXP### numberExpression unspecified unspecified unspecified unspecified unspecified  	I_DATE	null
1 . . . punctuation unspecified unspecified unspecified unspecified unspecified  	O	null

0 ; ; ; punctuation unspecified unspecified unspecified unspecified unspecified  	O	null
1 ###NUMBER### ###NUMBER### ###NUMBER### numeral unspecified unspecified unspecified unspecified unspecified  	O	null
2 קורצווייל קורצווייל קורצווייל properName unspecified unspecified unspecified unspecified unspecified  	O	null
3 , , , punctuation unspecified unspecified unspecified unspecified unspecified  	O	null
4 ברוך ברוך ברוך properName unspecified unspecified unspecified unspecified unspecified  	I_PERS	null
5 . . . punctuation unspecified unspecified unspecified unspecified unspecified  	O	null

0 " " " punctuation unspecified unspecified unspecified unspecified unspecified  	O	null
1 ב ב בסימן preposition unspecified unspecified unspecified unspecified unspecified 0 
1 סימן סימן בסימן noun masculine singular construct unspecified unspecified  	O	null
2 ה ה הקריקטורה definiteArticle unspecified unspecified unspecified unspecified unspecified 0 
2 הקריקטורה קריקטורה הקריקטורה noun feminine singular absolute unspecified unspecified  	O	null
3 של של של shel-preposition unspecified unspecified unspecified unspecified unspecified  	O	null
4 ה ה האידיאלים definiteArticle unspecified unspecified unspecified unspecified unspecified 0 
4 האידיאלים אידיאל האידיאלים noun masculine plural absolute unspecified unspecified  	O	null
5 " " " punctuation unspecified unspecified unspecified unspecified unspecified  	O	null
6 . . . punctuation unspecified unspecified unspecified unspecified unspecified  	O	null

0 ה ה הארץ definiteArticle unspecified unspecified unspecified unspecified unspecified 0 
0 הארץ ארץ הארץ noun feminine singular absolute unspecified unspecified  	O	null
1 . . . punctuation unspecified unspecified unspecified unspecified unspecified  	O	null

0 ###NUMEXP### ###NUMEXP### ###NUMEXP### numberExpression unspecified unspecified unspecified unspecified unspecified  	I_DATE	null
1 . . . punctuation unspecified unspecified unspecified unspecified unspecified  	O	null

0 , , , punctuation unspecified unspecified unspecified unspecified unspecified  	O	null
1 ###NUMBER### ###NUMBER### ###NUMBER### numeral unspecified unspecified unspecified unspecified unspecified  	O	null
2 ###NUMBER### ###NUMBER### ###NUMBER### numeral unspecified unspecified unspecified unspecified unspecified  	O	null
3 . . . punctuation unspecified unspecified unspecified unspecified unspecified  	O	null

