0 Name Name Name foreign unspecified unspecified unspecified unspecified unspecified  	O	null
1 : : : punctuation unspecified unspecified unspecified unspecified unspecified  	O	null
2 ב ב בלבן preposition unspecified unspecified unspecified unspecified unspecified 0 
2 לב לב בלבן noun masculine singular absolute unspecified unspecified  
2 ן ן בלבן possessive feminine plural unspecified 3 unspecified 0 	O	null
3 , , , punctuation unspecified unspecified unspecified unspecified unspecified  	O	null
4 אברהם אברהם אברהם properName unspecified unspecified unspecified unspecified unspecified  	I_PERS	null
5 Birth Birth Birth foreign unspecified unspecified unspecified unspecified unspecified  	O	null
6 Year Year Year foreign unspecified unspecified unspecified unspecified unspecified  	O	null
7 : : : punctuation unspecified unspecified unspecified unspecified unspecified  	O	null
8 Birth Birth Birth foreign unspecified unspecified unspecified unspecified unspecified  	O	null
9 Place Place Place foreign unspecified unspecified unspecified unspecified unspecified  	O	null
10 : : : punctuation unspecified unspecified unspecified unspecified unspecified  	O	null
11 קיבוץ קיבוץ קיבוץ noun masculine singular construct unspecified unspecified  	I_LOC	null
12 חולדה חולדה חולדה properName unspecified unspecified unspecified unspecified unspecified  	I_ORG	null
13 ל ל לשפרינצה preposition unspecified unspecified unspecified unspecified unspecified 0 
13 שפרינצה שפרינצה לשפרינצה properName unspecified unspecified unspecified unspecified unspecified  	I_ORG	null
14 Occupation Occupation Occupation foreign unspecified unspecified unspecified unspecified unspecified  	O	null
15 : : : punctuation unspecified unspecified unspecified unspecified unspecified  	O	null
16 סופר ספר סופר participle masculine singular absolute any unspecified  	O	null
17 , , , punctuation unspecified unspecified unspecified unspecified unspecified  	O	null
18 חוקר חוקר חוקר noun masculine singular construct unspecified unspecified  	O	null
19 ו ו ומבקר conjunction unspecified unspecified unspecified unspecified unspecified 0 
19 מ מ ומבקר preposition unspecified unspecified unspecified unspecified unspecified 0 
19 בקר בקר ומבקר properName unspecified unspecified unspecified unspecified unspecified  	O	null
20 Entry Entry Entry foreign unspecified unspecified unspecified unspecified unspecified  	O	null
21 writer writer writer foreign unspecified unspecified unspecified unspecified unspecified  	O	null
22 : : : punctuation unspecified unspecified unspecified unspecified unspecified  	O	null
23 זיסי זיסי זיסי properName unspecified unspecified unspecified unspecified unspecified  	I_ORG	null
24 סתוי סתיו סתוי noun masculine plural construct unspecified unspecified  	O	null
25 Entry Entry Entry foreign unspecified unspecified unspecified unspecified unspecified  	O	null
26 Value Value Value foreign unspecified unspecified unspecified unspecified unspecified  	O	null
27 : : : punctuation unspecified unspecified unspecified unspecified unspecified  	O	null
28 נולד נולד נולד verb masculine singular unspecified 3 past  	I_LOC	null
29 ב ב בקיבוץ preposition unspecified unspecified unspecified unspecified unspecified 0 
29 קיבוץ קיבוץ בקיבוץ noun masculine singular construct unspecified unspecified  	I_LOC	null
30 חולדה חולדה חולדה properName unspecified unspecified unspecified unspecified unspecified  	I_LOC	null
31 ל ל לשפרינצה preposition unspecified unspecified unspecified unspecified unspecified 0 
31 שפרינצה שפרינצה לשפרינצה properName unspecified unspecified unspecified unspecified unspecified  	I_LOC	null
32 ( ( ( punctuation unspecified unspecified unspecified unspecified unspecified  	O	null
33 בלאנק בלאנק בלאנק properName unspecified unspecified unspecified unspecified unspecified  	O	null
34 ) ) ) punctuation unspecified unspecified unspecified unspecified unspecified  	O	null
35 ו ו וליונה conjunction unspecified unspecified unspecified unspecified unspecified 0 
35 ל ל וליונה preposition unspecified unspecified unspecified unspecified unspecified 0 
35 יונה יונה וליונה properName unspecified unspecified unspecified unspecified unspecified  	I_PERS	null
36 ב ב בלבן preposition unspecified unspecified unspecified unspecified unspecified 0 
36 לב לב בלבן noun masculine singular absolute unspecified unspecified  
36 ן ן בלבן possessive feminine plural unspecified 3 unspecified 0 	O	null
37 , , , punctuation unspecified unspecified unspecified unspecified unspecified  	O	null
38 ש ש שעלו relativizer/subordinatingConjunction unspecified unspecified unspecified unspecified unspecified 0 
38 על עלה שעלו noun masculine singular absolute unspecified unspecified  
38 ו ו שעלו possessive masculine singular unspecified 3 unspecified 0 	O	null
39 ארצה ארצה ארצה adverb unspecified unspecified unspecified unspecified unspecified  	O	null
40 מבסרביה מבסרביה מבסרביה verb masculine plural unspecified any beinoni  	I_LOC	null
41 ב ב בסוף preposition unspecified unspecified unspecified unspecified unspecified 0 
41 סוף סוף בסוף noun masculine singular construct unspecified unspecified  	O	null
42 שנות שנה שנות noun feminine plural construct unspecified unspecified  	I_DATE	null
43 ה ה השלושים definiteArticle unspecified unspecified unspecified unspecified unspecified 0 
43 השלושים ORD-CARD30 השלושים numeral masculine-and-feminine plural absolute unspecified unspecified  	I_DATE	null
44 . . . punctuation unspecified unspecified unspecified unspecified unspecified  	O	null

0 החל החל החל verb masculine singular unspecified 3 past  	O	null
1 לפרסם פרסם לפרסם verb unspecified unspecified unspecified unspecified infinitive  	O	null
2 שירים שיר שירים noun masculine plural absolute unspecified unspecified  	O	null
3 ב ב בהיותו preposition unspecified unspecified unspecified unspecified unspecified 0 
3 היות היות בהיותו noun masculine singular absolute unspecified unspecified  
3 ו ו בהיותו possessive masculine singular unspecified 3 unspecified 0 	O	null
4 תלמיד תלמיד תלמיד noun masculine singular absolute unspecified unspecified  	O	null
5 תיכון תיכון תיכון adjective masculine singular absolute unspecified unspecified  	O	null
6 , , , punctuation unspecified unspecified unspecified unspecified unspecified  	O	null
7 תחילה תחילה תחילה adverb unspecified unspecified unspecified unspecified unspecified  	O	null
8 ב ב בהפועל preposition unspecified unspecified unspecified unspecified unspecified 0 
8 ה ה בהפועל definiteArticle unspecified unspecified unspecified unspecified unspecified 0 
8 ההפועל פועל בהפועל noun masculine singular absolute unspecified unspecified  	O	null
9 ה ה הצעיר definiteArticle unspecified unspecified unspecified unspecified unspecified 0 
9 הצעיר צעיר הצעיר adjective masculine singular absolute unspecified unspecified  	O	null
10 ב ב בעריכת preposition unspecified unspecified unspecified unspecified unspecified 0 
10 עריכת עריכה בעריכת noun feminine singular construct unspecified unspecified  	O	null
11 ישראל ישראל ישראל properName unspecified unspecified unspecified unspecified unspecified  	I_PERS	null
12 כהן כהן כהן properName unspecified unspecified unspecified unspecified unspecified  	I_PERS	null
13 , , , punctuation unspecified unspecified unspecified unspecified unspecified  	O	null
14 ו ו ומאוחר conjunction unspecified unspecified unspecified unspecified unspecified 0 
14 מאוחר מאוחר ומאוחר adverb unspecified unspecified unspecified unspecified unspecified  	O	null
15 יותר יותר יותר adverb unspecified unspecified unspecified unspecified unspecified  	O	null
16 ב ב במוספי preposition unspecified unspecified unspecified unspecified unspecified 0 
16 מוספי מוסף במוספי noun masculine plural construct unspecified unspecified  	O	null
17 ה ה הספרות definiteArticle unspecified unspecified unspecified unspecified unspecified 0 
17 הספרות ספרות הספרות noun feminine singular absolute unspecified unspecified  	O	null
18 של של של shel-preposition unspecified unspecified unspecified unspecified unspecified  	O	null
19 דבר דבר דבר noun masculine singular absolute unspecified unspecified  	O	null
20 ו ו וידיעות conjunction unspecified unspecified unspecified unspecified unspecified 0 
20 ידיעות ידיעה וידיעות noun feminine plural absolute unspecified unspecified  	I_ORG	null
21 אחרונות אחרון אחרונות adjective feminine plural absolute unspecified unspecified  	I_ORG	null
22 . . . punctuation unspecified unspecified unspecified unspecified unspecified  	O	null

0 ב ב בתום preposition unspecified unspecified unspecified unspecified unspecified 0 
0 תום תום בתום noun masculine singular construct unspecified unspecified  	O	null
1 שירות שירות שירותו noun masculine singular absolute unspecified unspecified  
1 ו ו שירותו possessive masculine singular unspecified 3 unspecified 0 	O	null
2 ה ה הצבאי definiteArticle unspecified unspecified unspecified unspecified unspecified 0 
2 הצבאי צבאי הצבאי adjective masculine singular absolute unspecified unspecified  	O	null
3 כ כ כחייל preposition unspecified unspecified unspecified unspecified unspecified 0 
3 חייל חייל כחייל noun masculine singular absolute unspecified unspecified  	O	null
4 ב ב בגולני preposition unspecified unspecified unspecified unspecified unspecified 0 
4 גולני גולני בגולני properName unspecified unspecified unspecified unspecified unspecified  	I_PERS	null
5 ו ו וככתב conjunction unspecified unspecified unspecified unspecified unspecified 0 
5 כ כ וככתב preposition unspecified unspecified unspecified unspecified unspecified 0 
5 כתב כתב וככתב noun masculine singular construct unspecified unspecified  	O	null
6 צבאי צבאי צבאי adjective masculine singular absolute unspecified unspecified  	O	null
7 של של של shel-preposition unspecified unspecified unspecified unspecified unspecified  	O	null
8 עיתון עיתון עיתון noun masculine singular absolute unspecified unspecified  	O	null
9 ב ב במחנה preposition unspecified unspecified unspecified unspecified unspecified 0 
9 ה ה במחנה definiteArticle unspecified unspecified unspecified unspecified unspecified 0 
9 המחנה מחנה במחנה noun masculine singular absolute unspecified unspecified  	O	null
10 , , , punctuation unspecified unspecified unspecified unspecified unspecified  	O	null
11 החל החל החל verb masculine singular unspecified 3 past  	O	null
12 ללמוד למד ללמוד verb unspecified unspecified unspecified unspecified infinitive  	O	null
13 ב ב בחוגים preposition unspecified unspecified unspecified unspecified unspecified 0 
13 חוגים חוג בחוגים noun masculine plural absolute unspecified unspecified  	O	null
14 ל ל לספרות preposition unspecified unspecified unspecified unspecified unspecified 0 
14 ספרות ספרות לספרות noun feminine singular absolute unspecified unspecified  	O	null
15 עברית עברי עברית adjective feminine singular absolute unspecified unspecified  	O	null
16 ו ו ולתורת conjunction unspecified unspecified unspecified unspecified unspecified 0 
16 ל ל ולתורת preposition unspecified unspecified unspecified unspecified unspecified 0 
16 תורת תורה ולתורת noun feminine singular construct unspecified unspecified  	O	null
17 ה ה הספרות definiteArticle unspecified unspecified unspecified unspecified unspecified 0 
17 הספרות ספרות הספרות noun feminine singular absolute unspecified unspecified  	O	null
18 ה ה הכללית definiteArticle unspecified unspecified unspecified unspecified unspecified 0 
18 הכללית כללי הכללית adjective feminine singular absolute unspecified unspecified  	O	null
19 ב ב באוניברסיטת preposition unspecified unspecified unspecified unspecified unspecified 0 
19 אוניברסיטת אוניברסיטה באוניברסיטת noun feminine singular construct unspecified unspecified  	I_ORG	null
20 תלאביב תלאביב תלאביב properName unspecified unspecified unspecified unspecified unspecified  	I_ORG	null
21 . . . punctuation unspecified unspecified unspecified unspecified unspecified  	O	null

0 ב ב ב preposition unspecified unspecified unspecified unspecified unspecified 0 	O	null
1 - - - punctuation unspecified unspecified unspecified unspecified unspecified  	O	null
2 ###NUMBER### ###NUMBER### ###NUMBER### numeral unspecified unspecified unspecified unspecified unspecified  	I_DATE	null
3 סיים סיים סיים verb masculine singular unspecified 3 past  	O	null
4 את את את at-preposition unspecified unspecified unspecified unspecified unspecified  	O	null
5 לימודי לימוד לימודי noun masculine plural construct unspecified unspecified  	O	null
6 ה ה התואר definiteArticle unspecified unspecified unspecified unspecified unspecified 0 
6 התואר תואר התואר noun masculine singular absolute unspecified unspecified  	O	null
7 ה ה הראשון definiteArticle unspecified unspecified unspecified unspecified unspecified 0 
7 הראשון ORD1 הראשון numeral masculine singular absolute unspecified unspecified  	O	null
8 ו ו והתקבל conjunction unspecified unspecified unspecified unspecified unspecified 0 
8 התקבל התקבל והתקבל verb masculine singular unspecified 3 past  	O	null
9 ל ל למסלול preposition unspecified unspecified unspecified unspecified unspecified 0 
9 מסלול מסלול למסלול noun masculine singular absolute unspecified unspecified  	O	null
10 ישיר ישיר ישיר adjective masculine singular absolute unspecified unspecified  	O	null
11 ל ל לדוקטורט preposition unspecified unspecified unspecified unspecified unspecified 0 
11 ה ה לדוקטורט definiteArticle unspecified unspecified unspecified unspecified unspecified 0 
11 הדוקטורט דוקטורט לדוקטורט noun masculine singular absolute unspecified unspecified  	O	null
12 . . . punctuation unspecified unspecified unspecified unspecified unspecified  	O	null

0 ב ב בהשפעת preposition unspecified unspecified unspecified unspecified unspecified 0 
0 השפעת השפעה בהשפעת noun feminine singular construct unspecified unspecified  	O	null
1 מור מור מורו noun masculine singular absolute unspecified unspecified  
1 ו ו מורו possessive masculine singular unspecified 3 unspecified 0 	O	null
2 , , , punctuation unspecified unspecified unspecified unspecified unspecified  	O	null
3 נתן נתן נתן properName unspecified unspecified unspecified unspecified unspecified  	I_PERS	null
4 זך זך זך adjective masculine singular absolute unspecified unspecified  	O	null
5 , , , punctuation unspecified unspecified unspecified unspecified unspecified  	O	null
6 הגיש הגיש הגיש verb masculine singular unspecified 3 past  	O	null
7 תוכנית תוכנייה תוכנית noun feminine singular construct unspecified unspecified  	O	null
8 מחקר מחקר מחקר noun masculine singular absolute unspecified unspecified  	O	null
9 ש ש שעניינה relativizer/subordinatingConjunction unspecified unspecified unspecified unspecified unspecified 0 
9 עניינה עניין שעניינה verb feminine singular unspecified 3 past  	O	null
10 ה ה הדרכים definiteArticle unspecified unspecified unspecified unspecified unspecified 0 
10 הדרכים דרך הדרכים noun feminine plural absolute unspecified unspecified  	O	null
11 ה ה השונות definiteArticle unspecified unspecified unspecified unspecified unspecified 0 
11 השונות שונה השונות adjective feminine plural absolute unspecified unspecified  	O	null
12 ש ש שבהן relativizer/subordinatingConjunction unspecified unspecified unspecified unspecified unspecified 0 
12 ב ב שבהן preposition unspecified unspecified unspecified unspecified unspecified 0 
12 הן הוא שבהן pronoun feminine plural unspecified 3 unspecified  	O	null
13 מרדו מרד מרדו verb masculine-and-feminine plural unspecified 3 past  	O	null
14 משוררי משורר משוררי noun masculine plural construct unspecified unspecified  	O	null
15 חבורת חבורה חבורת noun feminine singular construct unspecified unspecified  	O	null
16 " " " punctuation unspecified unspecified unspecified unspecified unspecified  	O	null
17 לקראת לקראת לקראת preposition unspecified unspecified unspecified unspecified unspecified  	O	null
18 " " " punctuation unspecified unspecified unspecified unspecified unspecified  	O	null
19 ( ( ( punctuation unspecified unspecified unspecified unspecified unspecified  	O	null
20 יהודה יהודה יהודה properName unspecified unspecified unspecified unspecified unspecified  	I_PERS	null
21 עמיחי עמיחי עמיחי properName unspecified unspecified unspecified unspecified unspecified  	I_PERS	null
22 , , , punctuation unspecified unspecified unspecified unspecified unspecified  	O	null
23 נתן נתן נתן properName unspecified unspecified unspecified unspecified unspecified  	I_PERS	null
24 זך זך זך adjective masculine singular absolute unspecified unspecified  	O	null
25 , , , punctuation unspecified unspecified unspecified unspecified unspecified  	O	null
26 דוד דוד דוד properName unspecified unspecified unspecified unspecified unspecified  	I_PERS	null
27 אבידן אבידן אבידן properName unspecified unspecified unspecified unspecified unspecified  	I_PERS	null
28 ו ו וחבריהם conjunction unspecified unspecified unspecified unspecified unspecified 0 
28 חברי חבר וחבריהם noun masculine plural absolute unspecified unspecified  
28 הם הם וחבריהם possessive masculine plural unspecified 3 unspecified 0 	O	null
29 ) ) ) punctuation unspecified unspecified unspecified unspecified unspecified  	O	null
30 ב ב בפואטיקה preposition unspecified unspecified unspecified unspecified unspecified 0 
30 פואטיקה פואטיקה בפואטיקה noun feminine singular absolute unspecified unspecified  	O	null
31 של של של shel-preposition unspecified unspecified unspecified unspecified unspecified  	O	null
32 נתן נתן נתן properName unspecified unspecified unspecified unspecified unspecified  	I_PERS	null
33 אלתרמן אלתרמן אלתרמן properName unspecified unspecified unspecified unspecified unspecified  	I_PERS	null
34 . . . punctuation unspecified unspecified unspecified unspecified unspecified  	O	null

0 שלוש CARD3 שלוש numeral feminine singular absolute unspecified unspecified  	O	null
1 שנים שנה שנים noun feminine plural absolute unspecified unspecified  	O	null
2 מאוחר מאוחר מאוחר adverb unspecified unspecified unspecified unspecified unspecified  	O	null
3 יותר יותר יותר adverb unspecified unspecified unspecified unspecified unspecified  	O	null
4 הגיש הגיש הגיש verb masculine singular unspecified 3 past  	O	null
5 תוכנית תוכנייה תוכנית noun feminine singular construct unspecified unspecified  	O	null
6 מחקר מחקר מחקר noun masculine singular absolute unspecified unspecified  	O	null
7 חדשה חדש חדשה adjective feminine singular absolute unspecified unspecified  	O	null
8 , , , punctuation unspecified unspecified unspecified unspecified unspecified  	O	null
9 ש ש שעסקה relativizer/subordinatingConjunction unspecified unspecified unspecified unspecified unspecified 0 
9 עסקה עסק שעסקה verb feminine singular unspecified 3 past  	O	null
10 ב ב במשמעות preposition unspecified unspecified unspecified unspecified unspecified 0 
10 משמעות משמעות במשמעות noun feminine singular absolute unspecified unspecified  	O	null
11 ו ו וברטוריקה conjunction unspecified unspecified unspecified unspecified unspecified 0 
11 ב ב וברטוריקה preposition unspecified unspecified unspecified unspecified unspecified 0 
11 רטוריקה רטוריקה וברטוריקה noun feminine singular absolute unspecified unspecified  	O	null
12 ב ב בשירי preposition unspecified unspecified unspecified unspecified unspecified 0 
12 שירי שיר בשירי noun masculine plural construct unspecified unspecified  	O	null
13 כוכבים כוכב כוכבים noun masculine plural absolute unspecified unspecified  	O	null
14 ב ב בחוץ preposition unspecified unspecified unspecified unspecified unspecified 0 
14 ה ה בחוץ definiteArticle unspecified unspecified unspecified unspecified unspecified 0 
14 החוץ חוץ בחוץ noun masculine singular absolute unspecified unspecified  	O	null
15 מאת מאת מאת preposition unspecified unspecified unspecified unspecified unspecified  	O	null
16 נתן נתן נתן properName unspecified unspecified unspecified unspecified unspecified  	I_PERS	null
17 אלתרמן אלתרמן אלתרמן properName unspecified unspecified unspecified unspecified unspecified  	I_PERS	null
18 . . . punctuation unspecified unspecified unspecified unspecified unspecified  	O	null

0 דיסרטציה דיסרטציה דיסרטציה properName unspecified unspecified unspecified unspecified unspecified  	I_PERS	null
1 זו זו זו pronoun feminine singular unspecified 3 unspecified  	O	null
2 , , , punctuation unspecified unspecified unspecified unspecified unspecified  	O	null
3 ש ש שנכתבה relativizer/subordinatingConjunction unspecified unspecified unspecified unspecified unspecified 0 
3 נכתבה נכתב שנכתבה verb feminine singular unspecified 3 past  	O	null
4 ב ב בהדרכת preposition unspecified unspecified unspecified unspecified unspecified 0 
4 הדרכת הדרכה בהדרכת noun feminine singular construct unspecified unspecified  	O	null
5 דן דן דן properName unspecified unspecified unspecified unspecified unspecified  	I_PERS	null
6 מירון מירון מירון properName unspecified unspecified unspecified unspecified unspecified  	I_PERS	null
7 , , , punctuation unspecified unspecified unspecified unspecified unspecified  	O	null
8 אושרה אושר אושרה verb feminine singular unspecified 3 past  	O	null
9 ב ב ב preposition unspecified unspecified unspecified unspecified unspecified 0 	O	null
10 - - - punctuation unspecified unspecified unspecified unspecified unspecified  	O	null
11 ###NUMBER### ###NUMBER### ###NUMBER### numeral unspecified unspecified unspecified unspecified unspecified  	I_DATE	null
12 . . . punctuation unspecified unspecified unspecified unspecified unspecified  	O	null

0 ב ב בכל preposition unspecified unspecified unspecified unspecified unspecified 0 
0 כל כול בכל quantifier unspecified unspecified construct unspecified unspecified  	O	null
1 ה ה התקופה definiteArticle unspecified unspecified unspecified unspecified unspecified 0 
1 התקופה תקופה התקופה noun feminine singular absolute unspecified unspecified  	O	null
2 ה ה הזאת definiteArticle unspecified unspecified unspecified unspecified unspecified 0 
2 הזאת זאת הזאת pronoun feminine singular unspecified 3 unspecified  	O	null
3 עבד עבד עבד verb masculine singular unspecified 3 past  	O	null
4 ב ב בלבן preposition unspecified unspecified unspecified unspecified unspecified 0 
4 לבן לבן בלבן noun masculine singular absolute unspecified unspecified  	O	null
5 ב ב בהוראה preposition unspecified unspecified unspecified unspecified unspecified 0 
5 הוראה הוראה בהוראה noun feminine singular absolute unspecified unspecified  	O	null
6 ב ב באוניברסיטת preposition unspecified unspecified unspecified unspecified unspecified 0 
6 אוניברסיטת אוניברסיטה באוניברסיטת noun feminine singular construct unspecified unspecified  	I_ORG	null
7 תלאביב תלאביב תלאביב properName unspecified unspecified unspecified unspecified unspecified  	I_ORG	null
8 ו ו וב conjunction unspecified unspecified unspecified unspecified unspecified 0 
8 ב ב וב preposition unspecified unspecified unspecified unspecified unspecified 0 	O	null
9 " " " punctuation unspecified unspecified unspecified unspecified unspecified  	O	null
10 סמינר סמינר סמינר noun masculine singular construct unspecified unspecified  	O	null
11 ה ה הקיבוצים definiteArticle unspecified unspecified unspecified unspecified unspecified 0 
11 הקיבוצים קיבוץ הקיבוצים noun masculine plural absolute unspecified unspecified  	O	null
12 " " " punctuation unspecified unspecified unspecified unspecified unspecified  	O	null
13 , , , punctuation unspecified unspecified unspecified unspecified unspecified  	O	null
14 ו ו וכן conjunction unspecified unspecified unspecified unspecified unspecified 0 
14 כן כן וכן conjunction unspecified unspecified unspecified unspecified unspecified  	O	null
15 פירסם פרסם פירסם verb masculine singular unspecified 3 past  	O	null
16 שירים שיר שירים noun masculine plural absolute unspecified unspecified  	O	null
17 , , , punctuation unspecified unspecified unspecified unspecified unspecified  	O	null
18 מאמרים מאמר מאמרים noun masculine plural absolute unspecified unspecified  	O	null
19 ו ו ורשימות conjunction unspecified unspecified unspecified unspecified unspecified 0 
19 רשימות רשימה ורשימות noun feminine plural absolute unspecified unspecified  	O	null
20 ביקורת ביקורת ביקורת noun feminine singular absolute unspecified unspecified  	O	null
21 ב ב בכתבי preposition unspecified unspecified unspecified unspecified unspecified 0 
21 כתבי כתב בכתבי noun masculine plural construct unspecified unspecified  	O	null
22 עת עת עת noun feminine singular absolute unspecified unspecified  	O	null
23 ו ו ובמוספי conjunction unspecified unspecified unspecified unspecified unspecified 0 
23 ב ב ובמוספי preposition unspecified unspecified unspecified unspecified unspecified 0 
23 מוספי מוסף ובמוספי noun masculine plural construct unspecified unspecified  	O	null
24 ה ה הספרות definiteArticle unspecified unspecified unspecified unspecified unspecified 0 
24 הספרות ספרות הספרות noun feminine singular absolute unspecified unspecified  	O	null
25 ה ה השונים definiteArticle unspecified unspecified unspecified unspecified unspecified 0 
25 השונים שונה השונים adjective masculine plural absolute unspecified unspecified  	O	null
26 . . . punctuation unspecified unspecified unspecified unspecified unspecified  	O	null

0 שניים ORD2 שניים numeral masculine plural absolute unspecified unspecified  	O	null
1 מ מ ממאמריו preposition unspecified unspecified unspecified unspecified unspecified 0 
1 מאמרי מאמר ממאמריו noun masculine plural absolute unspecified unspecified  
1 ו ו ממאמריו possessive masculine singular unspecified 3 unspecified 0 	O	null
2 ש ש שהופיעו relativizer/subordinatingConjunction unspecified unspecified unspecified unspecified unspecified 0 
2 הופיעו הופיע שהופיעו verb masculine-and-feminine plural unspecified 3 past  	O	null
3 ב ב בסימן preposition unspecified unspecified unspecified unspecified unspecified 0 
3 סימן סימן בסימן noun masculine singular construct unspecified unspecified  	O	null
4 קריאה קריאה קריאה noun feminine singular absolute unspecified unspecified  	O	null
5 שימשו שימש שימשו verb masculine-and-feminine plural unspecified 3 past  	O	null
6 בסיס בסיס בסיס noun masculine singular absolute unspecified unspecified  	O	null
7 ל ל לספרו preposition unspecified unspecified unspecified unspecified unspecified 0 
7 ספר ספר לספרו noun masculine singular absolute unspecified unspecified  
7 ו ו לספרו possessive masculine singular unspecified 3 unspecified 0 	O	null
8 ה ה הראשון definiteArticle unspecified unspecified unspecified unspecified unspecified 0 
8 הראשון ORD1 הראשון numeral masculine singular absolute unspecified unspecified  	O	null
9 , , , punctuation unspecified unspecified unspecified unspecified unspecified  	O	null
10 ה ה הקדוש definiteArticle unspecified unspecified unspecified unspecified unspecified 0 
10 הקדוש קדוש הקדוש adjective masculine singular absolute unspecified unspecified  	O	null
11 ו ו והדרקון conjunction unspecified unspecified unspecified unspecified unspecified 0 
11 ה ה והדרקון definiteArticle unspecified unspecified unspecified unspecified unspecified 0 
11 הדרקון הדרקון והדרקון adjective masculine singular absolute unspecified unspecified  	O	null
12 : : : punctuation unspecified unspecified unspecified unspecified unspecified  	O	null
13 עיון עיון עיון noun masculine singular absolute unspecified unspecified  	O	null
14 ב ב ביצירות preposition unspecified unspecified unspecified unspecified unspecified 0 
14 יצירות יצירה ביצירות noun feminine plural construct unspecified unspecified  	O	null
15 עמליה עמליה עמליה properName unspecified unspecified unspecified unspecified unspecified  	I_PERS	null
16 כהנא כהנא כהנא properName unspecified unspecified unspecified unspecified unspecified  	I_PERS	null
17 - - - punctuation unspecified unspecified unspecified unspecified unspecified  	O	null
18 כ כ כרמון preposition unspecified unspecified unspecified unspecified unspecified 0 
18 רמון רמון כרמון properName unspecified unspecified unspecified unspecified unspecified  	I_PERS	null
19 ) ) ) punctuation unspecified unspecified unspecified unspecified unspecified  	O	null
20 . . . punctuation unspecified unspecified unspecified unspecified unspecified  	O	null
21 ###NUMBER### ###NUMBER### ###NUMBER### numeral unspecified unspecified unspecified unspecified unspecified  	I_DATE	null
22 שלושת CARD3 שלושת numeral masculine plural construct unspecified unspecified  	O	null
23 מאמרי מאמר מאמריו noun masculine plural absolute unspecified unspecified  
23 ו ו מאמריו possessive masculine singular unspecified 3 unspecified 0 	O	null
24 ה ה המרכזיים definiteArticle unspecified unspecified unspecified unspecified unspecified 0 
24 המרכזיים מרכזי המרכזיים adjective masculine plural absolute unspecified unspecified  	O	null
25 של של של shel-preposition unspecified unspecified unspecified unspecified unspecified  	O	null
26 ה ה הספר definiteArticle unspecified unspecified unspecified unspecified unspecified 0 
26 הספר ספר הספר noun masculine singular absolute unspecified unspecified  	O	null
27 מאירים האיר מאירים verb masculine plural unspecified any beinoni  	O	null
28 את את את at-preposition unspecified unspecified unspecified unspecified unspecified  	O	null
29 שלושת CARD3 שלושת numeral masculine plural construct unspecified unspecified  	O	null
30 ספרי ספר ספריה noun masculine plural absolute unspecified unspecified  
30 ה ה ספריה possessive feminine singular unspecified 3 unspecified 0 	O	null
31 ה ה הראשונים definiteArticle unspecified unspecified unspecified unspecified unspecified 0 
31 הראשונים ORD1 הראשונים numeral masculine plural absolute unspecified unspecified  	O	null
32 של של של shel-preposition unspecified unspecified unspecified unspecified unspecified  	O	null
33 ה ה המחברת definiteArticle unspecified unspecified unspecified unspecified unspecified 0 
33 המחברת מחברת המחברת noun feminine singular absolute unspecified unspecified  	O	null
34 . . . punctuation unspecified unspecified unspecified unspecified unspecified  	O	null

0 ה ה הספר definiteArticle unspecified unspecified unspecified unspecified unspecified 0 
0 הספר ספר הספר noun masculine singular absolute unspecified unspecified  	O	null
1 זכה זכה זכה verb masculine singular unspecified 3 past  	O	null
2 ב ב בפרס preposition unspecified unspecified unspecified unspecified unspecified 0 
2 פרס פרס בפרס properName masculine singular unspecified unspecified unspecified  	I_PERS	null
3 טלפיר טלפיר טלפיר properName unspecified unspecified unspecified unspecified unspecified  	I_PERS	null
4 ) ) ) punctuation unspecified unspecified unspecified unspecified unspecified  	O	null
5 . . . punctuation unspecified unspecified unspecified unspecified unspecified  	O	null
6 ###NUMBER### ###NUMBER### ###NUMBER### numeral unspecified unspecified unspecified unspecified unspecified  	I_DATE	null
7 שנה שנה שנה noun feminine singular absolute unspecified unspecified  	O	null
8 מאוחר מאוחר מאוחר adverb unspecified unspecified unspecified unspecified unspecified  	O	null
9 יותר יותר יותר adverb unspecified unspecified unspecified unspecified unspecified  	O	null
10 הופיע הופיע הופיע verb masculine singular unspecified 3 past  	O	null
11 ספר ספר ספר noun masculine singular construct unspecified unspecified  	O	null
12 שירי שיר שיריו noun masculine plural absolute unspecified unspecified  
12 ו ו שיריו possessive masculine singular unspecified 3 unspecified 0 	O	null
13 ה ה הראשון definiteArticle unspecified unspecified unspecified unspecified unspecified 0 
13 הראשון ORD1 הראשון numeral masculine singular absolute unspecified unspecified  	O	null
14 , , , punctuation unspecified unspecified unspecified unspecified unspecified  	O	null
15 שירה שירה שירה noun feminine singular absolute unspecified unspecified  	O	null
16 יכולה יכול יכולה modal feminine singular unspecified any beinoni  	O	null
17 ( ( ( punctuation unspecified unspecified unspecified unspecified unspecified  	O	null
18 ספרית ספר ספרית noun feminine singular construct unspecified unspecified  	O	null
19 פועלים פועל פועלים noun masculine plural absolute unspecified unspecified  	O	null
20 , , , punctuation unspecified unspecified unspecified unspecified unspecified  	O	null
21 ###NUMBER### ###NUMBER### ###NUMBER### numeral unspecified unspecified unspecified unspecified unspecified  	I_DATE	null
22 ) ) ) punctuation unspecified unspecified unspecified unspecified unspecified  	O	null
23 . . . punctuation unspecified unspecified unspecified unspecified unspecified  	O	null

0 כותרת כותרת כותרת noun feminine singular construct unspecified unspecified  	O	null
1 ה ה הספר definiteArticle unspecified unspecified unspecified unspecified unspecified 0 
1 הספר ספר הספר noun masculine singular absolute unspecified unspecified  	O	null
2 מביעה הביע מביעה verb feminine singular unspecified any beinoni  	O	null
3 אמונה אמונה אמונה noun feminine singular absolute unspecified unspecified  	O	null
4 ב ב בכוחה preposition unspecified unspecified unspecified unspecified unspecified 0 
4 כוח כוח בכוחה noun masculine singular absolute unspecified unspecified  
4 ה ה בכוחה possessive feminine singular unspecified 3 unspecified 0 	O	null
5 של של של shel-preposition unspecified unspecified unspecified unspecified unspecified  	O	null
6 ה ה השירה definiteArticle unspecified unspecified unspecified unspecified unspecified 0 
6 השירה שירה השירה noun feminine singular absolute unspecified unspecified  	O	null
7 לא לא לא negation unspecified unspecified unspecified unspecified unspecified  	O	null
8 רק רק רק conjunction unspecified unspecified unspecified unspecified unspecified  	O	null
9 לבטא ביטא לבטא verb unspecified unspecified unspecified unspecified infinitive  	O	null
10 את את את at-preposition unspecified unspecified unspecified unspecified unspecified  	O	null
11 חוויות חוויה חוויותיו noun feminine plural absolute unspecified unspecified  
11 ו ו חוויותיו possessive masculine singular unspecified 3 unspecified 0 	O	null
12 של של של shel-preposition unspecified unspecified unspecified unspecified unspecified  	O	null
13 ה ה המשורר definiteArticle unspecified unspecified unspecified unspecified unspecified 0 
13 המשורר משורר המשורר noun masculine singular absolute unspecified unspecified  	O	null
14 , , , punctuation unspecified unspecified unspecified unspecified unspecified  	O	null
15 אלא אלא אלא conjunction unspecified unspecified unspecified unspecified unspecified  	O	null
16 גם גם גם conjunction unspecified unspecified unspecified unspecified unspecified  	O	null
17 להיות הוא להיות copula unspecified unspecified unspecified unspecified infinitive  	O	null
18 גורם גרם גורם verb masculine singular unspecified any beinoni  	O	null
19 בעל בעל בעל noun masculine singular construct unspecified unspecified  	O	null
20 השפעה השפעה השפעה noun feminine singular absolute unspecified unspecified  	O	null
21 ב ב בתהליכים preposition unspecified unspecified unspecified unspecified unspecified 0 
21 תהליכים תהליך בתהליכים noun masculine plural absolute unspecified unspecified  	O	null
22 חברתיים חברתי חברתיים adjective masculine plural absolute unspecified unspecified  	O	null
23 ו ו ותרבותיים conjunction unspecified unspecified unspecified unspecified unspecified 0 
23 תרבותיים תרבותי ותרבותיים adjective masculine plural absolute unspecified unspecified  	O	null
24 . . . punctuation unspecified unspecified unspecified unspecified unspecified  	O	null

0 אמונה אמונה אמונה properName unspecified unspecified unspecified unspecified unspecified  	I_PERS	null
1 זו זו זו pronoun feminine singular unspecified 3 unspecified  	O	null
2 מובעת הובע מובעת verb feminine singular unspecified any beinoni  	O	null
3 ב ב בספר preposition unspecified unspecified unspecified unspecified unspecified 0 
3 ה ה בספר definiteArticle unspecified unspecified unspecified unspecified unspecified 0 
3 הספר ספר בספר noun masculine singular absolute unspecified unspecified  	O	null
4 , , , punctuation unspecified unspecified unspecified unspecified unspecified  	O	null
5 בין בין בין preposition unspecified unspecified unspecified unspecified unspecified  	O	null
6 ה ה השאר definiteArticle unspecified unspecified unspecified unspecified unspecified 0 
6 השאר שאר השאר noun masculine singular absolute unspecified unspecified  	O	null
7 , , , punctuation unspecified unspecified unspecified unspecified unspecified  	O	null
8 ב ב בשילוב preposition unspecified unspecified unspecified unspecified unspecified 0 
8 שילוב שילוב בשילוב noun masculine singular absolute unspecified unspecified  	O	null
9 ה ה המתקיים definiteArticle unspecified unspecified unspecified unspecified unspecified 0 
9 המתקיים התקיים המתקיים participle masculine singular absolute any unspecified  	O	null
10 ב ב בו preposition unspecified unspecified unspecified unspecified unspecified  
10 ו ו בו pronomial masculine singular unspecified 3 unspecified 0 	O	null
11 בין בין בין preposition unspecified unspecified unspecified unspecified unspecified  	O	null
12 נושאים נושא נושאים noun masculine plural absolute unspecified unspecified  	O	null
13 אישיים אישי אישיים adjective masculine plural absolute unspecified unspecified  	O	null
14 ל ל לחברתיים preposition unspecified unspecified unspecified unspecified unspecified 0 
14 חברתיים חברתי לחברתיים adjective masculine plural absolute unspecified unspecified  	O	null
15 . . . punctuation unspecified unspecified unspecified unspecified unspecified  	O	null

0 במקביל במקביל במקביל adverb unspecified unspecified unspecified unspecified unspecified  	O	null
1 ל ל להכנת preposition unspecified unspecified unspecified unspecified unspecified 0 
1 הכנת הכנה להכנת noun feminine singular construct unspecified unspecified  	O	null
2 ספר ספר ספר noun masculine singular construct unspecified unspecified  	O	null
3 ה ה השירים definiteArticle unspecified unspecified unspecified unspecified unspecified 0 
3 השירים שיר השירים noun masculine plural absolute unspecified unspecified  	O	null
4 עיבד עיבד עיבד verb masculine singular unspecified 3 past  	O	null
5 ב ב בלבן preposition unspecified unspecified unspecified unspecified unspecified 0 
5 לבן לבן בלבן noun masculine singular absolute unspecified unspecified  	O	null
6 את את את at-preposition unspecified unspecified unspecified unspecified unspecified  	O	null
7 עבודת עבודה עבודת noun feminine singular construct unspecified unspecified  	O	null
8 ה ה הדוקטור definiteArticle unspecified unspecified unspecified unspecified unspecified 0 
8 הדוקטור דוקטור הדוקטור noun masculine singular absolute unspecified unspecified  	O	null
9 של של שלו shel-preposition unspecified unspecified unspecified unspecified unspecified  
9 ו ו שלו pronomial masculine singular unspecified 3 unspecified 0 	O	null
10 ל ל לספר preposition unspecified unspecified unspecified unspecified unspecified 0 
10 ה ה לספר definiteArticle unspecified unspecified unspecified unspecified unspecified 0 
10 הספר ספר לספר noun masculine singular absolute unspecified unspecified  	O	null
11 , , , punctuation unspecified unspecified unspecified unspecified unspecified  	O	null
12 ש ש שיצא relativizer/subordinatingConjunction unspecified unspecified unspecified unspecified unspecified 0 
12 יצא יצא שיצא verb masculine singular unspecified 3 past  	O	null
13 ל ל לאור preposition unspecified unspecified unspecified unspecified unspecified 0 
13 אור אור לאור noun masculine singular absolute unspecified unspecified  	O	null
14 ב ב ב preposition unspecified unspecified unspecified unspecified unspecified 0 	O	null
15 - - - punctuation unspecified unspecified unspecified unspecified unspecified  	O	null
16 : : : punctuation unspecified unspecified unspecified unspecified unspecified  	O	null
17 ###NUMBER### ###NUMBER### ###NUMBER### numeral unspecified unspecified unspecified unspecified unspecified  	I_DATE	null
18 ה ה הכוכבים definiteArticle unspecified unspecified unspecified unspecified unspecified 0 
18 הכוכבים כוכב הכוכבים noun masculine plural absolute unspecified unspecified  	O	null
19 ש ש שנשארו relativizer/subordinatingConjunction unspecified unspecified unspecified unspecified unspecified 0 
19 נשארו נשאר שנשארו verb masculine-and-feminine plural unspecified 3 past  	O	null
20 ב ב בחוץ preposition unspecified unspecified unspecified unspecified unspecified 0 
20 ה ה בחוץ definiteArticle unspecified unspecified unspecified unspecified unspecified 0 
20 החוץ חוץ בחוץ noun masculine singular absolute unspecified unspecified  	O	null
21 : : : punctuation unspecified unspecified unspecified unspecified unspecified  	O	null
22 פרשנות פרשנות פרשנות noun feminine singular absolute unspecified unspecified  	O	null
23 , , , punctuation unspecified unspecified unspecified unspecified unspecified  	O	null
24 צורות צורה צורות noun feminine plural absolute unspecified unspecified  	O	null
25 ו ו ורטוריקה conjunction unspecified unspecified unspecified unspecified unspecified 0 
25 רטוריקה רטוריקה ורטוריקה noun feminine singular absolute unspecified unspecified  	O	null
26 ב ב בשירי preposition unspecified unspecified unspecified unspecified unspecified 0 
26 שירי שיר בשירי noun masculine plural construct unspecified unspecified  	O	null
27 " " " punctuation unspecified unspecified unspecified unspecified unspecified  	O	null
28 כוכבים כוכב כוכבים noun masculine plural absolute unspecified unspecified  	O	null
29 ב ב בחוץ preposition unspecified unspecified unspecified unspecified unspecified 0 
29 ה ה בחוץ definiteArticle unspecified unspecified unspecified unspecified unspecified 0 
29 החוץ חוץ בחוץ noun masculine singular absolute unspecified unspecified  	O	null
30 " " " punctuation unspecified unspecified unspecified unspecified unspecified  	O	null
31 מאת מאת מאת preposition unspecified unspecified unspecified unspecified unspecified  	O	null
32 נתן נתן נתן properName unspecified unspecified unspecified unspecified unspecified  	I_PERS	null
33 אלתרמן אלתרמן אלתרמן properName unspecified unspecified unspecified unspecified unspecified  	I_PERS	null
34 . . . punctuation unspecified unspecified unspecified unspecified unspecified  	O	null

0 חידוש חידוש חידושו noun masculine singular absolute unspecified unspecified  
0 ו ו חידושו possessive masculine singular unspecified 3 unspecified 0 	O	null
1 ה ה העיקרי definiteArticle unspecified unspecified unspecified unspecified unspecified 0 
1 העיקרי עיקרי העיקרי adjective masculine singular absolute unspecified unspecified  	O	null
2 של של של shel-preposition unspecified unspecified unspecified unspecified unspecified  	O	null
3 ה ה הספר definiteArticle unspecified unspecified unspecified unspecified unspecified 0 
3 הספר ספר הספר noun masculine singular absolute unspecified unspecified  	O	null
4 הוא הוא הוא pronoun masculine singular unspecified 3 unspecified  	O	null
5 ב ב בהצבעה preposition unspecified unspecified unspecified unspecified unspecified 0 
5 הצבעה הצבעה בהצבעה noun feminine singular absolute unspecified unspecified  	O	null
6 על על על preposition unspecified unspecified unspecified unspecified unspecified  	O	null
7 עקרונות עיקרון עקרונות noun masculine plural construct unspecified unspecified  	O	null
8 ה ה הארגון definiteArticle unspecified unspecified unspecified unspecified unspecified 0 
8 הארגון ארגון הארגון noun masculine singular absolute unspecified unspecified  	O	null
9 של של של shel-preposition unspecified unspecified unspecified unspecified unspecified  	O	null
10 כוכבים כוכב כוכבים noun masculine plural absolute unspecified unspecified  	O	null
11 ב ב בחוץ preposition unspecified unspecified unspecified unspecified unspecified 0 
11 ה ה בחוץ definiteArticle unspecified unspecified unspecified unspecified unspecified 0 
11 החוץ חוץ בחוץ noun masculine singular absolute unspecified unspecified  	O	null
12 , , , punctuation unspecified unspecified unspecified unspecified unspecified  	O	null
13 ו ו וכן conjunction unspecified unspecified unspecified unspecified unspecified 0 
13 כן כן וכן conjunction unspecified unspecified unspecified unspecified unspecified  	O	null
14 ב ב בהארה preposition unspecified unspecified unspecified unspecified unspecified 0 
14 הארה הארה בהארה noun feminine singular absolute unspecified unspecified  	O	null
15 חדשה חדש חדשה adjective feminine singular absolute unspecified unspecified  	O	null
16 של של של shel-preposition unspecified unspecified unspecified unspecified unspecified  	O	null
17 דמות דמות דמות noun feminine singular absolute unspecified unspecified  	O	null
18 ה ה ה numeral unspecified unspecified unspecified unspecified unspecified  	O	null
19 " " " punctuation unspecified unspecified unspecified unspecified unspecified  	O	null
20 הלך הלך הלך verb masculine singular unspecified 3 past  	O	null
21 " " " punctuation unspecified unspecified unspecified unspecified unspecified  	O	null
22 ה ה האלתרמני definiteArticle unspecified unspecified unspecified unspecified unspecified 0 
22 האלתרמני האלתרמני האלתרמני noun feminine plural absolute unspecified unspecified  	O	null
23 . . . punctuation unspecified unspecified unspecified unspecified unspecified  	O	null

0 ה ה ה numeral unspecified unspecified unspecified unspecified unspecified  	O	null
1 " " " punctuation unspecified unspecified unspecified unspecified unspecified  	O	null
2 הלך הלך הלך verb masculine singular unspecified 3 past  	O	null
3 " " " punctuation unspecified unspecified unspecified unspecified unspecified  	O	null
4 , , , punctuation unspecified unspecified unspecified unspecified unspecified  	O	null
5 על על על preposition unspecified unspecified unspecified unspecified unspecified  	O	null
6 פי פה פי noun masculine singular construct unspecified unspecified  	O	null
7 תפישת תפישה תפישתו noun feminine singular absolute unspecified unspecified  
7 ו ו תפישתו possessive masculine singular unspecified 3 unspecified 0 	O	null
8 , , , punctuation unspecified unspecified unspecified unspecified unspecified  	O	null
9 אינו הוא אינו copula masculine singular unspecified 3 beinoni  	O	null
10 תואר תואר תואר noun masculine singular absolute unspecified unspecified  	O	null
11 גיאוגרפי גיאוגרפי גיאוגרפי adjective masculine singular absolute unspecified unspecified  	O	null
12 אלא אלא אלא conjunction unspecified unspecified unspecified unspecified unspecified  	O	null
13 חווייתי חווייתי חווייתי adjective masculine singular absolute unspecified unspecified  	O	null
14 , , , punctuation unspecified unspecified unspecified unspecified unspecified  	O	null
15 ו ו והוא conjunction unspecified unspecified unspecified unspecified unspecified 0 
15 הוא הוא והוא pronoun masculine singular unspecified 3 unspecified  	O	null
16 ניתן ניתן ניתן verb masculine singular unspecified 3 past  	O	null
17 ל ל לאדם preposition unspecified unspecified unspecified unspecified unspecified 0 
17 אדם אדם לאדם noun masculine singular absolute unspecified unspecified  	O	null
18 ש ש שכל relativizer/subordinatingConjunction unspecified unspecified unspecified unspecified unspecified 0 
18 כל כול שכל quantifier unspecified unspecified construct unspecified unspecified  	O	null
19 חושי חוש חושיו noun masculine plural absolute unspecified unspecified  
19 ו ו חושיו possessive masculine singular unspecified 3 unspecified 0 	O	null
20 פתוחים פתוח פתוחים adjective masculine plural absolute unspecified unspecified  	O	null
21 לקלוט קלט לקלוט verb unspecified unspecified unspecified unspecified infinitive  	O	null
22 את את את at-preposition unspecified unspecified unspecified unspecified unspecified  	O	null
23 ה ה העולם definiteArticle unspecified unspecified unspecified unspecified unspecified 0 
23 העולם עולם העולם noun masculine singular absolute unspecified unspecified  	O	null
24 סביב סביב סביבו preposition unspecified unspecified unspecified unspecified unspecified  
24 ו ו סביבו pronomial masculine singular unspecified 3 unspecified 0 	O	null
25 . . . punctuation unspecified unspecified unspecified unspecified unspecified  	O	null

0 ספר ספר ספר noun masculine singular construct unspecified unspecified  	O	null
1 שירי שיר שיריו noun masculine plural absolute unspecified unspecified  
1 ו ו שיריו possessive masculine singular unspecified 3 unspecified 0 	O	null
2 ה ה השני definiteArticle unspecified unspecified unspecified unspecified unspecified 0 
2 השני ORD2 השני numeral masculine singular absolute unspecified unspecified  	O	null
3 , , , punctuation unspecified unspecified unspecified unspecified unspecified  	O	null
4 טריסטן טריסטן טריסטן properName unspecified unspecified unspecified unspecified unspecified  	I_PERS	null
5 ואיזולדה ואיזולדה ואיזולדה properName unspecified unspecified unspecified unspecified unspecified  	I_PERS	null
6 : : : punctuation unspecified unspecified unspecified unspecified unspecified  	O	null
7 קורות קורה קורות noun feminine plural construct unspecified unspecified  	O	null
8 אהבה אהבה אהבה noun feminine singular absolute unspecified unspecified  	O	null
9 בלתי בלתי בלתי wPrefix unspecified unspecified unspecified unspecified unspecified  	O	null
10 אפשרית אפשרי אפשרית adjective feminine singular absolute unspecified unspecified  	O	null
11 , , , punctuation unspecified unspecified unspecified unspecified unspecified  	O	null
12 הופיע הופיע הופיע verb masculine singular unspecified 3 past  	O	null
13 ב ב ב preposition unspecified unspecified unspecified unspecified unspecified 0 	O	null
14 - - - punctuation unspecified unspecified unspecified unspecified unspecified  	O	null
15 ###NUMBER### ###NUMBER### ###NUMBER### numeral unspecified unspecified unspecified unspecified unspecified  	I_DATE	null
16 ו ו וזכה conjunction unspecified unspecified unspecified unspecified unspecified 0 
16 זכה זכה וזכה verb masculine singular unspecified 3 past  	O	null
17 ל ל לשבחי preposition unspecified unspecified unspecified unspecified unspecified 0 
17 שבחי שבח לשבחי noun masculine plural construct unspecified unspecified  	O	null
18 ה ה הביקורת definiteArticle unspecified unspecified unspecified unspecified unspecified 0 
18 הביקורת ביקורת הביקורת noun feminine singular absolute unspecified unspecified  	O	null
19 . . . punctuation unspecified unspecified unspecified unspecified unspecified  	O	null

0 על על על preposition unspecified unspecified unspecified unspecified unspecified  	O	null
1 מחקרי מחקר מחקריו noun masculine plural absolute unspecified unspecified  
1 ו ו מחקריו possessive masculine singular unspecified 3 unspecified 0 	O	null
2 ו ו ושיריו conjunction unspecified unspecified unspecified unspecified unspecified 0 
2 שירי שיר ושיריו noun masculine plural absolute unspecified unspecified  
2 ו ו ושיריו possessive masculine singular unspecified 3 unspecified 0 	O	null
3 זכה זכה זכה verb masculine singular unspecified 3 past  	O	null
4 ב ב באותה preposition unspecified unspecified unspecified unspecified unspecified 0 
4 אותו אותו באותה quantifier unspecified unspecified unspecified unspecified unspecified  
4 ה ה באותה pronomial feminine singular unspecified 3 unspecified 0 	O	null
5 שנה שנה שנה noun feminine singular absolute unspecified unspecified  	O	null
6 ב ב בפרס preposition unspecified unspecified unspecified unspecified unspecified 0 
6 פרס פרס בפרס noun masculine singular construct unspecified unspecified  	O	null
7 ה ה היצירה definiteArticle unspecified unspecified unspecified unspecified unspecified 0 
7 היצירה יצירה היצירה noun feminine singular absolute unspecified unspecified  	O	null
8 על על על preposition unspecified unspecified unspecified unspecified unspecified  	O	null
9 שם שם שם noun masculine singular construct unspecified unspecified  	O	null
10 ראש ראש ראש noun masculine singular absolute unspecified unspecified  	O	null
11 הממשלהלוי הממשלהלוי הממשלהלוי verb masculine singular unspecified 2 imperative  	O	null
12 אשכול.את אשכול.את אשכול.את noun masculine-and-feminine singular absolute unspecified unspecified  	O	null
13 שנת שינה שנת noun feminine singular construct unspecified unspecified  	O	null
14 ה ה ההתפנות definiteArticle unspecified unspecified unspecified unspecified unspecified 0 
14 ההתפנות התפנות ההתפנות noun feminine singular absolute unspecified unspecified  	O	null
15 ל ל לכתיבה preposition unspecified unspecified unspecified unspecified unspecified 0 
15 ה ה לכתיבה definiteArticle unspecified unspecified unspecified unspecified unspecified 0 
15 הכתיבה כתיבה לכתיבה noun feminine singular absolute unspecified unspecified  	O	null
16 עשה עשה עשה verb masculine singular unspecified 3 past  	O	null
17 ב ב באוניברסיטת preposition unspecified unspecified unspecified unspecified unspecified 0 
17 אוניברסיטת אוניברסיטה באוניברסיטת noun feminine singular construct unspecified unspecified  	I_ORG	null
18 ה ה הרווארד definiteArticle unspecified unspecified unspecified unspecified unspecified 0 
18 הרווארד הרווארד הרווארד properName unspecified unspecified unspecified unspecified unspecified  	I_ORG	null
19 כ כ כעמית preposition unspecified unspecified unspecified unspecified unspecified 0 
19 עמית עמית כעמית noun feminine singular construct unspecified unspecified  	O	null
20 מחקר מחקר מחקר noun masculine singular absolute unspecified unspecified  	O	null
21 , , , punctuation unspecified unspecified unspecified unspecified unspecified  	O	null
22 ו ו ושם conjunction unspecified unspecified unspecified unspecified unspecified 0 
22 שם שם ושם adverb unspecified unspecified unspecified unspecified unspecified  	O	null
23 קיבל קיבל קיבל verb masculine singular unspecified 3 past  	O	null
24 הזמנה הזמנה הזמנה noun feminine singular absolute unspecified unspecified  	O	null
25 ללמד לימד ללמד verb unspecified unspecified unspecified unspecified infinitive  	O	null
26 ב ב באוניברסיטת preposition unspecified unspecified unspecified unspecified unspecified 0 
26 אוניברסיטת אוניברסיטה באוניברסיטת noun feminine singular construct unspecified unspecified  	I_ORG	null
27 מישיגן מישיגן מישיגן properName unspecified unspecified unspecified unspecified unspecified  	I_ORG	null
28 . . . punctuation unspecified unspecified unspecified unspecified unspecified  	O	null

0 אחרי אחרי אחרי preposition unspecified unspecified unspecified unspecified unspecified  	O	null
1 חמש CARD5 חמש numeral feminine singular absolute unspecified unspecified  	O	null
2 שנות שנה שנות noun feminine plural construct unspecified unspecified  	O	null
3 הוראה הוראה הוראה noun feminine singular absolute unspecified unspecified  	O	null
4 ב ב במישיגן preposition unspecified unspecified unspecified unspecified unspecified 0 
4 מישיגן מישיגן במישיגן properName unspecified unspecified unspecified unspecified unspecified  	I_LOC	null
5 הוזמן הוזמן הוזמן verb masculine singular unspecified 3 past  	O	null
6 להורות הורה להורות verb unspecified unspecified unspecified unspecified infinitive  	O	null
7 ב ב באוניברסיטת preposition unspecified unspecified unspecified unspecified unspecified 0 
7 אוניברסיטת אוניברסיטה באוניברסיטת noun feminine singular construct unspecified unspecified  	I_ORG	null
8 פלורידה פלורידה פלורידה properName unspecified unspecified unspecified unspecified unspecified  	I_ORG	null
9 , , , punctuation unspecified unspecified unspecified unspecified unspecified  	O	null
10 שבה שב שבה verb feminine singular unspecified 3 past  	O	null
11 הוא הוא הוא pronoun masculine singular unspecified 3 unspecified  	O	null
12 מלמד לימד מלמד verb masculine singular unspecified any beinoni  	O	null
13 עד עד עד preposition unspecified unspecified unspecified unspecified unspecified  	O	null
14 ה ה היום definiteArticle unspecified unspecified unspecified unspecified unspecified 0 
14 היום יום היום noun masculine singular absolute unspecified unspecified  	O	null
15 . . . punctuation unspecified unspecified unspecified unspecified unspecified  	O	null

0 ב ב בשנים preposition unspecified unspecified unspecified unspecified unspecified 0 
0 שנים שנה בשנים noun feminine plural absolute unspecified unspecified  	O	null
1 ###NUMBER### ###NUMBER### ###NUMBER### numeral unspecified unspecified unspecified unspecified unspecified  	I_DATE	null
2 - - - punctuation unspecified unspecified unspecified unspecified unspecified  	O	null
3 ###NUMBER### ###NUMBER### ###NUMBER### numeral unspecified unspecified unspecified unspecified unspecified  	I_DATE	null
4 כיהן כיהן כיהן verb masculine singular unspecified 3 past  	O	null
5 כ כ כיו"ר preposition unspecified unspecified unspecified unspecified unspecified 0 
5 יו"ר יו"ר כיו"ר noun masculine singular construct unspecified unspecified  	O	null
6 ה ה המחלקה definiteArticle unspecified unspecified unspecified unspecified unspecified 0 
6 המחלקה מחלקה המחלקה noun feminine singular absolute unspecified unspecified  	O	null
7 שבה שב שבה verb feminine singular unspecified 3 past  	O	null
8 הוא הוא הוא pronoun masculine singular unspecified 3 unspecified  	O	null
9 חוקר חקר חוקר verb masculine singular unspecified any beinoni  	O	null
10 ( ( ( punctuation unspecified unspecified unspecified unspecified unspecified  	O	null
11 African African African foreign unspecified unspecified unspecified unspecified unspecified  	I_ORG	null
12 and and and foreign unspecified unspecified unspecified unspecified unspecified  	I_ORG	null
13 Asian Asian Asian foreign unspecified unspecified unspecified unspecified unspecified  	I_ORG	null
14 Languages Languages Languages foreign unspecified unspecified unspecified unspecified unspecified  	I_ORG	null
15 and and and foreign unspecified unspecified unspecified unspecified unspecified  	I_ORG	null
16 Literatures Literatures Literatures foreign unspecified unspecified unspecified unspecified unspecified  	I_ORG	null
17 ) ) ) punctuation unspecified unspecified unspecified unspecified unspecified  	O	null
18 . . . punctuation unspecified unspecified unspecified unspecified unspecified  	O	null

0 ב ב ב preposition unspecified unspecified unspecified unspecified unspecified 0 	O	null
1 - - - punctuation unspecified unspecified unspecified unspecified unspecified  	O	null
2 ###NUMBER### ###NUMBER### ###NUMBER### numeral unspecified unspecified unspecified unspecified unspecified  	I_DATE	null
3 ראה ראה ראה verb masculine singular unspecified 3 past  	O	null
4 אור אור אור noun masculine singular construct unspecified unspecified  	O	null
5 ספר ספר ספרו noun masculine singular absolute unspecified unspecified  
5 ו ו ספרו possessive masculine singular unspecified 3 unspecified 0 	O	null
6 בין בין בין preposition unspecified unspecified unspecified unspecified unspecified  	O	null
7 אל אל אל noun masculine singular absolute unspecified unspecified  	O	null
8 ל ל לחיה preposition unspecified unspecified unspecified unspecified unspecified 0 
8 חיה חיה לחיה properName unspecified unspecified unspecified unspecified unspecified  	I_PERS	null
9 : : : punctuation unspecified unspecified unspecified unspecified unspecified  	O	null
10 עיון עיון עיון noun masculine singular absolute unspecified unspecified  	O	null
11 ב ב ביצירתו preposition unspecified unspecified unspecified unspecified unspecified 0 
11 יצירת יצירה ביצירתו noun feminine singular absolute unspecified unspecified  
11 ו ו ביצירתו possessive masculine singular unspecified 3 unspecified 0 	O	null
12 של של של shel-preposition unspecified unspecified unspecified unspecified unspecified  	O	null
13 עמוס עמוס עמוס properName unspecified unspecified unspecified unspecified unspecified  	I_PERS	null
14 עוז עוז עוז properName unspecified unspecified unspecified unspecified unspecified  	I_PERS	null
15 . . . punctuation unspecified unspecified unspecified unspecified unspecified  	O	null

0 כמה כמה כמה quantifier unspecified unspecified construct unspecified unspecified  	O	null
1 ו ו וכמה conjunction unspecified unspecified unspecified unspecified unspecified 0 
1 כמה כמה וכמה quantifier unspecified unspecified construct unspecified unspecified  	O	null
2 מ מ מחידושיו preposition unspecified unspecified unspecified unspecified unspecified 0 
2 חידושי חידוש מחידושיו noun masculine plural absolute unspecified unspecified  
2 ו ו מחידושיו possessive masculine singular unspecified 3 unspecified 0 	O	null
3 של של של shel-preposition unspecified unspecified unspecified unspecified unspecified  	O	null
4 מחקר מחקר מחקר noun masculine singular absolute unspecified unspecified  	O	null
5 זה זה זה pronoun masculine singular unspecified 3 unspecified  	O	null
6 ( ( ( punctuation unspecified unspecified unspecified unspecified unspecified  	O	null
7 עוז עוז עוז properName unspecified unspecified unspecified unspecified unspecified  	I_PERS	null
8 כ כ כסוכן preposition unspecified unspecified unspecified unspecified unspecified 0 
8 סוכן סוכן כסוכן noun masculine singular absolute unspecified unspecified  	O	null
9 כפול כפול כפול adjective masculine singular absolute unspecified unspecified  	O	null
10 , , , punctuation unspecified unspecified unspecified unspecified unspecified  	O	null
11 חשיבות חשיבות חשיבות noun feminine singular construct unspecified unspecified  	O	null
12 ה ה היסוד definiteArticle unspecified unspecified unspecified unspecified unspecified 0 
12 היסוד יסוד היסוד noun masculine singular absolute unspecified unspecified  	O	null
13 ה ה הרליגיוזי definiteArticle unspecified unspecified unspecified unspecified unspecified 0 
13 הרליגיוזי הרליגיוזי הרליגיוזי adjective masculine singular absolute unspecified unspecified  	O	null
14 ב ב ביצירתו preposition unspecified unspecified unspecified unspecified unspecified 0 
14 יצירת יצירה ביצירתו noun feminine singular absolute unspecified unspecified  
14 ו ו ביצירתו possessive masculine singular unspecified 3 unspecified 0 	O	null
15 של של של shel-preposition unspecified unspecified unspecified unspecified unspecified  	O	null
16 עוז עוז עוז properName unspecified unspecified unspecified unspecified unspecified  	I_PERS	null
17 , , , punctuation unspecified unspecified unspecified unspecified unspecified  	O	null
18 ה ה הזיקה definiteArticle unspecified unspecified unspecified unspecified unspecified 0 
18 הזיקה זיקה הזיקה noun feminine singular absolute unspecified unspecified  	O	null
19 ה ה החזקה definiteArticle unspecified unspecified unspecified unspecified unspecified 0 
19 החזקה חזק החזקה adjective feminine singular absolute unspecified unspecified  	O	null
20 בין בין בין preposition unspecified unspecified unspecified unspecified unspecified  	O	null
21 נושאי נושא נושאיו noun masculine plural absolute unspecified unspecified  
21 ו ו נושאיו possessive masculine singular unspecified 3 unspecified 0 	O	null
22 ו ו וסמליו conjunction unspecified unspecified unspecified unspecified unspecified 0 
22 סמלי סמל וסמליו noun masculine plural absolute unspecified unspecified  
22 ו ו וסמליו possessive masculine singular unspecified 3 unspecified 0 	O	null
23 של של של shel-preposition unspecified unspecified unspecified unspecified unspecified  	O	null
24 עוז עוז עוז properName unspecified unspecified unspecified unspecified unspecified  	I_PERS	null
25 לבין לבין לבין preposition unspecified unspecified unspecified unspecified unspecified  	O	null
26 תפישות תפישה תפישותיו noun feminine plural absolute unspecified unspecified  
26 ו ו תפישותיו possessive masculine singular unspecified 3 unspecified 0 	O	null
27 של של של shel-preposition unspecified unspecified unspecified unspecified unspecified  	O	null
28 קארל קארל קארל properName unspecified unspecified unspecified unspecified unspecified  	I_PERS	null
29 גוסטב גוסטב גוסטב properName unspecified unspecified unspecified unspecified unspecified  	I_PERS	null
30 יונג יונג יונג properName unspecified unspecified unspecified unspecified unspecified  	I_PERS	null
31 ) ) ) punctuation unspecified unspecified unspecified unspecified unspecified  	O	null
32 הפכו הפך הפכו verb masculine-and-feminine plural unspecified 3 past  	O	null
33 ל ל להיות preposition unspecified unspecified unspecified unspecified unspecified 0 
33 היות היות להיות noun masculine singular construct unspecified unspecified  	O	null
34 חלק חלק חלק noun masculine singular absolute unspecified unspecified  	O	null
35 מ מ מהנחות preposition unspecified unspecified unspecified unspecified unspecified 0 
35 הנחות הנחה מהנחות noun feminine plural construct unspecified unspecified  	O	null
36 ה ה היסוד definiteArticle unspecified unspecified unspecified unspecified unspecified 0 
36 היסוד יסוד היסוד noun masculine singular absolute unspecified unspecified  	O	null
37 של של של shel-preposition unspecified unspecified unspecified unspecified unspecified  	O	null
38 ה ה החוקרים definiteArticle unspecified unspecified unspecified unspecified unspecified 0 
38 החוקרים חוקר החוקרים noun masculine plural absolute unspecified unspecified  	O	null
39 ה ה העוסקים definiteArticle unspecified unspecified unspecified unspecified unspecified 0 
39 העוסקים עסק העוסקים participle masculine plural absolute any unspecified  	O	null
40 ב ב ביצירתו preposition unspecified unspecified unspecified unspecified unspecified 0 
40 יצירת יצירה ביצירתו noun feminine singular absolute unspecified unspecified  
40 ו ו ביצירתו possessive masculine singular unspecified 3 unspecified 0 	O	null
41 של של של shel-preposition unspecified unspecified unspecified unspecified unspecified  	O	null
42 עוז עוז עוז properName unspecified unspecified unspecified unspecified unspecified  	I_PERS	null
43 . . . punctuation unspecified unspecified unspecified unspecified unspecified  	O	null

0 שנתיים שנתי שנתיים adjective masculine plural absolute unspecified unspecified  	O	null
1 מאוחר מאוחר מאוחר adverb unspecified unspecified unspecified unspecified unspecified  	O	null
2 יותר יותר יותר adverb unspecified unspecified unspecified unspecified unspecified  	O	null
3 הופיע הופיע הופיע verb masculine singular unspecified 3 past  	O	null
4 חלק חלק חלקו noun masculine singular absolute unspecified unspecified  
4 ו ו חלקו possessive masculine singular unspecified 3 unspecified 0 	O	null
5 ה ה השני definiteArticle unspecified unspecified unspecified unspecified unspecified 0 
5 השני ORD2 השני numeral masculine singular absolute unspecified unspecified  	O	null
6 של של של shel-preposition unspecified unspecified unspecified unspecified unspecified  	O	null
7 מחקר מחקר מחקר noun masculine singular absolute unspecified unspecified  	O	null
8 זה זה זה pronoun masculine singular unspecified 3 unspecified  	O	null
9 , , , punctuation unspecified unspecified unspecified unspecified unspecified  	O	null
10 אל אל אל preposition unspecified unspecified unspecified unspecified unspecified  	O	null
11 ה ה הלשון definiteArticle unspecified unspecified unspecified unspecified unspecified 0 
11 הלשון לשון הלשון noun feminine singular absolute unspecified unspecified  	O	null
12 ו ו וממנה conjunction unspecified unspecified unspecified unspecified unspecified 0 
12 מן מן וממנה preposition unspecified unspecified unspecified unspecified unspecified  
12 ה ה וממנה pronomial feminine singular unspecified 3 unspecified 0 	O	null
13 : : : punctuation unspecified unspecified unspecified unspecified unspecified  	O	null
14 לשון לשון לשון noun feminine singular absolute unspecified unspecified  	O	null
15 ו ו ומציאות conjunction unspecified unspecified unspecified unspecified unspecified 0 
15 מציאות מציאות ומציאות noun feminine singular absolute unspecified unspecified  	O	null
16 ב ב ביצירת preposition unspecified unspecified unspecified unspecified unspecified 0 
16 יצירת יצירה ביצירת noun feminine singular construct unspecified unspecified  	O	null
17 עמוס עמוס עמוס properName unspecified unspecified unspecified unspecified unspecified  	I_PERS	null
18 עוז עוז עוז properName unspecified unspecified unspecified unspecified unspecified  	I_PERS	null
19 . . . punctuation unspecified unspecified unspecified unspecified unspecified  	O	null

0 ב ב ב preposition unspecified unspecified unspecified unspecified unspecified 0 	O	null
1 - - - punctuation unspecified unspecified unspecified unspecified unspecified  	O	null
2 ###NUMBER### ###NUMBER### ###NUMBER### numeral unspecified unspecified unspecified unspecified unspecified  	I_DATE	null
3 פורסם פורסם פורסם verb masculine singular unspecified 3 past  	O	null
4 ספר ספר ספר noun masculine singular construct unspecified unspecified  	O	null
5 שיריוהחוםהנכון שיריוהחוםהנכון שיריוהחוםהנכון properName unspecified unspecified unspecified unspecified unspecified  	I_LOC	null
6 , , , punctuation unspecified unspecified unspecified unspecified unspecified  	O	null
7 ש ש שאף relativizer/subordinatingConjunction unspecified unspecified unspecified unspecified unspecified 0 
7 אף אף שאף conjunction unspecified unspecified unspecified unspecified unspecified  	O	null
8 הוא הוא הוא pronoun masculine singular unspecified 3 unspecified  	O	null
9 מחזור מחזור מחזור noun masculine singular absolute unspecified unspecified  	O	null
10 של של של shel-preposition unspecified unspecified unspecified unspecified unspecified  	O	null
11 שירי שיר שירי noun masculine plural construct unspecified unspecified  	O	null
12 אהבה אהבה אהבה noun feminine singular absolute unspecified unspecified  	O	null
13 . . . punctuation unspecified unspecified unspecified unspecified unspecified  	O	null

0 ה ה העניין definiteArticle unspecified unspecified unspecified unspecified unspecified 0 
0 העניין עניין העניין noun masculine singular absolute unspecified unspecified  	O	null
1 של של של shel-preposition unspecified unspecified unspecified unspecified unspecified  	O	null
2 ב ב בלבן preposition unspecified unspecified unspecified unspecified unspecified 0 
2 לב לב בלבן noun masculine singular absolute unspecified unspecified  
2 ן ן בלבן possessive feminine plural unspecified 3 unspecified 0 	O	null
3 ב ב בסופרי preposition unspecified unspecified unspecified unspecified unspecified 0 
3 סופרי סופר בסופרי noun masculine plural construct unspecified unspecified  	O	null
4 " " " punctuation unspecified unspecified unspecified unspecified unspecified  	O	null
5 ה ה הגל definiteArticle unspecified unspecified unspecified unspecified unspecified 0 
5 הגל גל הגל noun masculine singular absolute unspecified unspecified  	O	null
6 ה ה החדש definiteArticle unspecified unspecified unspecified unspecified unspecified 0 
6 החדש חדש החדש adjective masculine singular absolute unspecified unspecified  	O	null
7 " " " punctuation unspecified unspecified unspecified unspecified unspecified  	O	null
8 מצא מצא מצא verb masculine singular unspecified 3 past  	O	null
9 ביטוי ביטוי ביטוי noun masculine singular construct unspecified unspecified  	O	null
10 ב ב בספר preposition unspecified unspecified unspecified unspecified unspecified 0 
10 ספר ספר בספר noun masculine singular construct unspecified unspecified  	O	null
11 ה ה המחקר definiteArticle unspecified unspecified unspecified unspecified unspecified 0 
11 המחקר מחקר המחקר noun masculine singular absolute unspecified unspecified  	O	null
12 ה ה הבא definiteArticle unspecified unspecified unspecified unspecified unspecified 0 
12 הבא בא הבא participle masculine singular absolute any unspecified  	O	null
13 של של שלו shel-preposition unspecified unspecified unspecified unspecified unspecified  
13 ו ו שלו pronomial masculine singular unspecified 3 unspecified 0 	O	null
14 , , , punctuation unspecified unspecified unspecified unspecified unspecified  	O	null
15 מר מר מר title masculine singular unspecified unspecified unspecified  	O	null
16 מולך מלך מולכו participle masculine singular unspecified any unspecified  
16 ו ו מולכו possessive masculine singular unspecified 3 unspecified 0 	I_ORG	null
17 : : : punctuation unspecified unspecified unspecified unspecified unspecified  	O	null
18 עיון עיון עיון noun masculine singular construct unspecified unspecified  	O	null
19 ב ב ברומנים preposition unspecified unspecified unspecified unspecified unspecified 0 
19 ה ה ברומנים definiteArticle unspecified unspecified unspecified unspecified unspecified 0 
19 הרומנים רומני ברומנים adjective masculine plural absolute unspecified unspecified  	O	null
20 " " " punctuation unspecified unspecified unspecified unspecified unspecified  	O	null
21 מר מר מר title masculine singular unspecified unspecified unspecified  	O	null
22 מאני מיאן מאני verb feminine singular unspecified 2 imperative  	O	null
23 " " " punctuation unspecified unspecified unspecified unspecified unspecified  	O	null
24 ו ו ו conjunction unspecified unspecified unspecified unspecified unspecified 0 	O	null
25 " " " punctuation unspecified unspecified unspecified unspecified unspecified  	O	null
26 מולך מלך מולכו participle masculine singular unspecified any unspecified  
26 ו ו מולכו possessive masculine singular unspecified 3 unspecified 0 	O	null
27 " " " punctuation unspecified unspecified unspecified unspecified unspecified  	O	null
28 מאת מאת מאת preposition unspecified unspecified unspecified unspecified unspecified  	O	null
29 א.ב. א.ב. א.ב. properName unspecified unspecified unspecified unspecified unspecified  	I_ORG	null
30 יהושע יהושע יהושע properName unspecified unspecified unspecified unspecified unspecified  	I_ORG	null
31 ) ) ) punctuation unspecified unspecified unspecified unspecified unspecified  	O	null
32 . . . punctuation unspecified unspecified unspecified unspecified unspecified  	O	null
33 ###NUMBER### ###NUMBER### ###NUMBER### numeral unspecified unspecified unspecified unspecified unspecified  	I_DATE	null
34 בספר סיפר בספרו verb unspecified unspecified unspecified unspecified infinitive  
34 ו ו בספרו accusative-or-nominative masculine singular unspecified 3 unspecified 0 	O	null
35 ה ה הבא definiteArticle unspecified unspecified unspecified unspecified unspecified 0 
35 הבא בא הבא participle masculine singular absolute any unspecified  	I_ORG	null
36 , , , punctuation unspecified unspecified unspecified unspecified unspecified  	O	null
37 גל גל גל properName masculine-and-feminine singular unspecified unspecified unspecified  	I_PERS	null
38 אחר איחר אחר verb masculine singular unspecified 2 imperative  	O	null
39 ב ב בסיפורת preposition unspecified unspecified unspecified unspecified unspecified 0 
39 סיפורת סיפורת בסיפורת noun feminine singular construct unspecified unspecified  	O	null
40 ה ה העברית definiteArticle unspecified unspecified unspecified unspecified unspecified 0 
40 העברית עברית העברית properName feminine singular unspecified unspecified unspecified  	O	null
41 : : : punctuation unspecified unspecified unspecified unspecified unspecified  	O	null
42 סיפורת סיפורת סיפורת noun feminine singular construct unspecified unspecified  	O	null
43 עברית עברית עברית properName feminine singular unspecified unspecified unspecified  	I_ORG	null
44 פוסטמודרניסטית פוסטמודרניסטית פוסטמודרניסטית properName unspecified unspecified unspecified unspecified unspecified  	I_ORG	null
45 ) ) ) punctuation unspecified unspecified unspecified unspecified unspecified  	O	null
46 , , , punctuation unspecified unspecified unspecified unspecified unspecified  	O	null
47 ###NUMBER### ###NUMBER### ###NUMBER### numeral unspecified unspecified unspecified unspecified unspecified  	I_DATE	null
48 ב ב בחן preposition unspecified unspecified unspecified unspecified unspecified 0 
48 חן חן בחן properName masculine-and-feminine singular unspecified unspecified unspecified  	I_PERS	null
49 את את את at-preposition unspecified unspecified unspecified unspecified unspecified  	O	null
50 ה ה המגמות definiteArticle unspecified unspecified unspecified unspecified unspecified 0 
50 המגמות מגמה המגמות noun feminine plural absolute unspecified unspecified  	O	null
51 ה ה הפוסט definiteArticle unspecified unspecified unspecified unspecified unspecified 0 
51 הפוסט פוסט הפוסט noun masculine singular absolute unspecified unspecified  	O	null
52 - - - punctuation unspecified unspecified unspecified unspecified unspecified  	O	null
53 מודרניסטיות מודרניסטיות מודרניסטיות adjective feminine plural absolute unspecified unspecified  	O	null
54 ש ש שאפיינו relativizer/subordinatingConjunction unspecified unspecified unspecified unspecified unspecified 0 
54 אפיינו אפיין שאפיינו verb masculine-and-feminine plural unspecified 3 past  	O	null
55 את את את at-preposition unspecified unspecified unspecified unspecified unspecified  	O	null
56 ה ה הסיפורת definiteArticle unspecified unspecified unspecified unspecified unspecified 0 
56 הסיפורת סיפורת הסיפורת noun feminine singular absolute unspecified unspecified  	O	null
57 ה ה העברית definiteArticle unspecified unspecified unspecified unspecified unspecified 0 
57 העברית עברית העברית properName feminine singular unspecified unspecified unspecified  	O	null
58 בראשית בראשית בראשית adverb unspecified unspecified unspecified unspecified unspecified  	O	null
59 שנות שנה שנות noun feminine plural construct unspecified unspecified  	I_DATE	null
60 ה ה התשעים definiteArticle unspecified unspecified unspecified unspecified unspecified 0 
60 התשעים ORD-CARD90 התשעים numeral masculine-and-feminine plural absolute unspecified unspecified  	I_DATE	null
61 . . . punctuation unspecified unspecified unspecified unspecified unspecified  	O	null

0 חלק חלק חלקו noun masculine singular absolute unspecified unspecified  
0 ו ו חלקו possessive masculine singular unspecified 3 unspecified 0 	O	null
1 ה ה הראשון definiteArticle unspecified unspecified unspecified unspecified unspecified 0 
1 הראשון ORD1 הראשון numeral masculine singular absolute unspecified unspecified  	O	null
2 של של של shel-preposition unspecified unspecified unspecified unspecified unspecified  	O	null
3 ה ה הספר definiteArticle unspecified unspecified unspecified unspecified unspecified 0 
3 הספר ספר הספר noun masculine singular absolute unspecified unspecified  	O	null
4 סוקר סוקר סוקר verb masculine singular unspecified 3 past  	O	null
5 את את את at-preposition unspecified unspecified unspecified unspecified unspecified  	O	null
6 ה ה המגמות definiteArticle unspecified unspecified unspecified unspecified unspecified 0 
6 המגמות מגמה המגמות noun feminine plural absolute unspecified unspecified  	O	null
7 ה ה האלה definiteArticle unspecified unspecified unspecified unspecified unspecified 0 
7 האלה אלה האלה pronoun masculine-and-feminine plural unspecified 3 unspecified  	O	null
8 על על על preposition unspecified unspecified unspecified unspecified unspecified  	O	null
9 רקע רקע רקע noun masculine singular construct unspecified unspecified  	O	null
10 ה ה הסיפורת definiteArticle unspecified unspecified unspecified unspecified unspecified 0 
10 הסיפורת סיפורת הסיפורת noun feminine singular absolute unspecified unspecified  	O	null
11 של של של shel-preposition unspecified unspecified unspecified unspecified unspecified  	O	null
12 יהושע יהושע יהושע properName unspecified unspecified unspecified unspecified unspecified  	I_PERS	null
13 ו ו ועוז conjunction unspecified unspecified unspecified unspecified unspecified 0 
13 עוז עוז ועוז properName unspecified unspecified unspecified unspecified unspecified  	I_PERS	null
14 ו ו ובני conjunction unspecified unspecified unspecified unspecified unspecified 0 
14 בני בן ובני noun masculine plural construct unspecified unspecified  	O	null
15 דור דור דורם noun masculine singular absolute unspecified unspecified  
15 ם ם דורם possessive masculine plural unspecified 3 unspecified 0 	O	null
16 , , , punctuation unspecified unspecified unspecified unspecified unspecified  	O	null
17 ו ו וחלקו conjunction unspecified unspecified unspecified unspecified unspecified 0 
17 חלק חלק וחלקו noun masculine singular absolute unspecified unspecified  
17 ו ו וחלקו possessive masculine singular unspecified 3 unspecified 0 	O	null
18 ה ה השני definiteArticle unspecified unspecified unspecified unspecified unspecified 0 
18 השני ORD2 השני numeral masculine singular absolute unspecified unspecified  	O	null
19 סוקר סוקר סוקר verb masculine singular unspecified 3 past  	O	null
20 ב ב בהרחבה preposition unspecified unspecified unspecified unspecified unspecified 0 
20 הרחבה הרחבה בהרחבה noun feminine singular absolute unspecified unspecified  	O	null
21 יצירות יצירה יצירות noun feminine plural absolute unspecified unspecified  	O	null
22 עבריות עברי עבריות adjective feminine plural absolute unspecified unspecified  	O	null
23 פוסט פוסט פוסט wPrefix unspecified unspecified unspecified unspecified unspecified  	I_ORG	null
24 - - - punctuation unspecified unspecified unspecified unspecified unspecified  	I_ORG	null
25 מודרניות מודרני מודרניות adjective feminine plural absolute unspecified unspecified  	I_ORG	null
26 . . . punctuation unspecified unspecified unspecified unspecified unspecified  	O	null

0 זהו זהו זהו pronoun masculine singular unspecified 3 unspecified  	O	null
1 למעשה למעשה למעשה adverb unspecified unspecified unspecified unspecified unspecified  	O	null
2 ה ה הספר definiteArticle unspecified unspecified unspecified unspecified unspecified 0 
2 הספר ספר הספר noun masculine singular absolute unspecified unspecified  	O	null
3 ה ה הראשון definiteArticle unspecified unspecified unspecified unspecified unspecified 0 
3 הראשון ORD1 הראשון numeral masculine singular absolute unspecified unspecified  	O	null
4 , , , punctuation unspecified unspecified unspecified unspecified unspecified  	O	null
5 ו ו ובשלב conjunction unspecified unspecified unspecified unspecified unspecified 0 
5 ב ב ובשלב preposition unspecified unspecified unspecified unspecified unspecified 0 
5 שלב שלב ובשלב noun masculine singular absolute unspecified unspecified  	O	null
6 זה זה זה pronoun masculine singular unspecified 3 unspecified  	O	null
7 אולי אולי אולי adverb unspecified unspecified unspecified unspecified unspecified  	O	null
8 ה ה היחיד definiteArticle unspecified unspecified unspecified unspecified unspecified 0 
8 היחיד יחיד היחיד adjective masculine singular absolute unspecified unspecified  	O	null
9 , , , punctuation unspecified unspecified unspecified unspecified unspecified  	O	null
10 ה ה העוסק definiteArticle unspecified unspecified unspecified unspecified unspecified 0 
10 העוסק עסק העוסק participle masculine singular absolute any unspecified  	O	null
11 ב ב בחטיבת preposition unspecified unspecified unspecified unspecified unspecified 0 
11 חטיבת חטיבה בחטיבת noun feminine singular construct unspecified unspecified  	O	null
12 ה ה הסיפורת definiteArticle unspecified unspecified unspecified unspecified unspecified 0 
12 הסיפורת סיפורת הסיפורת noun feminine singular absolute unspecified unspecified  	O	null
13 ה ה הזאת definiteArticle unspecified unspecified unspecified unspecified unspecified 0 
13 הזאת זאת הזאת pronoun feminine singular unspecified 3 unspecified  	O	null
14 ב ב בדרך preposition unspecified unspecified unspecified unspecified unspecified 0 
14 דרך דרך בדרך noun feminine singular absolute unspecified unspecified  	O	null
15 מושכלת מושכל מושכלת adjective feminine singular absolute unspecified unspecified  	O	null
16 ו ו ושיטתית conjunction unspecified unspecified unspecified unspecified unspecified 0 
16 שיטתית שיטתי ושיטתית adjective feminine singular absolute unspecified unspecified  	O	null
17 . . . punctuation unspecified unspecified unspecified unspecified unspecified  	O	null

0 ב ב בשנים preposition unspecified unspecified unspecified unspecified unspecified 0 
0 ה ה בשנים definiteArticle unspecified unspecified unspecified unspecified unspecified 0 
0 השנים שנה בשנים noun feminine plural absolute unspecified unspecified  	O	null
1 ה ה האחרונות definiteArticle unspecified unspecified unspecified unspecified unspecified 0 
1 האחרונות אחרון האחרונות adjective feminine plural absolute unspecified unspecified  	O	null
2 עוסק עסק עוסק verb masculine singular unspecified any beinoni  	O	null
3 ב ב בלבן preposition unspecified unspecified unspecified unspecified unspecified 0 
3 לבן לבן בלבן noun masculine singular absolute unspecified unspecified  	O	null
4 ב ב בנושאים preposition unspecified unspecified unspecified unspecified unspecified 0 
4 נושאים נושא בנושאים noun masculine plural absolute unspecified unspecified  	O	null
5 פמיניסטיים פמיניסטיים פמיניסטיים adjective masculine plural absolute unspecified unspecified  	O	null
6 שונים שונה שונים adjective masculine plural absolute unspecified unspecified  	O	null
7 . . . punctuation unspecified unspecified unspecified unspecified unspecified  	O	null

0 ה ה המחקר definiteArticle unspecified unspecified unspecified unspecified unspecified 0 
0 המחקר מחקר המחקר noun masculine singular absolute unspecified unspecified  	O	null
1 זכה זכה זכה verb masculine singular unspecified 3 past  	O	null
2 ל ל להשלמה preposition unspecified unspecified unspecified unspecified unspecified 0 
2 השלמה השלמה להשלמה noun feminine singular absolute unspecified unspecified  	O	null
3 ב ב בספר preposition unspecified unspecified unspecified unspecified unspecified 0 
3 ספר ספר בספר noun masculine singular construct unspecified unspecified  	O	null
4 תשע CARD9 תשע numeral feminine singular absolute unspecified unspecified  	O	null
5 אמהות אם אמהות noun feminine plural absolute unspecified unspecified  	O	null
6 ו ו ואמא conjunction unspecified unspecified unspecified unspecified unspecified 0 
6 אמא אמא ואמא noun feminine singular absolute unspecified unspecified  	O	null
7 ) ) ) punctuation unspecified unspecified unspecified unspecified unspecified  	O	null
8 , , , punctuation unspecified unspecified unspecified unspecified unspecified  	O	null
9 ###NUMBER### ###NUMBER### ###NUMBER### numeral unspecified unspecified unspecified unspecified unspecified  	I_DATE	null
10 ש ש שכותרת relativizer/subordinatingConjunction unspecified unspecified unspecified unspecified unspecified 0 
10 כותרת כותרת שכותרת noun feminine singular construct unspecified unspecified  	O	null
11 ה ה המשנה definiteArticle unspecified unspecified unspecified unspecified unspecified 0 
11 המשנה משנה המשנה noun feminine singular absolute unspecified unspecified  	O	null
12 של של שלו shel-preposition unspecified unspecified unspecified unspecified unspecified  
12 ו ו שלו pronomial masculine singular unspecified 3 unspecified 0 	O	null
13 היא הוא היא copula feminine singular unspecified 3 beinoni  	O	null
14 ייצוגי ייצוג ייצוגי noun masculine plural construct unspecified unspecified  	O	null
15 אמהות אם אמהות noun feminine plural absolute unspecified unspecified  	O	null
16 ב ב בסיפורת preposition unspecified unspecified unspecified unspecified unspecified 0 
16 ה ה בסיפורת definiteArticle unspecified unspecified unspecified unspecified unspecified 0 
16 הסיפורת סיפורת בסיפורת noun feminine singular absolute unspecified unspecified  	O	null
17 ה ה העברית definiteArticle unspecified unspecified unspecified unspecified unspecified 0 
17 העברית עברי העברית adjective feminine singular absolute unspecified unspecified  	O	null
18 ה ה החדשה definiteArticle unspecified unspecified unspecified unspecified unspecified 0 
18 החדשה חדש החדשה adjective feminine singular absolute unspecified unspecified  	O	null
19 , , , punctuation unspecified unspecified unspecified unspecified unspecified  	O	null
20 ו ו והוא conjunction unspecified unspecified unspecified unspecified unspecified 0 
20 הוא הוא והוא pronoun masculine singular unspecified 3 unspecified  	O	null
21 כולל כלל כולל verb masculine singular unspecified any beinoni  	O	null
22 עיונים עיון עיונים noun masculine plural absolute unspecified unspecified  	O	null
23 מפורטים פורט מפורטים verb masculine plural unspecified any beinoni  	O	null
24 ב ב בייצוגי preposition unspecified unspecified unspecified unspecified unspecified 0 
24 ייצוגי ייצוג בייצוגי noun masculine plural construct unspecified unspecified  	O	null
25 ה ה האם definiteArticle unspecified unspecified unspecified unspecified unspecified 0 
25 האם אם האם noun feminine singular absolute unspecified unspecified  	O	null
26 ב ב ביצירותיהם preposition unspecified unspecified unspecified unspecified unspecified 0 
26 יצירות יצירה ביצירותיהם noun feminine plural absolute unspecified unspecified  
26 הם הם ביצירותיהם possessive masculine plural unspecified 3 unspecified 0 	O	null
27 של של של shel-preposition unspecified unspecified unspecified unspecified unspecified  	O	null
28 סופרים סופר סופרים noun masculine plural absolute unspecified unspecified  	O	null
29 ו ו וסופרות conjunction unspecified unspecified unspecified unspecified unspecified 0 
29 סופרות סופר וסופרות noun feminine plural absolute unspecified unspecified  	O	null
30 ישראליים ישראלי ישראליים adjective masculine plural absolute unspecified unspecified  	O	null
31 מרכזיים מרכזי מרכזיים adjective masculine plural absolute unspecified unspecified  	O	null
32 , , , punctuation unspecified unspecified unspecified unspecified unspecified  	O	null
33 ו ו ובצדם conjunction unspecified unspecified unspecified unspecified unspecified 0 
33 ב ב ובצדם preposition unspecified unspecified unspecified unspecified unspecified 0 
33 צד צד ובצדם noun masculine singular absolute unspecified unspecified  
33 ם ם ובצדם possessive masculine plural unspecified 3 unspecified 0 	O	null
34 שלושה CARD3 שלושה numeral masculine plural absolute unspecified unspecified  	O	null
35 מפרקי מפרק מפרקי noun masculine plural construct unspecified unspecified  	O	null
36 ה ה הרומן definiteArticle unspecified unspecified unspecified unspecified unspecified 0 
36 הרומן רומן הרומן noun masculine singular absolute unspecified unspecified  	O	null
37 של של שלו shel-preposition unspecified unspecified unspecified unspecified unspecified  
37 ו ו שלו pronomial masculine singular unspecified 3 unspecified 0 	O	null
38 שבעה שבעה שבעה noun feminine singular absolute unspecified unspecified  	O	null
39 , , , punctuation unspecified unspecified unspecified unspecified unspecified  	O	null
40 ש ש שאותם relativizer/subordinatingConjunction unspecified unspecified unspecified unspecified unspecified 0 
40 את את שאותם at-preposition unspecified unspecified unspecified unspecified unspecified  
40 הם הם שאותם pronomial masculine plural unspecified 3 unspecified 0 	O	null
41 הוא הוא הוא pronoun masculine singular unspecified 3 unspecified  	O	null
42 מביא הביא מביא verb masculine singular unspecified any beinoni  	O	null
43 ל ל לזכרה preposition unspecified unspecified unspecified unspecified unspecified 0 
43 זכר זכר לזכרה noun masculine singular absolute unspecified unspecified  
43 ה ה לזכרה possessive feminine singular unspecified 3 unspecified 0 	O	null
44 של של של shel-preposition unspecified unspecified unspecified unspecified unspecified  	O	null
45 אם אם אמו noun feminine singular absolute unspecified unspecified  
45 ו ו אמו possessive masculine singular unspecified 3 unspecified 0 	O	null
46 . . . punctuation unspecified unspecified unspecified unspecified unspecified  	O	null

0 הוא הוא הוא pronoun masculine singular unspecified 3 unspecified  	O	null
1 אף אף אף conjunction unspecified unspecified unspecified unspecified unspecified  	O	null
2 הגדיר הגדיר הגדיר verb masculine singular unspecified 3 past  	O	null
3 את את את at-preposition unspecified unspecified unspecified unspecified unspecified  	O	null
4 אם אם אמו noun feminine singular absolute unspecified unspecified  
4 ו ו אמו possessive masculine singular unspecified 3 unspecified 0 	O	null
5 כ כ כגיבורת preposition unspecified unspecified unspecified unspecified unspecified 0 
5 גיבורת גיבור כגיבורת noun feminine singular construct unspecified unspecified  	O	null
6 ה ה הספר definiteArticle unspecified unspecified unspecified unspecified unspecified 0 
6 הספר ספר הספר noun masculine singular absolute unspecified unspecified  	O	null
7 ו ו והקדיש conjunction unspecified unspecified unspecified unspecified unspecified 0 
7 הקדיש הקדיש והקדיש verb masculine singular unspecified 3 past  	O	null
8 ל ל לה preposition unspecified unspecified unspecified unspecified unspecified  
8 ה ה לה pronomial feminine singular unspecified 3 unspecified 0 	O	null
9 את את אותו at-preposition unspecified unspecified unspecified unspecified unspecified  
9 ו ו אותו pronomial masculine singular unspecified 3 unspecified 0 	O	null
10 . . . punctuation unspecified unspecified unspecified unspecified unspecified  	O	null

0 ב ב בשנה preposition unspecified unspecified unspecified unspecified unspecified 0 
0 שנה שנה בשנה noun feminine singular absolute unspecified unspecified  	O	null
1 זו זו זו pronoun feminine singular unspecified 3 unspecified  	O	null
2 ראה ראה ראה verb masculine singular unspecified 3 past  	O	null
3 אור אור אור noun masculine singular absolute unspecified unspecified  	O	null
4 גם גם גם conjunction unspecified unspecified unspecified unspecified unspecified  	O	null
5 ספר ספר ספר noun masculine singular construct unspecified unspecified  	O	null
6 שירי שיר שיריו noun masculine plural absolute unspecified unspecified  
6 ו ו שיריו possessive masculine singular unspecified 3 unspecified 0 	O	null
7 ש ש שירה relativizer/subordinatingConjunction unspecified unspecified unspecified unspecified unspecified 0 
7 ירה ירה שירה verb masculine singular unspecified 3 past  	O	null
8 ב ב בעיר preposition unspecified unspecified unspecified unspecified unspecified 0 
8 עיר עיר בעיר noun feminine singular absolute unspecified unspecified  	O	null
9 זרה זר זרה adjective feminine singular absolute unspecified unspecified  	O	null
10 . . . punctuation unspecified unspecified unspecified unspecified unspecified  	O	null

0 ב ב בצד preposition unspecified unspecified unspecified unspecified unspecified 0 
0 צד צד בצד noun masculine singular construct unspecified unspecified  	O	null
1 שירה שירה שירה noun feminine singular absolute unspecified unspecified  	O	null
2 ו ו ומחקר conjunction unspecified unspecified unspecified unspecified unspecified 0 
2 מחקר מחקר ומחקר noun masculine singular absolute unspecified unspecified  	O	null
3 פירסם פרסם פירסם verb masculine singular unspecified 3 past  	O	null
4 מאז מאז מאז adverb unspecified unspecified unspecified unspecified unspecified  	O	null
5 סוף סוף סוף noun masculine singular construct unspecified unspecified  	O	null
6 שנות שנה שנות noun feminine plural construct unspecified unspecified  	I_DATE	null
7 ה ה השישים definiteArticle unspecified unspecified unspecified unspecified unspecified 0 
7 השישים ORD-CARD60 השישים numeral masculine-and-feminine plural absolute unspecified unspecified  	I_DATE	null
8 מ מ מאות preposition unspecified unspecified unspecified unspecified unspecified 0 
8 אות אות מאות noun masculine singular construct unspecified unspecified  	O	null
9 רשימות רשימה רשימות noun feminine plural absolute unspecified unspecified  	O	null
10 ביקורת ביקורת ביקורת noun feminine singular absolute unspecified unspecified  	O	null
11 ב ב במוספי preposition unspecified unspecified unspecified unspecified unspecified 0 
11 מוספי מוסף במוספי noun masculine plural construct unspecified unspecified  	O	null
12 ה ה הספרות definiteArticle unspecified unspecified unspecified unspecified unspecified 0 
12 הספרות ספרות הספרות noun feminine singular absolute unspecified unspecified  	O	null
13 ה ה השונים definiteArticle unspecified unspecified unspecified unspecified unspecified 0 
13 השונים שונה השונים adjective masculine plural absolute unspecified unspecified  	O	null
14 . . . punctuation unspecified unspecified unspecified unspecified unspecified  	O	null

0 ב ב בשנות preposition unspecified unspecified unspecified unspecified unspecified 0 
0 שנות שנה בשנות noun feminine plural construct unspecified unspecified  	I_DATE	null
1 ה ה האלפיים definiteArticle unspecified unspecified unspecified unspecified unspecified 0 
1 האלפיים ORD-CARD2000 האלפיים numeral masculine-and-feminine dual absolute unspecified unspecified  	I_DATE	null
2 הוסיף הוסיף הוסיף verb masculine singular unspecified 3 past  	O	null
3 ב ב בלבן preposition unspecified unspecified unspecified unspecified unspecified 0 
3 לבן לבן בלבן noun masculine singular absolute unspecified unspecified  	O	null
4 ל ל לשירה preposition unspecified unspecified unspecified unspecified unspecified 0 
4 ה ה לשירה definiteArticle unspecified unspecified unspecified unspecified unspecified 0 
4 השירה שירה לשירה noun feminine singular absolute unspecified unspecified  	O	null
5 , , , punctuation unspecified unspecified unspecified unspecified unspecified  	O	null
6 ל ל למחקר preposition unspecified unspecified unspecified unspecified unspecified 0 
6 ה ה למחקר definiteArticle unspecified unspecified unspecified unspecified unspecified 0 
6 המחקר מחקר למחקר noun masculine singular absolute unspecified unspecified  	O	null
7 ו ו ולביקורת conjunction unspecified unspecified unspecified unspecified unspecified 0 
7 ל ל ולביקורת preposition unspecified unspecified unspecified unspecified unspecified 0 
7 ביקורת ביקורת ולביקורת noun feminine singular absolute unspecified unspecified  	O	null
8 גם גם גם conjunction unspecified unspecified unspecified unspecified unspecified  	O	null
9 כתיבת כתיבה כתיבת noun feminine singular construct unspecified unspecified  	O	null
10 סיפורת סיפורת סיפורת noun feminine singular absolute unspecified unspecified  	O	null
11 . . . punctuation unspecified unspecified unspecified unspecified unspecified  	O	null

0 ה ה הרומן definiteArticle unspecified unspecified unspecified unspecified unspecified 0 
0 הרומן רומן הרומן noun masculine singular absolute unspecified unspecified  	O	null
1 ה ה האוטוביוגרפי definiteArticle unspecified unspecified unspecified unspecified unspecified 0 
1 האוטוביוגרפי אוטוביוגרפי האוטוביוגרפי adjective masculine singular absolute unspecified unspecified  	O	null
2 של של שלו shel-preposition unspecified unspecified unspecified unspecified unspecified  
2 ו ו שלו pronomial masculine singular unspecified 3 unspecified 0 	O	null
3 שבעה שבעה שבעה noun feminine singular absolute unspecified unspecified  	O	null
4 ) ) ) punctuation unspecified unspecified unspecified unspecified unspecified  	O	null
5 , , , punctuation unspecified unspecified unspecified unspecified unspecified  	O	null
6 ###NUMBER### ###NUMBER### ###NUMBER### numeral unspecified unspecified unspecified unspecified unspecified  	I_DATE	null
7 שבו ישב שבו verb masculine-and-feminine plural unspecified 2 imperative  	O	null
8 תיאר תיאר תיאר verb masculine singular unspecified 3 past  	O	null
9 את את את at-preposition unspecified unspecified unspecified unspecified unspecified  	O	null
10 ילדות ילדות ילדותו noun feminine singular absolute unspecified unspecified  
10 ו ו ילדותו possessive masculine singular unspecified 3 unspecified 0 	O	null
11 ב ב בקיבוץ preposition unspecified unspecified unspecified unspecified unspecified 0 
11 ה ה בקיבוץ definiteArticle unspecified unspecified unspecified unspecified unspecified 0 
11 הקיבוץ קיבוץ בקיבוץ noun masculine singular absolute unspecified unspecified  	O	null
12 , , , punctuation unspecified unspecified unspecified unspecified unspecified  	O	null
13 נחשב נחשב נחשב verb masculine singular unspecified 3 past  	O	null
14 היום היום היום adverb unspecified unspecified unspecified unspecified unspecified  	O	null
15 ל ל לאחת preposition unspecified unspecified unspecified unspecified unspecified 0 
15 אחת CARD1 לאחת numeral feminine singular absolute unspecified unspecified  	O	null
16 ה ה היצירות definiteArticle unspecified unspecified unspecified unspecified unspecified 0 
16 היצירות יצירה היצירות noun feminine plural absolute unspecified unspecified  	O	null
17 ה ה החשובות definiteArticle unspecified unspecified unspecified unspecified unspecified 0 
17 החשובות חשוב החשובות adjective feminine plural absolute unspecified unspecified  	O	null
18 ה ה העוסקות definiteArticle unspecified unspecified unspecified unspecified unspecified 0 
18 העוסקות עסק העוסקות participle feminine plural absolute any unspecified  	O	null
19 ב ב בילדות preposition unspecified unspecified unspecified unspecified unspecified 0 
19 ילדות ילדות בילדות noun feminine singular absolute unspecified unspecified  	O	null
20 ב ב בקיבוץ preposition unspecified unspecified unspecified unspecified unspecified 0 
20 ה ה בקיבוץ definiteArticle unspecified unspecified unspecified unspecified unspecified 0 
20 הקיבוץ קיבוץ בקיבוץ noun masculine singular absolute unspecified unspecified  	O	null
21 ו ו ובכישלונו conjunction unspecified unspecified unspecified unspecified unspecified 0 
21 ב ב ובכישלונו preposition unspecified unspecified unspecified unspecified unspecified 0 
21 כישלון כישלון ובכישלונו noun masculine singular absolute unspecified unspecified  
21 ו ו ובכישלונו possessive masculine singular unspecified 3 unspecified 0 	O	null
22 של של של shel-preposition unspecified unspecified unspecified unspecified unspecified  	O	null
23 ה ה הרעיון definiteArticle unspecified unspecified unspecified unspecified unspecified 0 
23 הרעיון רעיון הרעיון noun masculine singular absolute unspecified unspecified  	O	null
24 ה ה הקיבוצי definiteArticle unspecified unspecified unspecified unspecified unspecified 0 
24 הקיבוצי קיבוצי הקיבוצי adjective masculine singular absolute unspecified unspecified  	O	null
25 . . . punctuation unspecified unspecified unspecified unspecified unspecified  	O	null

0 ה ה הרומן definiteArticle unspecified unspecified unspecified unspecified unspecified 0 
0 הרומן רומן הרומן noun masculine singular absolute unspecified unspecified  	O	null
1 של של שלו shel-preposition unspecified unspecified unspecified unspecified unspecified  
1 ו ו שלו pronomial masculine singular unspecified 3 unspecified 0 	O	null
2 אומרים אמר אומרים verb masculine plural unspecified any beinoni  	O	null
3 אהבה אהבה אהבה noun feminine singular absolute unspecified unspecified  	O	null
4 הופיע הופיע הופיע verb masculine singular unspecified 3 past  	O	null
5 ב ב ב preposition unspecified unspecified unspecified unspecified unspecified 0 	O	null
6 - - - punctuation unspecified unspecified unspecified unspecified unspecified  	O	null
7 ###NUMBER### ###NUMBER### ###NUMBER### numeral unspecified unspecified unspecified unspecified unspecified  	I_DATE	null
8 . . . punctuation unspecified unspecified unspecified unspecified unspecified  	O	null

0 References References References foreign unspecified unspecified unspecified unspecified unspecified  	O	null
1 : : : punctuation unspecified unspecified unspecified unspecified unspecified  	O	null
2 הרציג הרציג הרציג properName unspecified unspecified unspecified unspecified unspecified  	I_ORG	null
3 , , , punctuation unspecified unspecified unspecified unspecified unspecified  	O	null
4 חנה חנה חנה properName unspecified unspecified unspecified unspecified unspecified  	I_PERS	null
5 . . . punctuation unspecified unspecified unspecified unspecified unspecified  	O	null

0 " " " punctuation unspecified unspecified unspecified unspecified unspecified  	O	null
1 על על על preposition unspecified unspecified unspecified unspecified unspecified  	O	null
2 אל אל אל noun masculine singular construct unspecified unspecified  	O	null
3 ה ה הלשון definiteArticle unspecified unspecified unspecified unspecified unspecified 0 
3 הלשון לשון הלשון noun feminine singular absolute unspecified unspecified  	O	null
4 ו ו וממנה conjunction unspecified unspecified unspecified unspecified unspecified 0 
4 מן מן וממנה preposition unspecified unspecified unspecified unspecified unspecified  
4 ה ה וממנה pronomial feminine singular unspecified 3 unspecified 0 	O	null
5 " " " punctuation unspecified unspecified unspecified unspecified unspecified  	O	null
6 . . . punctuation unspecified unspecified unspecified unspecified unspecified  	O	null

0 ביקורת ביקורת ביקורת noun feminine singular absolute unspecified unspecified  	O	null
1 ו ו ופרשנות conjunction unspecified unspecified unspecified unspecified unspecified 0 
1 פרשנות פרשנות ופרשנות noun feminine singular absolute unspecified unspecified  	O	null
2 ###NUMBER### ###NUMBER### ###NUMBER### numeral unspecified unspecified unspecified unspecified unspecified  	O	null
3 . . . punctuation unspecified unspecified unspecified unspecified unspecified  	O	null

0 ###NUMBER### ###NUMBER### ###NUMBER### numeral unspecified unspecified unspecified unspecified unspecified  	I_DATE	null
1 . . . punctuation unspecified unspecified unspecified unspecified unspecified  	O	null

0 - - - punctuation unspecified unspecified unspecified unspecified unspecified  	O	null
1 ###NUMBER### ###NUMBER### ###NUMBER### numeral unspecified unspecified unspecified unspecified unspecified  	O	null
2 ; ; ; punctuation unspecified unspecified unspecified unspecified unspecified  	O	null
3 ###NUMBER### ###NUMBER### ###NUMBER### numeral unspecified unspecified unspecified unspecified unspecified  	O	null
4 לשם לשם לשם preposition unspecified unspecified unspecified unspecified unspecified  	O	null
5 , , , punctuation unspecified unspecified unspecified unspecified unspecified  	O	null
6 גיורא גיורא גיורא properName unspecified unspecified unspecified unspecified unspecified  	I_PERS	null
7 . . . punctuation unspecified unspecified unspecified unspecified unspecified  	O	null

0 " " " punctuation unspecified unspecified unspecified unspecified unspecified  	O	null
1 ביקורת ביקורת ביקורת noun feminine singular absolute unspecified unspecified  	O	null
2 אלתרמן אלתרמן אלתרמן properName unspecified unspecified unspecified unspecified unspecified  	I_PERS	null
3 – – – punctuation unspecified unspecified unspecified unspecified unspecified  	O	null
4 ה ה המרד definiteArticle unspecified unspecified unspecified unspecified unspecified 0 
4 המרד מרד המרד noun masculine singular absolute unspecified unspecified  	O	null
5 ו ו והאקדמיה conjunction unspecified unspecified unspecified unspecified unspecified 0 
5 ה ה והאקדמיה definiteArticle unspecified unspecified unspecified unspecified unspecified 0 
5 האקדמיה אקדמיה והאקדמיה noun feminine singular absolute unspecified unspecified  	O	null
6 " " " punctuation unspecified unspecified unspecified unspecified unspecified  	O	null
7 . . . punctuation unspecified unspecified unspecified unspecified unspecified  	O	null

0 דבר דבר דבר noun masculine singular absolute unspecified unspecified  	O	null
1 . . . punctuation unspecified unspecified unspecified unspecified unspecified  	O	null

0 ###NUMEXP### ###NUMEXP### ###NUMEXP### numberExpression unspecified unspecified unspecified unspecified unspecified  	I_DATE	null
1 . . . punctuation unspecified unspecified unspecified unspecified unspecified  	O	null

0 ; ; ; punctuation unspecified unspecified unspecified unspecified unspecified  	O	null
1 ###NUMBER### ###NUMBER### ###NUMBER### numeral unspecified unspecified unspecified unspecified unspecified  	O	null
2 נצר נצר נצר properName unspecified unspecified unspecified unspecified unspecified  	I_LOC	null
3 , , , punctuation unspecified unspecified unspecified unspecified unspecified  	O	null
4 רות רות רות properName feminine singular unspecified unspecified unspecified  	I_PERS	null
5 . . . punctuation unspecified unspecified unspecified unspecified unspecified  	O	null

0 " " " punctuation unspecified unspecified unspecified unspecified unspecified  	O	null
1 כ כ כאיש preposition unspecified unspecified unspecified unspecified unspecified 0 
1 איש איש כאיש noun masculine singular absolute unspecified unspecified  	O	null
2 עומד עמד עומד verb masculine singular unspecified any beinoni  	O	null
3 מול מול מול preposition unspecified unspecified unspecified unspecified unspecified  	O	null
4 סוד סוד סוד noun masculine singular absolute unspecified unspecified  	O	null
5 אפל אפל אפל adjective masculine singular absolute unspecified unspecified  	O	null
6 " " " punctuation unspecified unspecified unspecified unspecified unspecified  	O	null
7 . . . punctuation unspecified unspecified unspecified unspecified unspecified  	O	null

0 מאזניים מאזניים מאזניים noun masculine plural absolute unspecified unspecified  	O	null
1 ס"ג ס"ג ס"ג properName unspecified unspecified unspecified unspecified unspecified  	I_PERS	null
2 ) ) ) punctuation unspecified unspecified unspecified unspecified unspecified  	O	null
3 . . . punctuation unspecified unspecified unspecified unspecified unspecified  	O	null
4 ###NUMBER### ###NUMBER### ###NUMBER### numeral unspecified unspecified unspecified unspecified unspecified  	I_ORG	null
5 ###NUMBER### ###NUMBER### ###NUMBER### numeral unspecified unspecified unspecified unspecified unspecified  	I_DATE	null
6 . . . punctuation unspecified unspecified unspecified unspecified unspecified  	O	null

0 - - - punctuation unspecified unspecified unspecified unspecified unspecified  	O	null
1 ###NUMBER### ###NUMBER### ###NUMBER### numeral unspecified unspecified unspecified unspecified unspecified  	O	null
2 ; ; ; punctuation unspecified unspecified unspecified unspecified unspecified  	O	null
3 ###NUMBER### ###NUMBER### ###NUMBER### numeral unspecified unspecified unspecified unspecified unspecified  	O	null
4 שוויצר שוויצר שוויצר properName unspecified unspecified unspecified unspecified unspecified  	O	null
5 , , , punctuation unspecified unspecified unspecified unspecified unspecified  	O	null
6 ארז ארז ארז properName unspecified unspecified unspecified unspecified unspecified  	I_PERS	null
7 . . . punctuation unspecified unspecified unspecified unspecified unspecified  	O	null

0 " " " punctuation unspecified unspecified unspecified unspecified unspecified  	O	null
1 עפעף עפעף עפעף noun masculine singular absolute unspecified unspecified  	O	null
2 נופל נפל נופל verb masculine singular unspecified any beinoni  	O	null
3 על על על preposition unspecified unspecified unspecified unspecified unspecified  	O	null
4 עין עין עין noun feminine singular absolute unspecified unspecified  	O	null
5 רעבה רעב רעבה adjective feminine singular absolute unspecified unspecified  	O	null
6 " " " punctuation unspecified unspecified unspecified unspecified unspecified  	O	null
7 . . . punctuation unspecified unspecified unspecified unspecified unspecified  	O	null

0 ה ה הארץ definiteArticle unspecified unspecified unspecified unspecified unspecified 0 
0 הארץ ארץ הארץ noun feminine singular absolute unspecified unspecified  	O	null
1 . . . punctuation unspecified unspecified unspecified unspecified unspecified  	O	null

0 ###NUMEXP### ###NUMEXP### ###NUMEXP### numberExpression unspecified unspecified unspecified unspecified unspecified  	I_DATE	null
1 . . . punctuation unspecified unspecified unspecified unspecified unspecified  	O	null

0 ; ; ; punctuation unspecified unspecified unspecified unspecified unspecified  	O	null
1 ###NUMBER### ###NUMBER### ###NUMBER### numeral unspecified unspecified unspecified unspecified unspecified  	O	null
2 שניר שניר שניר properName unspecified unspecified unspecified unspecified unspecified  	I_PERS	null
3 , , , punctuation unspecified unspecified unspecified unspecified unspecified  	O	null
4 לאה לאה לאה properName unspecified unspecified unspecified unspecified unspecified  	I_PERS	null
5 . . . punctuation unspecified unspecified unspecified unspecified unspecified  	O	null

0 " " " punctuation unspecified unspecified unspecified unspecified unspecified  	O	null
1 בין בין בין preposition unspecified unspecified unspecified unspecified unspecified  	O	null
2 אל אל אל noun masculine singular absolute unspecified unspecified  	O	null
3 ל ל לחיה preposition unspecified unspecified unspecified unspecified unspecified 0 
3 חיה חיה לחיה properName unspecified unspecified unspecified unspecified unspecified  	I_PERS	null
4 : : : punctuation unspecified unspecified unspecified unspecified unspecified  	O	null
5 שיחה שיחה שיחה noun feminine singular absolute unspecified unspecified  	O	null
6 עם עם עם preposition unspecified unspecified unspecified unspecified unspecified  	O	null
7 אברהם אברהם אברהם properName unspecified unspecified unspecified unspecified unspecified  	I_PERS	null
8 ב ב בלבן preposition unspecified unspecified unspecified unspecified unspecified 0 
8 לבן לבן בלבן noun masculine singular absolute unspecified unspecified  	O	null
9 " " " punctuation unspecified unspecified unspecified unspecified unspecified  	O	null
10 . . . punctuation unspecified unspecified unspecified unspecified unspecified  	O	null

0 דבר דבר דבר noun masculine singular absolute unspecified unspecified  	O	null
1 . . . punctuation unspecified unspecified unspecified unspecified unspecified  	O	null

0 ###NUMEXP### ###NUMEXP### ###NUMEXP### numberExpression unspecified unspecified unspecified unspecified unspecified  	I_DATE	null
1 . . . punctuation unspecified unspecified unspecified unspecified unspecified  	O	null

0 ; ; ; punctuation unspecified unspecified unspecified unspecified unspecified  	O	null
1 ###NUMBER### ###NUMBER### ###NUMBER### numeral unspecified unspecified unspecified unspecified unspecified  	O	null
2 Fuchs Fuchs Fuchs foreign unspecified unspecified unspecified unspecified unspecified  	O	null
3 , , , punctuation unspecified unspecified unspecified unspecified unspecified  	O	null
4 Esther Esther Esther foreign unspecified unspecified unspecified unspecified unspecified  	O	null
5 . . . punctuation unspecified unspecified unspecified unspecified unspecified  	O	null

0 " " " punctuation unspecified unspecified unspecified unspecified unspecified  	O	null
1 A A A foreign unspecified unspecified unspecified unspecified unspecified  	I_ORG	null
2 Different Different Different foreign unspecified unspecified unspecified unspecified unspecified  	I_ORG	null
3 Wave Wave Wave foreign unspecified unspecified unspecified unspecified unspecified  	I_ORG	null
4 in in in foreign unspecified unspecified unspecified unspecified unspecified  	I_ORG	null
5 Israeli Israeli Israeli foreign unspecified unspecified unspecified unspecified unspecified  	I_ORG	null
6 Fiction Fiction Fiction foreign unspecified unspecified unspecified unspecified unspecified  	I_ORG	null
7 : : : punctuation unspecified unspecified unspecified unspecified unspecified  	O	null
8 Postmodernist Postmodernist Postmodernist foreign unspecified unspecified unspecified unspecified unspecified  	O	null
9 Israeli Israeli Israeli foreign unspecified unspecified unspecified unspecified unspecified  	O	null
10 Fiction Fiction Fiction foreign unspecified unspecified unspecified unspecified unspecified  	O	null
11 " " " punctuation unspecified unspecified unspecified unspecified unspecified  	O	null
12 . . . punctuation unspecified unspecified unspecified unspecified unspecified  	O	null

0 AJS AJS AJS foreign unspecified unspecified unspecified unspecified unspecified  	I_ORG	null
1 Review Review Review foreign unspecified unspecified unspecified unspecified unspecified  	I_ORG	null
2 ###NUMBER### ###NUMBER### ###NUMBER### numeral unspecified unspecified unspecified unspecified unspecified  	I_LOC	null
3 . . . punctuation unspecified unspecified unspecified unspecified unspecified  	O	null

0 ###NUMBER### ###NUMBER### ###NUMBER### numeral unspecified unspecified unspecified unspecified unspecified  	I_DATE	null
1 . . . punctuation unspecified unspecified unspecified unspecified unspecified  	O	null

0 - - - punctuation unspecified unspecified unspecified unspecified unspecified  	O	null
1 ###NUMBER### ###NUMBER### ###NUMBER### numeral unspecified unspecified unspecified unspecified unspecified  	O	null
2 ; ; ; punctuation unspecified unspecified unspecified unspecified unspecified  	O	null
3 ###NUMBER### ###NUMBER### ###NUMBER### numeral unspecified unspecified unspecified unspecified unspecified  	O	null
4 Lieblich Lieblich Lieblich foreign unspecified unspecified unspecified unspecified unspecified  	O	null
5 , , , punctuation unspecified unspecified unspecified unspecified unspecified  	O	null
6 Amia Amia Amia foreign unspecified unspecified unspecified unspecified unspecified  	O	null
7 . . . punctuation unspecified unspecified unspecified unspecified unspecified  	O	null

0 " " " punctuation unspecified unspecified unspecified unspecified unspecified  	O	null
1 Mourning Mourning Mourning foreign unspecified unspecified unspecified unspecified unspecified  	I_ORG	null
2 a a a foreign unspecified unspecified unspecified unspecified unspecified  	I_ORG	null
3 Father Father Father foreign unspecified unspecified unspecified unspecified unspecified  	I_ORG	null
4 Lost Lost Lost foreign unspecified unspecified unspecified unspecified unspecified  	I_ORG	null
5 : : : punctuation unspecified unspecified unspecified unspecified unspecified  	O	null
6 A A A foreign unspecified unspecified unspecified unspecified unspecified  	O	null
7 Kibbutz Kibbutz Kibbutz foreign unspecified unspecified unspecified unspecified unspecified  	O	null
8 Childhood Childhood Childhood foreign unspecified unspecified unspecified unspecified unspecified  	O	null
9 Remembered Remembered Remembered foreign unspecified unspecified unspecified unspecified unspecified  	O	null
10 " " " punctuation unspecified unspecified unspecified unspecified unspecified  	O	null
11 . . . punctuation unspecified unspecified unspecified unspecified unspecified  	O	null

0 Modern Modern Modern foreign unspecified unspecified unspecified unspecified unspecified  	O	null
1 Jewish Jewish Jewish foreign unspecified unspecified unspecified unspecified unspecified  	O	null
2 Studies Studies Studies foreign unspecified unspecified unspecified unspecified unspecified  	O	null
3 . . . punctuation unspecified unspecified unspecified unspecified unspecified  	O	null

0 4( 4( 4(3 noun masculine singular absolute unspecified unspecified  
0 ה ה 4(3 possessive feminine singular unspecified 3 unspecified 0 	O	null
1 ) ) ) punctuation unspecified unspecified unspecified unspecified unspecified  	O	null
2 . . . punctuation unspecified unspecified unspecified unspecified unspecified  	O	null

0 ###NUMBER### ###NUMBER### ###NUMBER### numeral unspecified unspecified unspecified unspecified unspecified  	I_DATE	null
1 . . . punctuation unspecified unspecified unspecified unspecified unspecified  	O	null

0 ###NUMBER### ###NUMBER### ###NUMBER### numeral unspecified unspecified unspecified unspecified unspecified  	O	null
1 - - - punctuation unspecified unspecified unspecified unspecified unspecified  	O	null
2 ###NUMBER### ###NUMBER### ###NUMBER### numeral unspecified unspecified unspecified unspecified unspecified  	O	null
3 . . . punctuation unspecified unspecified unspecified unspecified unspecified  	O	null

