0 Name Name Name foreign unspecified unspecified unspecified unspecified unspecified  	O	null
1 : : : punctuation unspecified unspecified unspecified unspecified unspecified  	O	null
2 בן בן בן properName unspecified unspecified unspecified unspecified unspecified  	I_ORG	null
3 - - - properName unspecified unspecified unspecified unspecified unspecified  	I_ORG	null
4 ארי ארי ארי properName unspecified unspecified unspecified unspecified unspecified  	I_ORG	null
5 , , , punctuation unspecified unspecified unspecified unspecified unspecified  	O	null
6 ניצה ניצה ניצה properName unspecified unspecified unspecified unspecified unspecified  	I_PERS	null
7 Birth Birth Birth foreign unspecified unspecified unspecified unspecified unspecified  	O	null
8 Year Year Year foreign unspecified unspecified unspecified unspecified unspecified  	O	null
9 : : : punctuation unspecified unspecified unspecified unspecified unspecified  	O	null
10 ###NUMBER### ###NUMBER### ###NUMBER### numeral unspecified unspecified unspecified unspecified unspecified  	I_DATE	null
11 Birth Birth Birth foreign unspecified unspecified unspecified unspecified unspecified  	O	null
12 Place Place Place foreign unspecified unspecified unspecified unspecified unspecified  	O	null
13 : : : punctuation unspecified unspecified unspecified unspecified unspecified  	O	null
14 קהיר קהיר קהיר properName unspecified unspecified unspecified unspecified unspecified  	I_LOC	null
15 ו ו ובגיל conjunction unspecified unspecified unspecified unspecified unspecified 0 
15 ב ב ובגיל preposition unspecified unspecified unspecified unspecified unspecified 0 
15 גיל גיל ובגיל noun masculine singular construct unspecified unspecified  	O	null
16 שנה שנה שנה noun feminine singular absolute unspecified unspecified  	O	null
17 Occupation Occupation Occupation foreign unspecified unspecified unspecified unspecified unspecified  	O	null
18 : : : punctuation unspecified unspecified unspecified unspecified unspecified  	O	null
19 מתרגמת מתרגם מתרגמת noun feminine singular absolute unspecified unspecified  	O	null
20 , , , punctuation unspecified unspecified unspecified unspecified unspecified  	O	null
21 עורכת ערך עורכת verb feminine singular unspecified any beinoni  	O	null
22 ו ו וחוקרת conjunction unspecified unspecified unspecified unspecified unspecified 0 
22 חוקרת חקר וחוקרת verb feminine singular unspecified any beinoni  	O	null
23 ספרות ספרות ספרות noun feminine singular construct unspecified unspecified  	O	null
24 Entry Entry Entry foreign unspecified unspecified unspecified unspecified unspecified  	O	null
25 writer writer writer foreign unspecified unspecified unspecified unspecified unspecified  	O	null
26 : : : punctuation unspecified unspecified unspecified unspecified unspecified  	O	null
27 סבטלנה סבטלנה סבטלנה properName unspecified unspecified unspecified unspecified unspecified  	I_PERS	null
28 נטקוביץ' נטקוביץ' נטקוביץ' properName unspecified unspecified unspecified unspecified unspecified  	I_PERS	null
29 Entry Entry Entry foreign unspecified unspecified unspecified unspecified unspecified  	O	null
30 Value Value Value foreign unspecified unspecified unspecified unspecified unspecified  	O	null
31 : : : punctuation unspecified unspecified unspecified unspecified unspecified  	O	null
32 נולדה נולד נולדה verb feminine singular unspecified 3 past  	O	null
33 ב ב בקהיר preposition unspecified unspecified unspecified unspecified unspecified 0 
33 קהיר קהיר בקהיר properName unspecified unspecified unspecified unspecified unspecified  	I_LOC	null
34 ו ו ובגיל conjunction unspecified unspecified unspecified unspecified unspecified 0 
34 ב ב ובגיל preposition unspecified unspecified unspecified unspecified unspecified 0 
34 גיל גיל ובגיל noun masculine singular construct unspecified unspecified  	O	null
35 שנה שנה שנה noun feminine singular absolute unspecified unspecified  	O	null
36 עלתה עלה עלתה verb feminine singular unspecified 3 past  	O	null
37 ארצה ארצה ארצה adverb unspecified unspecified unspecified unspecified unspecified  	O	null
38 עם עם עם preposition unspecified unspecified unspecified unspecified unspecified  	O	null
39 הוריה הוריה הוריה noun feminine singular absolute unspecified unspecified  	O	null
40 . . . punctuation unspecified unspecified unspecified unspecified unspecified  	O	null

0 את את את at-preposition unspecified unspecified unspecified unspecified unspecified  	O	null
1 לימודי לימוד לימודי noun masculine plural construct unspecified unspecified  	O	null
2 ה ה התואר definiteArticle unspecified unspecified unspecified unspecified unspecified 0 
2 התואר תואר התואר noun masculine singular absolute unspecified unspecified  	O	null
3 ה ה הראשון definiteArticle unspecified unspecified unspecified unspecified unspecified 0 
3 הראשון ORD1 הראשון numeral masculine singular absolute unspecified unspecified  	O	null
4 עשתה עשה עשתה verb feminine singular unspecified 3 past  	O	null
5 ב ב בחוגים preposition unspecified unspecified unspecified unspecified unspecified 0 
5 חוגים חוג בחוגים noun masculine plural absolute unspecified unspecified  	O	null
6 ל ל לאנגלית preposition unspecified unspecified unspecified unspecified unspecified 0 
6 אנגלית אנגלית לאנגלית properName feminine singular unspecified unspecified unspecified  	I_PERS	null
7 ו ו ולצרפתית conjunction unspecified unspecified unspecified unspecified unspecified 0 
7 ל ל ולצרפתית preposition unspecified unspecified unspecified unspecified unspecified 0 
7 ה ה ולצרפתית definiteArticle unspecified unspecified unspecified unspecified unspecified 0 
7 הצרפתית צרפתית ולצרפתית properName feminine singular unspecified unspecified unspecified  	I_PERS	null
8 , , , punctuation unspecified unspecified unspecified unspecified unspecified  	O	null
9 תחילה תחילה תחילה adverb unspecified unspecified unspecified unspecified unspecified  	O	null
10 ב ב באוניברסיטה preposition unspecified unspecified unspecified unspecified unspecified 0 
10 ה ה באוניברסיטה definiteArticle unspecified unspecified unspecified unspecified unspecified 0 
10 האוניברסיטה אוניברסיטה באוניברסיטה noun feminine singular absolute unspecified unspecified  	O	null
11 ה ה העברית definiteArticle unspecified unspecified unspecified unspecified unspecified 0 
11 העברית עברי העברית adjective feminine singular absolute unspecified unspecified  	O	null
12 ב ב בירושלים preposition unspecified unspecified unspecified unspecified unspecified 0 
12 ירושלים ירושלים בירושלים properName unspecified unspecified unspecified unspecified unspecified  	I_LOC	null
13 ו ו ובהמשך conjunction unspecified unspecified unspecified unspecified unspecified 0 
13 ב ב ובהמשך preposition unspecified unspecified unspecified unspecified unspecified 0 
13 המשך המשך ובהמשך noun masculine singular absolute unspecified unspecified  	O	null
14 ב ב באוניברסיטת preposition unspecified unspecified unspecified unspecified unspecified 0 
14 אוניברסיטת אוניברסיטה באוניברסיטת noun feminine singular construct unspecified unspecified  	I_ORG	null
15 תל תל תל properName unspecified unspecified unspecified unspecified unspecified  	I_ORG	null
16 אביב אביב אביב properName unspecified unspecified unspecified unspecified unspecified  	I_ORG	null
17 , , , punctuation unspecified unspecified unspecified unspecified unspecified  	O	null
18 שבה שב שבה verb feminine singular unspecified 3 past  	O	null
19 סיימה סיים סיימה verb feminine singular unspecified 3 past  	O	null
20 ב ב ב preposition unspecified unspecified unspecified unspecified unspecified 0 	O	null
21 - - - punctuation unspecified unspecified unspecified unspecified unspecified  	O	null
22 ###NUMBER### ###NUMBER### ###NUMBER### numeral unspecified unspecified unspecified unspecified unspecified  	I_DATE	null
23 . . . punctuation unspecified unspecified unspecified unspecified unspecified  	O	null

0 ב ב בשנים preposition unspecified unspecified unspecified unspecified unspecified 0 
0 שנים שנה בשנים noun feminine plural absolute unspecified unspecified  	O	null
1 ###NUMBER### ###NUMBER### ###NUMBER### numeral unspecified unspecified unspecified unspecified unspecified  	I_DATE	null
2 - - - punctuation unspecified unspecified unspecified unspecified unspecified  	O	null
3 ###NUMBER### ###NUMBER### ###NUMBER### numeral unspecified unspecified unspecified unspecified unspecified  	I_DATE	null
4 עבדה עבד עבדה verb feminine singular unspecified 3 past  	O	null
5 כמורה כמורה כמורה noun feminine singular absolute unspecified unspecified  	O	null
6 ל ל לאנגלית preposition unspecified unspecified unspecified unspecified unspecified 0 
6 אנגלית אנגלית לאנגלית properName feminine singular unspecified unspecified unspecified  	I_LOC	null
7 ו ו וכמחנכת conjunction unspecified unspecified unspecified unspecified unspecified 0 
7 כ כ וכמחנכת preposition unspecified unspecified unspecified unspecified unspecified 0 
7 מחנכת חינך וכמחנכת verb feminine singular unspecified any beinoni  	O	null
8 . . . punctuation unspecified unspecified unspecified unspecified unspecified  	O	null

0 ב ב ב preposition unspecified unspecified unspecified unspecified unspecified 0 	O	null
1 - - - punctuation unspecified unspecified unspecified unspecified unspecified  	O	null
2 ###NUMBER### ###NUMBER### ###NUMBER### numeral unspecified unspecified unspecified unspecified unspecified  	I_DATE	null
3 החלה החל החלה verb feminine singular unspecified 3 past  	O	null
4 לפרסם פרסם לפרסם verb unspecified unspecified unspecified unspecified infinitive  	O	null
5 תרגומים תרגום תרגומים noun masculine plural absolute unspecified unspecified  	O	null
6 פרי פרי פרי noun masculine singular construct unspecified unspecified  	O	null
7 עט עט עטה noun masculine singular absolute unspecified unspecified  
7 ה ה עטה possessive feminine singular unspecified 3 unspecified 0 	O	null
8 . . . punctuation unspecified unspecified unspecified unspecified unspecified  	O	null

0 ב ב ב preposition unspecified unspecified unspecified unspecified unspecified 0 	O	null
1 - - - punctuation unspecified unspecified unspecified unspecified unspecified  	O	null
2 ###NUMBER### ###NUMBER### ###NUMBER### numeral unspecified unspecified unspecified unspecified unspecified  	I_DATE	null
3 השלימה השלים השלימה verb feminine singular unspecified 3 past  	O	null
4 את את את at-preposition unspecified unspecified unspecified unspecified unspecified  	O	null
5 עבודת עבודה עבודת noun feminine singular construct unspecified unspecified  	O	null
6 ה ה הגמר definiteArticle unspecified unspecified unspecified unspecified unspecified 0 
6 הגמר גמר הגמר noun masculine singular absolute unspecified unspecified  	O	null
7 ל ל לתואר preposition unspecified unspecified unspecified unspecified unspecified 0 
7 תואר תואר לתואר noun masculine singular construct unspecified unspecified  	O	null
8 ה ה השני definiteArticle unspecified unspecified unspecified unspecified unspecified 0 
8 השני שני השני noun masculine singular absolute unspecified unspecified  	I_ORG	null
9 ב ב באוניברסיטת preposition unspecified unspecified unspecified unspecified unspecified 0 
9 אוניברסיטת אוניברסיטה באוניברסיטת noun feminine singular construct unspecified unspecified  	I_ORG	null
10 תלאביב תלאביב תלאביב properName unspecified unspecified unspecified unspecified unspecified  	I_ORG	null
11 , , , punctuation unspecified unspecified unspecified unspecified unspecified  	O	null
12 ש ש שעסקה relativizer/subordinatingConjunction unspecified unspecified unspecified unspecified unspecified 0 
12 עסקה עסק שעסקה verb feminine singular unspecified 3 past  	O	null
13 ב ב בניתוח preposition unspecified unspecified unspecified unspecified unspecified 0 
13 ניתוח ניתוח בניתוח noun masculine singular absolute unspecified unspecified  	O	null
14 השוואתי השוואתי השוואתי adjective masculine singular absolute unspecified unspecified  	O	null
15 של של של shel-preposition unspecified unspecified unspecified unspecified unspecified  	O	null
16 נורמות נורמה נורמות noun feminine plural construct unspecified unspecified  	O	null
17 ה ה התרגום definiteArticle unspecified unspecified unspecified unspecified unspecified 0 
17 התרגום תרגום התרגום noun masculine singular absolute unspecified unspecified  	O	null
18 של של של shel-preposition unspecified unspecified unspecified unspecified unspecified  	O	null
19 ה ה הספרות definiteArticle unspecified unspecified unspecified unspecified unspecified 0 
19 הספרות ספרות הספרות noun feminine singular absolute unspecified unspecified  	O	null
20 ה ה הגרמנית definiteArticle unspecified unspecified unspecified unspecified unspecified 0 
20 הגרמנית גרמני הגרמנית adjective feminine singular absolute unspecified unspecified  	O	null
21 ל ל לאנגלית preposition unspecified unspecified unspecified unspecified unspecified 0 
21 אנגלית אנגלית לאנגלית properName feminine singular unspecified unspecified unspecified  	I_LOC	null
22 , , , punctuation unspecified unspecified unspecified unspecified unspecified  	O	null
23 ל ל לצרפתית preposition unspecified unspecified unspecified unspecified unspecified 0 
23 צרפתית צרפתית לצרפתית properName unspecified unspecified unspecified unspecified unspecified  	I_LOC	null
24 ו ו ולאיטלקית conjunction unspecified unspecified unspecified unspecified unspecified 0 
24 ל ל ולאיטלקית preposition unspecified unspecified unspecified unspecified unspecified 0 
24 ה ה ולאיטלקית definiteArticle unspecified unspecified unspecified unspecified unspecified 0 
24 האיטלקית איטלקית ולאיטלקית properName feminine singular unspecified unspecified unspecified  	B_LOC	null
25 . . . punctuation unspecified unspecified unspecified unspecified unspecified  	O	null

0 ו ו וב conjunction unspecified unspecified unspecified unspecified unspecified 0 
0 ב ב וב preposition unspecified unspecified unspecified unspecified unspecified 0 	O	null
1 - - - punctuation unspecified unspecified unspecified unspecified unspecified  	O	null
2 ###NUMBER### ###NUMBER### ###NUMBER### numeral unspecified unspecified unspecified unspecified unspecified  	I_DATE	null
3 השלימה השלים השלימה verb feminine singular unspecified 3 past  	O	null
4 את את את at-preposition unspecified unspecified unspecified unspecified unspecified  	O	null
5 עבודת עבודה עבודת noun feminine singular construct unspecified unspecified  	O	null
6 ה ה הדוקטור definiteArticle unspecified unspecified unspecified unspecified unspecified 0 
6 הדוקטור דוקטור הדוקטור noun masculine singular absolute unspecified unspecified  	O	null
7 ב ב בנושא preposition unspecified unspecified unspecified unspecified unspecified 0 
7 נושא נושא בנושא noun masculine singular construct unspecified unspecified  	O	null
8 דימויים דימוי דימויים noun masculine plural absolute unspecified unspecified  	O	null
9 היסטוריים היסטורי היסטוריים adjective masculine plural absolute unspecified unspecified  	O	null
10 ו ו וצמיחתה conjunction unspecified unspecified unspecified unspecified unspecified 0 
10 צמיחת צמיחה וצמיחתה noun feminine singular absolute unspecified unspecified  
10 ה ה וצמיחתה possessive feminine singular unspecified 3 unspecified 0 	O	null
11 של של של shel-preposition unspecified unspecified unspecified unspecified unspecified  	O	null
12 מערכת מערכת מערכת noun feminine singular absolute unspecified unspecified  	O	null
13 ספרותית ספרותי ספרותית adjective feminine singular absolute unspecified unspecified  	O	null
14 לאומית לאומי לאומית adjective feminine singular absolute unspecified unspecified  	O	null
15 חדשה חדש חדשה adjective feminine singular absolute unspecified unspecified  	O	null
16 . . . punctuation unspecified unspecified unspecified unspecified unspecified  	O	null

0 ב ב בשנים preposition unspecified unspecified unspecified unspecified unspecified 0 
0 שנים שנה בשנים noun feminine plural absolute unspecified unspecified  	O	null
1 - - - punctuation unspecified unspecified unspecified unspecified unspecified  	O	null
2 ###NUMBER### ###NUMBER### ###NUMBER### numeral unspecified unspecified unspecified unspecified unspecified  	I_DATE	null
3 , , , punctuation unspecified unspecified unspecified unspecified unspecified  	O	null
4 ###NUMBER### ###NUMBER### ###NUMBER### numeral unspecified unspecified unspecified unspecified unspecified  	I_DATE	null
5 במקביל במקביל במקביל adverb unspecified unspecified unspecified unspecified unspecified  	O	null
6 ל ל לעבודתה preposition unspecified unspecified unspecified unspecified unspecified 0 
6 עבודת עבודה לעבודתה noun feminine singular absolute unspecified unspecified  
6 ה ה לעבודתה possessive feminine singular unspecified 3 unspecified 0 	O	null
7 ב ב במחקר preposition unspecified unspecified unspecified unspecified unspecified 0 
7 ה ה במחקר definiteArticle unspecified unspecified unspecified unspecified unspecified 0 
7 המחקר מחקר במחקר noun masculine singular absolute unspecified unspecified  	O	null
8 ו ו ובהוראה conjunction unspecified unspecified unspecified unspecified unspecified 0 
8 ב ב ובהוראה preposition unspecified unspecified unspecified unspecified unspecified 0 
8 הוראה הוראה ובהוראה noun feminine singular absolute unspecified unspecified  	O	null
9 ב ב באוניברסיטת preposition unspecified unspecified unspecified unspecified unspecified 0 
9 אוניברסיטת אוניברסיטה באוניברסיטת noun feminine singular construct unspecified unspecified  	I_ORG	null
10 תל תל תל properName unspecified unspecified unspecified unspecified unspecified  	I_ORG	null
11 אביב אביב אביב properName unspecified unspecified unspecified unspecified unspecified  	I_ORG	null
12 , , , punctuation unspecified unspecified unspecified unspecified unspecified  	O	null
13 שימשה שימש שימשה verb feminine singular unspecified 3 past  	O	null
14 כ כ כעורכת preposition unspecified unspecified unspecified unspecified unspecified 0 
14 עורכת עורך כעורכת noun feminine singular construct unspecified unspecified  	O	null
15 פרוזה פרוזה פרוזה noun feminine singular absolute unspecified unspecified  	O	null
16 ראשית ראשי ראשית adjective feminine singular absolute unspecified unspecified  	O	null
17 ב ב בהוצאת preposition unspecified unspecified unspecified unspecified unspecified 0 
17 הוצאת הוצאה בהוצאת noun feminine singular construct unspecified unspecified  	O	null
18 זמורה זמורה זמורה noun feminine singular absolute unspecified unspecified  	O	null
19 - - - punctuation unspecified unspecified unspecified unspecified unspecified  	O	null
20 ביתן ביתן ביתן noun masculine singular absolute unspecified unspecified  	O	null
21 . . . punctuation unspecified unspecified unspecified unspecified unspecified  	O	null

0 ב ב ב preposition unspecified unspecified unspecified unspecified unspecified 0 	O	null
1 - - - punctuation unspecified unspecified unspecified unspecified unspecified  	O	null
2 ###NUMBER### ###NUMBER### ###NUMBER### numeral unspecified unspecified unspecified unspecified unspecified  	I_DATE	null
3 הקימה הקים הקימה verb feminine singular unspecified 3 past  	O	null
4 את את את at-preposition unspecified unspecified unspecified unspecified unspecified  	O	null
5 ה ה התוכנית definiteArticle unspecified unspecified unspecified unspecified unspecified 0 
5 התוכנית תוכנית התוכנית noun feminine singular absolute unspecified unspecified  	O	null
6 ל ל ללימודי preposition unspecified unspecified unspecified unspecified unspecified 0 
6 לימודי לימוד ללימודי noun masculine plural construct unspecified unspecified  	O	null
7 תעודה תעודה תעודה noun feminine singular absolute unspecified unspecified  	O	null
8 ב ב בתרגום preposition unspecified unspecified unspecified unspecified unspecified 0 
8 תרגום תרגום בתרגום noun masculine singular absolute unspecified unspecified  	O	null
9 ו ו ובעריכת conjunction unspecified unspecified unspecified unspecified unspecified 0 
9 ב ב ובעריכת preposition unspecified unspecified unspecified unspecified unspecified 0 
9 עריכת עריכה ובעריכת noun feminine singular construct unspecified unspecified  	O	null
10 תרגום תרגום תרגום noun masculine singular absolute unspecified unspecified  	O	null
11 ב ב באוניברסיטת preposition unspecified unspecified unspecified unspecified unspecified 0 
11 אוניברסיטת אוניברסיטה באוניברסיטת noun feminine singular construct unspecified unspecified  	I_ORG	null
12 תל תל תל properName unspecified unspecified unspecified unspecified unspecified  	I_ORG	null
13 אביב אביב אביב properName unspecified unspecified unspecified unspecified unspecified  	I_ORG	null
14 , , , punctuation unspecified unspecified unspecified unspecified unspecified  	O	null
15 ש ש שבראשה relativizer/subordinatingConjunction unspecified unspecified unspecified unspecified unspecified 0 
15 ב ב שבראשה preposition unspecified unspecified unspecified unspecified unspecified 0 
15 ראש ראש שבראשה noun masculine singular absolute unspecified unspecified  
15 ה ה שבראשה possessive feminine singular unspecified 3 unspecified 0 	O	null
16 היא הוא היא pronoun feminine singular unspecified 3 unspecified  	O	null
17 עומדת עמד עומדת verb feminine singular unspecified any beinoni  	O	null
18 מאז מאז מאז adverb unspecified unspecified unspecified unspecified unspecified  	O	null
19 . . . punctuation unspecified unspecified unspecified unspecified unspecified  	O	null

0 ל ל לבן preposition unspecified unspecified unspecified unspecified unspecified 0 
0 בן בן לבן noun masculine singular construct unspecified unspecified  	O	null
1 - - - punctuation unspecified unspecified unspecified unspecified unspecified  	O	null
2 ארי ארי ארי properName unspecified unspecified unspecified unspecified unspecified  	O	null
3 ארבעה CARD4 ארבעה numeral masculine plural absolute unspecified unspecified  	O	null
4 תחומי תחום תחומי noun masculine plural construct unspecified unspecified  	O	null
5 פעילות פעילות פעילות noun feminine singular absolute unspecified unspecified  	O	null
6 עיקריים עיקרי עיקריים adjective masculine plural absolute unspecified unspecified  	O	null
7 : : : punctuation unspecified unspecified unspecified unspecified unspecified  	O	null
8 תרגומי תרגום תרגומי noun masculine plural construct unspecified unspecified  	O	null
9 ספרות ספרות ספרות noun feminine singular absolute unspecified unspecified  	O	null
10 יפה יפה יפה adjective feminine singular absolute unspecified unspecified  	O	null
11 מ מ מאנגלית preposition unspecified unspecified unspecified unspecified unspecified 0 
11 אנגלית אנגלית מאנגלית properName feminine singular unspecified unspecified unspecified  	I_LOC	null
12 , , , punctuation unspecified unspecified unspecified unspecified unspecified  	O	null
13 צרפתית צרפתית צרפתית properName unspecified unspecified unspecified unspecified unspecified  	I_PERS	null
14 , , , punctuation unspecified unspecified unspecified unspecified unspecified  	O	null
15 גרמנית גרמנית גרמנית properName unspecified unspecified unspecified unspecified unspecified  	I_PERS	null
16 ו ו ואיטלקית conjunction unspecified unspecified unspecified unspecified unspecified 0 
16 איטלקית איטלקית ואיטלקית properName unspecified unspecified unspecified unspecified unspecified  	I_PERS	null
17 ; ; ; punctuation unspecified unspecified unspecified unspecified unspecified  	O	null
18 עריכת עריכה עריכת noun feminine singular construct unspecified unspecified  	O	null
19 ספרות ספרות ספרות noun feminine singular construct unspecified unspecified  	O	null
20 מקור מקור מקור noun masculine singular absolute unspecified unspecified  	O	null
21 ב ב בעברית preposition unspecified unspecified unspecified unspecified unspecified 0 
21 עברית עברית בעברית properName feminine singular unspecified unspecified unspecified  	I_LOC	null
22 ; ; ; punctuation unspecified unspecified unspecified unspecified unspecified  	O	null
23 חקר חקר חקר noun masculine singular construct unspecified unspecified  	O	null
24 ה ה התרגום definiteArticle unspecified unspecified unspecified unspecified unspecified 0 
24 התרגום תרגום התרגום noun masculine singular absolute unspecified unspecified  	O	null
25 ו ו והוראתו conjunction unspecified unspecified unspecified unspecified unspecified 0 
25 הוראת הוראה והוראתו noun feminine singular absolute unspecified unspecified  
25 ו ו והוראתו possessive masculine singular unspecified 3 unspecified 0 	O	null
26 ; ; ; punctuation unspecified unspecified unspecified unspecified unspecified  	O	null
27 ו ו וחקר conjunction unspecified unspecified unspecified unspecified unspecified 0 
27 חקר חקר וחקר noun masculine singular construct unspecified unspecified  	O	null
28 ה ה הספרות definiteArticle unspecified unspecified unspecified unspecified unspecified 0 
28 הספרות ספרות הספרות noun feminine singular absolute unspecified unspecified  	O	null
29 ו ו והתרבות conjunction unspecified unspecified unspecified unspecified unspecified 0 
29 ה ה והתרבות definiteArticle unspecified unspecified unspecified unspecified unspecified 0 
29 התרבות תרבות והתרבות noun feminine singular absolute unspecified unspecified  	O	null
30 ה ה היהודית definiteArticle unspecified unspecified unspecified unspecified unspecified 0 
30 היהודית יהודי היהודית adjective feminine singular absolute unspecified unspecified  	O	null
31 , , , punctuation unspecified unspecified unspecified unspecified unspecified  	O	null
32 ה ה העברית definiteArticle unspecified unspecified unspecified unspecified unspecified 0 
32 העברית עברי העברית adjective feminine singular absolute unspecified unspecified  	O	null
33 ו ו והישראלית conjunction unspecified unspecified unspecified unspecified unspecified 0 
33 ה ה והישראלית definiteArticle unspecified unspecified unspecified unspecified unspecified 0 
33 הישראלית ישראלי והישראלית adjective feminine singular absolute unspecified unspecified  	O	null
34 . . . punctuation unspecified unspecified unspecified unspecified unspecified  	O	null

0 ספר ספר ספרה noun masculine singular absolute unspecified unspecified  
0 ה ה ספרה possessive feminine singular unspecified 3 unspecified 0 	O	null
1 ה ה הראשון definiteArticle unspecified unspecified unspecified unspecified unspecified 0 
1 הראשון ORD1 הראשון numeral masculine singular absolute unspecified unspecified  	O	null
2 , , , punctuation unspecified unspecified unspecified unspecified unspecified  	O	null
3 רומן רומן רומן properName unspecified unspecified unspecified unspecified unspecified  	I_PERS	null
4 עם עם עם preposition unspecified unspecified unspecified unspecified unspecified  	O	null
5 ה ה העבר definiteArticle unspecified unspecified unspecified unspecified unspecified 0 
5 העבר עבר העבר noun masculine singular absolute unspecified unspecified  	O	null
6 : : : punctuation unspecified unspecified unspecified unspecified unspecified  	O	null
7 ה ה הרומן definiteArticle unspecified unspecified unspecified unspecified unspecified 0 
7 הרומן רומן הרומן noun masculine singular absolute unspecified unspecified  	O	null
8 ה ה ההיסטורי definiteArticle unspecified unspecified unspecified unspecified unspecified 0 
8 ההיסטורי היסטורי ההיסטורי adjective masculine singular absolute unspecified unspecified  	O	null
9 ה ה היהודי definiteArticle unspecified unspecified unspecified unspecified unspecified 0 
9 היהודי יהודי היהודי adjective masculine singular absolute unspecified unspecified  	O	null
10 - - - punctuation unspecified unspecified unspecified unspecified unspecified  	O	null
11 ה ה הגרמני definiteArticle unspecified unspecified unspecified unspecified unspecified 0 
11 הגרמני גרמני הגרמני adjective masculine singular absolute unspecified unspecified  	O	null
12 מן מן מן preposition unspecified unspecified unspecified unspecified unspecified  	O	null
13 ה ה המאה definiteArticle unspecified unspecified unspecified unspecified unspecified 0 
13 המאה ORD-CARD100 המאה numeral feminine plural absolute unspecified unspecified  	O	null
14 ה ה ה numeral unspecified unspecified unspecified unspecified unspecified  	O	null
15 - - - punctuation unspecified unspecified unspecified unspecified unspecified  	O	null
16 ###NUMBER### ###NUMBER### ###NUMBER### numeral unspecified unspecified unspecified unspecified unspecified  	O	null
17 ו ו ויצירתה conjunction unspecified unspecified unspecified unspecified unspecified 0 
17 יצירת יצירה ויצירתה noun feminine singular absolute unspecified unspecified  
17 ה ה ויצירתה possessive feminine singular unspecified 3 unspecified 0 	O	null
18 של של של shel-preposition unspecified unspecified unspecified unspecified unspecified  	O	null
19 ספרות ספרות ספרות noun feminine singular absolute unspecified unspecified  	O	null
20 לאומית לאומי לאומית adjective feminine singular absolute unspecified unspecified  	O	null
21 ( ( ( punctuation unspecified unspecified unspecified unspecified unspecified  	O	null
22 דביר דביר דביר properName unspecified unspecified unspecified unspecified unspecified  	I_PERS	null
23 , , , punctuation unspecified unspecified unspecified unspecified unspecified  	O	null
24 , , , punctuation unspecified unspecified unspecified unspecified unspecified  	O	null
25 ###NUMBER### ###NUMBER### ###NUMBER### numeral unspecified unspecified unspecified unspecified unspecified  	I_DATE	null
26 תורגם תורגם תורגם verb masculine singular unspecified 3 past  	O	null
27 ל ל לגרמנית preposition unspecified unspecified unspecified unspecified unspecified 0 
27 גרמנית גרמנית לגרמנית properName feminine singular unspecified unspecified unspecified  	I_DATE	null
28 ב ב ב preposition unspecified unspecified unspecified unspecified unspecified 0 	O	null
29 - - - punctuation unspecified unspecified unspecified unspecified unspecified  	O	null
30 ) ) ) punctuation unspecified unspecified unspecified unspecified unspecified  	O	null
31 , , , punctuation unspecified unspecified unspecified unspecified unspecified  	O	null
32 ###NUMBER### ###NUMBER### ###NUMBER### numeral unspecified unspecified unspecified unspecified unspecified  	I_DATE	null
33 חקר חקר חקר verb masculine singular unspecified 3 past  	O	null
34 את את את at-preposition unspecified unspecified unspecified unspecified unspecified  	O	null
35 דרכי דרך דרכי noun feminine plural construct unspecified unspecified  	O	null
36 ה ה ההבניה definiteArticle unspecified unspecified unspecified unspecified unspecified 0 
36 ההבניה הבניה ההבניה noun feminine singular absolute unspecified unspecified  	O	null
37 של של של shel-preposition unspecified unspecified unspecified unspecified unspecified  	O	null
38 ה ה הזהות definiteArticle unspecified unspecified unspecified unspecified unspecified 0 
38 הזהות זהות הזהות noun feminine singular absolute unspecified unspecified  	O	null
39 ה ה היהודית definiteArticle unspecified unspecified unspecified unspecified unspecified 0 
39 היהודית יהודי היהודית adjective feminine singular absolute unspecified unspecified  	O	null
40 ה ה האירופית definiteArticle unspecified unspecified unspecified unspecified unspecified 0 
40 האירופית אירופי האירופית adjective feminine singular absolute unspecified unspecified  	O	null
41 ה ה המודרנית definiteArticle unspecified unspecified unspecified unspecified unspecified 0 
41 המודרנית מודרני המודרנית adjective feminine singular absolute unspecified unspecified  	O	null
42 באמצעות באמצעות באמצעות preposition unspecified unspecified unspecified unspecified unspecified  	O	null
43 דמיוּן דמיוּן דמיוּן noun feminine plural construct unspecified unspecified  	O	null
44 ה ה העבר definiteArticle unspecified unspecified unspecified unspecified unspecified 0 
44 העבר עבר העבר noun masculine singular absolute unspecified unspecified  	O	null
45 ה ה הלאומי definiteArticle unspecified unspecified unspecified unspecified unspecified 0 
45 הלאומי לאומי הלאומי adjective masculine singular absolute unspecified unspecified  	O	null
46 על על על preposition unspecified unspecified unspecified unspecified unspecified  	O	null
47 דפי דף דפי noun masculine plural construct unspecified unspecified  	O	null
48 ה ה הרומנים definiteArticle unspecified unspecified unspecified unspecified unspecified 0 
48 הרומנים רומן הרומנים noun masculine plural absolute unspecified unspecified  	O	null
49 ה ה ההיסטוריים definiteArticle unspecified unspecified unspecified unspecified unspecified 0 
49 ההיסטוריים היסטורי ההיסטוריים adjective masculine plural absolute unspecified unspecified  	O	null
50 ש ש שנכתבו relativizer/subordinatingConjunction unspecified unspecified unspecified unspecified unspecified 0 
50 נכתבו נכתב שנכתבו verb masculine-and-feminine plural unspecified 3 past  	O	null
51 ב ב בגרמנית preposition unspecified unspecified unspecified unspecified unspecified 0 
51 גרמנית גרמנית בגרמנית properName feminine singular unspecified unspecified unspecified  	I_LOC	null
52 . . . punctuation unspecified unspecified unspecified unspecified unspecified  	O	null

0 ספר ספר ספרה noun masculine singular absolute unspecified unspecified  
0 ה ה ספרה possessive feminine singular unspecified 3 unspecified 0 	O	null
1 ה ה השני definiteArticle unspecified unspecified unspecified unspecified unspecified 0 
1 השני ORD2 השני numeral masculine singular absolute unspecified unspecified  	O	null
2 , , , punctuation unspecified unspecified unspecified unspecified unspecified  	O	null
3 דיכוי דיכוי דיכוי noun masculine singular construct unspecified unspecified  	O	null
4 ה ה הארוטיקה definiteArticle unspecified unspecified unspecified unspecified unspecified 0 
4 הארוטיקה ארוטיקה הארוטיקה noun feminine singular absolute unspecified unspecified  	O	null
5 : : : punctuation unspecified unspecified unspecified unspecified unspecified  	O	null
6 צנזורה צנזורה צנזורה noun feminine singular absolute unspecified unspecified  	O	null
7 ו ו וצנזורה conjunction unspecified unspecified unspecified unspecified unspecified 0 
7 צנזורה צנזורה וצנזורה noun feminine singular absolute unspecified unspecified  	O	null
8 עצמית עצמי עצמית adjective feminine singular absolute unspecified unspecified  	O	null
9 ב ב בספרות preposition unspecified unspecified unspecified unspecified unspecified 0 
9 ה ה בספרות definiteArticle unspecified unspecified unspecified unspecified unspecified 0 
9 הספרות ספרות בספרות noun feminine singular absolute unspecified unspecified  	O	null
10 ה ה העברית definiteArticle unspecified unspecified unspecified unspecified unspecified 0 
10 העברית עברי העברית adjective feminine singular absolute unspecified unspecified  	O	null
11 ###NUMBER### ###NUMBER### ###NUMBER### numeral unspecified unspecified unspecified unspecified unspecified  	I_DATE	null
12 - - - punctuation unspecified unspecified unspecified unspecified unspecified  	O	null
13 ###NUMBER### ###NUMBER### ###NUMBER### numeral unspecified unspecified unspecified unspecified unspecified  	I_DATE	null
14 ) ) ) punctuation unspecified unspecified unspecified unspecified unspecified  	O	null
15 , , , punctuation unspecified unspecified unspecified unspecified unspecified  	O	null
16 ###NUMBER### ###NUMBER### ###NUMBER### numeral unspecified unspecified unspecified unspecified unspecified  	I_DATE	null
17 חקר חקר חקר verb masculine singular unspecified 3 past  	O	null
18 את את את at-preposition unspecified unspecified unspecified unspecified unspecified  	O	null
19 ייצוגי ייצוג ייצוגי noun masculine plural construct unspecified unspecified  	O	null
20 ה ה הדימויים definiteArticle unspecified unspecified unspecified unspecified unspecified 0 
20 הדימויים דימוי הדימויים noun masculine plural absolute unspecified unspecified  	O	null
21 ה ה הארוטיים definiteArticle unspecified unspecified unspecified unspecified unspecified 0 
21 הארוטיים ארוטי הארוטיים adjective masculine plural absolute unspecified unspecified  	O	null
22 ב ב במסורת preposition unspecified unspecified unspecified unspecified unspecified 0 
22 מסורת מסורת במסורת noun feminine singular construct unspecified unspecified  	O	null
23 ה ה הספרות definiteArticle unspecified unspecified unspecified unspecified unspecified 0 
23 הספרות ספרות הספרות noun feminine singular absolute unspecified unspecified  	O	null
24 ה ה העברית definiteArticle unspecified unspecified unspecified unspecified unspecified 0 
24 העברית עברי העברית adjective feminine singular absolute unspecified unspecified  	O	null
25 – – – punctuation unspecified unspecified unspecified unspecified unspecified  	O	null
26 הן הוא הן pronoun feminine plural unspecified 3 unspecified  	O	null
27 ב ב בספרות preposition unspecified unspecified unspecified unspecified unspecified 0 
27 ספרות ספרות בספרות noun feminine singular construct unspecified unspecified  	O	null
28 מקור מקור מקור noun masculine singular absolute unspecified unspecified  	O	null
29 ו ו והן conjunction unspecified unspecified unspecified unspecified unspecified 0 
29 הן הן והן conjunction unspecified unspecified unspecified unspecified unspecified  	O	null
30 ב ב בספרות preposition unspecified unspecified unspecified unspecified unspecified 0 
30 ספרות ספרות בספרות noun feminine singular absolute unspecified unspecified  	O	null
31 מתורגמת מתורגם מתורגמת adjective feminine singular absolute unspecified unspecified  	O	null
32 מ מ מלשונות preposition unspecified unspecified unspecified unspecified unspecified 0 
32 לשונות לשון מלשונות noun feminine plural absolute unspecified unspecified  	O	null
33 ל ל לעז preposition unspecified unspecified unspecified unspecified unspecified 0 
33 עז עז לעז noun feminine singular absolute unspecified unspecified  	O	null
34 ל ל לעברית preposition unspecified unspecified unspecified unspecified unspecified 0 
34 עברית עברית לעברית properName feminine singular unspecified unspecified unspecified  	I_LOC	null
35 . . . punctuation unspecified unspecified unspecified unspecified unspecified  	O	null

0 גםמחקרה גםמחקרה גםמחקרה participle feminine singular construct any unspecified  	O	null
1 עוסק עוסק עוסק noun masculine singular absolute unspecified unspecified  	O	null
2 ב ב בזיקה preposition unspecified unspecified unspecified unspecified unspecified 0 
2 ה ה בזיקה definiteArticle unspecified unspecified unspecified unspecified unspecified 0 
2 הזיקה זיקה בזיקה noun feminine singular absolute unspecified unspecified  	O	null
3 ה ה ההדדית definiteArticle unspecified unspecified unspecified unspecified unspecified 0 
3 ההדדית הדדי ההדדית adjective feminine singular absolute unspecified unspecified  	O	null
4 ש ש שבין relativizer/subordinatingConjunction unspecified unspecified unspecified unspecified unspecified 0 
4 בין בין שבין preposition unspecified unspecified unspecified unspecified unspecified  	O	null
5 ייצוגים ייצוג ייצוגים noun masculine plural absolute unspecified unspecified  	O	null
6 ספרותיים ספרותי ספרותיים adjective masculine plural absolute unspecified unspecified  	O	null
7 ל ל לתופעות preposition unspecified unspecified unspecified unspecified unspecified 0 
7 תופעות תופעה לתופעות noun feminine plural absolute unspecified unspecified  	O	null
8 חברתיות חברתי חברתיות adjective feminine plural absolute unspecified unspecified  	O	null
9 ו ו ודפוסי conjunction unspecified unspecified unspecified unspecified unspecified 0 
9 דפוסי דפוס ודפוסי noun masculine plural construct unspecified unspecified  	O	null
10 ה ה הזהות definiteArticle unspecified unspecified unspecified unspecified unspecified 0 
10 הזהות זהות הזהות noun feminine singular absolute unspecified unspecified  	O	null
11 ה ה הקולקטיבית definiteArticle unspecified unspecified unspecified unspecified unspecified 0 
11 הקולקטיבית קולקטיבי הקולקטיבית adjective feminine singular absolute unspecified unspecified  	O	null
12 . . . punctuation unspecified unspecified unspecified unspecified unspecified  	O	null

0 כמו כמו כמו conjunction unspecified unspecified unspecified unspecified unspecified  	O	null
1 כן כן כן conjunction unspecified unspecified unspecified unspecified unspecified  	O	null
2 חוקרת חקר חוקרת verb feminine singular unspecified any beinoni  	O	null
3 בן בן בן properName unspecified unspecified unspecified unspecified unspecified  	I_PERS	null
4 - - - punctuation unspecified unspecified unspecified unspecified unspecified  	O	null
5 ארי ארי ארי properName unspecified unspecified unspecified unspecified unspecified  	I_PERS	null
6 את את את at-preposition unspecified unspecified unspecified unspecified unspecified  	O	null
7 יצירת יצירה יצירתו noun feminine singular absolute unspecified unspecified  
7 ו ו יצירתו possessive masculine singular unspecified 3 unspecified 0 	O	null
8 ה ה הספרותית definiteArticle unspecified unspecified unspecified unspecified unspecified 0 
8 הספרותית ספרותי הספרותית adjective feminine singular absolute unspecified unspecified  	O	null
9 של של של shel-preposition unspecified unspecified unspecified unspecified unspecified  	O	null
10 ס' ס' ס' properName unspecified unspecified unspecified unspecified unspecified  	I_PERS	null
11 יזהר יזהר יזהר properName unspecified unspecified unspecified unspecified unspecified  	I_PERS	null
12 ו ו ואת conjunction unspecified unspecified unspecified unspecified unspecified 0 
12 את את ואת at-preposition unspecified unspecified unspecified unspecified unspecified  	O	null
13 מקום מקום מקומו noun masculine singular absolute unspecified unspecified  
13 ו ו מקומו possessive masculine singular unspecified 3 unspecified 0 	O	null
14 ב ב בתרבות preposition unspecified unspecified unspecified unspecified unspecified 0 
14 ה ה בתרבות definiteArticle unspecified unspecified unspecified unspecified unspecified 0 
14 התרבות תרבות בתרבות noun feminine singular absolute unspecified unspecified  	O	null
15 ה ה הישראלית definiteArticle unspecified unspecified unspecified unspecified unspecified 0 
15 הישראלית ישראלי הישראלית adjective feminine singular absolute unspecified unspecified  	O	null
16 . . . punctuation unspecified unspecified unspecified unspecified unspecified  	O	null

0 כ כ כמתרגמת preposition unspecified unspecified unspecified unspecified unspecified 0 
0 ה ה כמתרגמת definiteArticle unspecified unspecified unspecified unspecified unspecified 0 
0 המתרגמת מתרגם כמתרגמת noun feminine singular absolute unspecified unspecified  	O	null
1 הוציאה הוציא הוציאה verb feminine singular unspecified 3 past  	O	null
2 ב ב במרוצת preposition unspecified unspecified unspecified unspecified unspecified 0 
2 מרוצת מרוצה במרוצת noun feminine singular construct unspecified unspecified  	O	null
3 ה ה השנים definiteArticle unspecified unspecified unspecified unspecified unspecified 0 
3 השנים שנה השנים noun feminine plural absolute unspecified unspecified  	O	null
4 עשרות CARD10 עשרות numeral feminine plural construct unspecified unspecified  	O	null
5 תרגומי תרגום תרגומי noun masculine plural construct unspecified unspecified  	O	null
6 פרוזה פרוזה פרוזה noun feminine singular absolute unspecified unspecified  	O	null
7 ו ו ושירה conjunction unspecified unspecified unspecified unspecified unspecified 0 
7 שירה שירה ושירה noun feminine singular absolute unspecified unspecified  	O	null
8 . . . punctuation unspecified unspecified unspecified unspecified unspecified  	O	null

0 מ מ מצרפתית preposition unspecified unspecified unspecified unspecified unspecified 0 
0 צרפתית צרפתית מצרפתית properName unspecified unspecified unspecified unspecified unspecified  	I_PERS	null
1 תירגמה תרגם תירגמה verb feminine singular unspecified 3 past  	O	null
2 מ מ מיצירותיהם preposition unspecified unspecified unspecified unspecified unspecified 0 
2 יצירות יצירה מיצירותיהם noun feminine plural absolute unspecified unspecified  
2 הם הם מיצירותיהם possessive masculine plural unspecified 3 unspecified 0 	O	null
3 של של של shel-preposition unspecified unspecified unspecified unspecified unspecified  	O	null
4 אלבר אלבר אלבר properName unspecified unspecified unspecified unspecified unspecified  	I_PERS	null
5 כהן כהן כהן properName unspecified unspecified unspecified unspecified unspecified  	I_PERS	null
6 , , , punctuation unspecified unspecified unspecified unspecified unspecified  	O	null
7 ז'ק ז'ק ז'ק properName unspecified unspecified unspecified unspecified unspecified  	I_PERS	null
8 לנצמן לנצמן לנצמן properName unspecified unspecified unspecified unspecified unspecified  	I_PERS	null
9 ו ו ודני conjunction unspecified unspecified unspecified unspecified unspecified 0 
9 דני דני ודני properName unspecified unspecified unspecified unspecified unspecified  	B_PERS	null
10 דידרו דידרו דידרו properName unspecified unspecified unspecified unspecified unspecified  	I_PERS	null
11 . . . punctuation unspecified unspecified unspecified unspecified unspecified  	O	null

0 מ מ מאיטלקית preposition unspecified unspecified unspecified unspecified unspecified 0 
0 איטלקית איטלקית מאיטלקית properName feminine singular unspecified unspecified unspecified  	O	null
1 מ מ מיצירותיהם preposition unspecified unspecified unspecified unspecified unspecified 0 
1 יצירות יצירה מיצירותיהם noun feminine plural absolute unspecified unspecified  
1 הם הם מיצירותיהם possessive masculine plural unspecified 3 unspecified 0 	O	null
2 של של של shel-preposition unspecified unspecified unspecified unspecified unspecified  	O	null
3 פרנצ'סקה פרנצ'סקה פרנצ'סקה properName unspecified unspecified unspecified unspecified unspecified  	I_PERS	null
4 דורנטי דורנטי דורנטי properName unspecified unspecified unspecified unspecified unspecified  	I_PERS	null
5 ו ו ונטליה conjunction unspecified unspecified unspecified unspecified unspecified 0 
5 נטלי נטל ונטליה noun masculine plural absolute unspecified unspecified  
5 ה ה ונטליה possessive feminine singular unspecified 3 unspecified 0 	O	null
6 גינצבורג גינצבורג גינצבורג properName unspecified unspecified unspecified unspecified unspecified  	I_PERS	null
7 . . . punctuation unspecified unspecified unspecified unspecified unspecified  	O	null

0 מ מ מאנגלית preposition unspecified unspecified unspecified unspecified unspecified 0 
0 אנגלית אנגלית מאנגלית properName feminine singular unspecified unspecified unspecified  	O	null
1 מ מ מיצירותיהם preposition unspecified unspecified unspecified unspecified unspecified 0 
1 יצירות יצירה מיצירותיהם noun feminine plural absolute unspecified unspecified  
1 הם הם מיצירותיהם possessive masculine plural unspecified 3 unspecified 0 	O	null
2 של של של shel-preposition unspecified unspecified unspecified unspecified unspecified  	O	null
3 מרי מרי מרי noun masculine singular absolute unspecified unspecified  	O	null
4 רנו רנו רנו properName unspecified unspecified unspecified unspecified unspecified  	I_ORG	null
5 , , , punctuation unspecified unspecified unspecified unspecified unspecified  	O	null
6 סומרסט סומרסט סומרסט properName unspecified unspecified unspecified unspecified unspecified  	I_PERS	null
7 מוהם מוהם מוהם properName unspecified unspecified unspecified unspecified unspecified  	I_PERS	null
8 , , , punctuation unspecified unspecified unspecified unspecified unspecified  	O	null
9 דוריס דוריס דוריס properName unspecified unspecified unspecified unspecified unspecified  	I_PERS	null
10 לסינג לסינג לסינג properName unspecified unspecified unspecified unspecified unspecified  	I_PERS	null
11 , , , punctuation unspecified unspecified unspecified unspecified unspecified  	O	null
12 וירג'יניה וירג'יניה וירג'יניה properName unspecified unspecified unspecified unspecified unspecified  	I_LOC	null
13 וולף וולף וולף properName unspecified unspecified unspecified unspecified unspecified  	I_PERS	null
14 , , , punctuation unspecified unspecified unspecified unspecified unspecified  	O	null
15 פיליף פיליף פיליפ properName unspecified unspecified unspecified unspecified unspecified  	I_PERS	null
16 רות רות רות properName unspecified unspecified unspecified unspecified unspecified  	I_PERS	null
17 , , , punctuation unspecified unspecified unspecified unspecified unspecified  	O	null
18 לואיס לואיס לואיס properName unspecified unspecified unspecified unspecified unspecified  	I_PERS	null
19 קרול קרול קרול properName unspecified unspecified unspecified unspecified unspecified  	I_PERS	null
20 , , , punctuation unspecified unspecified unspecified unspecified unspecified  	O	null
21 טוני טוני טוני properName unspecified unspecified unspecified unspecified unspecified  	I_PERS	null
22 מוריסון מוריסון מוריסון properName unspecified unspecified unspecified unspecified unspecified  	I_PERS	null
23 ו ו ועוד conjunction unspecified unspecified unspecified unspecified unspecified 0 
23 עוד עוד ועוד adverb unspecified unspecified unspecified unspecified unspecified  	I_LOC	null
24 . . . punctuation unspecified unspecified unspecified unspecified unspecified  	O	null

0 מ מ מגרמנית preposition unspecified unspecified unspecified unspecified unspecified 0 
0 גרמנית גרמנית מגרמנית properName feminine singular unspecified unspecified unspecified  	O	null
1 מ מ מיצירותיהם preposition unspecified unspecified unspecified unspecified unspecified 0 
1 יצירות יצירה מיצירותיהם noun feminine plural absolute unspecified unspecified  
1 הם הם מיצירותיהם possessive masculine plural unspecified 3 unspecified 0 	O	null
2 של של של shel-preposition unspecified unspecified unspecified unspecified unspecified  	O	null
3 סטפן סטפן סטפן properName unspecified unspecified unspecified unspecified unspecified  	I_PERS	null
4 צווייג צווייג צווייג properName unspecified unspecified unspecified unspecified unspecified  	I_PERS	null
5 , , , punctuation unspecified unspecified unspecified unspecified unspecified  	O	null
6 אלפרד אלפרד אלפרד properName unspecified unspecified unspecified unspecified unspecified  	I_PERS	null
7 דבלין דבלין דבלין properName unspecified unspecified unspecified unspecified unspecified  	I_LOC	null
8 , , , punctuation unspecified unspecified unspecified unspecified unspecified  	O	null
9 פטריק פטריק פטריק properName unspecified unspecified unspecified unspecified unspecified  	I_PERS	null
10 זיסקינד זיסקינד זיסקינד properName unspecified unspecified unspecified unspecified unspecified  	I_PERS	null
11 , , , punctuation unspecified unspecified unspecified unspecified unspecified  	O	null
12 אנה אנה אנה properName unspecified unspecified unspecified unspecified unspecified  	I_PERS	null
13 מריה מריה מריה properName unspecified unspecified unspecified unspecified unspecified  	I_PERS	null
14 יוקל הוקל יוקל properName unspecified unspecified unspecified unspecified unspecified  	I_PERS	null
15 , , , punctuation unspecified unspecified unspecified unspecified unspecified  	O	null
16 קלאוס קלאוס קלאוס properName unspecified unspecified unspecified unspecified unspecified  	I_PERS	null
17 מן מן מן preposition unspecified unspecified unspecified unspecified unspecified  	O	null
18 , , , punctuation unspecified unspecified unspecified unspecified unspecified  	O	null
19 פרידריך פרידריך פרידריך properName unspecified unspecified unspecified unspecified unspecified  	I_PERS	null
20 שילר שילר שילר properName unspecified unspecified unspecified unspecified unspecified  	I_PERS	null
21 , , , punctuation unspecified unspecified unspecified unspecified unspecified  	O	null
22 ארתור ארתור ארתור properName unspecified unspecified unspecified unspecified unspecified  	I_PERS	null
23 שניצל שניצל שניצלר noun masculine singular absolute unspecified unspecified  
23 ו ו שניצלר possessive masculine singular unspecified 3 unspecified 0 	O	null
24 ו ו ועוד conjunction unspecified unspecified unspecified unspecified unspecified 0 
24 עוד עוד ועוד adverb unspecified unspecified unspecified unspecified unspecified  	I_LOC	null
25 . . . punctuation unspecified unspecified unspecified unspecified unspecified  	O	null

0 אחד איחד אחד verb masculine singular unspecified 3 past  	O	null
1 מ מ ממפעלי preposition unspecified unspecified unspecified unspecified unspecified 0 
1 מפעלי מפעל ממפעלי noun masculine plural construct unspecified unspecified  	O	null
2 ה ה התרגום definiteArticle unspecified unspecified unspecified unspecified unspecified 0 
2 התרגום תרגום התרגום noun masculine singular absolute unspecified unspecified  	O	null
3 ה ה המרכזיים definiteArticle unspecified unspecified unspecified unspecified unspecified 0 
3 המרכזיים מרכזי המרכזיים adjective masculine plural absolute unspecified unspecified  	O	null
4 של של שלה shel-preposition unspecified unspecified unspecified unspecified unspecified  
4 ה ה שלה pronomial feminine singular unspecified 3 unspecified 0 	O	null
5 היה הוא היה copula masculine singular unspecified 3 past  	O	null
6 ה ה העבודה definiteArticle unspecified unspecified unspecified unspecified unspecified 0 
6 העבודה עבודה העבודה noun feminine singular absolute unspecified unspecified  	O	null
7 על על על preposition unspecified unspecified unspecified unspecified unspecified  	O	null
8 תרגום תרגום תרגום noun masculine singular absolute unspecified unspecified  	O	null
9 פאוסט פאוסט פאוסט properName unspecified unspecified unspecified unspecified unspecified  	I_LOC	null
10 של של של shel-preposition unspecified unspecified unspecified unspecified unspecified  	I_DATE	null
11 גתה גתה גתה properName unspecified unspecified unspecified unspecified unspecified  	I_PERS	null
12 ל ל לעברית preposition unspecified unspecified unspecified unspecified unspecified 0 
12 עברית עברית לעברית properName feminine singular unspecified unspecified unspecified  	I_PERS	null
13 ) ) ) punctuation unspecified unspecified unspecified unspecified unspecified  	O	null
14 , , , punctuation unspecified unspecified unspecified unspecified unspecified  	O	null
15 ###NUMBER### ###NUMBER### ###NUMBER### numeral unspecified unspecified unspecified unspecified unspecified  	I_DATE	null
16 ב ב בליווי preposition unspecified unspecified unspecified unspecified unspecified 0 
16 ליווי ליווי בליווי noun masculine singular construct unspecified unspecified  	O	null
17 מאמר מאמר מאמר noun masculine singular construct unspecified unspecified  	O	null
18 מבוא מבוא מבוא noun masculine singular absolute unspecified unspecified  	O	null
19 ו ו והערות conjunction unspecified unspecified unspecified unspecified unspecified 0 
19 הערות הערה והערות noun feminine plural absolute unspecified unspecified  	O	null
20 פרי פרי פרי properName unspecified unspecified unspecified unspecified unspecified  	I_PERS	null
21 עטה עטה עטה verb masculine singular unspecified 3 past  	O	null
22 . . . punctuation unspecified unspecified unspecified unspecified unspecified  	O	null

0 ב ב ב preposition unspecified unspecified unspecified unspecified unspecified 0 	I_ORG	null
1 - - - punctuation unspecified unspecified unspecified unspecified unspecified  	I_ORG	null
2 ###NUMBER### ###NUMBER### ###NUMBER### numeral unspecified unspecified unspecified unspecified unspecified  	I_DATE	null
3 ראה ראה ראה verb masculine singular unspecified 3 past  	O	null
4 אור אור אור noun masculine singular construct unspecified unspecified  	O	null
5 תרגום תרגום תרגומה noun masculine singular absolute unspecified unspecified  
5 ה ה תרגומה possessive feminine singular unspecified 3 unspecified 0 	O	null
6 ל ל להרמן preposition unspecified unspecified unspecified unspecified unspecified 0 
6 הרמן הרמן להרמן properName unspecified unspecified unspecified unspecified unspecified  	I_PERS	null
7 ו ו ודורותיאה conjunction unspecified unspecified unspecified unspecified unspecified 0 
7 דורותיאה דורותיאה ודורותיאה properName unspecified unspecified unspecified unspecified unspecified  	I_PERS	null
8 של של של shel-preposition unspecified unspecified unspecified unspecified unspecified  	O	null
9 גתה גתה גתה properName unspecified unspecified unspecified unspecified unspecified  	I_PERS	null
10 . . . punctuation unspecified unspecified unspecified unspecified unspecified  	O	null

0 ב ב ב preposition unspecified unspecified unspecified unspecified unspecified 0 	I_ORG	null
1 - - - punctuation unspecified unspecified unspecified unspecified unspecified  	I_ORG	null
2 ###NUMBER### ###NUMBER### ###NUMBER### numeral unspecified unspecified unspecified unspecified unspecified  	I_DATE	null
3 זכתה זכה זכתה verb feminine singular unspecified 3 past  	O	null
4 ב ב בפרס preposition unspecified unspecified unspecified unspecified unspecified 0 
4 פרס פרס בפרס noun masculine singular absolute unspecified unspecified  	O	null
5 טשרניחובסקי טשרניחובסקי טשרניחובסקי properName unspecified unspecified unspecified unspecified unspecified  	I_PERS	null
6 ל ל לתרגומי preposition unspecified unspecified unspecified unspecified unspecified 0 
6 תרגומי תרגום לתרגומי noun masculine plural construct unspecified unspecified  	O	null
7 מופת מופת מופת noun feminine singular absolute unspecified unspecified  	O	null
8 על על על preposition unspecified unspecified unspecified unspecified unspecified  	O	null
9 מכלול מכלול מכלול noun masculine singular construct unspecified unspecified  	O	null
10 יצירת יצירה יצירתה noun feminine singular absolute unspecified unspecified  
10 ה ה יצירתה possessive feminine singular unspecified 3 unspecified 0 	O	null
11 ב ב בתחום preposition unspecified unspecified unspecified unspecified unspecified 0 
11 תחום תחום בתחום noun masculine singular construct unspecified unspecified  	O	null
12 ה ה התרגום definiteArticle unspecified unspecified unspecified unspecified unspecified 0 
12 התרגום תרגום התרגום noun masculine singular absolute unspecified unspecified  	O	null
13 . . . punctuation unspecified unspecified unspecified unspecified unspecified  	O	null

0 מ מ מ preposition unspecified unspecified unspecified unspecified unspecified 0 	O	null
1 - - - punctuation unspecified unspecified unspecified unspecified unspecified  	O	null
2 ###NUMBER### ###NUMBER### ###NUMBER### numeral unspecified unspecified unspecified unspecified unspecified  	I_DATE	null
3 היא הוא היא pronoun feminine singular unspecified 3 unspecified  	O	null
4 משמשת שימש משמשת verb feminine singular unspecified any beinoni  	O	null
5 כ כ כיו"ר preposition unspecified unspecified unspecified unspecified unspecified 0 
5 יו"ר יו"ר כיו"ר noun masculine singular construct unspecified unspecified  	O	null
6 ה ה המפעל definiteArticle unspecified unspecified unspecified unspecified unspecified 0 
6 המפעל מפעל המפעל noun masculine singular absolute unspecified unspecified  	O	null
7 ל ל לתרגום preposition unspecified unspecified unspecified unspecified unspecified 0 
7 תרגום תרגום לתרגום noun masculine singular construct unspecified unspecified  	O	null
8 ספרות ספרות ספרות noun feminine singular construct unspecified unspecified  	O	null
9 מופת מופת מופת noun feminine singular absolute unspecified unspecified  	O	null
10 . . . punctuation unspecified unspecified unspecified unspecified unspecified  	O	null

0 References References References foreign unspecified unspecified unspecified unspecified unspecified  	O	null
1 : : : punctuation unspecified unspecified unspecified unspecified unspecified  	O	null
2 זנדבנק זנדבנק זנדבנק properName unspecified unspecified unspecified unspecified unspecified  	I_ORG	null
3 , , , punctuation unspecified unspecified unspecified unspecified unspecified  	O	null
4 שמעון שמעון שמעון properName unspecified unspecified unspecified unspecified unspecified  	I_PERS	null
5 . . . punctuation unspecified unspecified unspecified unspecified unspecified  	O	null

0 " " " punctuation unspecified unspecified unspecified unspecified unspecified  	O	null
1 איך איך איך adverb unspecified unspecified unspecified unspecified unspecified  	I_ORG	null
2 להציל הציל להציל verb unspecified unspecified unspecified unspecified infinitive  	O	null
3 קלסיקון קלסיקון קלסיקון noun masculine singular construct unspecified unspecified  	O	null
4 " " " punctuation unspecified unspecified unspecified unspecified unspecified  	O	null
5 . . . punctuation unspecified unspecified unspecified unspecified unspecified  	O	null

0 ה ה הארץ definiteArticle unspecified unspecified unspecified unspecified unspecified 0 
0 הארץ ארץ הארץ noun feminine singular absolute unspecified unspecified  	O	null
1 ספרים ספר ספרים noun masculine plural absolute unspecified unspecified  	O	null
2 . . . punctuation unspecified unspecified unspecified unspecified unspecified  	O	null

0 ###NUMEXP### ###NUMEXP### ###NUMEXP### numberExpression unspecified unspecified unspecified unspecified unspecified  	I_DATE	null
1 . . . punctuation unspecified unspecified unspecified unspecified unspecified  	O	null

0 ; ; ; punctuation unspecified unspecified unspecified unspecified unspecified  	O	null
1 ###NUMBER### ###NUMBER### ###NUMBER### numeral unspecified unspecified unspecified unspecified unspecified  	O	null
2 ל ל ליבנה preposition unspecified unspecified unspecified unspecified unspecified 0 
2 יבנה יבנה ליבנה properName unspecified unspecified unspecified unspecified unspecified  	I_LOC	null
3 , , , punctuation unspecified unspecified unspecified unspecified unspecified  	O	null
4 נר נר נרי noun masculine singular absolute unspecified unspecified  
4 י י נרי possessive masculine-and-feminine singular unspecified 1 unspecified 0 	O	null
5 . . . punctuation unspecified unspecified unspecified unspecified unspecified  	O	null

0 " " " punctuation unspecified unspecified unspecified unspecified unspecified  	O	null
1 שטן שטן שטן noun masculine singular absolute unspecified unspecified  	O	null
2 קטן קטן קטן adjective masculine singular absolute unspecified unspecified  	O	null
3 של של שלי shel-preposition unspecified unspecified unspecified unspecified unspecified  
3 י י שלי pronomial masculine-and-feminine singular unspecified 1 unspecified 0 	O	null
4 " " " punctuation unspecified unspecified unspecified unspecified unspecified  	O	null
5 . . . punctuation unspecified unspecified unspecified unspecified unspecified  	O	null

0 ה ה הארץ definiteArticle unspecified unspecified unspecified unspecified unspecified 0 
0 הארץ ארץ הארץ noun feminine singular absolute unspecified unspecified  	O	null
1 מוסף מוסף מוסף adjective masculine singular absolute unspecified unspecified  	O	null
2 . . . punctuation unspecified unspecified unspecified unspecified unspecified  	O	null

0 ###NUMEXP### ###NUMEXP### ###NUMEXP### numberExpression unspecified unspecified unspecified unspecified unspecified  	I_DATE	null
1 . . . punctuation unspecified unspecified unspecified unspecified unspecified  	O	null

0 ; ; ; punctuation unspecified unspecified unspecified unspecified unspecified  	O	null
1 ###NUMBER### ###NUMBER### ###NUMBER### numeral unspecified unspecified unspecified unspecified unspecified  	O	null
2 סלע סלע סלע noun masculine singular absolute unspecified unspecified  	O	null
3 , , , punctuation unspecified unspecified unspecified unspecified unspecified  	O	null
4 מיה מיה מיה properName feminine singular unspecified unspecified unspecified  	I_PERS	null
5 . . . punctuation unspecified unspecified unspecified unspecified unspecified  	O	null

0 " " " punctuation unspecified unspecified unspecified unspecified unspecified  	O	null
1 תרגום תרגום תרגום noun masculine singular absolute unspecified unspecified  	O	null
2 ב ב בגוף preposition unspecified unspecified unspecified unspecified unspecified 0 
2 גוף גוף בגוף noun masculine singular construct unspecified unspecified  	O	null
3 ה ה החיים definiteArticle unspecified unspecified unspecified unspecified unspecified 0 
3 החיים חיים החיים noun masculine plural absolute unspecified unspecified  	O	null
4 " " " punctuation unspecified unspecified unspecified unspecified unspecified  	O	null
5 . . . punctuation unspecified unspecified unspecified unspecified unspecified  	O	null

0 ה ה הארץ definiteArticle unspecified unspecified unspecified unspecified unspecified 0 
0 הארץ ארץ הארץ noun feminine singular absolute unspecified unspecified  	O	null
1 גלריה גלריה גלריה noun feminine singular absolute unspecified unspecified  	O	null
2 . . . punctuation unspecified unspecified unspecified unspecified unspecified  	O	null

0 ###NUMEXP### ###NUMEXP### ###NUMEXP### numberExpression unspecified unspecified unspecified unspecified unspecified  	I_DATE	null
1 . . . punctuation unspecified unspecified unspecified unspecified unspecified  	O	null

0 ###NUMBER### ###NUMBER### ###NUMBER### numeral unspecified unspecified unspecified unspecified unspecified  	O	null
1 . . . punctuation unspecified unspecified unspecified unspecified unspecified  	O	null

