0 Name Name Name foreign unspecified unspecified unspecified unspecified unspecified  	O	null
1 : : : punctuation unspecified unspecified unspecified unspecified unspecified  	O	null
2 בן בן בן properName unspecified unspecified unspecified unspecified unspecified  	I_ORG	null
3 - - - properName unspecified unspecified unspecified unspecified unspecified  	I_ORG	null
4 אריה אריה אריה properName unspecified unspecified unspecified unspecified unspecified  	I_ORG	null
5 , , , punctuation unspecified unspecified unspecified unspecified unspecified  	O	null
6 יגאל יגאל יגאל properName unspecified unspecified unspecified unspecified unspecified  	I_PERS	null
7 Birth Birth Birth foreign unspecified unspecified unspecified unspecified unspecified  	O	null
8 Year Year Year foreign unspecified unspecified unspecified unspecified unspecified  	O	null
9 : : : punctuation unspecified unspecified unspecified unspecified unspecified  	O	null
10 ###NUMBER### ###NUMBER### ###NUMBER### numeral unspecified unspecified unspecified unspecified unspecified  	I_DATE	null
11 Birth Birth Birth foreign unspecified unspecified unspecified unspecified unspecified  	O	null
12 Place Place Place foreign unspecified unspecified unspecified unspecified unspecified  	O	null
13 : : : punctuation unspecified unspecified unspecified unspecified unspecified  	O	null
14 תלאביב תלאביב תלאביב properName unspecified unspecified unspecified unspecified unspecified  	O	null
15 Occupation Occupation Occupation foreign unspecified unspecified unspecified unspecified unspecified  	O	null
16 : : : punctuation unspecified unspecified unspecified unspecified unspecified  	O	null
17 משורר משורר משורר noun masculine singular absolute unspecified unspecified  	O	null
18 Entry Entry Entry foreign unspecified unspecified unspecified unspecified unspecified  	O	null
19 writer writer writer foreign unspecified unspecified unspecified unspecified unspecified  	O	null
20 : : : punctuation unspecified unspecified unspecified unspecified unspecified  	O	null
21 גלעד גלעד גלעד properName unspecified unspecified unspecified unspecified unspecified  	I_ORG	null
22 מאירי האיר מאירי participle masculine plural construct any unspecified  	O	null
23 Entry Entry Entry foreign unspecified unspecified unspecified unspecified unspecified  	O	null
24 Value Value Value foreign unspecified unspecified unspecified unspecified unspecified  	O	null
25 : : : punctuation unspecified unspecified unspecified unspecified unspecified  	O	null
26 נולד נולד נולד verb masculine singular unspecified 3 past  	O	null
27 בתלאביב בתלאביב בתלאביב properName unspecified unspecified unspecified unspecified unspecified  	I_PERS	null
28 . . . punctuation unspecified unspecified unspecified unspecified unspecified  	O	null

0 למד למד למד verb masculine singular unspecified 3 past  	O	null
1 ב ב בתיכון preposition unspecified unspecified unspecified unspecified unspecified 0 
1 ה ה בתיכון definiteArticle unspecified unspecified unspecified unspecified unspecified 0 
1 התיכון תיכון בתיכון noun masculine singular absolute unspecified unspecified  	O	null
2 " " " punctuation unspecified unspecified unspecified unspecified unspecified  	O	null
3 עירוני עירוני עירוני noun masculine singular absolute unspecified unspecified  	O	null
4 ד' ד' ד' noun masculine singular absolute unspecified unspecified  	O	null
5 " " " punctuation unspecified unspecified unspecified unspecified unspecified  	O	null
6 . . . punctuation unspecified unspecified unspecified unspecified unspecified  	O	null

0 בעל בעל בעל noun masculine singular construct unspecified unspecified  	O	null
1 תואר תואר תואר noun masculine singular absolute unspecified unspecified  	O	null
2 ראשון ORD1 ראשון numeral masculine singular absolute unspecified unspecified  	O	null
3 ב ב בעבודה preposition unspecified unspecified unspecified unspecified unspecified 0 
3 עבודה עבודה בעבודה noun feminine singular absolute unspecified unspecified  	O	null
4 סוציאלית סוציאלי סוציאלית adjective feminine singular absolute unspecified unspecified  	O	null
5 מ מ מהאוניברסיטה preposition unspecified unspecified unspecified unspecified unspecified 0 
5 ה ה מהאוניברסיטה definiteArticle unspecified unspecified unspecified unspecified unspecified 0 
5 האוניברסיטה אוניברסיטה מהאוניברסיטה noun feminine singular absolute unspecified unspecified  	I_ORG	null
6 ה ה העברית definiteArticle unspecified unspecified unspecified unspecified unspecified 0 
6 העברית עברי העברית adjective feminine singular absolute unspecified unspecified  	I_ORG	null
7 ב ב בירושלים preposition unspecified unspecified unspecified unspecified unspecified 0 
7 ירושלים ירושלים בירושלים properName unspecified unspecified unspecified unspecified unspecified  	I_LOC	null
8 . . . punctuation unspecified unspecified unspecified unspecified unspecified  	O	null

0 משמש משמש משמש verb masculine singular unspecified 3 past  	O	null
1 כיום כיום כיום adverb unspecified unspecified unspecified unspecified unspecified  	O	null
2 כ כ כסמנכ"ל preposition unspecified unspecified unspecified unspecified unspecified 0 
2 סמנכ"ל סמנכ"ל כסמנכ"ל noun masculine singular absolute unspecified unspecified  	O	null
3 ב ב בחברת preposition unspecified unspecified unspecified unspecified unspecified 0 
3 חברת חבר בחברת noun feminine singular construct unspecified unspecified  	O	null
4 ה ה החשמל definiteArticle unspecified unspecified unspecified unspecified unspecified 0 
4 החשמל חשמל החשמל noun masculine singular absolute unspecified unspecified  	O	null
5 . . . punctuation unspecified unspecified unspecified unspecified unspecified  	O	null

0 פירסם פרסם פירסם verb masculine singular unspecified 3 past  	O	null
1 שבעה CARD7 שבעה numeral masculine plural absolute unspecified unspecified  	O	null
2 ספרי ספר ספרי noun masculine plural construct unspecified unspecified  	O	null
3 שירה שירה שירה noun feminine singular absolute unspecified unspecified  	O	null
4 . . . punctuation unspecified unspecified unspecified unspecified unspecified  	O	null

0 פרסום פרסום פרסומו noun masculine singular absolute unspecified unspecified  
0 ו ו פרסומו possessive masculine singular unspecified 3 unspecified 0 	O	null
1 ה ה הראשון definiteArticle unspecified unspecified unspecified unspecified unspecified 0 
1 הראשון ORD1 הראשון numeral masculine singular absolute unspecified unspecified  	O	null
2 היה הוא היה copula masculine singular unspecified 3 past  	O	null
3 שיר שיר שירו noun masculine singular absolute unspecified unspecified  
3 ו ו שירו possessive masculine singular unspecified 3 unspecified 0 	O	null
4 " " " punctuation unspecified unspecified unspecified unspecified unspecified  	O	null
5 שרב שרב שרב noun masculine singular absolute unspecified unspecified  	O	null
6 " " " punctuation unspecified unspecified unspecified unspecified unspecified  	O	null
7 ( ( ( punctuation unspecified unspecified unspecified unspecified unspecified  	O	null
8 סימן סימן סימן noun masculine singular absolute unspecified unspecified  	O	null
9 קריאה קריאה קריאה noun feminine singular absolute unspecified unspecified  	O	null
10 , , , punctuation unspecified unspecified unspecified unspecified unspecified  	O	null
11 ###NUMBER### ###NUMBER### ###NUMBER### numeral unspecified unspecified unspecified unspecified unspecified  	I_DATE	null
12 ינואר ינואר ינואר properName unspecified unspecified unspecified unspecified unspecified  	I_DATE	null
13 ) ) ) punctuation unspecified unspecified unspecified unspecified unspecified  	O	null
14 , , , punctuation unspecified unspecified unspecified unspecified unspecified  	O	null
15 ###NUMBER### ###NUMBER### ###NUMBER### numeral unspecified unspecified unspecified unspecified unspecified  	I_DATE	null
16 ש ש שכונס relativizer/subordinatingConjunction unspecified unspecified unspecified unspecified unspecified 0 
16 כונס כונס שכונס verb masculine singular unspecified 3 past  	O	null
17 ב ב בספרו preposition unspecified unspecified unspecified unspecified unspecified 0 
17 ספר ספר בספרו noun masculine singular absolute unspecified unspecified  
17 ו ו בספרו possessive masculine singular unspecified 3 unspecified 0 	O	null
18 ה ה הראשון definiteArticle unspecified unspecified unspecified unspecified unspecified 0 
18 הראשון ORD1 הראשון numeral masculine singular absolute unspecified unspecified  	O	null
19 , , , punctuation unspecified unspecified unspecified unspecified unspecified  	O	null
20 צינת צינה צינת noun feminine singular construct unspecified unspecified  	O	null
21 רוחות רוח רוחות noun feminine plural absolute unspecified unspecified  	O	null
22 ( ( ( punctuation unspecified unspecified unspecified unspecified unspecified  	O	null
23 עם עם עם preposition unspecified unspecified unspecified unspecified unspecified  	O	null
24 עובד עובד עובד noun masculine singular absolute unspecified unspecified  	O	null
25 , , , punctuation unspecified unspecified unspecified unspecified unspecified  	O	null
26 ###NUMBER### ###NUMBER### ###NUMBER### numeral unspecified unspecified unspecified unspecified unspecified  	I_DATE	null
27 ) ) ) punctuation unspecified unspecified unspecified unspecified unspecified  	O	null
28 . . . punctuation unspecified unspecified unspecified unspecified unspecified  	O	null

0 ה ה הפואטיקה definiteArticle unspecified unspecified unspecified unspecified unspecified 0 
0 הפואטיקה הפואטיקה הפואטיקה noun feminine singular absolute unspecified unspecified  	O	null
1 של של שלו shel-preposition unspecified unspecified unspecified unspecified unspecified  
1 ו ו שלו pronomial masculine singular unspecified 3 unspecified 0 	O	null
2 ב ב בדרך preposition unspecified unspecified unspecified unspecified unspecified 0 
2 דרך דרך בדרך noun feminine singular construct unspecified unspecified  	O	null
3 כלל כלל כלל noun masculine singular absolute unspecified unspecified  	O	null
4 מאופקת מאופק מאופקת adjective feminine singular absolute unspecified unspecified  	O	null
5 , , , punctuation unspecified unspecified unspecified unspecified unspecified  	O	null
6 נוטה נטה נוטה verb masculine singular unspecified any beinoni  	O	null
7 ל ל ללשון preposition unspecified unspecified unspecified unspecified unspecified 0 
7 לשון לשון ללשון noun feminine singular construct unspecified unspecified  	O	null
8 ה ה הדיבור definiteArticle unspecified unspecified unspecified unspecified unspecified 0 
8 הדיבור דיבור הדיבור noun masculine singular absolute unspecified unspecified  	O	null
9 , , , punctuation unspecified unspecified unspecified unspecified unspecified  	O	null
10 אך אך אך conjunction unspecified unspecified unspecified unspecified unspecified  	O	null
11 משלבת שילב משלבת verb feminine singular unspecified any beinoni  	O	null
12 ב ב במתינות preposition unspecified unspecified unspecified unspecified unspecified 0 
12 מתינות מתינות במתינות noun feminine singular construct unspecified unspecified  	O	null
13 שפה שפה שפה noun feminine singular absolute unspecified unspecified  	O	null
14 פיגורטיבית פיגורטיבית פיגורטיבית adjective feminine singular absolute unspecified unspecified  	O	null
15 . . . punctuation unspecified unspecified unspecified unspecified unspecified  	O	null

0 ה ה הנושאים definiteArticle unspecified unspecified unspecified unspecified unspecified 0 
0 הנושאים נושא הנושאים noun masculine plural absolute unspecified unspecified  	O	null
1 ה ה המשמעותיים definiteArticle unspecified unspecified unspecified unspecified unspecified 0 
1 המשמעותיים משמעותי המשמעותיים adjective masculine plural absolute unspecified unspecified  	O	null
2 הם הוא הם pronoun masculine plural unspecified 3 unspecified  	O	null
3 : : : punctuation unspecified unspecified unspecified unspecified unspecified  	O	null
4 זוגיות זוגיות זוגיות noun feminine singular absolute unspecified unspecified  	O	null
5 ו ו וארוס conjunction unspecified unspecified unspecified unspecified unspecified 0 
5 ארוס ארוס וארוס noun masculine singular absolute unspecified unspecified  	O	null
6 , , , punctuation unspecified unspecified unspecified unspecified unspecified  	O	null
7 מקומות מקום מקומות noun masculine plural absolute unspecified unspecified  	O	null
8 , , , punctuation unspecified unspecified unspecified unspecified unspecified  	O	null
9 זהות זהות זהותו noun feminine singular absolute unspecified unspecified  
9 ו ו זהותו possessive masculine singular unspecified 3 unspecified 0 	O	null
10 ה ה היהודית definiteArticle unspecified unspecified unspecified unspecified unspecified 0 
10 היהודית יהודי היהודית adjective feminine singular absolute unspecified unspecified  	O	null
11 - - - punctuation unspecified unspecified unspecified unspecified unspecified  	O	null
12 אירופית אירופי אירופית adjective feminine singular absolute unspecified unspecified  	O	null
13 , , , punctuation unspecified unspecified unspecified unspecified unspecified  	O	null
14 הגות הגות הגות noun feminine singular absolute unspecified unspecified  	O	null
15 ו ו ומחאה conjunction unspecified unspecified unspecified unspecified unspecified 0 
15 מחאה מחאה ומחאה noun feminine singular absolute unspecified unspecified  	O	null
16 חברתית חברתי חברתית adjective feminine singular absolute unspecified unspecified  	O	null
17 . . . punctuation unspecified unspecified unspecified unspecified unspecified  	O	null

0 שירי שיר שיריו noun masculine plural absolute unspecified unspecified  
0 ו ו שיריו possessive masculine singular unspecified 3 unspecified 0 	O	null
1 מתארים תיאר מתארים verb masculine plural unspecified any beinoni  	O	null
2 היבטים היבט היבטים noun masculine plural absolute unspecified unspecified  	O	null
3 שונים שונה שונים adjective masculine plural absolute unspecified unspecified  	O	null
4 של של של shel-preposition unspecified unspecified unspecified unspecified unspecified  	O	null
5 אהבה אהבה אהבה noun feminine singular absolute unspecified unspecified  	O	null
6 : : : punctuation unspecified unspecified unspecified unspecified unspecified  	O	null
7 תשוקה תשוקה תשוקה noun feminine singular absolute unspecified unspecified  	O	null
8 , , , punctuation unspecified unspecified unspecified unspecified unspecified  	O	null
9 פרֵדה פרֵדה פרֵדה properName unspecified unspecified unspecified unspecified unspecified  	I_PERS	null
10 , , , punctuation unspecified unspecified unspecified unspecified unspecified  	O	null
11 תחושת תחושה תחושת noun feminine singular construct unspecified unspecified  	O	null
12 אשמה אשמה אשמה noun feminine singular absolute unspecified unspecified  	O	null
13 בגין בגין בגין preposition unspecified unspecified unspecified unspecified unspecified  	O	null
14 משיכה משיכה משיכה noun feminine singular absolute unspecified unspecified  	O	null
15 ל ל לנשים preposition unspecified unspecified unspecified unspecified unspecified 0 
15 נשים איש לנשים noun feminine plural absolute unspecified unspecified  	O	null
16 אחרות אחר אחרות adjective feminine plural absolute unspecified unspecified  	O	null
17 ו ו ועוד conjunction unspecified unspecified unspecified unspecified unspecified 0 
17 עוד עוד ועוד adverb unspecified unspecified unspecified unspecified unspecified  	O	null
18 . . . punctuation unspecified unspecified unspecified unspecified unspecified  	O	null

0 שירת שירה שירתו noun feminine singular absolute unspecified unspecified  
0 ו ו שירתו possessive masculine singular unspecified 3 unspecified 0 	O	null
1 משופעת משופע משופעת adjective feminine singular absolute unspecified unspecified  	O	null
2 ב ב בתיאורים preposition unspecified unspecified unspecified unspecified unspecified 0 
2 תיאורים תיאור בתיאורים noun masculine plural absolute unspecified unspecified  	O	null
3 של של של shel-preposition unspecified unspecified unspecified unspecified unspecified  	O	null
4 מקומות מקום מקומות noun masculine plural absolute unspecified unspecified  	O	null
5 . . . punctuation unspecified unspecified unspecified unspecified unspecified  	O	null

0 ירושלים ירושלים ירושלים properName unspecified unspecified unspecified unspecified unspecified  	I_LOC	null
1 מרכזית מרכזי מרכזית adjective feminine singular absolute unspecified unspecified  	O	null
2 ב ב בספריו preposition unspecified unspecified unspecified unspecified unspecified 0 
2 ספרי ספר בספריו noun masculine plural absolute unspecified unspecified  
2 ו ו בספריו possessive masculine singular unspecified 3 unspecified 0 	O	null
3 ה ה המוקדמים definiteArticle unspecified unspecified unspecified unspecified unspecified 0 
3 המוקדמים מוקדם המוקדמים adjective masculine plural absolute unspecified unspecified  	O	null
4 , , , punctuation unspecified unspecified unspecified unspecified unspecified  	O	null
5 ש ש שבהם relativizer/subordinatingConjunction unspecified unspecified unspecified unspecified unspecified 0 
5 ב ב שבהם preposition unspecified unspecified unspecified unspecified unspecified  
5 הם הם שבהם pronomial masculine plural unspecified 3 unspecified 0 	O	null
6 תיאורי תיאור תיאורי noun masculine plural construct unspecified unspecified  	O	null
7 מקור מקור מקור noun masculine singular construct unspecified unspecified  	O	null
8 ברוך ברוך ברוך properName unspecified unspecified unspecified unspecified unspecified  	I_PERS	null
9 , , , punctuation unspecified unspecified unspecified unspecified unspecified  	O	null
10 גן גן גן properName unspecified unspecified unspecified unspecified unspecified  	I_PERS	null
11 אפרתה אפרתה אפרתה properName unspecified unspecified unspecified unspecified unspecified  	I_PERS	null
12 , , , punctuation unspecified unspecified unspecified unspecified unspecified  	O	null
13 רחוב רחוב רחוב properName unspecified unspecified unspecified unspecified unspecified  	I_PERS	null
14 שטראוס שטראוס שטראוס properName unspecified unspecified unspecified unspecified unspecified  	I_PERS	null
15 , , , punctuation unspecified unspecified unspecified unspecified unspecified  	O	null
16 קטמון קטמון קטמון properName unspecified unspecified unspecified unspecified unspecified  	I_LOC	null
17 וכדומה וכדומה וכדומה adverb unspecified unspecified unspecified unspecified unspecified  	O	null
18 ( ( ( punctuation unspecified unspecified unspecified unspecified unspecified  	O	null
19 כמו כמו כמו conjunction unspecified unspecified unspecified unspecified unspecified  	O	null
20 ב ב בשירים preposition unspecified unspecified unspecified unspecified unspecified 0 
20 שירים שיר בשירים noun masculine plural absolute unspecified unspecified  	O	null
21 , , , punctuation unspecified unspecified unspecified unspecified unspecified  	O	null
22 ###NUMBER### ###NUMBER### ###NUMBER### numeral unspecified unspecified unspecified unspecified unspecified  	I_DATE	null
23 ) ) ) punctuation unspecified unspecified unspecified unspecified unspecified  	O	null
24 . . . punctuation unspecified unspecified unspecified unspecified unspecified  	O	null

0 אחר אחר אחר preposition unspecified unspecified unspecified unspecified unspecified  	O	null
1 כך כך כך pronoun unspecified unspecified unspecified unspecified unspecified  	O	null
2 נוספו נוסף נוספו verb masculine-and-feminine plural unspecified 3 past  	O	null
3 נופי נוף נופי noun masculine plural construct unspecified unspecified  	O	null
4 ארץ ארץ ארץ noun feminine singular absolute unspecified unspecified  	O	null
5 אחרים אחר אחרים adjective masculine plural absolute unspecified unspecified  	O	null
6 ו ו ונופי conjunction unspecified unspecified unspecified unspecified unspecified 0 
6 נופי נוף ונופי noun masculine plural construct unspecified unspecified  	O	null
7 אירופה אירופה אירופה properName unspecified unspecified unspecified unspecified unspecified  	I_LOC	null
8 : : : punctuation unspecified unspecified unspecified unspecified unspecified  	O	null
9 פראג פראג פראג properName unspecified unspecified unspecified unspecified unspecified  	I_LOC	null
10 , , , punctuation unspecified unspecified unspecified unspecified unspecified  	O	null
11 רומא רומא רומא properName unspecified unspecified unspecified unspecified unspecified  	I_LOC	null
12 , , , punctuation unspecified unspecified unspecified unspecified unspecified  	O	null
13 לונדון לונדון לונדון properName unspecified unspecified unspecified unspecified unspecified  	I_LOC	null
14 ו ו ועוד conjunction unspecified unspecified unspecified unspecified unspecified 0 
14 עוד עוד ועוד adverb unspecified unspecified unspecified unspecified unspecified  	I_LOC	null
15 ( ( ( punctuation unspecified unspecified unspecified unspecified unspecified  	O	null
16 אפשרות אפשרות אפשרות noun feminine singular absolute unspecified unspecified  	O	null
17 אחרת אחר אחרת adjective feminine singular absolute unspecified unspecified  	O	null
18 , , , punctuation unspecified unspecified unspecified unspecified unspecified  	O	null
19 ) ) ) punctuation unspecified unspecified unspecified unspecified unspecified  	O	null
20 , , , punctuation unspecified unspecified unspecified unspecified unspecified  	O	null
21 ###NUMBER### ###NUMBER### ###NUMBER### numeral unspecified unspecified unspecified unspecified unspecified  	I_DATE	null
22 ה ה המבטאים definiteArticle unspecified unspecified unspecified unspecified unspecified 0 
22 המבטאים ביטא המבטאים participle masculine plural absolute any unspecified  	O	null
23 כמיהה כמיהה כמיהה noun feminine singular absolute unspecified unspecified  	O	null
24 ל ל למציאות preposition unspecified unspecified unspecified unspecified unspecified 0 
24 מציאות מציאות למציאות noun feminine singular absolute unspecified unspecified  	O	null
25 אחרת אחר אחרת adjective feminine singular absolute unspecified unspecified  	O	null
26 , , , punctuation unspecified unspecified unspecified unspecified unspecified  	O	null
27 אקזוטית אקזוטי אקזוטית adjective feminine singular absolute unspecified unspecified  	O	null
28 ו ו ומשוחררת conjunction unspecified unspecified unspecified unspecified unspecified 0 
28 משוחררת משוחרר ומשוחררת adjective feminine singular absolute unspecified unspecified  	O	null
29 , , , punctuation unspecified unspecified unspecified unspecified unspecified  	O	null
30 אך אך אך conjunction unspecified unspecified unspecified unspecified unspecified  	O	null
31 גם גם גם conjunction unspecified unspecified unspecified unspecified unspecified  	O	null
32 געגוע געגוע געגוע noun masculine singular absolute unspecified unspecified  	O	null
33 ל ל לשורשים preposition unspecified unspecified unspecified unspecified unspecified 0 
33 ה ה לשורשים definiteArticle unspecified unspecified unspecified unspecified unspecified 0 
33 השורשים שורש לשורשים noun masculine plural absolute unspecified unspecified  	O	null
34 ה ה המשפחתיים definiteArticle unspecified unspecified unspecified unspecified unspecified 0 
34 המשפחתיים משפחתי המשפחתיים adjective masculine plural absolute unspecified unspecified  	O	null
35 , , , punctuation unspecified unspecified unspecified unspecified unspecified  	O	null
36 ה ה הקהילתיים definiteArticle unspecified unspecified unspecified unspecified unspecified 0 
36 הקהילתיים קהילתי הקהילתיים adjective masculine plural absolute unspecified unspecified  	O	null
37 ו ו והיהודיים conjunction unspecified unspecified unspecified unspecified unspecified 0 
37 ה ה והיהודיים definiteArticle unspecified unspecified unspecified unspecified unspecified 0 
37 היהודיים יהודי והיהודיים adjective masculine plural absolute unspecified unspecified  	O	null
38 ש ש שנגדעו relativizer/subordinatingConjunction unspecified unspecified unspecified unspecified unspecified 0 
38 נגדעו נגדע שנגדעו verb masculine-and-feminine plural unspecified 3 past  	O	null
39 ב ב בשואה preposition unspecified unspecified unspecified unspecified unspecified 0 
39 ה ה בשואה definiteArticle unspecified unspecified unspecified unspecified unspecified 0 
39 השואה שואה בשואה noun feminine singular absolute unspecified unspecified  	O	null
40 , , , punctuation unspecified unspecified unspecified unspecified unspecified  	O	null
41 ו ו וגם conjunction unspecified unspecified unspecified unspecified unspecified 0 
41 גם גם וגם conjunction unspecified unspecified unspecified unspecified unspecified  	O	null
42 ל ל לאווירה preposition unspecified unspecified unspecified unspecified unspecified 0 
42 ה ה לאווירה definiteArticle unspecified unspecified unspecified unspecified unspecified 0 
42 האווירה אווירה לאווירה noun feminine singular absolute unspecified unspecified  	O	null
43 ה ה הנינוחה definiteArticle unspecified unspecified unspecified unspecified unspecified 0 
43 הנינוחה נינוח הנינוחה adjective feminine singular absolute unspecified unspecified  	O	null
44 ה ה החגיגית definiteArticle unspecified unspecified unspecified unspecified unspecified 0 
44 החגיגית חגיגי החגיגית adjective feminine singular absolute unspecified unspecified  	O	null
45 של של של shel-preposition unspecified unspecified unspecified unspecified unspecified  	O	null
46 ה ה הנצרות definiteArticle unspecified unspecified unspecified unspecified unspecified 0 
46 הנצרות נצרות הנצרות noun feminine singular absolute unspecified unspecified  	O	null
47 . . . punctuation unspecified unspecified unspecified unspecified unspecified  	O	null

0 ל ל לדוגמה preposition unspecified unspecified unspecified unspecified unspecified 0 
0 דוגמה דוגמה לדוגמה noun feminine singular absolute unspecified unspecified  	O	null
1 , , , punctuation unspecified unspecified unspecified unspecified unspecified  	O	null
2 ב ב בפתיחת preposition unspecified unspecified unspecified unspecified unspecified 0 
2 פתיחת פתיחה בפתיחת noun feminine singular construct unspecified unspecified  	O	null
3 ה ה השיר definiteArticle unspecified unspecified unspecified unspecified unspecified 0 
3 השיר שיר השיר noun masculine singular absolute unspecified unspecified  	O	null
4 " " " punctuation unspecified unspecified unspecified unspecified unspecified  	O	null
5 הכנות הכנה הכנות noun feminine plural construct unspecified unspecified  	O	null
6 ל ל לנסיעה preposition unspecified unspecified unspecified unspecified unspecified 0 
6 ה ה לנסיעה definiteArticle unspecified unspecified unspecified unspecified unspecified 0 
6 הנסיעה נסיעה לנסיעה noun feminine singular absolute unspecified unspecified  	O	null
7 " " " punctuation unspecified unspecified unspecified unspecified unspecified  	O	null
8 ( ( ( punctuation unspecified unspecified unspecified unspecified unspecified  	O	null
9 שם שם שם adverb unspecified unspecified unspecified unspecified unspecified  	O	null
10 ) ) ) punctuation unspecified unspecified unspecified unspecified unspecified  	O	null
11 : : : punctuation unspecified unspecified unspecified unspecified unspecified  	O	null
12 " " " punctuation unspecified unspecified unspecified unspecified unspecified  	O	null
13 אֲנִי אֲנִי אֲנִי noun masculine singular absolute unspecified unspecified  	O	null
14 אֶסַּע אֶסַּע אֶסַּע noun masculine singular absolute unspecified unspecified  	O	null
15 ל ל לְפּוֹלָנְיָה preposition unspecified unspecified unspecified unspecified unspecified 0 
15 ה ה לְפּוֹלָנְיָה definiteArticle unspecified unspecified unspecified unspecified unspecified 0 
15 הְפּוֹלָנְיָה הְפּוֹלָנְיָה לְפּוֹלָנְיָה noun feminine singular absolute unspecified unspecified  	O	null
16 / / / punctuation unspecified unspecified unspecified unspecified unspecified  	O	null
17 ל ל לִגְמֹר preposition unspecified unspecified unspecified unspecified unspecified 0 
17 ה ה לִגְמֹר definiteArticle unspecified unspecified unspecified unspecified unspecified 0 
17 הִגְמֹר הִגְמֹר לִגְמֹר noun masculine singular absolute unspecified unspecified  	O	null
18 חֶשְׁבּוֹנוֹת חֶשְׁבּוֹנוֹת חֶשְׁבּוֹנוֹת properName unspecified unspecified unspecified unspecified unspecified  	I_PERS	null
19 יְשָׁנִים יְשָׁנִים יְשָׁנִים properName unspecified unspecified unspecified unspecified unspecified  	I_PERS	null
20 , , , punctuation unspecified unspecified unspecified unspecified unspecified  	O	null
21 / / / punctuation unspecified unspecified unspecified unspecified unspecified  	O	null
22 ל ל לִמְצוֹא preposition unspecified unspecified unspecified unspecified unspecified 0 
22 ה ה לִמְצוֹא definiteArticle unspecified unspecified unspecified unspecified unspecified 0 
22 הִמְצוֹא הִמְצוֹא לִמְצוֹא noun masculine singular absolute unspecified unspecified  	O	null
23 בַּיִת..." בַּיִת..." בַּיִת..." properName unspecified unspecified unspecified unspecified unspecified  	I_ORG	null
24 ו ו ולקראת conjunction unspecified unspecified unspecified unspecified unspecified 0 
24 לקראת לקראת ולקראת preposition unspecified unspecified unspecified unspecified unspecified  	O	null
25 סוף סוף סופו noun masculine singular absolute unspecified unspecified  
25 ו ו סופו possessive masculine singular unspecified 3 unspecified 0 	O	null
26 : : : punctuation unspecified unspecified unspecified unspecified unspecified  	O	null
27 " " " punctuation unspecified unspecified unspecified unspecified unspecified  	O	null
28 אֲבַקֵּש אֲבַקֵּש אֲבַקֵּש noun masculine singular absolute unspecified unspecified  	O	null
29 ׁ ׁ ׁ punctuation unspecified unspecified unspecified unspecified unspecified  	O	null
30 אֶת אֶת אֶת noun masculine singular absolute unspecified unspecified  	O	null
31 ה ה הַכְּתֹבֶת definiteArticle unspecified unspecified unspecified unspecified unspecified 0 
31 הַכְּתֹבֶת הַכְּתֹבֶת הַכְּתֹבֶת noun feminine singular absolute unspecified unspecified  	O	null
32 עַל עַל עַל noun masculine singular construct unspecified unspecified  	O	null
33 פִּי פִּי פִּי properName unspecified unspecified unspecified unspecified unspecified  	O	null
34 הַתְּעוּדָה הַתְּעוּדָה הַתְּעוּדָה noun masculine singular absolute unspecified unspecified  	O	null
35 : : : punctuation unspecified unspecified unspecified unspecified unspecified  	O	null
36 / / / punctuation unspecified unspecified unspecified unspecified unspecified  	O	null
37 יַחְמִיצו יַחְמִיצו יַחְמִיצו properName unspecified unspecified unspecified unspecified unspecified  	I_PERS	null
38 ּ ּ ּ punctuation unspecified unspecified unspecified unspecified unspecified  	O	null
39 ל ל לִי preposition unspecified unspecified unspecified unspecified unspecified 0 
39 ִי ִי לִי properName unspecified unspecified unspecified unspecified unspecified  	I_PERS	null
40 פָּנִים פָּנִים פָּנִים properName unspecified unspecified unspecified unspecified unspecified  	I_PERS	null
41 , , , punctuation unspecified unspecified unspecified unspecified unspecified  	O	null
42 יִתְבּוֹנְנו יִתְבּוֹנְנו יִתְבּוֹנְנו verb masculine singular unspecified 3 past  	O	null
43 ּ ּ ּ punctuation unspecified unspecified unspecified unspecified unspecified  	O	null
44 ב ב בְּשִׂטְנָה...". preposition unspecified unspecified unspecified unspecified unspecified 0 
44 ה ה בְּשִׂטְנָה...". definiteArticle unspecified unspecified unspecified unspecified unspecified 0 
44 הְּשִׂטְנָה...". הְּשִׂטְנָה...". בְּשִׂטְנָה...". noun masculine singular absolute unspecified unspecified  	O	null
45 ב ב בן preposition unspecified unspecified unspecified unspecified unspecified  
45 הן הן בן pronomial feminine plural unspecified 3 unspecified 0 	O	null
46 - - - properName unspecified unspecified unspecified unspecified unspecified  	I_ORG	null
47 אריה אריה אריה properName unspecified unspecified unspecified unspecified unspecified  	I_ORG	null
48 מ מ משלב preposition unspecified unspecified unspecified unspecified unspecified 0 
48 שלב שלב משלב noun masculine singular construct unspecified unspecified  	O	null
49 ב ב בשיריו preposition unspecified unspecified unspecified unspecified unspecified 0 
49 שירי שיר בשיריו noun masculine plural absolute unspecified unspecified  
49 ו ו בשיריו possessive masculine singular unspecified 3 unspecified 0 	O	null
50 מילים מילה מילים noun feminine plural absolute unspecified unspecified  	O	null
51 ב ב ביידיש preposition unspecified unspecified unspecified unspecified unspecified 0 
51 יידיש יידיש ביידיש properName feminine singular unspecified unspecified unspecified  	O	null
52 ב ב בתעתיק preposition unspecified unspecified unspecified unspecified unspecified 0 
52 תעתיק תעתיק בתעתיק noun masculine singular construct unspecified unspecified  	O	null
53 כ כ כדרך preposition unspecified unspecified unspecified unspecified unspecified 0 
53 דר דר כדרך participle masculine singular unspecified any unspecified  
53 ך ך כדרך possessive feminine singular unspecified 2 unspecified 0 	O	null
54 להמחיש המחיש להמחיש verb unspecified unspecified unspecified unspecified infinitive  	O	null
55 את את את at-preposition unspecified unspecified unspecified unspecified unspecified  	O	null
56 ה ה האובדן definiteArticle unspecified unspecified unspecified unspecified unspecified 0 
56 האובדן אובדן האובדן noun masculine singular absolute unspecified unspecified  	O	null
57 ו ו ולהנציח conjunction unspecified unspecified unspecified unspecified unspecified 0 
57 להנציח הנציח ולהנציח verb unspecified unspecified unspecified unspecified infinitive  	O	null
58 את את את at-preposition unspecified unspecified unspecified unspecified unspecified  	O	null
59 ה ה הזיכרון definiteArticle unspecified unspecified unspecified unspecified unspecified 0 
59 הזיכרון זיכרון הזיכרון noun masculine singular absolute unspecified unspecified  	O	null
60 . . . punctuation unspecified unspecified unspecified unspecified unspecified  	O	null

0 יחס יחס יחסו noun masculine singular absolute unspecified unspecified  
0 ו ו יחסו possessive masculine singular unspecified 3 unspecified 0 	O	null
1 ל ל ליהדות preposition unspecified unspecified unspecified unspecified unspecified 0 
1 יהדות יהדות ליהדות noun feminine singular construct unspecified unspecified  	O	null
2 מורכב מורכב מורכב adjective masculine singular absolute unspecified unspecified  	O	null
3 אף אף אף conjunction unspecified unspecified unspecified unspecified unspecified  	O	null
4 הוא הוא הוא pronoun masculine singular unspecified 3 unspecified  	O	null
5 . . . punctuation unspecified unspecified unspecified unspecified unspecified  	O	null

0 מ מ מחד preposition unspecified unspecified unspecified unspecified unspecified 0 
0 חד חד מחד wPrefix unspecified unspecified unspecified unspecified unspecified  	O	null
1 גיסא גיסא גיסא properName unspecified unspecified unspecified unspecified unspecified  	I_PERS	null
2 , , , punctuation unspecified unspecified unspecified unspecified unspecified  	O	null
3 קיימת קיים קיימת adjective feminine singular absolute unspecified unspecified  	O	null
4 משיכה משיכה משיכה noun feminine singular absolute unspecified unspecified  	O	null
5 ל ל למכמנים preposition unspecified unspecified unspecified unspecified unspecified 0 
5 מכמנים מכמנים למכמנים properName masculine singular unspecified unspecified unspecified  	O	null
6 ה ה התרבותיים definiteArticle unspecified unspecified unspecified unspecified unspecified 0 
6 התרבותיים תרבותי התרבותיים adjective masculine plural absolute unspecified unspecified  	O	null
7 , , , punctuation unspecified unspecified unspecified unspecified unspecified  	O	null
8 ה ה הלשוניים definiteArticle unspecified unspecified unspecified unspecified unspecified 0 
8 הלשוניים לשוני הלשוניים adjective masculine plural absolute unspecified unspecified  	O	null
9 ו ו והמיסטיים conjunction unspecified unspecified unspecified unspecified unspecified 0 
9 ה ה והמיסטיים definiteArticle unspecified unspecified unspecified unspecified unspecified 0 
9 המיסטיים מיסטי והמיסטיים adjective masculine plural absolute unspecified unspecified  	O	null
10 , , , punctuation unspecified unspecified unspecified unspecified unspecified  	O	null
11 כמו כמו כמו conjunction unspecified unspecified unspecified unspecified unspecified  	O	null
12 ב ב בשיר preposition unspecified unspecified unspecified unspecified unspecified 0 
12 שיר שיר בשיר properName feminine singular unspecified unspecified unspecified  	I_PERS	null
13 " " " punctuation unspecified unspecified unspecified unspecified unspecified  	O	null
14 שקט שקט שקט noun masculine singular construct unspecified unspecified  	O	null
15 נסער נסער נסער adjective masculine singular absolute unspecified unspecified  	O	null
16 " " " punctuation unspecified unspecified unspecified unspecified unspecified  	O	null
17 , , , punctuation unspecified unspecified unspecified unspecified unspecified  	O	null
18 ה ה הנשען definiteArticle unspecified unspecified unspecified unspecified unspecified 0 
18 הנשען נשען הנשען participle masculine singular absolute any unspecified  	O	null
19 על על על preposition unspecified unspecified unspecified unspecified unspecified  	O	null
20 טרמינולוגיה טרמינולוגיה טרמינולוגיה noun feminine singular absolute unspecified unspecified  	O	null
21 קבלית קבלית קבלית verb masculine singular unspecified 2 past  	O	null
22 ש ש שמשקפת relativizer/subordinatingConjunction unspecified unspecified unspecified unspecified unspecified 0 
22 משקפת שיקף שמשקפת participle feminine singular construct any unspecified  	O	null
23 מצב מצב מצב noun masculine singular construct unspecified unspecified  	O	null
24 אקסטטי אקסטטי אקסטטי adjective masculine singular absolute unspecified unspecified  	O	null
25 של של של shel-preposition unspecified unspecified unspecified unspecified unspecified  	O	null
26 " " " punctuation unspecified unspecified unspecified unspecified unspecified  	O	null
27 מ מ מִגְּאֻלַּת preposition unspecified unspecified unspecified unspecified unspecified 0 
27 ִגְּאֻלַּת ִגְּאֻלַּת מִגְּאֻלַּת noun masculine singular construct unspecified unspecified  	O	null
28 ה ה הַנִּיצוֹצוֹת definiteArticle unspecified unspecified unspecified unspecified unspecified 0 
28 הַנִּיצוֹצוֹת הַנִּיצוֹצוֹת הַנִּיצוֹצוֹת noun feminine singular absolute unspecified unspecified  	O	null
29 / / / punctuation unspecified unspecified unspecified unspecified unspecified  	O	null
30 הַמִּסְתַּתְּרִים הַמִּסְתַּתְּרִים הַמִּסְתַּתְּרִים noun feminine singular absolute unspecified unspecified  	O	null
31 / / / punctuation unspecified unspecified unspecified unspecified unspecified  	O	null
32 ב ב בְּתוֹך preposition unspecified unspecified unspecified unspecified unspecified 0 
32 ה ה בְּתוֹך definiteArticle unspecified unspecified unspecified unspecified unspecified 0 
32 הְּתוֹך הְּתוֹך בְּתוֹך noun masculine singular absolute unspecified unspecified  	O	null
33 ְ ְ ְ punctuation unspecified unspecified unspecified unspecified unspecified  	O	null
34 יָם יָם יָם properName unspecified unspecified unspecified unspecified unspecified  	I_PERS	null
35 הַפְּחָדִים הַפְּחָדִים הַפְּחָדִים verb masculine singular unspecified 3 past  	O	null
36 " " " punctuation unspecified unspecified unspecified unspecified unspecified  	O	null
37 ( ( ( punctuation unspecified unspecified unspecified unspecified unspecified  	O	null
38 קו קו קו noun masculine singular construct unspecified unspecified  	O	null
39 פרשת פרשה פרשת noun feminine singular construct unspecified unspecified  	O	null
40 ה ה הזמן definiteArticle unspecified unspecified unspecified unspecified unspecified 0 
40 הזמן זמן הזמן noun masculine singular absolute unspecified unspecified  	O	null
41 , , , punctuation unspecified unspecified unspecified unspecified unspecified  	O	null
42 ###NUMBER### ###NUMBER### ###NUMBER### numeral unspecified unspecified unspecified unspecified unspecified  	I_DATE	null
43 ) ) ) punctuation unspecified unspecified unspecified unspecified unspecified  	O	null
44 . . . punctuation unspecified unspecified unspecified unspecified unspecified  	O	null

0 מאידך מאידך מאידך conjunction unspecified unspecified unspecified unspecified unspecified  	O	null
1 גיסא גיסא גיסא properName unspecified unspecified unspecified unspecified unspecified  	I_PERS	null
2 , , , punctuation unspecified unspecified unspecified unspecified unspecified  	O	null
3 הוא הוא הוא pronoun masculine singular unspecified 3 unspecified  	O	null
4 מקיים קיים מקיים verb masculine singular unspecified any beinoni  	O	null
5 פולמוס פולמוס פולמוס noun masculine singular absolute unspecified unspecified  	O	null
6 עם עם עם preposition unspecified unspecified unspecified unspecified unspecified  	O	null
7 היבטים היבט היבטים noun masculine plural absolute unspecified unspecified  	O	null
8 שונים שונה שונים adjective masculine plural absolute unspecified unspecified  	O	null
9 ב ב ביהדות preposition unspecified unspecified unspecified unspecified unspecified 0 
9 ה ה ביהדות definiteArticle unspecified unspecified unspecified unspecified unspecified 0 
9 היהדות יהדות ביהדות noun feminine singular absolute unspecified unspecified  	O	null
10 , , , punctuation unspecified unspecified unspecified unspecified unspecified  	O	null
11 למשל למשל למשל conjunction unspecified unspecified unspecified unspecified unspecified  	O	null
12 עם עם עם preposition unspecified unspecified unspecified unspecified unspecified  	O	null
13 ה ה השמרנות definiteArticle unspecified unspecified unspecified unspecified unspecified 0 
13 השמרנות שמרנות השמרנות noun feminine singular absolute unspecified unspecified  	O	null
14 ה ה המינית definiteArticle unspecified unspecified unspecified unspecified unspecified 0 
14 המינית מיני המינית adjective feminine singular absolute unspecified unspecified  	O	null
15 ( ( ( punctuation unspecified unspecified unspecified unspecified unspecified  	O	null
16 צינת צינה צינת noun feminine singular construct unspecified unspecified  	O	null
17 רוחות רוח רוחות noun feminine plural absolute unspecified unspecified  	O	null
18 ) ) ) punctuation unspecified unspecified unspecified unspecified unspecified  	O	null
19 . . . punctuation unspecified unspecified unspecified unspecified unspecified  	O	null

0 שירת שירה שירתו noun feminine singular absolute unspecified unspecified  
0 ו ו שירתו possessive masculine singular unspecified 3 unspecified 0 	O	null
1 עוסקת עסק עוסקת verb feminine singular unspecified any beinoni  	O	null
2 גם גם גם conjunction unspecified unspecified unspecified unspecified unspecified  	O	null
3 ב ב בסוגיות preposition unspecified unspecified unspecified unspecified unspecified 0 
3 סוגיות סוגיה בסוגיות noun feminine plural absolute unspecified unspecified  	O	null
4 פילוסופיות פילוסוף פילוסופיות adjective feminine plural absolute unspecified unspecified  	O	null
5 . . . punctuation unspecified unspecified unspecified unspecified unspecified  	O	null

0 ל ל לדוגמה preposition unspecified unspecified unspecified unspecified unspecified 0 
0 דוגמה דוגמה לדוגמה noun feminine singular absolute unspecified unspecified  	O	null
1 , , , punctuation unspecified unspecified unspecified unspecified unspecified  	O	null
2 ה ה השיר definiteArticle unspecified unspecified unspecified unspecified unspecified 0 
2 השיר שיר השיר noun masculine singular absolute unspecified unspecified  	O	null
3 " " " punctuation unspecified unspecified unspecified unspecified unspecified  	O	null
4 דו דו דו properName masculine singular unspecified unspecified unspecified  	I_ORG	null
5 - - - punctuation unspecified unspecified unspecified unspecified unspecified  	O	null
6 פרצופיות פרצופיות פרצופיות noun feminine singular absolute unspecified unspecified  	O	null
7 אמיתית אמיתי אמיתית adjective feminine singular absolute unspecified unspecified  	O	null
8 " " " punctuation unspecified unspecified unspecified unspecified unspecified  	O	null
9 ב ב בטיפות preposition unspecified unspecified unspecified unspecified unspecified 0 
9 טיפות טיפה בטיפות noun feminine plural absolute unspecified unspecified  	O	null
10 של של של shel-preposition unspecified unspecified unspecified unspecified unspecified  	O	null
11 זמן זמן זמן noun masculine singular absolute unspecified unspecified  	O	null
12 ( ( ( punctuation unspecified unspecified unspecified unspecified unspecified  	O	null
13 ###NUMBER### ###NUMBER### ###NUMBER### numeral unspecified unspecified unspecified unspecified unspecified  	I_DATE	null
14 ) ) ) punctuation unspecified unspecified unspecified unspecified unspecified  	O	null
15 ה ה המתאר definiteArticle unspecified unspecified unspecified unspecified unspecified 0 
15 המתאר תיאר המתאר participle masculine singular absolute any unspecified  	O	null
16 את את את at-preposition unspecified unspecified unspecified unspecified unspecified  	O	null
17 יחסיות יחסיות יחסיותם noun feminine singular absolute unspecified unspecified  
17 ם ם יחסיותם possessive masculine plural unspecified 3 unspecified 0 	O	null
18 של של של shel-preposition unspecified unspecified unspecified unspecified unspecified  	O	null
19 ה ה האמת definiteArticle unspecified unspecified unspecified unspecified unspecified 0 
19 האמת אמת האמת noun feminine singular absolute unspecified unspecified  	O	null
20 ו ו והשקר conjunction unspecified unspecified unspecified unspecified unspecified 0 
20 ה ה והשקר definiteArticle unspecified unspecified unspecified unspecified unspecified 0 
20 השקר שקר והשקר noun masculine singular absolute unspecified unspecified  	O	null
21 . . . punctuation unspecified unspecified unspecified unspecified unspecified  	O	null

0 היקף היקף היקף noun masculine singular construct unspecified unspecified  	O	null
1 שירי שיר שירי noun masculine plural construct unspecified unspecified  	O	null
2 ה ה המחאה definiteArticle unspecified unspecified unspecified unspecified unspecified 0 
2 המחאה מחאה המחאה noun feminine singular absolute unspecified unspecified  	O	null
3 אינו הוא אינו copula masculine singular unspecified 3 beinoni  	O	null
4 גדול גדול גדול adjective masculine singular absolute unspecified unspecified  	O	null
5 , , , punctuation unspecified unspecified unspecified unspecified unspecified  	O	null
6 אך אך אך conjunction unspecified unspecified unspecified unspecified unspecified  	O	null
7 הוא הוא הוא pronoun masculine singular unspecified 3 unspecified  	O	null
8 משמעותי משמעותי משמעותי adjective masculine singular absolute unspecified unspecified  	O	null
9 ו ו ומתייחס conjunction unspecified unspecified unspecified unspecified unspecified 0 
9 מתייחס התייחס ומתייחס verb masculine singular unspecified any beinoni  	O	null
10 הן הן הן conjunction unspecified unspecified unspecified unspecified unspecified  	O	null
11 ל ל לסוגיות preposition unspecified unspecified unspecified unspecified unspecified 0 
11 סוגיות סוגיה לסוגיות noun feminine plural absolute unspecified unspecified  	O	null
12 אקטואליות אקטואלי אקטואליות adjective feminine plural absolute unspecified unspecified  	O	null
13 ו ו והן conjunction unspecified unspecified unspecified unspecified unspecified 0 
13 הן הן והן conjunction unspecified unspecified unspecified unspecified unspecified  	O	null
14 ל ל לסוגיות preposition unspecified unspecified unspecified unspecified unspecified 0 
14 סוגיות סוגיה לסוגיות noun feminine plural absolute unspecified unspecified  	O	null
15 אוניברסליות אוניברסלי אוניברסליות adjective feminine plural absolute unspecified unspecified  	O	null
16 . . . punctuation unspecified unspecified unspecified unspecified unspecified  	O	null

0 ל ל לדוגמה preposition unspecified unspecified unspecified unspecified unspecified 0 
0 דוגמה דוגמה לדוגמה noun feminine singular absolute unspecified unspecified  	O	null
1 , , , punctuation unspecified unspecified unspecified unspecified unspecified  	O	null
2 ה ה השיר definiteArticle unspecified unspecified unspecified unspecified unspecified 0 
2 השיר שיר השיר noun masculine singular absolute unspecified unspecified  	O	null
3 " " " punctuation unspecified unspecified unspecified unspecified unspecified  	O	null
4 הודאה הודאה הודאה noun feminine singular absolute unspecified unspecified  	O	null
5 " " " punctuation unspecified unspecified unspecified unspecified unspecified  	O	null
6 שבו שב שבו verb masculine-and-feminine plural unspecified 3 past  	O	null
7 מחאה מחאה מחאה noun feminine singular absolute unspecified unspecified  	O	null
8 חריפה חריף חריפה adjective feminine singular absolute unspecified unspecified  	O	null
9 נגד נגד נגד preposition unspecified unspecified unspecified unspecified unspecified  	O	null
10 מעשים מעשה מעשים noun masculine plural absolute unspecified unspecified  	O	null
11 לא לא לא negation unspecified unspecified unspecified unspecified unspecified  	O	null
12 מוסריים מוסרי מוסריים adjective masculine plural absolute unspecified unspecified  	O	null
13 של של של shel-preposition unspecified unspecified unspecified unspecified unspecified  	O	null
14 ממשלת ממשלה ממשלת noun feminine singular construct unspecified unspecified  	I_ORG	null
15 ישראל ישראל ישראל properName unspecified unspecified unspecified unspecified unspecified  	I_ORG	null
16 , , , punctuation unspecified unspecified unspecified unspecified unspecified  	O	null
17 כמו כמו כמו conjunction unspecified unspecified unspecified unspecified unspecified  	O	null
18 מכירת מכירה מכירת noun feminine singular construct unspecified unspecified  	O	null
19 נשק נשק נשק noun masculine singular absolute unspecified unspecified  	O	null
20 ל ל לאידי preposition unspecified unspecified unspecified unspecified unspecified 0 
20 אידי יידי לאידי adjective masculine singular absolute unspecified unspecified  	O	null
21 אמין אמין אמין adjective masculine singular absolute unspecified unspecified  	O	null
22 , , , punctuation unspecified unspecified unspecified unspecified unspecified  	O	null
23 הקמת הקמה הקמת noun feminine singular construct unspecified unspecified  	O	null
24 התנחלויות התנחלות התנחלויות noun feminine plural absolute unspecified unspecified  	O	null
25 וכדומה וכדומה וכדומה adverb unspecified unspecified unspecified unspecified unspecified  	I_LOC	null
26 . . . punctuation unspecified unspecified unspecified unspecified unspecified  	O	null

0 ב ב בשיר preposition unspecified unspecified unspecified unspecified unspecified 0 
0 ה ה בשיר definiteArticle unspecified unspecified unspecified unspecified unspecified 0 
0 השיר שיר בשיר noun masculine singular absolute unspecified unspecified  	O	null
1 יש יש יש existential unspecified unspecified unspecified unspecified unspecified  	O	null
2 גם גם גם conjunction unspecified unspecified unspecified unspecified unspecified  	O	null
3 מחאה מחאה מחאה noun feminine singular absolute unspecified unspecified  	O	null
4 חברתית חברתי חברתית adjective feminine singular absolute unspecified unspecified  	O	null
5 : : : punctuation unspecified unspecified unspecified unspecified unspecified  	O	null
6 " " " punctuation unspecified unspecified unspecified unspecified unspecified  	O	null
7 אֲנִי אֲנִי אֲנִי noun masculine singular absolute unspecified unspecified  	O	null
8 מוֹדֶה מוֹדֶה מוֹדֶה properName unspecified unspecified unspecified unspecified unspecified  	I_PERS	null
9 , , , punctuation unspecified unspecified unspecified unspecified unspecified  	O	null
10 הֵבֵאתִי הֵבֵאתִי הֵבֵאתִי noun masculine-and-feminine singular absolute unspecified unspecified  	O	null
11 ל ל לָעוֹלָם preposition unspecified unspecified unspecified unspecified unspecified 0 
11 ה ה לָעוֹלָם definiteArticle unspecified unspecified unspecified unspecified unspecified 0 
11 הָעוֹלָם הָעוֹלָם לָעוֹלָם noun masculine singular absolute unspecified unspecified  	O	null
12 מִלִּים מִלִּים מִלִּים properName unspecified unspecified unspecified unspecified unspecified  	I_PERS	null
13 חֲדָשׁוֹת חֲדָשׁוֹת חֲדָשׁוֹת properName unspecified unspecified unspecified unspecified unspecified  	I_PERS	null
14 : : : punctuation unspecified unspecified unspecified unspecified unspecified  	O	null
15 / / / punctuation unspecified unspecified unspecified unspecified unspecified  	O	null
16 קִפּוּח קִפּוּח קִפּוּח properName unspecified unspecified unspecified unspecified unspecified  	I_PERS	null
17 ַ ַ ַ punctuation unspecified unspecified unspecified unspecified unspecified  	O	null
18 , , , punctuation unspecified unspecified unspecified unspecified unspecified  	O	null
19 טִפּוּח טִפּוּח טִפּוּח properName unspecified unspecified unspecified unspecified unspecified  	I_PERS	null
20 ַ ַ ַ punctuation unspecified unspecified unspecified unspecified unspecified  	O	null
21 , , , punctuation unspecified unspecified unspecified unspecified unspecified  	O	null
22 פִּתּוּח פִּתּוּח פִּתּוּח properName unspecified unspecified unspecified unspecified unspecified  	I_PERS	null
23 ַ ַ ַ punctuation unspecified unspecified unspecified unspecified unspecified  	O	null
24 . . . punctuation unspecified unspecified unspecified unspecified unspecified  	O	null

0 נוֹתֵן נוֹתֵן נוֹתֵן properName unspecified unspecified unspecified unspecified unspecified  	I_PERS	null
1 מְלָגּוֹת מְלָגּוֹת מְלָגּוֹת properName unspecified unspecified unspecified unspecified unspecified  	I_PERS	null
2 , , , punctuation unspecified unspecified unspecified unspecified unspecified  	O	null
3 מַעֲנָקִים מַעֲנָקִים מַעֲנָקִים adjective masculine singular construct unspecified unspecified  	O	null
4 , , , punctuation unspecified unspecified unspecified unspecified unspecified  	O	null
5 נְקֻדּוֹת נְקֻדּוֹת נְקֻדּוֹת properName unspecified unspecified unspecified unspecified unspecified  	I_PERS	null
6 זְכוּת זְכוּת זְכוּת verb feminine singular unspecified any beinoni  	O	null
7 / / / punctuation unspecified unspecified unspecified unspecified unspecified  	O	null
8 פּוֹתֵח פּוֹתֵח פּוֹתֵח properName unspecified unspecified unspecified unspecified unspecified  	I_PERS	null
9 ַ ַ ַ punctuation unspecified unspecified unspecified unspecified unspecified  	O	null
10 כִּתָּה כִּתָּה כִּתָּה adjective masculine singular construct unspecified unspecified  	O	null
11 מ מ מְקַדֶּמֶת preposition unspecified unspecified unspecified unspecified unspecified 0 
11 ְקַדֶּמֶת ְקַדֶּמֶת מְקַדֶּמֶת properName unspecified unspecified unspecified unspecified unspecified  	I_LOC	null
12 , , , punctuation unspecified unspecified unspecified unspecified unspecified  	O	null
13 מְסַיַּעַת מְסַיַּעַת מְסַיַּעַת properName unspecified unspecified unspecified unspecified unspecified  	I_PERS	null
14 , , , punctuation unspecified unspecified unspecified unspecified unspecified  	O	null
15 מְטַפַּחַת..." מְטַפַּחַת..." מְטַפַּחַת..." properName unspecified unspecified unspecified unspecified unspecified  	I_ORG	null
16 ( ( ( punctuation unspecified unspecified unspecified unspecified unspecified  	O	null
17 כמו כמו כמו conjunction unspecified unspecified unspecified unspecified unspecified  	O	null
18 ב ב בשירים preposition unspecified unspecified unspecified unspecified unspecified 0 
18 שירים שיר בשירים noun masculine plural absolute unspecified unspecified  	O	null
19 ) ) ) punctuation unspecified unspecified unspecified unspecified unspecified  	O	null
20 . . . punctuation unspecified unspecified unspecified unspecified unspecified  	O	null

0 עוד עוד עוד adverb unspecified unspecified unspecified unspecified unspecified  	O	null
1 מ מ מספריו preposition unspecified unspecified unspecified unspecified unspecified 0 
1 ספרי ספר מספריו noun masculine plural absolute unspecified unspecified  
1 ו ו מספריו possessive masculine singular unspecified 3 unspecified 0 	O	null
2 : : : punctuation unspecified unspecified unspecified unspecified unspecified  	O	null
3 ו ו והיה conjunction unspecified unspecified unspecified unspecified unspecified 0 
3 היה הוא והיה copula masculine singular unspecified 3 past  	O	null
4 נותן נתן נותן verb masculine singular unspecified any beinoni  	O	null
5 שמות שם שמות noun masculine plural absolute unspecified unspecified  	O	null
6 ) ) ) punctuation unspecified unspecified unspecified unspecified unspecified  	O	null
7 ; ; ; punctuation unspecified unspecified unspecified unspecified unspecified  	O	null
8 ###NUMBER### ###NUMBER### ###NUMBER### numeral unspecified unspecified unspecified unspecified unspecified  	I_DATE	null
9 ה ה הארץ definiteArticle unspecified unspecified unspecified unspecified unspecified 0 
9 הארץ ארץ הארץ noun feminine singular absolute unspecified unspecified  	O	null
10 ש ש שהבטיחה relativizer/subordinatingConjunction unspecified unspecified unspecified unspecified unspecified 0 
10 הבטיחה הבטיח שהבטיחה verb feminine singular unspecified 3 past  	O	null
11 ) ) ) punctuation unspecified unspecified unspecified unspecified unspecified  	O	null
12 . . . punctuation unspecified unspecified unspecified unspecified unspecified  	O	null
13 ###NUMBER### ###NUMBER### ###NUMBER### numeral unspecified unspecified unspecified unspecified unspecified  	I_DATE	null
14 שירי שיר שיריו noun masculine plural absolute unspecified unspecified  
14 ו ו שיריו possessive masculine singular unspecified 3 unspecified 0 	O	null
15 תורגמו תורגם תורגמו verb masculine-and-feminine plural unspecified 3 past  	O	null
16 ל ל לכמה preposition unspecified unspecified unspecified unspecified unspecified 0 
16 כמה כמה לכמה quantifier unspecified unspecified construct unspecified unspecified  	O	null
17 שפות שפה שפות noun feminine plural absolute unspecified unspecified  	O	null
18 . . . punctuation unspecified unspecified unspecified unspecified unspecified  	O	null

0 ספר ספר ספרו noun masculine singular absolute unspecified unspecified  
0 ו ו ספרו possessive masculine singular unspecified 3 unspecified 0 	O	null
1 צינת צינה צינת noun feminine singular construct unspecified unspecified  	O	null
2 רוחות רוח רוחות noun feminine plural absolute unspecified unspecified  	O	null
3 זכה זכה זכה verb masculine singular unspecified 3 past  	O	null
4 ב ב בפרס preposition unspecified unspecified unspecified unspecified unspecified 0 
4 פרס פרס בפרס noun masculine singular absolute unspecified unspecified  	O	null
5 ל ל לספר preposition unspecified unspecified unspecified unspecified unspecified 0 
5 ספר ספר לספר noun masculine singular construct unspecified unspecified  	O	null
6 ביכורים ביכורים ביכורים noun masculine singular absolute unspecified unspecified  	O	null
7 על על על preposition unspecified unspecified unspecified unspecified unspecified  	O	null
8 שם שם שם noun masculine singular construct unspecified unspecified  	O	null
9 ירוחם ירוחם ירוחם properName unspecified unspecified unspecified unspecified unspecified  	I_PERS	null
10 לוריא לוריא לוריא properName unspecified unspecified unspecified unspecified unspecified  	I_PERS	null
11 ) ) ) punctuation unspecified unspecified unspecified unspecified unspecified  	O	null
12 . . . punctuation unspecified unspecified unspecified unspecified unspecified  	O	null
13 ###NUMBER### ###NUMBER### ###NUMBER### numeral unspecified unspecified unspecified unspecified unspecified  	I_DATE	null
14 References References References foreign unspecified unspecified unspecified unspecified unspecified  	O	null
15 : : : punctuation unspecified unspecified unspecified unspecified unspecified  	O	null
16 בן בן בן properName unspecified unspecified unspecified unspecified unspecified  	I_PERS	null
17 , , , punctuation unspecified unspecified unspecified unspecified unspecified  	O	null
18 מנחם מנחם מנחם properName unspecified unspecified unspecified unspecified unspecified  	I_PERS	null
19 . . . punctuation unspecified unspecified unspecified unspecified unspecified  	O	null

0 " " " punctuation unspecified unspecified unspecified unspecified unspecified  	O	null
1 ה ה הוויתור definiteArticle unspecified unspecified unspecified unspecified unspecified 0 
1 הוויתור ויתור הוויתור noun masculine singular absolute unspecified unspecified  	O	null
2 קרוב קרוב קרוב adjective masculine singular absolute unspecified unspecified  	O	null
3 ל ל לשחיתות preposition unspecified unspecified unspecified unspecified unspecified 0 
3 ה ה לשחיתות definiteArticle unspecified unspecified unspecified unspecified unspecified 0 
3 השחיתות שחיתות לשחיתות noun feminine singular absolute unspecified unspecified  	O	null
4 " " " punctuation unspecified unspecified unspecified unspecified unspecified  	O	null
5 . . . punctuation unspecified unspecified unspecified unspecified unspecified  	O	null

0 כל כול כל quantifier unspecified unspecified construct unspecified unspecified  	O	null
1 עיר עיר עיר noun feminine singular absolute unspecified unspecified  	O	null
2 . . . punctuation unspecified unspecified unspecified unspecified unspecified  	O	null

0 ###NUMEXP### ###NUMEXP### ###NUMEXP### numberExpression unspecified unspecified unspecified unspecified unspecified  	I_DATE	null
1 . . . punctuation unspecified unspecified unspecified unspecified unspecified  	O	null

0 ; ; ; punctuation unspecified unspecified unspecified unspecified unspecified  	O	null
1 ###NUMBER### ###NUMBER### ###NUMBER### numeral unspecified unspecified unspecified unspecified unspecified  	O	null
2 דותן דותן דותן properName unspecified unspecified unspecified unspecified unspecified  	I_PERS	null
3 , , , punctuation unspecified unspecified unspecified unspecified unspecified  	O	null
4 ראובן ראובן ראובן properName unspecified unspecified unspecified unspecified unspecified  	I_PERS	null
5 . . . punctuation unspecified unspecified unspecified unspecified unspecified  	O	null

0 " " " punctuation unspecified unspecified unspecified unspecified unspecified  	O	null
1 טיפות טיפה טיפות noun feminine plural absolute unspecified unspecified  	O	null
2 של של של shel-preposition unspecified unspecified unspecified unspecified unspecified  	O	null
3 שירה שירה שירה noun feminine singular absolute unspecified unspecified  	O	null
4 דתית דתי דתית adjective feminine singular absolute unspecified unspecified  	O	null
5 , , , punctuation unspecified unspecified unspecified unspecified unspecified  	O	null
6 על על על preposition unspecified unspecified unspecified unspecified unspecified  	O	null
7 ספר ספר ספרו noun masculine singular absolute unspecified unspecified  
7 ו ו ספרו possessive masculine singular unspecified 3 unspecified 0 	O	null
8 של של של shel-preposition unspecified unspecified unspecified unspecified unspecified  	O	null
9 יגאל יגאל יגאל properName unspecified unspecified unspecified unspecified unspecified  	I_PERS	null
10 בן בן בן properName unspecified unspecified unspecified unspecified unspecified  	I_PERS	null
11 אריה אריה אריה properName unspecified unspecified unspecified unspecified unspecified  	I_PERS	null
12 ' ' ' punctuation unspecified unspecified unspecified unspecified unspecified  	O	null
13 טיפות טיפה טיפות noun feminine plural absolute unspecified unspecified  	O	null
14 של של של shel-preposition unspecified unspecified unspecified unspecified unspecified  	O	null
15 זמן זמן זמן noun masculine singular absolute unspecified unspecified  	O	null
16 ' ' ' punctuation unspecified unspecified unspecified unspecified unspecified  	O	null
17 " " " punctuation unspecified unspecified unspecified unspecified unspecified  	O	null
18 . . . punctuation unspecified unspecified unspecified unspecified unspecified  	O	null
19 הרהורים הרהור הרהורים noun masculine plural absolute unspecified unspecified  	O	null
20 על על על preposition unspecified unspecified unspecified unspecified unspecified  	O	null
21 שירה שירה שירה noun feminine singular absolute unspecified unspecified  	O	null
22 : : : punctuation unspecified unspecified unspecified unspecified unspecified  	O	null
23 בעקבות בעקבות בעקבות preposition unspecified unspecified unspecified unspecified unspecified  	O	null
24 ###NUMBER### ###NUMBER### ###NUMBER### numeral unspecified unspecified unspecified unspecified unspecified  	O	null
25 משוררים משורר משוררים noun masculine plural absolute unspecified unspecified  	O	null
26 ישראלים ישראלי ישראלים adjective masculine plural absolute unspecified unspecified  	O	null
27 . . . punctuation unspecified unspecified unspecified unspecified unspecified  	O	null

0 תל תל תל properName unspecified unspecified unspecified unspecified unspecified  	I_PERS	null
1 אביב:י' אביב:י' אביב:י' properName unspecified unspecified unspecified unspecified unspecified  	I_PERS	null
2 גולן גולן גולן properName unspecified unspecified unspecified unspecified unspecified  	I_PERS	null
3 . . . punctuation unspecified unspecified unspecified unspecified unspecified  	O	null

0 ###NUMBER### ###NUMBER### ###NUMBER### numeral unspecified unspecified unspecified unspecified unspecified  	I_DATE	null
1 . . . punctuation unspecified unspecified unspecified unspecified unspecified  	O	null

0 - - - punctuation unspecified unspecified unspecified unspecified unspecified  	O	null
1 ###NUMBER### ###NUMBER### ###NUMBER### numeral unspecified unspecified unspecified unspecified unspecified  	O	null
2 ; ; ; punctuation unspecified unspecified unspecified unspecified unspecified  	O	null
3 ###NUMBER### ###NUMBER### ###NUMBER### numeral unspecified unspecified unspecified unspecified unspecified  	O	null
4 עומר עומר עומר properName unspecified unspecified unspecified unspecified unspecified  	I_LOC	null
5 , , , punctuation unspecified unspecified unspecified unspecified unspecified  	O	null
6 דן דן דן properName unspecified unspecified unspecified unspecified unspecified  	I_PERS	null
7 . . . punctuation unspecified unspecified unspecified unspecified unspecified  	O	null

0 " " " punctuation unspecified unspecified unspecified unspecified unspecified  	O	null
1 צינה צינה צינה noun feminine singular absolute unspecified unspecified  	O	null
2 מלוטשת מלוטש מלוטשת adjective feminine singular absolute unspecified unspecified  	O	null
3 " " " punctuation unspecified unspecified unspecified unspecified unspecified  	O	null
4 . . . punctuation unspecified unspecified unspecified unspecified unspecified  	O	null

0 ה ה העולם definiteArticle unspecified unspecified unspecified unspecified unspecified 0 
0 העולם עולם העולם noun masculine singular absolute unspecified unspecified  	O	null
1 ה ה הזה definiteArticle unspecified unspecified unspecified unspecified unspecified 0 
1 הזה זה הזה pronoun masculine singular unspecified 3 unspecified  	O	null
2 . . . punctuation unspecified unspecified unspecified unspecified unspecified  	O	null

0 ###NUMEXP### ###NUMEXP### ###NUMEXP### numberExpression unspecified unspecified unspecified unspecified unspecified  	I_DATE	null
1 . . . punctuation unspecified unspecified unspecified unspecified unspecified  	O	null

0 ; ; ; punctuation unspecified unspecified unspecified unspecified unspecified  	O	null
1 ###NUMBER### ###NUMBER### ###NUMBER### numeral unspecified unspecified unspecified unspecified unspecified  	O	null
2 עפרת עפרה עפרת noun feminine singular construct unspecified unspecified  	O	null
3 , , , punctuation unspecified unspecified unspecified unspecified unspecified  	O	null
4 גדעון גדעון גדעון properName unspecified unspecified unspecified unspecified unspecified  	I_PERS	null
5 . . . punctuation unspecified unspecified unspecified unspecified unspecified  	O	null

0 " " " punctuation unspecified unspecified unspecified unspecified unspecified  	O	null
1 אמשיך המשיך אמשיך verb masculine-and-feminine singular unspecified 1 future  	O	null
2 בלעדי בלעדי בלעדי preposition unspecified unspecified unspecified unspecified unspecified  	O	null
3 " " " punctuation unspecified unspecified unspecified unspecified unspecified  	O	null
4 . . . punctuation unspecified unspecified unspecified unspecified unspecified  	O	null

0 מאזניים מאזניים מאזניים noun masculine plural absolute unspecified unspecified  	O	null
1 ע"ז ע"ז ע"ז properName unspecified unspecified unspecified unspecified unspecified  	I_PERS	null
2 ) ) ) punctuation unspecified unspecified unspecified unspecified unspecified  	O	null
3 . . . punctuation unspecified unspecified unspecified unspecified unspecified  	O	null
4 ###NUMBER### ###NUMBER### ###NUMBER### numeral unspecified unspecified unspecified unspecified unspecified  	O	null
5 ###NUMBER### ###NUMBER### ###NUMBER### numeral unspecified unspecified unspecified unspecified unspecified  	I_DATE	null
6 . . . punctuation unspecified unspecified unspecified unspecified unspecified  	O	null

0 ###NUMBER### ###NUMBER### ###NUMBER### numeral unspecified unspecified unspecified unspecified unspecified  	O	null
1 - - - punctuation unspecified unspecified unspecified unspecified unspecified  	O	null
2 ###NUMBER### ###NUMBER### ###NUMBER### numeral unspecified unspecified unspecified unspecified unspecified  	O	null
3 . . . punctuation unspecified unspecified unspecified unspecified unspecified  	O	null

