0 Name Name Name foreign unspecified unspecified unspecified unspecified unspecified  	O	null
1 : : : punctuation unspecified unspecified unspecified unspecified unspecified  	O	null
2 ב ב בֶּנְיוֹעֵץ preposition unspecified unspecified unspecified unspecified unspecified 0 
2 ֶּנְיוֹעֵץ ֶּנְיוֹעֵץ בֶּנְיוֹעֵץ noun feminine plural absolute unspecified unspecified  	O	null
3 ( ( ( punctuation unspecified unspecified unspecified unspecified unspecified  	O	null
4 קופל קופל קופל verb masculine singular unspecified 3 past  	O	null
5 ) ) ) punctuation unspecified unspecified unspecified unspecified unspecified  	O	null
6 , , , punctuation unspecified unspecified unspecified unspecified unspecified  	O	null
7 אלעזר אלעזר אלעזר properName unspecified unspecified unspecified unspecified unspecified  	I_PERS	null
8 ( ( ( punctuation unspecified unspecified unspecified unspecified unspecified  	O	null
9 פאול פאול פאול properName unspecified unspecified unspecified unspecified unspecified  	I_DATE	null
10 ) ) ) punctuation unspecified unspecified unspecified unspecified unspecified  	O	null
11 Birth Birth Birth foreign unspecified unspecified unspecified unspecified unspecified  	O	null
12 Year Year Year foreign unspecified unspecified unspecified unspecified unspecified  	O	null
13 : : : punctuation unspecified unspecified unspecified unspecified unspecified  	O	null
14 ###NUMBER### ###NUMBER### ###NUMBER### numeral unspecified unspecified unspecified unspecified unspecified  	I_DATE	null
15 Birth Birth Birth foreign unspecified unspecified unspecified unspecified unspecified  	O	null
16 Place Place Place foreign unspecified unspecified unspecified unspecified unspecified  	O	null
17 : : : punctuation unspecified unspecified unspecified unspecified unspecified  	O	null
18 ווינר וינר ווינר properName unspecified unspecified unspecified unspecified unspecified  	I_ORG	null
19 - - - punctuation unspecified unspecified unspecified unspecified unspecified  	O	null
20 נוישטדט נוישטדט נוישטדט properName unspecified unspecified unspecified unspecified unspecified  	I_ORG	null
21 ה ה הסמוכה definiteArticle unspecified unspecified unspecified unspecified unspecified 0 
21 הסמוכה סמך הסמוכה participle feminine singular absolute any unspecified  	I_ORG	null
22 ל ל לווינה preposition unspecified unspecified unspecified unspecified unspecified 0 
22 ווינה וינה לווינה properName unspecified unspecified unspecified unspecified unspecified  	I_ORG	null
23 , , , punctuation unspecified unspecified unspecified unspecified unspecified  	O	null
24 Occupation Occupation Occupation foreign unspecified unspecified unspecified unspecified unspecified  	O	null
25 : : : punctuation unspecified unspecified unspecified unspecified unspecified  	O	null
26 משורר משורר משורר noun masculine singular absolute unspecified unspecified  	O	null
27 , , , punctuation unspecified unspecified unspecified unspecified unspecified  	O	null
28 מתרגם מתרגם מתרגם noun masculine singular absolute unspecified unspecified  	O	null
29 ו ו ומסאי conjunction unspecified unspecified unspecified unspecified unspecified 0 
29 מסאי מסאי ומסאי noun masculine singular absolute unspecified unspecified  	O	null
30 Entry Entry Entry foreign unspecified unspecified unspecified unspecified unspecified  	O	null
31 writer writer writer foreign unspecified unspecified unspecified unspecified unspecified  	O	null
32 : : : punctuation unspecified unspecified unspecified unspecified unspecified  	O	null
33 אלישע אלישע אלישע properName unspecified unspecified unspecified unspecified unspecified  	I_PERS	null
34 פורת פורת פורת properName unspecified unspecified unspecified unspecified unspecified  	I_PERS	null
35 Entry Entry Entry foreign unspecified unspecified unspecified unspecified unspecified  	O	null
36 Value Value Value foreign unspecified unspecified unspecified unspecified unspecified  	O	null
37 : : : punctuation unspecified unspecified unspecified unspecified unspecified  	O	null
38 נולד נולד נולד verb masculine singular unspecified 3 past  	O	null
39 ב ב בווינר preposition unspecified unspecified unspecified unspecified unspecified 0 
39 ווינר וינר בווינר properName unspecified unspecified unspecified unspecified unspecified  	I_LOC	null
40 - - - punctuation unspecified unspecified unspecified unspecified unspecified  	O	null
41 נוישטדט נוישטדט נוישטדט properName unspecified unspecified unspecified unspecified unspecified  	I_ORG	null
42 ה ה הסמוכה definiteArticle unspecified unspecified unspecified unspecified unspecified 0 
42 הסמוכה סמך הסמוכה participle feminine singular absolute any unspecified  	I_ORG	null
43 ל ל לווינה preposition unspecified unspecified unspecified unspecified unspecified 0 
43 ווינה וינה לווינה properName unspecified unspecified unspecified unspecified unspecified  	I_LOC	null
44 , , , punctuation unspecified unspecified unspecified unspecified unspecified  	O	null
45 אוסטריה אוסטריה אוסטריה properName unspecified unspecified unspecified unspecified unspecified  	I_LOC	null
46 . . . punctuation unspecified unspecified unspecified unspecified unspecified  	O	null

0 לאחר לאחר לאחר conjunction unspecified unspecified unspecified unspecified unspecified  	O	null
1 האנשלוס האנשלוס האנשלוס properName unspecified unspecified unspecified unspecified unspecified  	I_PERS	null
2 ( ( ( punctuation unspecified unspecified unspecified unspecified unspecified  	O	null
3 סיפוח סיפוח סיפוח noun masculine singular construct unspecified unspecified  	O	null
4 אוסטריה אוסטריה אוסטריה properName unspecified unspecified unspecified unspecified unspecified  	I_LOC	null
5 ל ל לגרמניה preposition unspecified unspecified unspecified unspecified unspecified 0 
5 גרמניה גרמניה לגרמניה properName unspecified unspecified unspecified unspecified unspecified  	I_LOC	null
6 ) ) ) punctuation unspecified unspecified unspecified unspecified unspecified  	O	null
7 עלתה עלה עלתה verb feminine singular unspecified 3 past  	O	null
8 משפחת משפחה משפחתו noun feminine singular absolute unspecified unspecified  
8 ו ו משפחתו possessive masculine singular unspecified 3 unspecified 0 	O	null
9 ארצה ארצה ארצה adverb unspecified unspecified unspecified unspecified unspecified  	I_LOC	null
10 , , , punctuation unspecified unspecified unspecified unspecified unspecified  	O	null
11 ו ו וב conjunction unspecified unspecified unspecified unspecified unspecified 0 
11 ב ב וב preposition unspecified unspecified unspecified unspecified unspecified 0 	I_ORG	null
12 - - - punctuation unspecified unspecified unspecified unspecified unspecified  	I_ORG	null
13 ###NUMBER### ###NUMBER### ###NUMBER### numeral unspecified unspecified unspecified unspecified unspecified  	I_DATE	null
14 התיישבה התיישב התיישבה verb feminine singular unspecified 3 past  	O	null
15 ב ב בירושלים preposition unspecified unspecified unspecified unspecified unspecified 0 
15 ירושלים ירושלים בירושלים properName unspecified unspecified unspecified unspecified unspecified  	I_LOC	null
16 . . . punctuation unspecified unspecified unspecified unspecified unspecified  	O	null

0 למד למד למד verb masculine singular unspecified 3 past  	O	null
1 ב ב בבתי preposition unspecified unspecified unspecified unspecified unspecified 0 
1 בתי בית בבתי noun masculine plural construct unspecified unspecified  	O	null
2 חינוך חינוך חינוך noun masculine singular absolute unspecified unspecified  	O	null
3 ב ב בתלאביב preposition unspecified unspecified unspecified unspecified unspecified 0 
3 תלאביב תלאביב בתלאביב noun masculine singular absolute unspecified unspecified  	O	null
4 , , , punctuation unspecified unspecified unspecified unspecified unspecified  	O	null
5 ב ב בכפראתא preposition unspecified unspecified unspecified unspecified unspecified 0 
5 כ כ בכפראתא adverb unspecified unspecified unspecified unspecified unspecified 0 
5 פראת פראת בכפראתא noun masculine singular absolute unspecified unspecified  
5 י י בכפראתא possessive masculine-and-feminine singular unspecified 1 unspecified 0 	O	null
6 ו ו ובישיבת conjunction unspecified unspecified unspecified unspecified unspecified 0 
6 ב ב ובישיבת preposition unspecified unspecified unspecified unspecified unspecified 0 
6 ישיבת ישיבה ובישיבת noun feminine singular construct unspecified unspecified  	O	null
7 כפר כפר כפר noun masculine singular construct unspecified unspecified  	O	null
8 ה ה הרוא"ה definiteArticle unspecified unspecified unspecified unspecified unspecified 0 
8 הרוא"ה הרוא"ה הרוא"ה properName unspecified unspecified unspecified unspecified unspecified  	I_LOC	null
9 . . . punctuation unspecified unspecified unspecified unspecified unspecified  	O	null

0 לאחר לאחר לאחר preposition unspecified unspecified unspecified unspecified unspecified  	O	null
1 שירות שירות שירותו noun masculine singular absolute unspecified unspecified  
1 ו ו שירותו possessive masculine singular unspecified 3 unspecified 0 	O	null
2 ה ה הצבאי definiteArticle unspecified unspecified unspecified unspecified unspecified 0 
2 הצבאי צבאי הצבאי adjective masculine singular absolute unspecified unspecified  	O	null
3 החל החל החל verb masculine singular unspecified 3 past  	O	null
4 ללמוד למד ללמוד verb unspecified unspecified unspecified unspecified infinitive  	O	null
5 ל ל להסמכה preposition unspecified unspecified unspecified unspecified unspecified 0 
5 הסמכה הסמכה להסמכה noun feminine singular absolute unspecified unspecified  	O	null
6 ל ל לרבנות preposition unspecified unspecified unspecified unspecified unspecified 0 
6 ה ה לרבנות definiteArticle unspecified unspecified unspecified unspecified unspecified 0 
6 הרבנות רבנות לרבנות noun feminine singular absolute unspecified unspecified  	O	null
7 ו ו ובמקביל conjunction unspecified unspecified unspecified unspecified unspecified 0 
7 במקביל במקביל ובמקביל adverb unspecified unspecified unspecified unspecified unspecified  	O	null
8 השלים השלים השלים verb masculine singular unspecified 3 past  	O	null
9 את את את at-preposition unspecified unspecified unspecified unspecified unspecified  	O	null
10 לימודי לימוד לימודיו noun masculine plural absolute unspecified unspecified  
10 ו ו לימודיו possessive masculine singular unspecified 3 unspecified 0 	O	null
11 ב ב באוניברסיטה preposition unspecified unspecified unspecified unspecified unspecified 0 
11 ה ה באוניברסיטה definiteArticle unspecified unspecified unspecified unspecified unspecified 0 
11 האוניברסיטה אוניברסיטה באוניברסיטה noun feminine singular absolute unspecified unspecified  	O	null
12 ה ה העברית definiteArticle unspecified unspecified unspecified unspecified unspecified 0 
12 העברית עברי העברית adjective feminine singular absolute unspecified unspecified  	O	null
13 ב ב בירושלים preposition unspecified unspecified unspecified unspecified unspecified 0 
13 ירושלים ירושלים בירושלים properName unspecified unspecified unspecified unspecified unspecified  	I_LOC	null
14 ב ב בספרות preposition unspecified unspecified unspecified unspecified unspecified 0 
14 ה ה בספרות definiteArticle unspecified unspecified unspecified unspecified unspecified 0 
14 הספרות ספרות בספרות noun feminine singular absolute unspecified unspecified  	O	null
15 ו ו ובחינוך conjunction unspecified unspecified unspecified unspecified unspecified 0 
15 ב ב ובחינוך preposition unspecified unspecified unspecified unspecified unspecified 0 
15 ה ה ובחינוך definiteArticle unspecified unspecified unspecified unspecified unspecified 0 
15 החינוך חינוך ובחינוך noun masculine singular absolute unspecified unspecified  	O	null
16 . . . punctuation unspecified unspecified unspecified unspecified unspecified  	O	null

0 עם עם עם preposition unspecified unspecified unspecified unspecified unspecified  	O	null
1 תום תום תום noun masculine singular construct unspecified unspecified  	O	null
2 לימודי לימוד לימודיו noun masculine plural absolute unspecified unspecified  
2 ו ו לימודיו possessive masculine singular unspecified 3 unspecified 0 	O	null
3 עבד עבד עבד verb masculine singular unspecified 3 past  	O	null
4 כ כ כספרן preposition unspecified unspecified unspecified unspecified unspecified 0 
4 ספרן ספרן כספרן noun masculine singular absolute unspecified unspecified  	O	null
5 , , , punctuation unspecified unspecified unspecified unspecified unspecified  	O	null
6 כארכיונאי כארכיונאי כארכיונאי participle masculine plural construct any unspecified  	O	null
7 ו ו וכגנז conjunction unspecified unspecified unspecified unspecified unspecified 0 
7 כגנז כגנז וכגנז noun feminine singular absolute unspecified unspecified  	O	null
8 ב ב במוסד preposition unspecified unspecified unspecified unspecified unspecified 0 
8 מוסד מוסד במוסד noun masculine singular construct unspecified unspecified  	O	null
9 ה ה הרב definiteArticle unspecified unspecified unspecified unspecified unspecified 0 
9 הרב רב הרב noun masculine singular absolute unspecified unspecified  	O	null
10 קוק קוק קוק properName unspecified unspecified unspecified unspecified unspecified  	I_PERS	null
11 , , , punctuation unspecified unspecified unspecified unspecified unspecified  	O	null
12 ו ו ומ conjunction unspecified unspecified unspecified unspecified unspecified 0 
12 מ מ ומ preposition unspecified unspecified unspecified unspecified unspecified 0 	O	null
13 - - - punctuation unspecified unspecified unspecified unspecified unspecified  	O	null
14 ###NUMBER### ###NUMBER### ###NUMBER### numeral unspecified unspecified unspecified unspecified unspecified  	I_DATE	null
15 ב ב במכון preposition unspecified unspecified unspecified unspecified unspecified 0 
15 ה ה במכון definiteArticle unspecified unspecified unspecified unspecified unspecified 0 
15 המכון מיכון במכון noun masculine singular absolute unspecified unspecified  	O	null
16 " " " punctuation unspecified unspecified unspecified unspecified unspecified  	O	null
17 גנזים גנזים גנזים noun masculine plural absolute unspecified unspecified  	O	null
18 " " " punctuation unspecified unspecified unspecified unspecified unspecified  	O	null
19 של של של shel-preposition unspecified unspecified unspecified unspecified unspecified  	O	null
20 אגודת אגודה אגודת noun feminine singular construct unspecified unspecified  	O	null
21 ה ה הסופרים definiteArticle unspecified unspecified unspecified unspecified unspecified 0 
21 הסופרים סופר הסופרים noun masculine plural absolute unspecified unspecified  	O	null
22 . . . punctuation unspecified unspecified unspecified unspecified unspecified  	O	null

0 נשוי נשוי נשוי adjective masculine singular absolute unspecified unspecified  	O	null
1 ל ל לציירת preposition unspecified unspecified unspecified unspecified unspecified 0 
1 ציירת צייר לציירת noun feminine singular construct unspecified unspecified  	O	null
2 רנה רנה רנה properName unspecified unspecified unspecified unspecified unspecified  	I_PERS	null
3 קופל קופל קופל verb masculine singular unspecified 3 past  	O	null
4 ה ה הידועה definiteArticle unspecified unspecified unspecified unspecified unspecified 0 
4 הידועה ידע הידועה participle feminine singular absolute any unspecified  	O	null
5 ב ב בשמה preposition unspecified unspecified unspecified unspecified unspecified 0 
5 שם שם בשמה noun masculine singular absolute unspecified unspecified  
5 ה ה בשמה possessive feminine singular unspecified 3 unspecified 0 	O	null
6 ה ה האמנותי definiteArticle unspecified unspecified unspecified unspecified unspecified 0 
6 האמנותי אמנותי האמנותי adjective masculine singular absolute unspecified unspecified  	O	null
7 " " " punctuation unspecified unspecified unspecified unspecified unspecified  	O	null
8 מיטבאל מיטבאל מיטבאל properName unspecified unspecified unspecified unspecified unspecified  	I_ORG	null
9 ״ ״ ״ punctuation unspecified unspecified unspecified unspecified unspecified  	O	null
10 . . . punctuation unspecified unspecified unspecified unspecified unspecified  	O	null

0 ספר ספר ספרו noun masculine singular absolute unspecified unspecified  
0 ו ו ספרו possessive masculine singular unspecified 3 unspecified 0 	O	null
1 ה ה הראשון definiteArticle unspecified unspecified unspecified unspecified unspecified 0 
1 הראשון ORD1 הראשון numeral masculine singular absolute unspecified unspecified  	O	null
2 , , , punctuation unspecified unspecified unspecified unspecified unspecified  	O	null
3 בין בין ביני preposition unspecified unspecified unspecified unspecified unspecified  
3 י י ביני pronomial masculine-and-feminine singular unspecified 1 unspecified 0 	O	null
4 לבין לבין לבין preposition unspecified unspecified unspecified unspecified unspecified  	O	null
5 עצמו עצמו עצמי pronoun unspecified unspecified unspecified unspecified unspecified  
5 י י עצמי pronomial masculine-and-feminine singular unspecified 1 unspecified 0 	O	null
6 : : : punctuation unspecified unspecified unspecified unspecified unspecified  	O	null
7 שירים שיר שירים noun masculine plural absolute unspecified unspecified  	O	null
8 , , , punctuation unspecified unspecified unspecified unspecified unspecified  	O	null
9 יצא יצא יצא verb masculine singular unspecified 3 past  	O	null
10 לאור לאור לאור preposition unspecified unspecified unspecified unspecified unspecified  	O	null
11 עוד עוד עוד adverb unspecified unspecified unspecified unspecified unspecified  	O	null
12 ב ב בעת preposition unspecified unspecified unspecified unspecified unspecified 0 
12 עת עת בעת noun feminine singular construct unspecified unspecified  	O	null
13 שירות שירות שירותו noun masculine singular absolute unspecified unspecified  
13 ו ו שירותו possessive masculine singular unspecified 3 unspecified 0 	O	null
14 ה ה הצבאי definiteArticle unspecified unspecified unspecified unspecified unspecified 0 
14 הצבאי צבאי הצבאי adjective masculine singular absolute unspecified unspecified  	O	null
15 ( ( ( punctuation unspecified unspecified unspecified unspecified unspecified  	O	null
16 מ' מ' מ' noun masculine singular absolute unspecified unspecified  	O	null
17 ניומן ניומן ניומן properName unspecified unspecified unspecified unspecified unspecified  	I_PERS	null
18 , , , punctuation unspecified unspecified unspecified unspecified unspecified  	O	null
19 ###NUMBER### ###NUMBER### ###NUMBER### numeral unspecified unspecified unspecified unspecified unspecified  	I_DATE	null
20 ) ) ) punctuation unspecified unspecified unspecified unspecified unspecified  	O	null
21 . . . punctuation unspecified unspecified unspecified unspecified unspecified  	O	null

0 בדבבד בדבבד בדבבד properName unspecified unspecified unspecified unspecified unspecified  	I_PERS	null
1 החל החל החל verb masculine singular unspecified 3 past  	O	null
2 לתר תרגם לתרגם verb unspecified unspecified unspecified unspecified infinitive  
2 גם גם לתרגם accusative-or-nominative feminine plural unspecified 1 unspecified 0 	O	null
3 מ מ משירת preposition unspecified unspecified unspecified unspecified unspecified 0 
3 שירת שירה משירת noun feminine singular construct unspecified unspecified  	O	null
4 גרמניה גרמני גרמניה properName unspecified unspecified unspecified unspecified unspecified  	I_LOC	null
5 ו ו ואף conjunction unspecified unspecified unspecified unspecified unspecified 0 
5 אף אף ואף conjunction unspecified unspecified unspecified unspecified unspecified  	O	null
6 לכתוב כתב לכתוב verb unspecified unspecified unspecified unspecified infinitive  	O	null
7 ו ו ולפרסם conjunction unspecified unspecified unspecified unspecified unspecified 0 
7 לפרסם פרסם ולפרסם verb unspecified unspecified unspecified unspecified infinitive  	O	null
8 מ מ משיריו preposition unspecified unspecified unspecified unspecified unspecified 0 
8 שירי שיר משיריו noun masculine plural absolute unspecified unspecified  
8 ו ו משיריו possessive masculine singular unspecified 3 unspecified 0 	O	null
9 ב ב בגרמנית preposition unspecified unspecified unspecified unspecified unspecified 0 
9 גרמנית גרמנית בגרמנית properName feminine singular unspecified unspecified unspecified  	I_LOC	null
10 . . . punctuation unspecified unspecified unspecified unspecified unspecified  	O	null

0 ב ב בשנים preposition unspecified unspecified unspecified unspecified unspecified 0 
0 שנים שנה בשנים noun feminine plural absolute unspecified unspecified  	O	null
1 ###NUMBER### ###NUMBER### ###NUMBER### numeral unspecified unspecified unspecified unspecified unspecified  	I_DATE	null
2 - - - punctuation unspecified unspecified unspecified unspecified unspecified  	O	null
3 ###NUMBER### ###NUMBER### ###NUMBER### numeral unspecified unspecified unspecified unspecified unspecified  	I_DATE	null
4 שהה שהה שהה verb masculine singular unspecified 3 past  	O	null
5 ב ב בברלין preposition unspecified unspecified unspecified unspecified unspecified 0 
5 ברלין ברלין בברלין properName unspecified unspecified unspecified unspecified unspecified  	I_LOC	null
6 , , , punctuation unspecified unspecified unspecified unspecified unspecified  	O	null
7 ו ו ובעזרת conjunction unspecified unspecified unspecified unspecified unspecified 0 
7 בעזרת בעזרת ובעזרת preposition unspecified unspecified unspecified unspecified unspecified  	O	null
8 מלגה מלגה מלגה noun feminine singular absolute unspecified unspecified  	O	null
9 מ מ מקרן preposition unspecified unspecified unspecified unspecified unspecified 0 
9 קרן קרן מקרן noun feminine singular construct unspecified unspecified  	O	null
10 " " " punctuation unspecified unspecified unspecified unspecified unspecified  	I_ORG	null
11 פורד פורד פורד properName unspecified unspecified unspecified unspecified unspecified  	I_ORG	null
12 " " " punctuation unspecified unspecified unspecified unspecified unspecified  	O	null
13 ייסד ייסד ייסד verb masculine singular unspecified 3 past  	O	null
14 ב ב בעיר preposition unspecified unspecified unspecified unspecified unspecified 0 
14 ה ה בעיר definiteArticle unspecified unspecified unspecified unspecified unspecified 0 
14 העיר עיר בעיר noun feminine singular absolute unspecified unspecified  	O	null
15 את את את at-preposition unspecified unspecified unspecified unspecified unspecified  	O	null
16 ה ה המכון definiteArticle unspecified unspecified unspecified unspecified unspecified 0 
16 המכון מיכון המכון noun masculine singular absolute unspecified unspecified  	O	null
17 ה ה הביבליוגרפי definiteArticle unspecified unspecified unspecified unspecified unspecified 0 
17 הביבליוגרפי ביבליוגראפי הביבליוגרפי adjective masculine singular absolute unspecified unspecified  	O	null
18 ה ה היהודי definiteArticle unspecified unspecified unspecified unspecified unspecified 0 
18 היהודי יהודי היהודי adjective masculine singular absolute unspecified unspecified  	O	null
19 - - - punctuation unspecified unspecified unspecified unspecified unspecified  	O	null
20 גרמני גרמני גרמני adjective masculine singular absolute unspecified unspecified  	O	null
21 " " " punctuation unspecified unspecified unspecified unspecified unspecified  	O	null
22 ביבליוגרפיה ביבליוגרפיה ביבליוגרפיה noun feminine singular absolute unspecified unspecified  	O	null
23 יודאיקה יודאיקה יודאיקה properName unspecified unspecified unspecified unspecified unspecified  	I_PERS	null
24 ״ ״ ״ punctuation unspecified unspecified unspecified unspecified unspecified  	O	null
25 , , , punctuation unspecified unspecified unspecified unspecified unspecified  	O	null
26 ש ש שרשם relativizer/subordinatingConjunction unspecified unspecified unspecified unspecified unspecified 0 
26 רשם רשם שרשם verb masculine singular unspecified 3 past  	O	null
27 פרסומים פרסום פרסומים noun masculine plural absolute unspecified unspecified  	O	null
28 יהודיים יהודי יהודיים adjective masculine plural absolute unspecified unspecified  	O	null
29 - - - punctuation unspecified unspecified unspecified unspecified unspecified  	O	null
30 גרמניים גרמני גרמניים adjective masculine plural absolute unspecified unspecified  	O	null
31 ב ב בגרמנית preposition unspecified unspecified unspecified unspecified unspecified 0 
31 גרמנית גרמנית בגרמנית properName feminine singular unspecified unspecified unspecified  	O	null
32 מ מ מהמאה preposition unspecified unspecified unspecified unspecified unspecified 0 
32 ה ה מהמאה definiteArticle unspecified unspecified unspecified unspecified unspecified 0 
32 המאה ORD-CARD100 מהמאה numeral feminine plural absolute unspecified unspecified  	O	null
33 ה ה השמונה definiteArticle unspecified unspecified unspecified unspecified unspecified 0 
33 השמונה CARD8 השמונה numeral feminine plural absolute unspecified unspecified  	O	null
34 - - - punctuation unspecified unspecified unspecified unspecified unspecified  	O	null
35 עשרהעד עשרהעד עשרהעד verb feminine singular unspecified any beinoni  	O	null
36 מלחמת מלחמה מלחמת noun feminine singular construct unspecified unspecified  	O	null
37 ה ה העולם definiteArticle unspecified unspecified unspecified unspecified unspecified 0 
37 העולם עולם העולם noun masculine singular absolute unspecified unspecified  	O	null
38 ה ה השנייה definiteArticle unspecified unspecified unspecified unspecified unspecified 0 
38 השנייה ORD2 השנייה numeral feminine singular absolute unspecified unspecified  	O	null
39 . . . punctuation unspecified unspecified unspecified unspecified unspecified  	O	null

0 כמו כמו כמו conjunction unspecified unspecified unspecified unspecified unspecified  	O	null
1 כן כן כן conjunction unspecified unspecified unspecified unspecified unspecified  	O	null
2 כתב כתב כתב verb masculine singular unspecified 3 past  	O	null
3 על על על preposition unspecified unspecified unspecified unspecified unspecified  	O	null
4 סופרים סופר סופרים noun masculine plural absolute unspecified unspecified  	O	null
5 יהודים יהודי יהודים adjective masculine plural absolute unspecified unspecified  	O	null
6 ש ש שכתבו relativizer/subordinatingConjunction unspecified unspecified unspecified unspecified unspecified 0 
6 כתבו כתב שכתבו verb masculine-and-feminine plural unspecified 3 past  	O	null
7 ב ב בגרמנית preposition unspecified unspecified unspecified unspecified unspecified 0 
7 גרמנית גרמנית בגרמנית properName feminine singular unspecified unspecified unspecified  	I_PERS	null
8 : : : punctuation unspecified unspecified unspecified unspecified unspecified  	O	null
9 יוזף יוזף יוזף properName unspecified unspecified unspecified unspecified unspecified  	I_PERS	null
10 רות רות רות properName unspecified unspecified unspecified unspecified unspecified  	I_PERS	null
11 , , , punctuation unspecified unspecified unspecified unspecified unspecified  	O	null
12 פרנץ פרנץ פרנץ properName unspecified unspecified unspecified unspecified unspecified  	I_PERS	null
13 רוזנצווייג רוזנצווייג רוזנצווייג properName unspecified unspecified unspecified unspecified unspecified  	I_PERS	null
14 , , , punctuation unspecified unspecified unspecified unspecified unspecified  	O	null
15 מקס מקס מקס properName unspecified unspecified unspecified unspecified unspecified  	I_PERS	null
16 ברוד ברוד ברוד properName unspecified unspecified unspecified unspecified unspecified  	I_PERS	null
17 ו ו ואחרים conjunction unspecified unspecified unspecified unspecified unspecified 0 
17 אחרים אחר ואחרים adjective masculine plural absolute unspecified unspecified  	O	null
18 . . . punctuation unspecified unspecified unspecified unspecified unspecified  	O	null

0 ב ב בשנות preposition unspecified unspecified unspecified unspecified unspecified 0 
0 שנות שנה בשנות noun feminine plural construct unspecified unspecified  	O	null
1 ה ה השבעים definiteArticle unspecified unspecified unspecified unspecified unspecified 0 
1 השבעים ORD-CARD70 השבעים numeral masculine-and-feminine plural absolute unspecified unspecified  	O	null
2 פירסם פרסם פירסם verb masculine singular unspecified 3 past  	O	null
3 כמה כמה כמה quantifier unspecified unspecified construct unspecified unspecified  	O	null
4 מאמרים מאמר מאמרים noun masculine plural absolute unspecified unspecified  	O	null
5 על על על preposition unspecified unspecified unspecified unspecified unspecified  	O	null
6 ה ה היוצרים definiteArticle unspecified unspecified unspecified unspecified unspecified 0 
6 היוצרים יוצר היוצרים noun masculine plural absolute unspecified unspecified  	O	null
7 ה ה היהודים definiteArticle unspecified unspecified unspecified unspecified unspecified 0 
7 היהודים יהודי היהודים adjective masculine plural absolute unspecified unspecified  	O	null
8 ה ה הגרמנים definiteArticle unspecified unspecified unspecified unspecified unspecified 0 
8 הגרמנים גרמני הגרמנים adjective masculine plural absolute unspecified unspecified  	O	null
9 , , , punctuation unspecified unspecified unspecified unspecified unspecified  	O	null
10 ו ו וגם conjunction unspecified unspecified unspecified unspecified unspecified 0 
10 גם גם וגם conjunction unspecified unspecified unspecified unspecified unspecified  	O	null
11 ב ב בנושאי preposition unspecified unspecified unspecified unspecified unspecified 0 
11 נושאי נושא בנושאי noun masculine plural construct unspecified unspecified  	O	null
12 תנ"ך תנ"ך תנ"ך noun masculine singular absolute unspecified unspecified  	O	null
13 ו ו ומסורת conjunction unspecified unspecified unspecified unspecified unspecified 0 
13 מסורת מסורת ומסורת noun feminine singular absolute unspecified unspecified  	O	null
14 , , , punctuation unspecified unspecified unspecified unspecified unspecified  	O	null
15 ב ב בכתבי preposition unspecified unspecified unspecified unspecified unspecified 0 
15 כתבי כתב בכתבי noun masculine plural construct unspecified unspecified  	O	null
16 עת עת עת noun feminine singular absolute unspecified unspecified  	O	null
17 שונים שונה שונים adjective masculine plural absolute unspecified unspecified  	O	null
18 , , , punctuation unspecified unspecified unspecified unspecified unspecified  	O	null
19 ו ו ובהם conjunction unspecified unspecified unspecified unspecified unspecified 0 
19 ב ב ובהם preposition unspecified unspecified unspecified unspecified unspecified  
19 הם הם ובהם pronomial masculine plural unspecified 3 unspecified 0 	O	null
20 מולד מולד מולד adjective masculine singular absolute unspecified unspecified  	O	null
21 ו ו והאומה conjunction unspecified unspecified unspecified unspecified unspecified 0 
21 ה ה והאומה definiteArticle unspecified unspecified unspecified unspecified unspecified 0 
21 האומה אומה והאומה noun feminine singular absolute unspecified unspecified  	O	null
22 . . . punctuation unspecified unspecified unspecified unspecified unspecified  	O	null

0 מאז מאז מאז adverb unspecified unspecified unspecified unspecified unspecified  	O	null
1 ###NUMBER### ###NUMBER### ###NUMBER### numeral unspecified unspecified unspecified unspecified unspecified  	I_DATE	null
2 עיקר עיקר עיקר noun masculine singular construct unspecified unspecified  	O	null
3 כתיבת כתיבה כתיבתו noun feminine singular absolute unspecified unspecified  
3 ו ו כתיבתו possessive masculine singular unspecified 3 unspecified 0 	O	null
4 ב ב בגרמנית preposition unspecified unspecified unspecified unspecified unspecified 0 
4 גרמנית גרמנית בגרמנית properName feminine singular unspecified unspecified unspecified  	I_LOC	null
5 , , , punctuation unspecified unspecified unspecified unspecified unspecified  	O	null
6 ו ו והיא conjunction unspecified unspecified unspecified unspecified unspecified 0 
6 היא הוא והיא pronoun feminine singular unspecified 3 unspecified  	O	null
7 זיכתה זיכה זיכתה verb feminine singular unspecified 3 past  	O	null
8 את את אותו at-preposition unspecified unspecified unspecified unspecified unspecified  
8 ו ו אותו pronomial masculine singular unspecified 3 unspecified 0 	O	null
9 ב ב בגרמניה preposition unspecified unspecified unspecified unspecified unspecified 0 
9 גרמניה גרמני בגרמניה properName unspecified unspecified unspecified unspecified unspecified  	I_LOC	null
10 ב ב בפרסים preposition unspecified unspecified unspecified unspecified unspecified 0 
10 פרסים פרס בפרסים noun masculine plural absolute unspecified unspecified  	O	null
11 ספרותיים ספרותי ספרותיים adjective masculine plural absolute unspecified unspecified  	O	null
12 : : : punctuation unspecified unspecified unspecified unspecified unspecified  	O	null
13 ה ה הפרס definiteArticle unspecified unspecified unspecified unspecified unspecified 0 
13 הפרס פרס הפרס noun masculine singular absolute unspecified unspecified  	O	null
14 על על על preposition unspecified unspecified unspecified unspecified unspecified  	O	null
15 שם שם שם adverb unspecified unspecified unspecified unspecified unspecified  	O	null
16 אדלברט אדלברט אדלברט properName unspecified unspecified unspecified unspecified unspecified  	I_PERS	null
17 פון פון פון properName unspecified unspecified unspecified unspecified unspecified  	I_PERS	null
18 שאמיסו שאמיסו שאמיסו properName unspecified unspecified unspecified unspecified unspecified  	I_PERS	null
19 מטעם מטעם מטעם preposition unspecified unspecified unspecified unspecified unspecified  	O	null
20 ה ה האקדמיה definiteArticle unspecified unspecified unspecified unspecified unspecified 0 
20 האקדמיה אקדמיה האקדמיה noun feminine singular absolute unspecified unspecified  	O	null
21 ה ה הבווארית definiteArticle unspecified unspecified unspecified unspecified unspecified 0 
21 הבווארית הבווארית הבווארית adjective feminine singular absolute unspecified unspecified  	O	null
22 ל ל לאמנויות preposition unspecified unspecified unspecified unspecified unspecified 0 
22 ה ה לאמנויות definiteArticle unspecified unspecified unspecified unspecified unspecified 0 
22 האמנויות אמנות לאמנויות noun feminine plural absolute unspecified unspecified  	O	null
23 ה ה היפות definiteArticle unspecified unspecified unspecified unspecified unspecified 0 
23 היפות יפה היפות adjective feminine plural absolute unspecified unspecified  	O	null
24 ) ) ) punctuation unspecified unspecified unspecified unspecified unspecified  	O	null
25 ; ; ; punctuation unspecified unspecified unspecified unspecified unspecified  	I_MONEY	null
26 ###NUMBER### ###NUMBER### ###NUMBER### numeral unspecified unspecified unspecified unspecified unspecified  	I_DATE	null
27 פרס פרס פרס noun masculine singular absolute unspecified unspecified  	I_MONEY	null
28 מטעם מטעם מטעם preposition unspecified unspecified unspecified unspecified unspecified  	O	null
29 ה ה הממשלה definiteArticle unspecified unspecified unspecified unspecified unspecified 0 
29 הממשלה ממשלה הממשלה noun feminine singular absolute unspecified unspecified  	O	null
30 ה ה הפדרלית definiteArticle unspecified unspecified unspecified unspecified unspecified 0 
30 הפדרלית פדרלי הפדרלית adjective feminine singular absolute unspecified unspecified  	O	null
31 ה ה הגרמנית definiteArticle unspecified unspecified unspecified unspecified unspecified 0 
31 הגרמנית גרמני הגרמנית adjective feminine singular absolute unspecified unspecified  	O	null
32 ) ) ) punctuation unspecified unspecified unspecified unspecified unspecified  	O	null
33 ; ; ; punctuation unspecified unspecified unspecified unspecified unspecified  	O	null
34 ###NUMBER### ###NUMBER### ###NUMBER### numeral unspecified unspecified unspecified unspecified unspecified  	I_DATE	null
35 ו ו ופרס conjunction unspecified unspecified unspecified unspecified unspecified 0 
35 פרס פרס ופרס properName unspecified unspecified unspecified unspecified unspecified  	I_PERS	null
36 יוסף יוסף יוסף properName unspecified unspecified unspecified unspecified unspecified  	I_PERS	null
37 ברייטבאך ברייטבאך ברייטבאך properName unspecified unspecified unspecified unspecified unspecified  	I_PERS	null
38 של של של shel-preposition unspecified unspecified unspecified unspecified unspecified  	O	null
39 ה ה האקדמיה definiteArticle unspecified unspecified unspecified unspecified unspecified 0 
39 האקדמיה אקדמיה האקדמיה noun feminine singular absolute unspecified unspecified  	O	null
40 ל ל למדעים preposition unspecified unspecified unspecified unspecified unspecified 0 
40 ה ה למדעים definiteArticle unspecified unspecified unspecified unspecified unspecified 0 
40 המדעים מדע למדעים noun masculine plural absolute unspecified unspecified  	O	null
41 ו ו ולספרות conjunction unspecified unspecified unspecified unspecified unspecified 0 
41 ל ל ולספרות preposition unspecified unspecified unspecified unspecified unspecified 0 
41 ה ה ולספרות definiteArticle unspecified unspecified unspecified unspecified unspecified 0 
41 הספרות ספרות ולספרות noun feminine singular absolute unspecified unspecified  	O	null
42 ה ה הגרמנית definiteArticle unspecified unspecified unspecified unspecified unspecified 0 
42 הגרמנית גרמני הגרמנית adjective feminine singular absolute unspecified unspecified  	O	null
43 ) ) ) punctuation unspecified unspecified unspecified unspecified unspecified  	O	null
44 . . . punctuation unspecified unspecified unspecified unspecified unspecified  	O	null
45 ###NUMBER### ###NUMBER### ###NUMBER### numeral unspecified unspecified unspecified unspecified unspecified  	I_DATE	null
46 ב ב ב preposition unspecified unspecified unspecified unspecified unspecified 0 	O	null
47 - - - punctuation unspecified unspecified unspecified unspecified unspecified  	O	null
48 ###NUMBER### ###NUMBER### ###NUMBER### numeral unspecified unspecified unspecified unspecified unspecified  	I_DATE	null
49 התמנה התמנה התמנה verb masculine singular unspecified 3 past  	O	null
50 ל ל לחבר preposition unspecified unspecified unspecified unspecified unspecified 0 
50 חבר חבר לחבר noun masculine singular construct unspecified unspecified  	O	null
51 ה ה האקדמיה definiteArticle unspecified unspecified unspecified unspecified unspecified 0 
51 האקדמיה אקדמיה האקדמיה noun feminine singular absolute unspecified unspecified  	O	null
52 ל ל לספרות preposition unspecified unspecified unspecified unspecified unspecified 0 
52 ה ה לספרות definiteArticle unspecified unspecified unspecified unspecified unspecified 0 
52 הספרות ספרות לספרות noun feminine singular absolute unspecified unspecified  	O	null
53 ו ו ולשון conjunction unspecified unspecified unspecified unspecified unspecified 0 
53 לשון לשון ולשון noun feminine singular construct unspecified unspecified  	O	null
54 גרמנית גרמני גרמנית adjective feminine singular absolute unspecified unspecified  	O	null
55 . . . punctuation unspecified unspecified unspecified unspecified unspecified  	O	null

0 ב ב בשנות preposition unspecified unspecified unspecified unspecified unspecified 0 
0 שנות שנה בשנות noun feminine plural construct unspecified unspecified  	O	null
1 ה ה השבעים definiteArticle unspecified unspecified unspecified unspecified unspecified 0 
1 השבעים ORD-CARD70 השבעים numeral masculine-and-feminine plural absolute unspecified unspecified  	O	null
2 חל חל חל verb masculine singular unspecified 3 past  	O	null
3 שינוי שינוי שינוי noun masculine singular absolute unspecified unspecified  	O	null
4 ב ב בז'אנר preposition unspecified unspecified unspecified unspecified unspecified 0 
4 ז'אנר ז'אנר בז'אנר noun masculine singular construct unspecified unspecified  	O	null
5 כתיבת כתיבה כתיבתו noun feminine singular absolute unspecified unspecified  
5 ו ו כתיבתו possessive masculine singular unspecified 3 unspecified 0 	O	null
6 ו ו והוא conjunction unspecified unspecified unspecified unspecified unspecified 0 
6 הוא הוא והוא pronoun masculine singular unspecified 3 unspecified  	O	null
7 התמסר התמסר התמסר verb masculine singular unspecified 3 past  	O	null
8 ל ל לכתיבת preposition unspecified unspecified unspecified unspecified unspecified 0 
8 כתיבת כתיבה לכתיבת noun feminine singular construct unspecified unspecified  	O	null
9 אפוריזמים אפוריזמים אפוריזמים verb feminine singular unspecified 2 imperative  	O	null
10 קצרים קצר קצרים adjective masculine plural absolute unspecified unspecified  	O	null
11 , , , punctuation unspecified unspecified unspecified unspecified unspecified  	O	null
12 הן הן הן conjunction unspecified unspecified unspecified unspecified unspecified  	O	null
13 ב ב בעברית preposition unspecified unspecified unspecified unspecified unspecified 0 
13 עברית עברית בעברית properName feminine singular unspecified unspecified unspecified  	I_LOC	null
14 ו ו ובעיקר conjunction unspecified unspecified unspecified unspecified unspecified 0 
14 בעיקר בעיקר ובעיקר adverb unspecified unspecified unspecified unspecified unspecified  	O	null
15 ב ב בגרמנית preposition unspecified unspecified unspecified unspecified unspecified 0 
15 גרמנית גרמנית בגרמנית properName feminine singular unspecified unspecified unspecified  	I_LOC	null
16 . . . punctuation unspecified unspecified unspecified unspecified unspecified  	O	null

0 קובץ קובץ קובץ noun masculine singular absolute unspecified unspecified  	O	null
1 ראשון ORD1 ראשון numeral masculine singular absolute unspecified unspecified  	O	null
2 של של של shel-preposition unspecified unspecified unspecified unspecified unspecified  	O	null
3 אפוריזמים אפוריזמים אפוריזמים verb feminine singular unspecified 2 imperative  	O	null
4 של של שלו shel-preposition unspecified unspecified unspecified unspecified unspecified  
4 ו ו שלו pronomial masculine singular unspecified 3 unspecified 0 	O	null
5 ב ב בעברית preposition unspecified unspecified unspecified unspecified unspecified 0 
5 עברית עברית בעברית properName feminine singular unspecified unspecified unspecified  	O	null
6 הוא הוא הוא pronoun masculine singular unspecified 3 unspecified  	O	null
7 משפטים משפט משפטים noun masculine plural absolute unspecified unspecified  	O	null
8 ( ( ( punctuation unspecified unspecified unspecified unspecified unspecified  	O	null
9 ) ) ) punctuation unspecified unspecified unspecified unspecified unspecified  	O	null
10 , , , punctuation unspecified unspecified unspecified unspecified unspecified  	O	null
11 ###NUMBER### ###NUMBER### ###NUMBER### numeral unspecified unspecified unspecified unspecified unspecified  	I_DATE	null
12 ש ש שעליו relativizer/subordinatingConjunction unspecified unspecified unspecified unspecified unspecified 0 
12 על על שעליו preposition unspecified unspecified unspecified unspecified unspecified  
12 ו ו שעליו pronomial masculine singular unspecified 3 unspecified 0 	O	null
13 כתב כתב כתב verb masculine singular unspecified 3 past  	O	null
14 ה ה החוקר definiteArticle unspecified unspecified unspecified unspecified unspecified 0 
14 החוקר חוקר החוקר noun masculine singular absolute unspecified unspecified  	O	null
15 ו ו והמתרגם conjunction unspecified unspecified unspecified unspecified unspecified 0 
15 ה ה והמתרגם definiteArticle unspecified unspecified unspecified unspecified unspecified 0 
15 המתרגם מתרגם והמתרגם noun masculine singular absolute unspecified unspecified  	O	null
16 דוד דוד דוד properName unspecified unspecified unspecified unspecified unspecified  	I_PERS	null
17 וינפלד וינפלד וינפלד properName unspecified unspecified unspecified unspecified unspecified  	I_PERS	null
18 על על על preposition unspecified unspecified unspecified unspecified unspecified  	O	null
19 כריכת כריכה כריכת noun feminine singular construct unspecified unspecified  	O	null
20 ה ה הספר definiteArticle unspecified unspecified unspecified unspecified unspecified 0 
20 הספר ספר הספר noun masculine singular absolute unspecified unspecified  	O	null
21 : : : punctuation unspecified unspecified unspecified unspecified unspecified  	O	null
22 ' ' ' punctuation unspecified unspecified unspecified unspecified unspecified  	O	null
23 ' ' ' punctuation unspecified unspecified unspecified unspecified unspecified  	O	null
24 בניועץ בניועץ בניועץ properName unspecified unspecified unspecified unspecified unspecified  	I_ORG	null
25 שואף שאף שואף verb masculine singular unspecified any beinoni  	O	null
26 למסור מסר למסור verb unspecified unspecified unspecified unspecified infinitive  	O	null
27 ב ב בדיבור preposition unspecified unspecified unspecified unspecified unspecified 0 
27 דיבור דיבור בדיבור noun masculine singular absolute unspecified unspecified  	O	null
28 אחד CARD1 אחד numeral masculine singular absolute unspecified unspecified  	O	null
29 , , , punctuation unspecified unspecified unspecified unspecified unspecified  	O	null
30 מגובש מגובש מגובש adjective masculine singular absolute unspecified unspecified  	O	null
31 עד עד עד preposition unspecified unspecified unspecified unspecified unspecified  	O	null
32 תכלית תכלית תכלית noun feminine singular absolute unspecified unspecified  	O	null
33 , , , punctuation unspecified unspecified unspecified unspecified unspecified  	O	null
34 מסר מסר מסר verb masculine singular unspecified 3 past  	O	null
35 הגות הגות הגותי noun feminine singular absolute unspecified unspecified  
35 י י הגותי possessive masculine-and-feminine singular unspecified 1 unspecified 0 	O	null
36 , , , punctuation unspecified unspecified unspecified unspecified unspecified  	O	null
37 רגשי רגשי רגשי adjective masculine singular absolute unspecified unspecified  	O	null
38 או או או conjunction unspecified unspecified unspecified unspecified unspecified  	O	null
39 מוסרי מוסרי מוסרי adjective masculine singular absolute unspecified unspecified  	O	null
40 . . . punctuation unspecified unspecified unspecified unspecified unspecified  	O	null

0 משפטי משפט משפטיו noun masculine plural absolute unspecified unspecified  
0 ו ו משפטיו possessive masculine singular unspecified 3 unspecified 0 	O	null
1 הם הוא הם pronoun masculine plural unspecified 3 unspecified  	O	null
2 מסות מסה מסות noun feminine plural construct unspecified unspecified  	O	null
3 ב ב בזעיר preposition unspecified unspecified unspecified unspecified unspecified 0 
3 זעיר זעיר בזעיר adjective masculine singular construct unspecified unspecified  	O	null
4 אנפין אנפין אנפין properName unspecified unspecified unspecified unspecified unspecified  	I_LOC	null
5 , , , punctuation unspecified unspecified unspecified unspecified unspecified  	O	null
6 ש ש שקסמן relativizer/subordinatingConjunction unspecified unspecified unspecified unspecified unspecified 0 
6 קסם קסם שקסמן noun masculine singular absolute unspecified unspecified  
6 ן ן שקסמן possessive feminine plural unspecified 3 unspecified 0 	O	null
7 ב ב בקיצורי preposition unspecified unspecified unspecified unspecified unspecified 0 
7 קיצורי קיצור בקיצורי noun masculine plural construct unspecified unspecified  	O	null
8 ה ה הדרך definiteArticle unspecified unspecified unspecified unspecified unspecified 0 
8 הדרך דרך הדרך noun feminine singular absolute unspecified unspecified  	O	null
9 ה ה המפתיעים definiteArticle unspecified unspecified unspecified unspecified unspecified 0 
9 המפתיעים הפתיע המפתיעים participle masculine plural absolute any unspecified  	O	null
10 של של של shel-preposition unspecified unspecified unspecified unspecified unspecified  	O	null
11 ה ה המחשבה definiteArticle unspecified unspecified unspecified unspecified unspecified 0 
11 המחשבה מחשבה המחשבה noun feminine singular absolute unspecified unspecified  	O	null
12 ו ו ובמתחי conjunction unspecified unspecified unspecified unspecified unspecified 0 
12 ב ב ובמתחי preposition unspecified unspecified unspecified unspecified unspecified 0 
12 מתחי מתח ובמתחי noun masculine plural construct unspecified unspecified  	O	null
13 ה ה הלשון definiteArticle unspecified unspecified unspecified unspecified unspecified 0 
13 הלשון לשון הלשון noun feminine singular absolute unspecified unspecified  	O	null
14 ה ה המסוגננת definiteArticle unspecified unspecified unspecified unspecified unspecified 0 
14 המסוגננת סוגנן המסוגננת participle feminine singular absolute any unspecified  	O	null
15 , , , punctuation unspecified unspecified unspecified unspecified unspecified  	O	null
16 ה ה הכופה definiteArticle unspecified unspecified unspecified unspecified unspecified 0 
16 הכופה כפה הכופה participle feminine singular absolute any unspecified  	O	null
17 תשומת תשומה תשומת noun feminine singular construct unspecified unspecified  	O	null
18 לב לב לב properName unspecified unspecified unspecified unspecified unspecified  	I_PERS	null
19 ל ל לכל preposition unspecified unspecified unspecified unspecified unspecified 0 
19 כל כול לכל quantifier unspecified unspecified construct unspecified unspecified  	O	null
20 מלה מילה מלה noun feminine singular absolute unspecified unspecified  	O	null
21 ו ו ומלה conjunction unspecified unspecified unspecified unspecified unspecified 0 
21 מ מ ומלה preposition unspecified unspecified unspecified unspecified unspecified 0 
21 לה לה ומלה properName unspecified unspecified unspecified unspecified unspecified  	O	null
22 ' ' ' punctuation unspecified unspecified unspecified unspecified unspecified  	O	null
23 ' ' ' punctuation unspecified unspecified unspecified unspecified unspecified  	O	null
24 . . . punctuation unspecified unspecified unspecified unspecified unspecified  	O	null
25 עוד עוד עוד quantifier unspecified unspecified construct unspecified unspecified  	O	null
26 מ מ מספריו preposition unspecified unspecified unspecified unspecified unspecified 0 
26 ספרי ספר מספריו noun masculine plural absolute unspecified unspecified  
26 ו ו מספריו possessive masculine singular unspecified 3 unspecified 0 	O	null
27 : : : punctuation unspecified unspecified unspecified unspecified unspecified  	O	null
28 ראות ראות ראות noun feminine singular construct unspecified unspecified  	O	null
29 רוח רוח רוח noun feminine singular construct unspecified unspecified  	O	null
30 : : : punctuation unspecified unspecified unspecified unspecified unspecified  	O	null
31 שירים שיר שירים noun masculine plural absolute unspecified unspecified  	O	null
32 ( ( ( punctuation unspecified unspecified unspecified unspecified unspecified  	O	null
33 ) ) ) punctuation unspecified unspecified unspecified unspecified unspecified  	O	null
34 ; ; ; punctuation unspecified unspecified unspecified unspecified unspecified  	O	null
35 ###NUMBER### ###NUMBER### ###NUMBER### numeral unspecified unspecified unspecified unspecified unspecified  	I_DATE	null
36 וריאציות וריאציה וריאציות noun feminine plural construct unspecified unspecified  	O	null
37 על על על preposition unspecified unspecified unspecified unspecified unspecified  	O	null
38 נושא נושא נושא noun masculine singular construct unspecified unspecified  	O	null
39 אבוד אבד אבוד participle masculine singular absolute any unspecified  	O	null
40 : : : punctuation unspecified unspecified unspecified unspecified unspecified  	O	null
41 שירים שיר שירים noun masculine plural absolute unspecified unspecified  	O	null
42 ) ) ) punctuation unspecified unspecified unspecified unspecified unspecified  	O	null
43 ; ; ; punctuation unspecified unspecified unspecified unspecified unspecified  	O	null
44 ###NUMBER### ###NUMBER### ###NUMBER### numeral unspecified unspecified unspecified unspecified unspecified  	I_DATE	null
45 שירי שיר שירי noun masculine plural construct unspecified unspecified  	O	null
46 ה ה היפים definiteArticle unspecified unspecified unspecified unspecified unspecified 0 
46 היפים יפה היפים adjective masculine plural absolute unspecified unspecified  	O	null
47 ב ב ביותר preposition unspecified unspecified unspecified unspecified unspecified 0 
47 יותר יותר ביותר quantifier unspecified unspecified construct unspecified unspecified  	O	null
48 : : : punctuation unspecified unspecified unspecified unspecified unspecified  	O	null
49 מבחר מבחר מבחר quantifier unspecified unspecified construct unspecified unspecified  	O	null
50 שירים שיר שירים noun masculine plural absolute unspecified unspecified  	O	null
51 ) ) ) punctuation unspecified unspecified unspecified unspecified unspecified  	O	null
52 ; ; ; punctuation unspecified unspecified unspecified unspecified unspecified  	O	null
53 יחפת יחף יחפת adjective feminine singular construct unspecified unspecified  	O	null
54 : : : punctuation unspecified unspecified unspecified unspecified unspecified  	O	null
55 ###NUMBER### ###NUMBER### ###NUMBER### numeral unspecified unspecified unspecified unspecified unspecified  	I_DATE	null
56 שירים שיר שירים noun masculine plural absolute unspecified unspecified  	O	null
57 ( ( ( punctuation unspecified unspecified unspecified unspecified unspecified  	O	null
58 ) ) ) punctuation unspecified unspecified unspecified unspecified unspecified  	O	null
59 ; ; ; punctuation unspecified unspecified unspecified unspecified unspecified  	O	null
60 ###NUMBER### ###NUMBER### ###NUMBER### numeral unspecified unspecified unspecified unspecified unspecified  	I_DATE	null
61 קצות קץ קצות verb feminine plural unspecified any beinoni  	O	null
62 ה ה החושך definiteArticle unspecified unspecified unspecified unspecified unspecified 0 
62 החושך חושך החושך noun masculine singular absolute unspecified unspecified  	O	null
63 ( ( ( punctuation unspecified unspecified unspecified unspecified unspecified  	O	null
64 ) ) ) punctuation unspecified unspecified unspecified unspecified unspecified  	O	null
65 . . . punctuation unspecified unspecified unspecified unspecified unspecified  	O	null
66 ###NUMBER### ###NUMBER### ###NUMBER### numeral unspecified unspecified unspecified unspecified unspecified  	I_DATE	null
67 References References References foreign unspecified unspecified unspecified unspecified unspecified  	O	null
68 : : : punctuation unspecified unspecified unspecified unspecified unspecified  	O	null
69 ב ב בן preposition unspecified unspecified unspecified unspecified unspecified  
69 הן הן בן pronomial feminine plural unspecified 3 unspecified 0 	O	null
70 עזר עזר עזר properName unspecified unspecified unspecified unspecified unspecified  	I_PERS	null
71 , , , punctuation unspecified unspecified unspecified unspecified unspecified  	O	null
72 אהוד אהוד אהוד properName unspecified unspecified unspecified unspecified unspecified  	I_PERS	null
73 . . . punctuation unspecified unspecified unspecified unspecified unspecified  	O	null

0 ״ ״ ״ punctuation unspecified unspecified unspecified unspecified unspecified  	O	null
1 ש ש שיהיה relativizer/subordinatingConjunction unspecified unspecified unspecified unspecified unspecified 0 
1 יהיה הוא שיהיה copula masculine singular unspecified 3 future  	O	null
2 לנו לן לנו verb masculine-and-feminine plural unspecified 1 past  	O	null
3 כמו כמו כמו conjunction unspecified unspecified unspecified unspecified unspecified  	O	null
4 ב ב בבית preposition unspecified unspecified unspecified unspecified unspecified 0 
4 בית בית בבית noun masculine singular construct unspecified unspecified  	O	null
5 " " " punctuation unspecified unspecified unspecified unspecified unspecified  	O	null
6 . . . punctuation unspecified unspecified unspecified unspecified unspecified  	O	null

0 מאזנייםי"ט מאזנייםי"ט מאזנייםי"ט properName unspecified unspecified unspecified unspecified unspecified  	I_PERS	null
1 . . . punctuation unspecified unspecified unspecified unspecified unspecified  	O	null

0 ###NUMBER### ###NUMBER### ###NUMBER### numeral unspecified unspecified unspecified unspecified unspecified  	I_DATE	null
1 . . . punctuation unspecified unspecified unspecified unspecified unspecified  	O	null

0 ; ; ; punctuation unspecified unspecified unspecified unspecified unspecified  	O	null
1 ###NUMBER### ###NUMBER### ###NUMBER### numeral unspecified unspecified unspecified unspecified unspecified  	O	null
2 בן בן בן properName unspecified unspecified unspecified unspecified unspecified  	I_PERS	null
3 שאול שאול שאול properName unspecified unspecified unspecified unspecified unspecified  	I_PERS	null
4 , , , punctuation unspecified unspecified unspecified unspecified unspecified  	O	null
5 משה משה משה properName unspecified unspecified unspecified unspecified unspecified  	I_PERS	null
6 . . . punctuation unspecified unspecified unspecified unspecified unspecified  	O	null

0 ״ ״ ״ punctuation unspecified unspecified unspecified unspecified unspecified  	O	null
1 ואריאציות ואריאציות ואריאציות noun feminine plural absolute unspecified unspecified  	O	null
2 על על על preposition unspecified unspecified unspecified unspecified unspecified  	O	null
3 נושא נושא נושא noun masculine singular absolute unspecified unspecified  	O	null
4 אבוד אבוד אבוד adjective masculine singular absolute unspecified unspecified  	O	null
5 " " " punctuation unspecified unspecified unspecified unspecified unspecified  	O	null
6 . . . punctuation unspecified unspecified unspecified unspecified unspecified  	O	null

0 מאזניים מאזניים מאזניים noun masculine plural absolute unspecified unspecified  	O	null
1 י"ד י"ד י"ד properName unspecified unspecified unspecified unspecified unspecified  	I_PERS	null
2 . . . punctuation unspecified unspecified unspecified unspecified unspecified  	O	null

0 ###NUMBER### ###NUMBER### ###NUMBER### numeral unspecified unspecified unspecified unspecified unspecified  	I_DATE	null
1 . . . punctuation unspecified unspecified unspecified unspecified unspecified  	O	null

0 ###NUMBER### ###NUMBER### ###NUMBER### numeral unspecified unspecified unspecified unspecified unspecified  	O	null
1 - - - punctuation unspecified unspecified unspecified unspecified unspecified  	O	null
2 ###NUMBER### ###NUMBER### ###NUMBER### numeral unspecified unspecified unspecified unspecified unspecified  	O	null
3 . . . punctuation unspecified unspecified unspecified unspecified unspecified  	O	null

