0 Name Name Name foreign unspecified unspecified unspecified unspecified unspecified  	O	null
1 : : : punctuation unspecified unspecified unspecified unspecified unspecified  	O	null
2 גבע גבע גבע properName unspecified unspecified unspecified unspecified unspecified  	I_PERS	null
3 , , , punctuation unspecified unspecified unspecified unspecified unspecified  	O	null
4 טלי טלי טלי properName unspecified unspecified unspecified unspecified unspecified  	I_PERS	null
5 Birth Birth Birth foreign unspecified unspecified unspecified unspecified unspecified  	O	null
6 Year Year Year foreign unspecified unspecified unspecified unspecified unspecified  	O	null
7 : : : punctuation unspecified unspecified unspecified unspecified unspecified  	O	null
8 ###NUMBER### ###NUMBER### ###NUMBER### numeral unspecified unspecified unspecified unspecified unspecified  	I_DATE	null
9 Birth Birth Birth foreign unspecified unspecified unspecified unspecified unspecified  	O	null
10 Place Place Place foreign unspecified unspecified unspecified unspecified unspecified  	O	null
11 : : : punctuation unspecified unspecified unspecified unspecified unspecified  	O	null
12 קריית קריה קריית noun feminine singular construct unspecified unspecified  	O	null
13 טבעון טבעון טבעון properName unspecified unspecified unspecified unspecified unspecified  	I_PERS	null
14 ו ו וחיה conjunction unspecified unspecified unspecified unspecified unspecified 0 
14 חיה חי וחיה properName unspecified unspecified unspecified unspecified unspecified  	I_PERS	null
15 Occupation Occupation Occupation foreign unspecified unspecified unspecified unspecified unspecified  	O	null
16 : : : punctuation unspecified unspecified unspecified unspecified unspecified  	O	null
17 סופרת סופר סופרת noun feminine singular construct unspecified unspecified  	O	null
18 Entry Entry Entry foreign unspecified unspecified unspecified unspecified unspecified  	O	null
19 writer writer writer foreign unspecified unspecified unspecified unspecified unspecified  	O	null
20 : : : punctuation unspecified unspecified unspecified unspecified unspecified  	O	null
21 חן חן חן noun masculine singular absolute unspecified unspecified  	O	null
22 שטרס שטרס שטרס properName unspecified unspecified unspecified unspecified unspecified  	O	null
23 Entry Entry Entry foreign unspecified unspecified unspecified unspecified unspecified  	O	null
24 Value Value Value foreign unspecified unspecified unspecified unspecified unspecified  	O	null
25 : : : punctuation unspecified unspecified unspecified unspecified unspecified  	O	null
26 נולדה נולד נולדה verb feminine singular unspecified 3 past  	O	null
27 ב ב בקריית preposition unspecified unspecified unspecified unspecified unspecified 0 
27 קריית קריה בקריית properName unspecified unspecified unspecified unspecified unspecified  	I_PERS	null
28 טבעון טבעון טבעון properName unspecified unspecified unspecified unspecified unspecified  	I_PERS	null
29 ו ו וחיה conjunction unspecified unspecified unspecified unspecified unspecified 0 
29 חיה חי וחיה verb feminine singular unspecified 3 past  	O	null
30 ב ב בה preposition unspecified unspecified unspecified unspecified unspecified  
30 ה ה בה pronomial feminine singular unspecified 3 unspecified 0 	O	null
31 שנים שנה שנים noun feminine plural absolute unspecified unspecified  	O	null
32 רבות רב רבות adjective feminine plural absolute unspecified unspecified  	O	null
33 . . . punctuation unspecified unspecified unspecified unspecified unspecified  	O	null

0 למדה למד למדה verb feminine singular unspecified 3 past  	O	null
1 ספרות ספרות ספרות noun feminine singular absolute unspecified unspecified  	O	null
2 ו ו ומקרא conjunction unspecified unspecified unspecified unspecified unspecified 0 
2 מקרא מקרא ומקרא noun masculine singular absolute unspecified unspecified  	O	null
3 ב ב במכללת preposition unspecified unspecified unspecified unspecified unspecified 0 
3 מכללת מכללה במכללת noun feminine singular construct unspecified unspecified  	O	null
4 " " " punctuation unspecified unspecified unspecified unspecified unspecified  	O	null
5 אורנים אורן אורנים properName unspecified unspecified unspecified unspecified unspecified  	I_ORG	null
6 " " " punctuation unspecified unspecified unspecified unspecified unspecified  	O	null
7 ו ו וספרות conjunction unspecified unspecified unspecified unspecified unspecified 0 
7 ספרות ספרות וספרות noun feminine singular absolute unspecified unspecified  	O	null
8 השוואתית השוואתי השוואתית adjective feminine singular absolute unspecified unspecified  	O	null
9 ל ל לתואר preposition unspecified unspecified unspecified unspecified unspecified 0 
9 תואר תואר לתואר noun masculine singular construct unspecified unspecified  	O	null
10 שני שני שני noun masculine singular absolute unspecified unspecified  	I_ORG	null
11 ב ב באוניברסיטת preposition unspecified unspecified unspecified unspecified unspecified 0 
11 אוניברסיטת אוניברסיטה באוניברסיטת noun feminine singular construct unspecified unspecified  	I_ORG	null
12 חיפה חיפה חיפה properName unspecified unspecified unspecified unspecified unspecified  	I_ORG	null
13 . . . punctuation unspecified unspecified unspecified unspecified unspecified  	O	null

0 עבדה עבד עבדה verb feminine singular unspecified 3 past  	O	null
1 כמורה כמורה כמורה noun feminine singular absolute unspecified unspecified  	O	null
2 ל ל לספרות preposition unspecified unspecified unspecified unspecified unspecified 0 
2 ה ה לספרות definiteArticle unspecified unspecified unspecified unspecified unspecified 0 
2 הספרות ספרות לספרות noun feminine singular absolute unspecified unspecified  	O	null
3 ו ו ומחנכת conjunction unspecified unspecified unspecified unspecified unspecified 0 
3 מחנכת חינך ומחנכת verb feminine singular unspecified any beinoni  	O	null
4 ב ב בתיכון preposition unspecified unspecified unspecified unspecified unspecified 0 
4 תיכון תיכון בתיכון noun masculine singular absolute unspecified unspecified  	O	null
5 ב ב בקריית preposition unspecified unspecified unspecified unspecified unspecified 0 
5 קריית קריה בקריית noun feminine singular construct unspecified unspecified  	O	null
6 טבעון טבעון טבעון properName unspecified unspecified unspecified unspecified unspecified  	I_PERS	null
7 . . . punctuation unspecified unspecified unspecified unspecified unspecified  	O	null

0 ב ב בזמן preposition unspecified unspecified unspecified unspecified unspecified 0 
0 זמן זמן בזמן noun masculine singular absolute unspecified unspecified  	O	null
1 ש ש שהיתה relativizer/subordinatingConjunction unspecified unspecified unspecified unspecified unspecified 0 
1 היתה הוא שהיתה copula feminine singular unspecified 3 past  	O	null
2 ב ב בוונקובר preposition unspecified unspecified unspecified unspecified unspecified 0 
2 וונקובר ונקובר בוונקובר properName unspecified unspecified unspecified unspecified unspecified  	I_LOC	null
3 , , , punctuation unspecified unspecified unspecified unspecified unspecified  	O	null
4 קנדה קנדה קנדה properName unspecified unspecified unspecified unspecified unspecified  	I_LOC	null
5 - - - punctuation unspecified unspecified unspecified unspecified unspecified  	O	null
6 ###NUMBER### ###NUMBER### ###NUMBER### numeral unspecified unspecified unspecified unspecified unspecified  	I_DATE	null
7 ) ) ) punctuation unspecified unspecified unspecified unspecified unspecified  	O	null
8 , , , punctuation unspecified unspecified unspecified unspecified unspecified  	O	null
9 ###NUMBER### ###NUMBER### ###NUMBER### numeral unspecified unspecified unspecified unspecified unspecified  	I_DATE	null
10 עסקה עסקה עסקה noun feminine singular absolute unspecified unspecified  	O	null
11 ב ב בהוראת preposition unspecified unspecified unspecified unspecified unspecified 0 
11 הוראת הוראה בהוראת noun feminine singular construct unspecified unspecified  	O	null
12 ספרות ספרות ספרות noun feminine singular absolute unspecified unspecified  	O	null
13 עברית עברי עברית adjective feminine singular absolute unspecified unspecified  	O	null
14 ל ל למבוגרים preposition unspecified unspecified unspecified unspecified unspecified 0 
14 מבוגרים מבוגר למבוגרים noun masculine plural absolute unspecified unspecified  	O	null
15 . . . punctuation unspecified unspecified unspecified unspecified unspecified  	O	null

0 פירסמה פרסם פירסמה verb feminine singular unspecified 3 past  	O	null
1 שלושה CARD3 שלושה numeral masculine plural absolute unspecified unspecified  	O	null
2 רומנים רומן רומנים noun masculine plural absolute unspecified unspecified  	O	null
3 . . . punctuation unspecified unspecified unspecified unspecified unspecified  	O	null

0 שני CARD2 שני numeral masculine dual construct unspecified unspecified  	O	null
1 ה ה הראשונים definiteArticle unspecified unspecified unspecified unspecified unspecified 0 
1 הראשונים ראשונים הראשונים noun masculine plural absolute unspecified unspecified  	O	null
2 מושפעים הושפע מושפעים verb masculine plural unspecified any beinoni  	O	null
3 מ מ מז'אנר preposition unspecified unspecified unspecified unspecified unspecified 0 
3 ז'אנר ז'אנר מז'אנר noun masculine singular construct unspecified unspecified  	O	null
4 ה ה הריאליזם definiteArticle unspecified unspecified unspecified unspecified unspecified 0 
4 הריאליזם ריאליזם הריאליזם noun masculine singular absolute unspecified unspecified  	O	null
5 ה ה הפנטסטי definiteArticle unspecified unspecified unspecified unspecified unspecified 0 
5 הפנטסטי הפנטסטי הפנטסטי adjective masculine singular absolute unspecified unspecified  	O	null
6 . . . punctuation unspecified unspecified unspecified unspecified unspecified  	O	null

0 ה ה הציר definiteArticle unspecified unspecified unspecified unspecified unspecified 0 
0 הציר ציר הציר noun masculine singular absolute unspecified unspecified  	O	null
1 ה ה המעגן definiteArticle unspecified unspecified unspecified unspecified unspecified 0 
1 המעגן עיגן המעגן participle masculine singular absolute any unspecified  	O	null
2 את את את at-preposition unspecified unspecified unspecified unspecified unspecified  	O	null
3 עלילת עלילה עלילת noun feminine singular construct unspecified unspecified  	O	null
4 ה ה הרומנים definiteArticle unspecified unspecified unspecified unspecified unspecified 0 
4 הרומנים רומן הרומנים noun masculine plural absolute unspecified unspecified  	O	null
5 הוא הוא הוא pronoun masculine singular unspecified 3 unspecified  	O	null
6 המטא המטא המטא noun masculine singular construct unspecified unspecified  	O	null
7 - - - punctuation unspecified unspecified unspecified unspecified unspecified  	O	null
8 נרטיב הרטיב נרטיב verb masculine-and-feminine plural unspecified 1 future  	O	null
9 ה ה הציוני definiteArticle unspecified unspecified unspecified unspecified unspecified 0 
9 הציוני ציוני הציוני adjective masculine singular absolute unspecified unspecified  	O	null
10 , , , punctuation unspecified unspecified unspecified unspecified unspecified  	O	null
11 אך אך אך conjunction unspecified unspecified unspecified unspecified unspecified  	O	null
12 ה ה הרומנים definiteArticle unspecified unspecified unspecified unspecified unspecified 0 
12 הרומנים רומן הרומנים noun masculine plural absolute unspecified unspecified  	O	null
13 חותרים חתר חותרים verb masculine plural unspecified any beinoni  	O	null
14 ב ב במידה preposition unspecified unspecified unspecified unspecified unspecified 0 
14 מידה מידה במידה noun feminine singular absolute unspecified unspecified  	O	null
15 רבה רב רבה adjective feminine singular absolute unspecified unspecified  	O	null
16 ל ל לעיצוב preposition unspecified unspecified unspecified unspecified unspecified 0 
16 עיצוב עיצוב לעיצוב noun masculine singular construct unspecified unspecified  	O	null
17 משמעויות משמעות משמעויות noun feminine plural absolute unspecified unspecified  	O	null
18 אוניברסליות אוניברסלי אוניברסליות adjective feminine plural absolute unspecified unspecified  	O	null
19 . . . punctuation unspecified unspecified unspecified unspecified unspecified  	O	null

0 ב ב בשילוב preposition unspecified unspecified unspecified unspecified unspecified 0 
0 ה ה בשילוב definiteArticle unspecified unspecified unspecified unspecified unspecified 0 
0 השילוב שילוב בשילוב noun masculine singular absolute unspecified unspecified  	O	null
1 ה ה המתקיים definiteArticle unspecified unspecified unspecified unspecified unspecified 0 
1 המתקיים התקיים המתקיים participle masculine singular absolute any unspecified  	O	null
2 ב ב בה preposition unspecified unspecified unspecified unspecified unspecified  
2 ה ה בה pronomial feminine singular unspecified 3 unspecified 0 	O	null
3 בין בין בין preposition unspecified unspecified unspecified unspecified unspecified  	O	null
4 דמויות דמות דמויות noun feminine plural absolute unspecified unspecified  	O	null
5 פלאיות פלאי פלאיות adjective feminine plural absolute unspecified unspecified  	O	null
6 לבין לבין לבין preposition unspecified unspecified unspecified unspecified unspecified  	O	null
7 ה ה הסיפור definiteArticle unspecified unspecified unspecified unspecified unspecified 0 
7 הסיפור סיפור הסיפור noun masculine singular absolute unspecified unspecified  	O	null
8 ה ה ההיסטורי definiteArticle unspecified unspecified unspecified unspecified unspecified 0 
8 ההיסטורי היסטורי ההיסטורי adjective masculine singular absolute unspecified unspecified  	O	null
9 של של של shel-preposition unspecified unspecified unspecified unspecified unspecified  	O	null
10 ארץ ארץ ארץ noun feminine singular construct unspecified unspecified  	I_LOC	null
11 ישראל ישראל ישראל properName unspecified unspecified unspecified unspecified unspecified  	I_LOC	null
12 ה ה הקדומה definiteArticle unspecified unspecified unspecified unspecified unspecified 0 
12 הקדומה קדום הקדומה adjective feminine singular absolute unspecified unspecified  	O	null
13 ו ו וההתיישבות conjunction unspecified unspecified unspecified unspecified unspecified 0 
13 ה ה וההתיישבות definiteArticle unspecified unspecified unspecified unspecified unspecified 0 
13 ההתיישבות התיישבות וההתיישבות noun feminine singular absolute unspecified unspecified  	O	null
14 ב ב בעמק preposition unspecified unspecified unspecified unspecified unspecified 0 
14 ה ה בעמק definiteArticle unspecified unspecified unspecified unspecified unspecified 0 
14 העמק עמק בעמק noun masculine singular absolute unspecified unspecified  	O	null
15 , , , punctuation unspecified unspecified unspecified unspecified unspecified  	O	null
16 ו ו וכן conjunction unspecified unspecified unspecified unspecified unspecified 0 
16 כן כן וכן conjunction unspecified unspecified unspecified unspecified unspecified  	O	null
17 ב ב בנימה preposition unspecified unspecified unspecified unspecified unspecified 0 
17 ה ה בנימה definiteArticle unspecified unspecified unspecified unspecified unspecified 0 
17 הנימה נימה בנימה noun feminine singular absolute unspecified unspecified  	O	null
18 ה ה הנוסטלגית definiteArticle unspecified unspecified unspecified unspecified unspecified 0 
18 הנוסטלגית נוסטלגי הנוסטלגית adjective feminine singular absolute unspecified unspecified  	O	null
19 , , , punctuation unspecified unspecified unspecified unspecified unspecified  	O	null
20 קרובה קרוב קרובה adjective feminine singular absolute unspecified unspecified  	O	null
21 יצירת יצירה יצירתה noun feminine singular absolute unspecified unspecified  
21 ה ה יצירתה possessive feminine singular unspecified 3 unspecified 0 	O	null
22 ל ל לזו preposition unspecified unspecified unspecified unspecified unspecified 0 
22 זו זו לזו pronoun feminine singular unspecified 3 unspecified  	O	null
23 של של של shel-preposition unspecified unspecified unspecified unspecified unspecified  	O	null
24 מאיר מאיר מאיר properName unspecified unspecified unspecified unspecified unspecified  	I_PERS	null
25 של של שלו shel-preposition unspecified unspecified unspecified unspecified unspecified  
25 ו ו שלו pronomial masculine singular unspecified 3 unspecified 0 	O	null
26 . . . punctuation unspecified unspecified unspecified unspecified unspecified  	O	null

0 ש ש שלא relativizer/subordinatingConjunction unspecified unspecified unspecified unspecified unspecified 0 
0 לא לא שלא negation unspecified unspecified unspecified unspecified unspecified  	O	null
1 כמו כמו כמותו preposition unspecified unspecified unspecified unspecified unspecified  
1 ו ו כמותו pronomial masculine singular unspecified 3 unspecified 0 	O	null
2 , , , punctuation unspecified unspecified unspecified unspecified unspecified  	O	null
3 יצירת יצירה יצירתה noun feminine singular absolute unspecified unspecified  
3 ה ה יצירתה possessive feminine singular unspecified 3 unspecified 0 	O	null
4 לא לא לא negation unspecified unspecified unspecified unspecified unspecified  	O	null
5 זכתה זכה זכתה verb feminine singular unspecified 3 past  	O	null
6 ל ל לתשומת preposition unspecified unspecified unspecified unspecified unspecified 0 
6 תשומת תשומה לתשומת noun feminine singular construct unspecified unspecified  	O	null
7 לב לב לב noun masculine singular absolute unspecified unspecified  	O	null
8 של של של shel-preposition unspecified unspecified unspecified unspecified unspecified  	O	null
9 ה ה הביקורת definiteArticle unspecified unspecified unspecified unspecified unspecified 0 
9 הביקורת ביקורת הביקורת noun feminine singular absolute unspecified unspecified  	O	null
10 ו ו וקהל conjunction unspecified unspecified unspecified unspecified unspecified 0 
10 קהל קהל וקהל noun masculine singular construct unspecified unspecified  	O	null
11 ה ה הקוראים definiteArticle unspecified unspecified unspecified unspecified unspecified 0 
11 הקוראים קורא הקוראים noun masculine plural absolute unspecified unspecified  	O	null
12 . . . punctuation unspecified unspecified unspecified unspecified unspecified  	O	null

0 ה ה הרומן definiteArticle unspecified unspecified unspecified unspecified unspecified 0 
0 הרומן רומן הרומן noun masculine singular absolute unspecified unspecified  	O	null
1 ה ה הראשון definiteArticle unspecified unspecified unspecified unspecified unspecified 0 
1 הראשון ORD1 הראשון numeral masculine singular absolute unspecified unspecified  	O	null
2 פרי פרי פרי properName unspecified unspecified unspecified unspecified unspecified  	I_PERS	null
3 עטה עטה עטה verb masculine singular unspecified 3 past  	O	null
4 , , , punctuation unspecified unspecified unspecified unspecified unspecified  	O	null
5 ש ש שממית relativizer/subordinatingConjunction unspecified unspecified unspecified unspecified unspecified 0 
5 ממית המית שממית verb masculine singular unspecified any beinoni  	O	null
6 ב ב בהיכלי preposition unspecified unspecified unspecified unspecified unspecified 0 
6 היכלי היכל בהיכלי noun masculine plural construct unspecified unspecified  	O	null
7 מלך מלך מלך noun masculine singular absolute unspecified unspecified  	O	null
8 ( ( ( punctuation unspecified unspecified unspecified unspecified unspecified  	O	null
9 ספרית ספר ספרית noun feminine singular construct unspecified unspecified  	O	null
10 פועלים פועל פועלים noun masculine plural absolute unspecified unspecified  	O	null
11 , , , punctuation unspecified unspecified unspecified unspecified unspecified  	O	null
12 ) ) ) punctuation unspecified unspecified unspecified unspecified unspecified  	O	null
13 , , , punctuation unspecified unspecified unspecified unspecified unspecified  	O	null
14 ###NUMBER### ###NUMBER### ###NUMBER### numeral unspecified unspecified unspecified unspecified unspecified  	I_DATE	null
15 בנוי בנוי בנוי adjective masculine singular absolute unspecified unspecified  	O	null
16 ב ב במתכונת preposition unspecified unspecified unspecified unspecified unspecified 0 
16 מתכונת מתכונת במתכונת noun feminine singular absolute unspecified unspecified  	O	null
17 של של של shel-preposition unspecified unspecified unspecified unspecified unspecified  	O	null
18 סאגה סאגה סאגה noun feminine singular absolute unspecified unspecified  	O	null
19 בין בין בין preposition unspecified unspecified unspecified unspecified unspecified  	O	null
20 - - - punctuation unspecified unspecified unspecified unspecified unspecified  	O	null
21 דורית דורית דורית properName unspecified unspecified unspecified unspecified unspecified  	I_PERS	null
22 ו ו ומגולל conjunction unspecified unspecified unspecified unspecified unspecified 0 
22 מגולל גולל ומגולל verb masculine singular unspecified any beinoni  	O	null
23 את את את at-preposition unspecified unspecified unspecified unspecified unspecified  	O	null
24 קורות קורה קורותיהן noun feminine plural absolute unspecified unspecified  
24 הן הן קורותיהן possessive feminine plural unspecified 3 unspecified 0 	O	null
25 של של של shel-preposition unspecified unspecified unspecified unspecified unspecified  	O	null
26 כמה כמה כמה quantifier unspecified unspecified construct unspecified unspecified  	O	null
27 דמויות דמות דמויות noun feminine plural absolute unspecified unspecified  	O	null
28 ש ש שכוחות relativizer/subordinatingConjunction unspecified unspecified unspecified unspecified unspecified 0 
28 כוחות כוח שכוחות noun masculine plural absolute unspecified unspecified  	O	null
29 עליונים עליון עליונים adjective masculine plural absolute unspecified unspecified  	O	null
30 מנתבים ניתב מנתבים verb masculine plural unspecified any beinoni  	O	null
31 את את את at-preposition unspecified unspecified unspecified unspecified unspecified  	O	null
32 גורל גורל גורלן noun masculine singular absolute unspecified unspecified  
32 ן ן גורלן possessive feminine plural unspecified 3 unspecified 0 	O	null
33 ה ה המשותף definiteArticle unspecified unspecified unspecified unspecified unspecified 0 
33 המשותף משותף המשותף adjective masculine singular absolute unspecified unspecified  	O	null
34 . . . punctuation unspecified unspecified unspecified unspecified unspecified  	O	null

0 ה ה העלילה definiteArticle unspecified unspecified unspecified unspecified unspecified 0 
0 העלילה עלילה העלילה noun feminine singular absolute unspecified unspecified  	O	null
1 מתרחשת התרחש מתרחשת verb feminine singular unspecified any beinoni  	O	null
2 ב ב במזרח preposition unspecified unspecified unspecified unspecified unspecified 0 
2 מזרח מזרח במזרח noun masculine singular construct unspecified unspecified  	O	null
3 - - - punctuation unspecified unspecified unspecified unspecified unspecified  	I_LOC	null
4 אירופה אירופה אירופה properName unspecified unspecified unspecified unspecified unspecified  	I_LOC	null
5 , , , punctuation unspecified unspecified unspecified unspecified unspecified  	O	null
6 ב ב בתל preposition unspecified unspecified unspecified unspecified unspecified 0 
6 תל תל בתל properName unspecified unspecified unspecified unspecified unspecified  	I_LOC	null
7 אביב אביב אביב properName unspecified unspecified unspecified unspecified unspecified  	I_LOC	null
8 , , , punctuation unspecified unspecified unspecified unspecified unspecified  	O	null
9 ב ב בחיפה preposition unspecified unspecified unspecified unspecified unspecified 0 
9 חיפה חיפה בחיפה properName unspecified unspecified unspecified unspecified unspecified  	I_LOC	null
10 ו ו ובמושב conjunction unspecified unspecified unspecified unspecified unspecified 0 
10 ב ב ובמושב preposition unspecified unspecified unspecified unspecified unspecified 0 
10 ה ה ובמושב definiteArticle unspecified unspecified unspecified unspecified unspecified 0 
10 המושב מושב ובמושב noun masculine singular absolute unspecified unspecified  	B_LOC	null
11 ב ב בעמק preposition unspecified unspecified unspecified unspecified unspecified 0 
11 ה ה בעמק definiteArticle unspecified unspecified unspecified unspecified unspecified 0 
11 העמק עמק בעמק noun masculine singular absolute unspecified unspecified  	I_LOC	null
12 , , , punctuation unspecified unspecified unspecified unspecified unspecified  	O	null
13 ו ו והיא conjunction unspecified unspecified unspecified unspecified unspecified 0 
13 היא הוא והיא pronoun feminine singular unspecified 3 unspecified  	O	null
14 מחושקת חושק מחושקת verb feminine singular unspecified any beinoni  	O	null
15 על על על preposition unspecified unspecified unspecified unspecified unspecified  	O	null
16 ידי יד ידי noun feminine plural construct unspecified unspecified  	O	null
17 מלחמות מלחמה מלחמות noun feminine plural absolute unspecified unspecified  	O	null
18 : : : punctuation unspecified unspecified unspecified unspecified unspecified  	O	null
19 מלחמת מלחמה מלחמת noun feminine singular construct unspecified unspecified  	O	null
20 ה ה העולם definiteArticle unspecified unspecified unspecified unspecified unspecified 0 
20 העולם עולם העולם noun masculine singular absolute unspecified unspecified  	O	null
21 ה ה השנייה definiteArticle unspecified unspecified unspecified unspecified unspecified 0 
21 השנייה ORD2 השנייה numeral feminine singular absolute unspecified unspecified  	O	null
22 ו ו והשואה conjunction unspecified unspecified unspecified unspecified unspecified 0 
22 ה ה והשואה definiteArticle unspecified unspecified unspecified unspecified unspecified 0 
22 השואה שואה והשואה noun feminine singular absolute unspecified unspecified  	O	null
23 , , , punctuation unspecified unspecified unspecified unspecified unspecified  	O	null
24 מלחמת מלחמה מלחמת noun feminine singular construct unspecified unspecified  	O	null
25 ששת CARD6 ששת numeral masculine plural construct unspecified unspecified  	O	null
26 ה ה הימים definiteArticle unspecified unspecified unspecified unspecified unspecified 0 
26 הימים יום הימים noun masculine plural absolute unspecified unspecified  	O	null
27 ו ו ומלחמת conjunction unspecified unspecified unspecified unspecified unspecified 0 
27 מלחמת מלחמה ומלחמת noun feminine singular construct unspecified unspecified  	O	null
28 יום יום יום noun masculine singular construct unspecified unspecified  	I_DATE	null
29 ה ה הכיפורים definiteArticle unspecified unspecified unspecified unspecified unspecified 0 
29 הכיפורים כיפור הכיפורים noun masculine plural absolute unspecified unspecified  	I_DATE	null
30 . . . punctuation unspecified unspecified unspecified unspecified unspecified  	O	null

0 גם גם גם conjunction unspecified unspecified unspecified unspecified unspecified  	O	null
1 ה ה הרומן definiteArticle unspecified unspecified unspecified unspecified unspecified 0 
1 הרומן רומן הרומן noun masculine singular absolute unspecified unspecified  	O	null
2 דרך דרך דרך preposition unspecified unspecified unspecified unspecified unspecified  	O	null
3 ה ה האלה definiteArticle unspecified unspecified unspecified unspecified unspecified 0 
3 האלה אל האלה noun feminine singular absolute unspecified unspecified  	O	null
4 ( ( ( punctuation unspecified unspecified unspecified unspecified unspecified  	O	null
5 ###NUMBER### ###NUMBER### ###NUMBER### numeral unspecified unspecified unspecified unspecified unspecified  	I_DATE	null
6 ) ) ) punctuation unspecified unspecified unspecified unspecified unspecified  	O	null
7 מספר מספר מספר verb masculine singular unspecified 3 past  	O	null
8 את את את at-preposition unspecified unspecified unspecified unspecified unspecified  	O	null
9 קורות קורה קורותיהם noun feminine plural absolute unspecified unspecified  
9 הם הם קורותיהם possessive masculine plural unspecified 3 unspecified 0 	O	null
10 של של של shel-preposition unspecified unspecified unspecified unspecified unspecified  	O	null
11 מהגרים מהגר מהגרים noun masculine plural absolute unspecified unspecified  	O	null
12 ו ו וילדיהם conjunction unspecified unspecified unspecified unspecified unspecified 0 
12 ילדי ילד וילדיהם noun masculine plural absolute unspecified unspecified  
12 הם הם וילדיהם possessive masculine plural unspecified 3 unspecified 0 	O	null
13 ש ש שכוחות relativizer/subordinatingConjunction unspecified unspecified unspecified unspecified unspecified 0 
13 כוחות כוח שכוחות noun masculine plural absolute unspecified unspecified  	O	null
14 עליונים עליון עליונים adjective masculine plural absolute unspecified unspecified  	O	null
15 , , , punctuation unspecified unspecified unspecified unspecified unspecified  	O	null
16 כאן כאן כאן adverb unspecified unspecified unspecified unspecified unspecified  	O	null
17 הם הוא הם pronoun masculine plural unspecified 3 unspecified  	O	null
18 מתגלמים התגלם מתגלמים verb masculine plural unspecified any beinoni  	O	null
19 ב ב בדמות preposition unspecified unspecified unspecified unspecified unspecified 0 
19 דמות דמות בדמות noun feminine singular absolute unspecified unspecified  	O	null
20 פלאית פלאי פלאית adjective feminine singular absolute unspecified unspecified  	O	null
21 , , , punctuation unspecified unspecified unspecified unspecified unspecified  	O	null
22 משפיעים השפיע משפיעים verb masculine plural unspecified any beinoni  	O	null
23 על על על preposition unspecified unspecified unspecified unspecified unspecified  	O	null
24 חיי חיים חייהם noun masculine plural absolute unspecified unspecified  
24 הם הם חייהם possessive masculine plural unspecified 3 unspecified 0 	O	null
25 . . . punctuation unspecified unspecified unspecified unspecified unspecified  	O	null

0 אך אך אך conjunction unspecified unspecified unspecified unspecified unspecified  	O	null
1 ב ב בשונה preposition unspecified unspecified unspecified unspecified unspecified 0 
1 שונה שונה בשונה adjective masculine singular absolute unspecified unspecified  	O	null
2 מ מ מהספר preposition unspecified unspecified unspecified unspecified unspecified 0 
2 ה ה מהספר definiteArticle unspecified unspecified unspecified unspecified unspecified 0 
2 הספר ספר מהספר noun masculine singular absolute unspecified unspecified  	O	null
3 ה ה הקודם definiteArticle unspecified unspecified unspecified unspecified unspecified 0 
3 הקודם קודם הקודם adjective masculine singular absolute unspecified unspecified  	O	null
4 , , , punctuation unspecified unspecified unspecified unspecified unspecified  	O	null
5 זהו זהו זהו pronoun masculine singular unspecified 3 unspecified  	O	null
6 ב ב במידה preposition unspecified unspecified unspecified unspecified unspecified 0 
6 מידה מידה במידה noun feminine singular absolute unspecified unspecified  	O	null
7 רבה רב רבה adjective feminine singular absolute unspecified unspecified  	O	null
8 סיפור סיפור סיפור noun masculine singular absolute unspecified unspecified  	O	null
9 של של של shel-preposition unspecified unspecified unspecified unspecified unspecified  	O	null
10 מקום מקום מקום noun masculine singular absolute unspecified unspecified  	O	null
11 : : : punctuation unspecified unspecified unspecified unspecified unspecified  	O	null
12 יישוב יישוב יישוב noun masculine singular absolute unspecified unspecified  	O	null
13 חדש חדש חדש adjective masculine singular absolute unspecified unspecified  	O	null
14 - - - punctuation unspecified unspecified unspecified unspecified unspecified  	O	null
15 ישן ישן ישן adjective masculine singular absolute unspecified unspecified  	O	null
16 ב ב בצפון preposition unspecified unspecified unspecified unspecified unspecified 0 
16 צפון צפון בצפון noun masculine singular construct unspecified unspecified  	O	null
17 ה ה הארץ definiteArticle unspecified unspecified unspecified unspecified unspecified 0 
17 הארץ ארץ הארץ noun feminine singular absolute unspecified unspecified  	O	null
18 , , , punctuation unspecified unspecified unspecified unspecified unspecified  	O	null
19 ש ש ששמו relativizer/subordinatingConjunction unspecified unspecified unspecified unspecified unspecified 0 
19 שם שם ששמו noun masculine singular absolute unspecified unspecified  
19 ו ו ששמו possessive masculine singular unspecified 3 unspecified 0 	O	null
20 ה ה הבדיוני definiteArticle unspecified unspecified unspecified unspecified unspecified 0 
20 הבדיוני בדיוני הבדיוני adjective masculine singular absolute unspecified unspecified  	O	null
21 , , , punctuation unspecified unspecified unspecified unspecified unspecified  	O	null
22 " " " punctuation unspecified unspecified unspecified unspecified unspecified  	O	null
23 ביסר ייסר ביסרה verb unspecified unspecified unspecified unspecified infinitive  
23 ה ה ביסרה accusative-or-nominative feminine singular unspecified 3 unspecified 0 	O	null
24 " " " punctuation unspecified unspecified unspecified unspecified unspecified  	O	null
25 , , , punctuation unspecified unspecified unspecified unspecified unspecified  	O	null
26 הוא הוא הוא pronoun masculine singular unspecified 3 unspecified  	O	null
27 שם שם שמה noun masculine singular absolute unspecified unspecified  
27 ה ה שמה possessive feminine singular unspecified 3 unspecified 0 	O	null
28 ה ה הקדום definiteArticle unspecified unspecified unspecified unspecified unspecified 0 
28 הקדום קדום הקדום adjective masculine singular absolute unspecified unspecified  	O	null
29 של של של shel-preposition unspecified unspecified unspecified unspecified unspecified  	O	null
30 בית בית בית noun masculine singular construct unspecified unspecified  	O	null
31 שערים שער שערים noun masculine plural absolute unspecified unspecified  	O	null
32 ה ה העתיקה definiteArticle unspecified unspecified unspecified unspecified unspecified 0 
32 העתיקה עתיק העתיקה adjective feminine singular absolute unspecified unspecified  	O	null
33 ש ש שבסמוך relativizer/subordinatingConjunction unspecified unspecified unspecified unspecified unspecified 0 
33 ב ב שבסמוך preposition unspecified unspecified unspecified unspecified unspecified 0 
33 סמוך סמך שבסמוך participle masculine singular absolute any unspecified  	O	null
34 ל ל לחורבותיה preposition unspecified unspecified unspecified unspecified unspecified 0 
34 חורבות חורבה לחורבותיה noun feminine plural absolute unspecified unspecified  
34 ה ה לחורבותיה possessive feminine singular unspecified 3 unspecified 0 	O	null
35 שוכנת שכן שוכנת verb feminine singular unspecified any beinoni  	O	null
36 טבעון טבעון טבעון properName unspecified unspecified unspecified unspecified unspecified  	I_PERS	null
37 . . . punctuation unspecified unspecified unspecified unspecified unspecified  	O	null

0 בדומה בדומה בדומה adverb unspecified unspecified unspecified unspecified unspecified  	O	null
1 ל ל לדרך preposition unspecified unspecified unspecified unspecified unspecified 0 
1 דרך דרך לדרך noun feminine singular construct unspecified unspecified  	O	null
2 ה ה האלה definiteArticle unspecified unspecified unspecified unspecified unspecified 0 
2 האלה אל האלה noun feminine singular absolute unspecified unspecified  	O	null
3 , , , punctuation unspecified unspecified unspecified unspecified unspecified  	O	null
4 ש ש ששולטת relativizer/subordinatingConjunction unspecified unspecified unspecified unspecified unspecified 0 
4 שולטת שלט ששולטת verb feminine singular unspecified any beinoni  	O	null
5 ב ב בו preposition unspecified unspecified unspecified unspecified unspecified  
5 ו ו בו pronomial masculine singular unspecified 3 unspecified 0 	O	null
6 עמדה עמדה עמדה noun feminine singular absolute unspecified unspecified  	O	null
7 רטרוספקטיבית רטרוספקטיבית רטרוספקטיבית adjective feminine singular absolute unspecified unspecified  	O	null
8 , , , punctuation unspecified unspecified unspecified unspecified unspecified  	O	null
9 ה ה הרומן definiteArticle unspecified unspecified unspecified unspecified unspecified 0 
9 הרומן רומן הרומן noun masculine singular absolute unspecified unspecified  	O	null
10 אהבת אהבה אהבת noun feminine singular construct unspecified unspecified  	O	null
11 פתאום פתאום פתאום adverb unspecified unspecified unspecified unspecified unspecified  	I_LOC	null
12 ( ( ( punctuation unspecified unspecified unspecified unspecified unspecified  	O	null
13 ###NUMBER### ###NUMBER### ###NUMBER### numeral unspecified unspecified unspecified unspecified unspecified  	I_DATE	null
14 ) ) ) punctuation unspecified unspecified unspecified unspecified unspecified  	O	null
15 מסופר סופר מסופר verb masculine singular unspecified any beinoni  	O	null
16 על על על preposition unspecified unspecified unspecified unspecified unspecified  	O	null
17 ידי יד ידי noun feminine plural construct unspecified unspecified  	O	null
18 אישה איש אישה noun feminine singular absolute unspecified unspecified  	O	null
19 בוגרת בוגר בוגרת adjective feminine singular absolute unspecified unspecified  	O	null
20 ה ה הכותבת definiteArticle unspecified unspecified unspecified unspecified unspecified 0 
20 הכותבת כתב הכותבת participle feminine singular absolute any unspecified  	O	null
21 את את את at-preposition unspecified unspecified unspecified unspecified unspecified  	O	null
22 סיפור סיפור סיפור noun masculine singular construct unspecified unspecified  	O	null
23 אהבת אהבה אהבתה noun feminine singular absolute unspecified unspecified  
23 ה ה אהבתה possessive feminine singular unspecified 3 unspecified 0 	O	null
24 רבת רב רבת noun feminine singular construct unspecified unspecified  	O	null
25 - - - punctuation unspecified unspecified unspecified unspecified unspecified  	O	null
26 ה ה השנים definiteArticle unspecified unspecified unspecified unspecified unspecified 0 
26 השנים שנה השנים noun feminine plural absolute unspecified unspecified  	O	null
27 ל ל לחבר preposition unspecified unspecified unspecified unspecified unspecified 0 
27 חבר חבר לחבר noun masculine singular construct unspecified unspecified  	O	null
28 ילדות ילדות ילדותה noun feminine singular absolute unspecified unspecified  
28 ה ה ילדותה possessive feminine singular unspecified 3 unspecified 0 	O	null
29 , , , punctuation unspecified unspecified unspecified unspecified unspecified  	O	null
30 ה ה המבקשת definiteArticle unspecified unspecified unspecified unspecified unspecified 0 
30 המבקשת ביקש המבקשת participle feminine singular absolute any unspecified  	O	null
31 להשיג השיג להשיג verb unspecified unspecified unspecified unspecified infinitive  	O	null
32 תיקון תיקון תיקון noun masculine singular absolute unspecified unspecified  	O	null
33 דרך דרך דרך preposition unspecified unspecified unspecified unspecified unspecified  	O	null
34 מעשה מעשה מעשה noun masculine singular construct unspecified unspecified  	O	null
35 ה ה הכתיבה definiteArticle unspecified unspecified unspecified unspecified unspecified 0 
35 הכתיבה כתיבה הכתיבה noun feminine singular absolute unspecified unspecified  	O	null
36 . . . punctuation unspecified unspecified unspecified unspecified unspecified  	O	null

0 נקודת נקודה נקודת noun feminine singular construct unspecified unspecified  	O	null
1 ה ה המוצא definiteArticle unspecified unspecified unspecified unspecified unspecified 0 
1 המוצא מוצא המוצא noun masculine singular absolute unspecified unspecified  	O	null
2 של של של shel-preposition unspecified unspecified unspecified unspecified unspecified  	O	null
3 ה ה הרומנים definiteArticle unspecified unspecified unspecified unspecified unspecified 0 
3 הרומנים רומן הרומנים noun masculine plural absolute unspecified unspecified  	O	null
4 היא הוא היא pronoun feminine singular unspecified 3 unspecified  	O	null
5 תפישה תפישה תפישה noun feminine singular absolute unspecified unspecified  	O	null
6 של של של shel-preposition unspecified unspecified unspecified unspecified unspecified  	O	null
7 ה ה הילדות definiteArticle unspecified unspecified unspecified unspecified unspecified 0 
7 הילדות ילדות הילדות noun feminine singular absolute unspecified unspecified  	O	null
8 ו ו ושל conjunction unspecified unspecified unspecified unspecified unspecified 0 
8 של של ושל shel-preposition unspecified unspecified unspecified unspecified unspecified  	O	null
9 ערש ערש ערש noun masculine singular construct unspecified unspecified  	O	null
10 הולדת הולדה הולדתו noun feminine singular absolute unspecified unspecified  
10 ו ו הולדתו possessive masculine singular unspecified 3 unspecified 0 	O	null
11 של של של shel-preposition unspecified unspecified unspecified unspecified unspecified  	O	null
12 אדם אדם אדם noun masculine singular absolute unspecified unspecified  	O	null
13 כ כ כגורמים preposition unspecified unspecified unspecified unspecified unspecified 0 
13 גורמים גורם כגורמים noun masculine plural absolute unspecified unspecified  	O	null
14 מכוננים כונן מכוננים verb masculine plural unspecified any beinoni  	O	null
15 ש ש שקובעים relativizer/subordinatingConjunction unspecified unspecified unspecified unspecified unspecified 0 
15 קובעים קבע שקובעים verb masculine plural unspecified any beinoni  	O	null
16 את את את at-preposition unspecified unspecified unspecified unspecified unspecified  	O	null
17 גורל גורל גורלו noun masculine singular absolute unspecified unspecified  
17 ו ו גורלו possessive masculine singular unspecified 3 unspecified 0 	O	null
18 . . . punctuation unspecified unspecified unspecified unspecified unspecified  	O	null

0 כך כך כך adverb unspecified unspecified unspecified unspecified unspecified  	I_ORG	null
1 , , , punctuation unspecified unspecified unspecified unspecified unspecified  	O	null
2 דמויות דמות דמויות noun feminine plural construct unspecified unspecified  	O	null
3 ה ה המהגרים definiteArticle unspecified unspecified unspecified unspecified unspecified 0 
3 המהגרים מהגר המהגרים noun masculine plural absolute unspecified unspecified  	O	null
4 ו ו והפליטים conjunction unspecified unspecified unspecified unspecified unspecified 0 
4 ה ה והפליטים definiteArticle unspecified unspecified unspecified unspecified unspecified 0 
4 הפליטים פליט והפליטים noun masculine plural absolute unspecified unspecified  	O	null
5 ה ה הנעקרים definiteArticle unspecified unspecified unspecified unspecified unspecified 0 
5 הנעקרים נעקר הנעקרים participle masculine plural absolute any unspecified  	O	null
6 מ מ מערש preposition unspecified unspecified unspecified unspecified unspecified 0 
6 ערש ערש מערש noun masculine singular construct unspecified unspecified  	O	null
7 הולדת הולדה הולדתם noun feminine singular absolute unspecified unspecified  
7 ם ם הולדתם possessive masculine plural unspecified 3 unspecified 0 	O	null
8 , , , punctuation unspecified unspecified unspecified unspecified unspecified  	O	null
9 מעוצבות מעוצב מעוצבות adjective feminine plural absolute unspecified unspecified  	O	null
10 כ כ כמי preposition unspecified unspecified unspecified unspecified unspecified 0 
10 מי מי כמי interrogative unspecified unspecified unspecified unspecified unspecified  	O	null
11 ש ש שתמיד relativizer/subordinatingConjunction unspecified unspecified unspecified unspecified unspecified 0 
11 תמיד תמיד שתמיד adverb unspecified unspecified unspecified unspecified unspecified  	O	null
12 יכוננו כונן יכוננו verb masculine-and-feminine plural unspecified 3 future  	O	null
13 את את את at-preposition unspecified unspecified unspecified unspecified unspecified  	O	null
14 חיי חיים חייהן noun masculine plural absolute unspecified unspecified  
14 הן הן חייהן possessive feminine plural unspecified 3 unspecified 0 	O	null
15 היעדר היעדר היעדר noun masculine singular construct unspecified unspecified  	O	null
16 או או או conjunction unspecified unspecified unspecified unspecified unspecified  	O	null
17 פגימה פגימה פגימה noun feminine singular absolute unspecified unspecified  	O	null
18 ש ש שאין relativizer/subordinatingConjunction unspecified unspecified unspecified unspecified unspecified 0 
18 אין יש שאין existential unspecified unspecified unspecified unspecified unspecified  	O	null
19 ל ל להם preposition unspecified unspecified unspecified unspecified unspecified  
19 הם הם להם pronomial masculine plural unspecified 3 unspecified 0 	O	null
20 תיקון תיקון תיקון noun masculine singular absolute unspecified unspecified  	O	null
21 . . . punctuation unspecified unspecified unspecified unspecified unspecified  	O	null

0 References References References foreign unspecified unspecified unspecified unspecified unspecified  	O	null
1 : : : punctuation unspecified unspecified unspecified unspecified unspecified  	O	null
2 אבי אב אביו noun masculine singular absolute unspecified unspecified  
2 ו ו אביו possessive masculine singular unspecified 3 unspecified 0 	O	null
3 , , , punctuation unspecified unspecified unspecified unspecified unspecified  	O	null
4 שלמה שלמה שלמה properName unspecified unspecified unspecified unspecified unspecified  	I_PERS	null
5 . . . punctuation unspecified unspecified unspecified unspecified unspecified  	O	null

0 " " " punctuation unspecified unspecified unspecified unspecified unspecified  	O	null
1 יהלום יהלום יהלום properName masculine singular unspecified unspecified unspecified  	I_PERS	null
2 שמימי שמימי שמימי adjective masculine singular absolute unspecified unspecified  	O	null
3 ב ב באדמת preposition unspecified unspecified unspecified unspecified unspecified 0 
3 אדמת אדמה באדמת noun feminine singular construct unspecified unspecified  	O	null
4 ארץ ארץ ארץ noun feminine singular construct unspecified unspecified  	I_LOC	null
5 ישראל ישראל ישראל properName unspecified unspecified unspecified unspecified unspecified  	I_ORG	null
6 " " " punctuation unspecified unspecified unspecified unspecified unspecified  	O	null
7 . . . punctuation unspecified unspecified unspecified unspecified unspecified  	O	null

0 מעריב מעריב מעריב properName unspecified unspecified unspecified unspecified unspecified  	I_ORG	null
1 ספרות ספרות ספרות noun feminine singular absolute unspecified unspecified  	O	null
2 . . . punctuation unspecified unspecified unspecified unspecified unspecified  	O	null

0 ###NUMEXP### ###NUMEXP### ###NUMEXP### numberExpression unspecified unspecified unspecified unspecified unspecified  	I_DATE	null
1 . . . punctuation unspecified unspecified unspecified unspecified unspecified  	O	null

0 ; ; ; punctuation unspecified unspecified unspecified unspecified unspecified  	O	null
1 ###NUMBER### ###NUMBER### ###NUMBER### numeral unspecified unspecified unspecified unspecified unspecified  	O	null
2 סלע סלע סלע noun masculine singular absolute unspecified unspecified  	O	null
3 , , , punctuation unspecified unspecified unspecified unspecified unspecified  	O	null
4 אביבה אביבה אביבה properName unspecified unspecified unspecified unspecified unspecified  	I_PERS	null
5 . . . punctuation unspecified unspecified unspecified unspecified unspecified  	O	null

0 " " " punctuation unspecified unspecified unspecified unspecified unspecified  	O	null
1 על על על preposition unspecified unspecified unspecified unspecified unspecified  	O	null
2 ' ' ' punctuation unspecified unspecified unspecified unspecified unspecified  	O	null
3 דרך דרך דרך noun feminine singular construct unspecified unspecified  	O	null
4 ה ה האלה definiteArticle unspecified unspecified unspecified unspecified unspecified 0 
4 האלה אל האלה noun feminine singular absolute unspecified unspecified  	O	null
5 ' ' ' punctuation unspecified unspecified unspecified unspecified unspecified  	O	null
6 – – – punctuation unspecified unspecified unspecified unspecified unspecified  	O	null
7 רומאן רומן רומאן noun masculine singular absolute unspecified unspecified  	O	null
8 מאת מאת מאת preposition unspecified unspecified unspecified unspecified unspecified  	O	null
9 טלי טלי טלי properName unspecified unspecified unspecified unspecified unspecified  	I_PERS	null
10 גבע גבע גבע properName unspecified unspecified unspecified unspecified unspecified  	I_PERS	null
11 " " " punctuation unspecified unspecified unspecified unspecified unspecified  	O	null
12 . . . punctuation unspecified unspecified unspecified unspecified unspecified  	O	null

0 קשר קשר קשר noun masculine singular absolute unspecified unspecified  	O	null
1 עין עין עין properName unspecified unspecified unspecified unspecified unspecified  	O	null
2 ###NUMBER### ###NUMBER### ###NUMBER### numeral unspecified unspecified unspecified unspecified unspecified  	O	null
3 . . . punctuation unspecified unspecified unspecified unspecified unspecified  	O	null

0 ###NUMBER### ###NUMBER### ###NUMBER### numeral unspecified unspecified unspecified unspecified unspecified  	I_DATE	null
1 . . . punctuation unspecified unspecified unspecified unspecified unspecified  	O	null

0 ###NUMBER### ###NUMBER### ###NUMBER### numeral unspecified unspecified unspecified unspecified unspecified  	O	null
1 . . . punctuation unspecified unspecified unspecified unspecified unspecified  	O	null

