0 Name Name Name foreign unspecified unspecified unspecified unspecified unspecified  	O	null
1 : : : punctuation unspecified unspecified unspecified unspecified unspecified  	O	null
2 גולדשטיין גולדשטיין גולדשטיין properName unspecified unspecified unspecified unspecified unspecified  	I_PERS	null
3 , , , punctuation unspecified unspecified unspecified unspecified unspecified  	O	null
4 אלכסנדר אלכסנדר אלכסנדר properName unspecified unspecified unspecified unspecified unspecified  	I_PERS	null
5 Birth Birth Birth foreign unspecified unspecified unspecified unspecified unspecified  	O	null
6 Year Year Year foreign unspecified unspecified unspecified unspecified unspecified  	O	null
7 : : : punctuation unspecified unspecified unspecified unspecified unspecified  	O	null
8 ###NUMBER### ###NUMBER### ###NUMBER### numeral unspecified unspecified unspecified unspecified unspecified  	I_DATE	null
9 Death Death Death foreign unspecified unspecified unspecified unspecified unspecified  	O	null
10 Year Year Year foreign unspecified unspecified unspecified unspecified unspecified  	O	null
11 : : : punctuation unspecified unspecified unspecified unspecified unspecified  	O	null
12 ###NUMBER### ###NUMBER### ###NUMBER### numeral unspecified unspecified unspecified unspecified unspecified  	I_DATE	null
13 Birth Birth Birth foreign unspecified unspecified unspecified unspecified unspecified  	O	null
14 Place Place Place foreign unspecified unspecified unspecified unspecified unspecified  	O	null
15 : : : punctuation unspecified unspecified unspecified unspecified unspecified  	O	null
16 טָלין טָלין טָלין properName unspecified unspecified unspecified unspecified unspecified  	I_ORG	null
17 , , , punctuation unspecified unspecified unspecified unspecified unspecified  	O	null
18 אסטוניה אסטוניה אסטוניה properName unspecified unspecified unspecified unspecified unspecified  	I_LOC	null
19 Occupation Occupation Occupation foreign unspecified unspecified unspecified unspecified unspecified  	O	null
20 : : : punctuation unspecified unspecified unspecified unspecified unspecified  	O	null
21 סופר סופר סופר noun masculine singular absolute unspecified unspecified  	O	null
22 ב ב בשפה preposition unspecified unspecified unspecified unspecified unspecified 0 
22 ה ה בשפה definiteArticle unspecified unspecified unspecified unspecified unspecified 0 
22 השפה שפה בשפה noun feminine singular absolute unspecified unspecified  	O	null
23 ה ה הרוסית definiteArticle unspecified unspecified unspecified unspecified unspecified 0 
23 הרוסית רוסי הרוסית adjective feminine singular absolute unspecified unspecified  	O	null
24 Entry Entry Entry foreign unspecified unspecified unspecified unspecified unspecified  	O	null
25 writer writer writer foreign unspecified unspecified unspecified unspecified unspecified  	O	null
26 : : : punctuation unspecified unspecified unspecified unspecified unspecified  	O	null
27 נקודא נקודא נקודא properName unspecified unspecified unspecified unspecified unspecified  	I_ORG	null
28 זינגר זינגר זינגר properName unspecified unspecified unspecified unspecified unspecified  	I_PERS	null
29 Entry Entry Entry foreign unspecified unspecified unspecified unspecified unspecified  	O	null
30 Value Value Value foreign unspecified unspecified unspecified unspecified unspecified  	O	null
31 : : : punctuation unspecified unspecified unspecified unspecified unspecified  	O	null
32 נולד נולד נולד verb masculine singular unspecified 3 past  	O	null
33 בטָלין בטָלין בטָלין properName unspecified unspecified unspecified unspecified unspecified  	I_PERS	null
34 , , , punctuation unspecified unspecified unspecified unspecified unspecified  	O	null
35 אסטוניה אסטוניה אסטוניה properName unspecified unspecified unspecified unspecified unspecified  	I_LOC	null
36 . . . punctuation unspecified unspecified unspecified unspecified unspecified  	O	null

0 גדל גדל גדל verb masculine singular unspecified 3 past  	O	null
1 ו ו ולמד conjunction unspecified unspecified unspecified unspecified unspecified 0 
1 למד למד ולמד verb masculine singular unspecified 3 past  	O	null
2 בבָּקו בבָּקו בבָּקו properName unspecified unspecified unspecified unspecified unspecified  	I_PERS	null
3 ּ ּ ּ punctuation unspecified unspecified unspecified unspecified unspecified  	O	null
4 , , , punctuation unspecified unspecified unspecified unspecified unspecified  	O	null
5 אזרבייג'ן איזרבאיג`ן אזרבייג'ן properName unspecified unspecified unspecified unspecified unspecified  	I_PERS	null
6 . . . punctuation unspecified unspecified unspecified unspecified unspecified  	O	null

0 עלה עלה עלה verb masculine singular unspecified 3 past  	O	null
1 ארצה ארצה ארצה adverb unspecified unspecified unspecified unspecified unspecified  	O	null
2 ב ב ב preposition unspecified unspecified unspecified unspecified unspecified 0 	O	null
3 - - - punctuation unspecified unspecified unspecified unspecified unspecified  	O	null
4 ###NUMBER### ###NUMBER### ###NUMBER### numeral unspecified unspecified unspecified unspecified unspecified  	I_DATE	null
5 . . . punctuation unspecified unspecified unspecified unspecified unspecified  	O	null

0 מ מ מתחילת preposition unspecified unspecified unspecified unspecified unspecified 0 
0 תחילת תחילה מתחילת noun feminine singular construct unspecified unspecified  	O	null
1 שנות שנה שנות noun feminine plural construct unspecified unspecified  	I_DATE	null
2 ה ה האלפיים definiteArticle unspecified unspecified unspecified unspecified unspecified 0 
2 האלפיים ORD-CARD2000 האלפיים numeral masculine-and-feminine dual absolute unspecified unspecified  	I_DATE	null
3 היה הוא היה copula masculine singular unspecified 3 past  	O	null
4 עורך עורך עורך noun masculine singular construct unspecified unspecified  	O	null
5 ראשי ראשי ראשי adjective masculine singular absolute unspecified unspecified  	O	null
6 של של של shel-preposition unspecified unspecified unspecified unspecified unspecified  	O	null
7 מוסף מוסף מוסף noun masculine singular construct unspecified unspecified  	O	null
8 ה ה התרבות definiteArticle unspecified unspecified unspecified unspecified unspecified 0 
8 התרבות תרבות התרבות noun feminine singular absolute unspecified unspecified  	O	null
9 " " " punctuation unspecified unspecified unspecified unspecified unspecified  	O	null
10 אוקְנה אוקְנה אוקְנה properName unspecified unspecified unspecified unspecified unspecified  	I_ORG	null
11 " " " punctuation unspecified unspecified unspecified unspecified unspecified  	O	null
12 ( ( ( punctuation unspecified unspecified unspecified unspecified unspecified  	O	null
13 חלונות חלון חלונות noun masculine plural absolute unspecified unspecified  	O	null
14 ) ) ) punctuation unspecified unspecified unspecified unspecified unspecified  	O	null
15 של של של shel-preposition unspecified unspecified unspecified unspecified unspecified  	O	null
16 ה ה העיתון definiteArticle unspecified unspecified unspecified unspecified unspecified 0 
16 העיתון עיתון העיתון noun masculine singular absolute unspecified unspecified  	O	null
17 ו ו וסטי conjunction unspecified unspecified unspecified unspecified unspecified 0 
17 סטי סט וסטי noun masculine plural construct unspecified unspecified  	O	null
18 , , , punctuation unspecified unspecified unspecified unspecified unspecified  	O	null
19 שבו ישב שבו verb masculine-and-feminine plural unspecified 2 imperative  	O	null
20 פירסם פרסם פירסם verb masculine singular unspecified 3 past  	O	null
21 מאז מאז מאז adverb unspecified unspecified unspecified unspecified unspecified  	O	null
22 ראשית ראשית ראשית noun feminine singular construct unspecified unspecified  	O	null
23 שנות שנה שנות noun feminine plural construct unspecified unspecified  	I_DATE	null
24 ה ה התשעים definiteArticle unspecified unspecified unspecified unspecified unspecified 0 
24 התשעים ORD-CARD90 התשעים numeral masculine-and-feminine plural absolute unspecified unspecified  	I_DATE	null
25 מאמרים מאמר מאמרים noun masculine plural absolute unspecified unspecified  	O	null
26 , , , punctuation unspecified unspecified unspecified unspecified unspecified  	O	null
27 מסות מסה מסות noun feminine plural absolute unspecified unspecified  	O	null
28 , , , punctuation unspecified unspecified unspecified unspecified unspecified  	O	null
29 ביקורות ביקורת ביקורות noun feminine plural absolute unspecified unspecified  	O	null
30 ספרים ספר ספרים noun masculine plural absolute unspecified unspecified  	O	null
31 ו ו ופרקים conjunction unspecified unspecified unspecified unspecified unspecified 0 
31 פרקים פארק ופרקים noun masculine plural absolute unspecified unspecified  	O	null
32 מ מ מספריו preposition unspecified unspecified unspecified unspecified unspecified 0 
32 ספרי ספר מספריו noun masculine plural absolute unspecified unspecified  
32 ו ו מספריו possessive masculine singular unspecified 3 unspecified 0 	O	null
33 ב ב בכתובים preposition unspecified unspecified unspecified unspecified unspecified 0 
33 כתובים כתוב בכתובים noun masculine plural absolute unspecified unspecified  	O	null
34 . . . punctuation unspecified unspecified unspecified unspecified unspecified  	O	null

0 היה הוא היה copula masculine singular unspecified 3 past  	O	null
1 חבר חיבר חבר verb masculine singular unspecified 2 imperative  	O	null
2 מרכזי מרכזי מרכזי adjective masculine singular absolute unspecified unspecified  	O	null
3 ב ב במערכת preposition unspecified unspecified unspecified unspecified unspecified 0 
3 מערכת מערכה במערכת noun feminine singular construct unspecified unspecified  	O	null
4 כתב כתב כתב noun masculine singular construct unspecified unspecified  	O	null
5 ה ה העת definiteArticle unspecified unspecified unspecified unspecified unspecified 0 
5 העת עת העת noun feminine singular absolute unspecified unspecified  	O	null
6 ה ה התל definiteArticle unspecified unspecified unspecified unspecified unspecified 0 
6 התל תל התל noun masculine singular absolute unspecified unspecified  	O	null
7 - - - punctuation unspecified unspecified unspecified unspecified unspecified  	O	null
8 אביבי אביבי אביבי adjective masculine singular absolute unspecified unspecified  	O	null
9 זרקלו זרקלו זרקלו properName unspecified unspecified unspecified unspecified unspecified  	I_PERS	null
10 . . . punctuation unspecified unspecified unspecified unspecified unspecified  	O	null

0 ספר ספר ספרו noun masculine singular absolute unspecified unspecified  
0 ו ו ספרו possessive masculine singular unspecified 3 unspecified 0 	O	null
1 ה ה הראשון definiteArticle unspecified unspecified unspecified unspecified unspecified 0 
1 הראשון ORD1 הראשון numeral masculine singular absolute unspecified unspecified  	O	null
2 , , , punctuation unspecified unspecified unspecified unspecified unspecified  	O	null
3 ה ה הפרידה definiteArticle unspecified unspecified unspecified unspecified unspecified 0 
3 הפרידה פרידה הפרידה noun feminine singular absolute unspecified unspecified  	O	null
4 מ מ מנרקיס preposition unspecified unspecified unspecified unspecified unspecified 0 
4 נרקיס נרקיס מנרקיס properName unspecified unspecified unspecified unspecified unspecified  	I_PERS	null
5 ) ) ) punctuation unspecified unspecified unspecified unspecified unspecified  	O	null
6 , , , punctuation unspecified unspecified unspecified unspecified unspecified  	O	null
7 ###NUMBER### ###NUMBER### ###NUMBER### numeral unspecified unspecified unspecified unspecified unspecified  	I_DATE	null
8 התקבל התקבל התקבל verb masculine singular unspecified 3 past  	O	null
9 ב ב בהתלהבות preposition unspecified unspecified unspecified unspecified unspecified 0 
9 התלהבות התלהבות בהתלהבות noun feminine singular absolute unspecified unspecified  	O	null
10 ב ב ברוסיה preposition unspecified unspecified unspecified unspecified unspecified 0 
10 רוסיה רוסי ברוסיה properName unspecified unspecified unspecified unspecified unspecified  	I_LOC	null
11 . . . punctuation unspecified unspecified unspecified unspecified unspecified  	O	null

0 זהו זהו זהו pronoun masculine singular unspecified 3 unspecified  	O	null
1 מבחר מבחר מבחר quantifier unspecified unspecified construct unspecified unspecified  	O	null
2 מסות מסה מסות noun feminine plural absolute unspecified unspecified  	O	null
3 , , , punctuation unspecified unspecified unspecified unspecified unspecified  	O	null
4 ש ש שיש relativizer/subordinatingConjunction unspecified unspecified unspecified unspecified unspecified 0 
4 יש יש שיש existential unspecified unspecified unspecified unspecified unspecified  	O	null
5 ב ב בהן preposition unspecified unspecified unspecified unspecified unspecified 0 
5 הן הוא בהן pronoun feminine plural unspecified 3 unspecified  	O	null
6 מבט מבט מבט noun masculine singular absolute unspecified unspecified  	O	null
7 חדשני חדשני חדשני adjective masculine singular absolute unspecified unspecified  	O	null
8 על על על preposition unspecified unspecified unspecified unspecified unspecified  	O	null
9 תולדות תולדה תולדות noun feminine plural construct unspecified unspecified  	O	null
10 ה ה הספרות definiteArticle unspecified unspecified unspecified unspecified unspecified 0 
10 הספרות ספרות הספרות noun feminine singular absolute unspecified unspecified  	O	null
11 ה ה הרוסית definiteArticle unspecified unspecified unspecified unspecified unspecified 0 
11 הרוסית רוסי הרוסית adjective feminine singular absolute unspecified unspecified  	O	null
12 , , , punctuation unspecified unspecified unspecified unspecified unspecified  	O	null
13 ו ו ובעיקר conjunction unspecified unspecified unspecified unspecified unspecified 0 
13 בעיקר בעיקר ובעיקר adverb unspecified unspecified unspecified unspecified unspecified  	O	null
14 על על על preposition unspecified unspecified unspecified unspecified unspecified  	O	null
15 ה ה המתח definiteArticle unspecified unspecified unspecified unspecified unspecified 0 
15 המתח מתח המתח noun masculine singular absolute unspecified unspecified  	O	null
16 בין בין בין preposition unspecified unspecified unspecified unspecified unspecified  	O	null
17 ה ה המטרופולין definiteArticle unspecified unspecified unspecified unspecified unspecified 0 
17 המטרופולין מטרופולין המטרופולין noun masculine singular absolute unspecified unspecified  	O	null
18 ל ל לפזורה preposition unspecified unspecified unspecified unspecified unspecified 0 
18 ה ה לפזורה definiteArticle unspecified unspecified unspecified unspecified unspecified 0 
18 הפזורה פזורה לפזורה noun feminine singular absolute unspecified unspecified  	O	null
19 . . . punctuation unspecified unspecified unspecified unspecified unspecified  	O	null

0 עודמיצירותיו עודמיצירותיו עודמיצירותיו participle masculine plural construct any unspecified  	O	null
1 : : : punctuation unspecified unspecified unspecified unspecified unspecified  	O	null
2 ה ה הרומן definiteArticle unspecified unspecified unspecified unspecified unspecified 0 
2 הרומן רומן הרומן noun masculine singular absolute unspecified unspecified  	O	null
3 היבטי היבט היבטיו noun masculine plural absolute unspecified unspecified  
3 ו ו היבטיו possessive masculine singular unspecified 3 unspecified 0 	O	null
4 של של של shel-preposition unspecified unspecified unspecified unspecified unspecified  	O	null
5 ה ה הזיווג definiteArticle unspecified unspecified unspecified unspecified unspecified 0 
5 הזיווג זיווג הזיווג noun masculine singular absolute unspecified unspecified  	O	null
6 ה ה הרוחני definiteArticle unspecified unspecified unspecified unspecified unspecified 0 
6 הרוחני רוחני הרוחני adjective masculine singular absolute unspecified unspecified  	O	null
7 ) ) ) punctuation unspecified unspecified unspecified unspecified unspecified  	O	null
8 , , , punctuation unspecified unspecified unspecified unspecified unspecified  	O	null
9 ###NUMBER### ###NUMBER### ###NUMBER### numeral unspecified unspecified unspecified unspecified unspecified  	I_DATE	null
10 ה ה המשלב definiteArticle unspecified unspecified unspecified unspecified unspecified 0 
10 המשלב שילב המשלב participle masculine singular absolute any unspecified  	O	null
11 חומר חומר חומר noun masculine singular absolute unspecified unspecified  	O	null
12 אוטוביוגרפי אוטוביוגרפי אוטוביוגרפי adjective masculine singular absolute unspecified unspecified  	O	null
13 , , , punctuation unspecified unspecified unspecified unspecified unspecified  	O	null
14 תמונות תמונה תמונות noun feminine plural absolute unspecified unspecified  	O	null
15 מ מ מהחיים preposition unspecified unspecified unspecified unspecified unspecified 0 
15 ה ה מהחיים definiteArticle unspecified unspecified unspecified unspecified unspecified 0 
15 החיים חיים מהחיים noun masculine plural absolute unspecified unspecified  	O	null
16 ה ה העכשוויים definiteArticle unspecified unspecified unspecified unspecified unspecified 0 
16 העכשוויים עכשווי העכשוויים adjective masculine plural absolute unspecified unspecified  	O	null
17 ו ו ומסות conjunction unspecified unspecified unspecified unspecified unspecified 0 
17 מסות מסה ומסות noun feminine plural absolute unspecified unspecified  	O	null
18 פילולוגיות פילולוגיות פילולוגיות adjective feminine plural absolute unspecified unspecified  	O	null
19 . . . punctuation unspecified unspecified unspecified unspecified unspecified  	O	null

0 פרקים פארק פרקים noun masculine plural absolute unspecified unspecified  	O	null
1 מן מן ממנו preposition unspecified unspecified unspecified unspecified unspecified  
1 ו ו ממנו pronomial masculine singular unspecified 3 unspecified 0 	O	null
2 פורסמו פורסם פורסמו verb masculine-and-feminine plural unspecified 3 past  	O	null
3 ב ב בתרגום preposition unspecified unspecified unspecified unspecified unspecified 0 
3 תרגום תרגום בתרגום noun masculine singular absolute unspecified unspecified  	O	null
4 ל ל לעברית preposition unspecified unspecified unspecified unspecified unspecified 0 
4 עברית עברית לעברית properName feminine singular unspecified unspecified unspecified  	I_PERS	null
5 באנתולוגיה באנתולוגיה באנתולוגיה properName unspecified unspecified unspecified unspecified unspecified  	I_PERS	null
6 זרקלו זרקלו זרקלו properName unspecified unspecified unspecified unspecified unspecified  	I_PERS	null
7 : : : punctuation unspecified unspecified unspecified unspecified unspecified  	O	null
8 ראילספרותרוסיתעכשווית ראילספרותרוסיתעכשווית ראילספרותרוסיתעכשווית verb feminine singular unspecified 2 imperative  	O	null
9 ( ( ( punctuation unspecified unspecified unspecified unspecified unspecified  	O	null
10 ה ה הקיבוץ definiteArticle unspecified unspecified unspecified unspecified unspecified 0 
10 הקיבוץ קיבוץ הקיבוץ noun masculine singular absolute unspecified unspecified  	O	null
11 ה ה המאוחד definiteArticle unspecified unspecified unspecified unspecified unspecified 0 
11 המאוחד מאוחד המאוחד adjective masculine singular absolute unspecified unspecified  	O	null
12 , , , punctuation unspecified unspecified unspecified unspecified unspecified  	O	null
13 ) ) ) punctuation unspecified unspecified unspecified unspecified unspecified  	O	null
14 ; ; ; punctuation unspecified unspecified unspecified unspecified unspecified  	O	null
15 ###NUMBER### ###NUMBER### ###NUMBER### numeral unspecified unspecified unspecified unspecified unspecified  	I_DATE	null
16 רומן רומן רומן properName unspecified unspecified unspecified unspecified unspecified  	I_PERS	null
17 פנטסמגורי פנטסמגורי פנטסמגורי properName unspecified unspecified unspecified unspecified unspecified  	I_PERS	null
18 סאטירי סאטירי סאטירי properName unspecified unspecified unspecified unspecified unspecified  	I_PERS	null
19 , , , punctuation unspecified unspecified unspecified unspecified unspecified  	O	null
20 זכור זכור זכור adjective masculine singular absolute unspecified unspecified  	O	null
21 את את את at-preposition unspecified unspecified unspecified unspecified unspecified  	O	null
22 פמגוסטה פמגוסטה פמגוסטה properName unspecified unspecified unspecified unspecified unspecified  	I_PERS	null
23 ) ) ) punctuation unspecified unspecified unspecified unspecified unspecified  	O	null
24 , , , punctuation unspecified unspecified unspecified unspecified unspecified  	O	null
25 ###NUMBER### ###NUMBER### ###NUMBER### numeral unspecified unspecified unspecified unspecified unspecified  	I_DATE	null
26 ש ש שעלילתו relativizer/subordinatingConjunction unspecified unspecified unspecified unspecified unspecified 0 
26 עלילת עלילה שעלילתו noun feminine singular absolute unspecified unspecified  
26 ו ו שעלילתו possessive masculine singular unspecified 3 unspecified 0 	O	null
27 מתרחשת התרחש מתרחשת verb feminine singular unspecified any beinoni  	O	null
28 ב ב בחללים preposition unspecified unspecified unspecified unspecified unspecified 0 
28 חללים חלל בחללים noun masculine plural absolute unspecified unspecified  	O	null
29 היסטוריים היסטורי היסטוריים adjective masculine plural absolute unspecified unspecified  	O	null
30 ו ו וגיאוגרפיים conjunction unspecified unspecified unspecified unspecified unspecified 0 
30 גיאוגרפיים גיאוגרפי וגיאוגרפיים adjective masculine plural absolute unspecified unspecified  	O	null
31 שונים שונה שונים adjective masculine plural absolute unspecified unspecified  	O	null
32 , , , punctuation unspecified unspecified unspecified unspecified unspecified  	O	null
33 מ מ מארץ preposition unspecified unspecified unspecified unspecified unspecified 0 
33 ארץ ארץ מארץ noun feminine singular construct unspecified unspecified  	I_LOC	null
34 ישראל ישראל ישראל properName unspecified unspecified unspecified unspecified unspecified  	I_LOC	null
35 עד עד עד preposition unspecified unspecified unspecified unspecified unspecified  	I_LOC	null
36 רוסיה רוסי רוסיה properName unspecified unspecified unspecified unspecified unspecified  	I_LOC	null
37 ו ו ומקפריסין conjunction unspecified unspecified unspecified unspecified unspecified 0 
37 מ מ ומקפריסין preposition unspecified unspecified unspecified unspecified unspecified 0 
37 קפריסין קפריסין ומקפריסין properName unspecified unspecified unspecified unspecified unspecified  	B_LOC	null
38 עד עד עד preposition unspecified unspecified unspecified unspecified unspecified  	I_LOC	null
39 קווקז קווקז קווקז properName unspecified unspecified unspecified unspecified unspecified  	I_LOC	null
40 . . . punctuation unspecified unspecified unspecified unspecified unspecified  	O	null

0 גיבורי גיבור גיבוריו noun masculine plural absolute unspecified unspecified  
0 ו ו גיבוריו possessive masculine singular unspecified 3 unspecified 0 	O	null
1 מחפשים חיפש מחפשים verb masculine plural unspecified any beinoni  	O	null
2 מעשה מעשה מעשה noun masculine singular absolute unspecified unspecified  	O	null
3 ממשי ממשי ממשי adjective masculine singular absolute unspecified unspecified  	O	null
4 ש ש שיביא relativizer/subordinatingConjunction unspecified unspecified unspecified unspecified unspecified 0 
4 יביא הביא שיביא verb masculine singular unspecified 3 future  	O	null
5 ל ל לתיקון preposition unspecified unspecified unspecified unspecified unspecified 0 
5 תיקון תיקון לתיקון noun masculine singular construct unspecified unspecified  	O	null
6 ה ה העולם definiteArticle unspecified unspecified unspecified unspecified unspecified 0 
6 העולם עולם העולם noun masculine singular absolute unspecified unspecified  	O	null
7 , , , punctuation unspecified unspecified unspecified unspecified unspecified  	O	null
8 ה ה השרוי definiteArticle unspecified unspecified unspecified unspecified unspecified 0 
8 השרוי שרוי השרוי adjective masculine singular absolute unspecified unspecified  	O	null
9 ב ב באדישות preposition unspecified unspecified unspecified unspecified unspecified 0 
9 ה ה באדישות definiteArticle unspecified unspecified unspecified unspecified unspecified 0 
9 האדישות אדישות באדישות noun feminine singular absolute unspecified unspecified  	O	null
10 . . . punctuation unspecified unspecified unspecified unspecified unspecified  	O	null

0 פרקי פרק פרקי noun masculine plural construct unspecified unspecified  	O	null
1 ה ה הספר definiteArticle unspecified unspecified unspecified unspecified unspecified 0 
1 הספר ספר הספר noun masculine singular absolute unspecified unspecified  	O	null
2 פורסמו פורסם פורסמו verb masculine-and-feminine plural unspecified 3 past  	O	null
3 ב ב בתרגום preposition unspecified unspecified unspecified unspecified unspecified 0 
3 תרגום תרגום בתרגום noun masculine singular absolute unspecified unspecified  	O	null
4 ל ל לעברית preposition unspecified unspecified unspecified unspecified unspecified 0 
4 עברית עברית לעברית properName feminine singular unspecified unspecified unspecified  	I_PERS	null
5 באנתולוגיה באנתולוגיה באנתולוגיה properName unspecified unspecified unspecified unspecified unspecified  	I_PERS	null
6 זרקלו זרקלו זרקלו properName unspecified unspecified unspecified unspecified unspecified  	I_PERS	null
7 : : : punctuation unspecified unspecified unspecified unspecified unspecified  	O	null
8 יצירה יצירה יצירה noun feminine singular absolute unspecified unspecified  	O	null
9 רוסית רוסי רוסית adjective feminine singular absolute unspecified unspecified  	O	null
10 עכשווית עכשווי עכשווית adjective feminine singular absolute unspecified unspecified  	O	null
11 ב ב בשיח preposition unspecified unspecified unspecified unspecified unspecified 0 
11 ה ה בשיח definiteArticle unspecified unspecified unspecified unspecified unspecified 0 
11 השיח שיח בשיח noun masculine singular absolute unspecified unspecified  	O	null
12 ה ה הישראלי definiteArticle unspecified unspecified unspecified unspecified unspecified 0 
12 הישראלי ישראלי הישראלי adjective masculine singular absolute unspecified unspecified  	O	null
13 ( ( ( punctuation unspecified unspecified unspecified unspecified unspecified  	O	null
14 עם עם עם preposition unspecified unspecified unspecified unspecified unspecified  	O	null
15 עובד עובד עובד noun masculine singular absolute unspecified unspecified  	O	null
16 , , , punctuation unspecified unspecified unspecified unspecified unspecified  	O	null
17 ###NUMBER### ###NUMBER### ###NUMBER### numeral unspecified unspecified unspecified unspecified unspecified  	I_DATE	null
18 ) ) ) punctuation unspecified unspecified unspecified unspecified unspecified  	O	null
19 . . . punctuation unspecified unspecified unspecified unspecified unspecified  	O	null

0 ה ה הרומן definiteArticle unspecified unspecified unspecified unspecified unspecified 0 
0 הרומן רומן הרומן noun masculine singular absolute unspecified unspecified  	O	null
1 ה ה השדות definiteArticle unspecified unspecified unspecified unspecified unspecified 0 
1 השדות שדה השדות noun masculine plural absolute unspecified unspecified  	O	null
2 ה ה השלווים definiteArticle unspecified unspecified unspecified unspecified unspecified 0 
2 השלווים שלו השלווים adjective masculine plural absolute unspecified unspecified  	O	null
3 ( ( ( punctuation unspecified unspecified unspecified unspecified unspecified  	O	null
4 ###NUMBER### ###NUMBER### ###NUMBER### numeral unspecified unspecified unspecified unspecified unspecified  	I_DATE	null
5 ) ) ) punctuation unspecified unspecified unspecified unspecified unspecified  	O	null
6 ראה ראה ראה verb masculine singular unspecified 3 past  	O	null
7 אור אור אור noun masculine singular absolute unspecified unspecified  	O	null
8 אחרי אחרי אחרי preposition unspecified unspecified unspecified unspecified unspecified  	O	null
9 מות מוות מותו noun masculine singular absolute unspecified unspecified  
9 ו ו מותו possessive masculine singular unspecified 3 unspecified 0 	O	null
10 ו ו וזכה conjunction unspecified unspecified unspecified unspecified unspecified 0 
10 זכה זכה וזכה verb masculine singular unspecified 3 past  	O	null
11 ב ב בפרס preposition unspecified unspecified unspecified unspecified unspecified 0 
11 ה ה בפרס definiteArticle unspecified unspecified unspecified unspecified unspecified 0 
11 הפרס פרס בפרס noun masculine singular absolute unspecified unspecified  	O	null
12 ה ה הספרותי definiteArticle unspecified unspecified unspecified unspecified unspecified 0 
12 הספרותי ספרותי הספרותי adjective masculine singular absolute unspecified unspecified  	O	null
13 על על על preposition unspecified unspecified unspecified unspecified unspecified  	O	null
14 שם שם שם noun masculine singular construct unspecified unspecified  	O	null
15 אנדריי אנדריי אנדריי properName unspecified unspecified unspecified unspecified unspecified  	I_PERS	null
16 ביילי בייל ביילי verb feminine singular unspecified 2 imperative  	O	null
17 . . . punctuation unspecified unspecified unspecified unspecified unspecified  	O	null

0 יש יש יש existential unspecified unspecified unspecified unspecified unspecified  	O	null
1 ב ב בו preposition unspecified unspecified unspecified unspecified unspecified  
1 ו ו בו pronomial masculine singular unspecified 3 unspecified 0 	O	null
2 שילוב שילוב שילוב noun masculine singular absolute unspecified unspecified  	O	null
3 של של של shel-preposition unspecified unspecified unspecified unspecified unspecified  	O	null
4 תמונות תמונה תמונות noun feminine plural absolute unspecified unspecified  	O	null
5 חושפניות חושפני חושפניות adjective feminine plural absolute unspecified unspecified  	O	null
6 של של של shel-preposition unspecified unspecified unspecified unspecified unspecified  	O	null
7 חיי חיים חיי noun masculine plural construct unspecified unspecified  	O	null
8 יומיום יומיום יומיום properName unspecified unspecified unspecified unspecified unspecified  	I_ORG	null
9 אכזריים אכזרי אכזריים adjective masculine plural absolute unspecified unspecified  	O	null
10 עם עם עם preposition unspecified unspecified unspecified unspecified unspecified  	O	null
11 ה ה הצד definiteArticle unspecified unspecified unspecified unspecified unspecified 0 
11 הצד צד הצד noun masculine singular absolute unspecified unspecified  	O	null
12 ה ה החלומי definiteArticle unspecified unspecified unspecified unspecified unspecified 0 
12 החלומי חלומי החלומי adjective masculine singular absolute unspecified unspecified  	O	null
13 של של של shel-preposition unspecified unspecified unspecified unspecified unspecified  	O	null
14 ה ה ההוויה definiteArticle unspecified unspecified unspecified unspecified unspecified 0 
14 ההוויה הוויה ההוויה noun feminine singular absolute unspecified unspecified  	O	null
15 . . . punctuation unspecified unspecified unspecified unspecified unspecified  	O	null

0 גיבורי גיבור גיבוריו noun masculine plural absolute unspecified unspecified  
0 ו ו גיבוריו possessive masculine singular unspecified 3 unspecified 0 	O	null
1 , , , punctuation unspecified unspecified unspecified unspecified unspecified  	O	null
2 ה ה הרומנטיקנים definiteArticle unspecified unspecified unspecified unspecified unspecified 0 
2 הרומנטיקנים הרומנטיקנים הרומנטיקנים noun masculine plural absolute unspecified unspecified  	O	null
3 ו ו והמיסטיקנים conjunction unspecified unspecified unspecified unspecified unspecified 0 
3 ה ה והמיסטיקנים definiteArticle unspecified unspecified unspecified unspecified unspecified 0 
3 המיסטיקנים מיסטיקן והמיסטיקנים noun masculine plural absolute unspecified unspecified  	O	null
4 , , , punctuation unspecified unspecified unspecified unspecified unspecified  	O	null
5 אנשי איש אנשי noun masculine plural construct unspecified unspecified  	O	null
6 ה ה המעשה definiteArticle unspecified unspecified unspecified unspecified unspecified 0 
6 המעשה מעשה המעשה noun masculine singular absolute unspecified unspecified  	O	null
7 ו ו ובעלי conjunction unspecified unspecified unspecified unspecified unspecified 0 
7 בעלי בעל ובעלי noun masculine plural construct unspecified unspecified  	O	null
8 ה ה הדמיונות definiteArticle unspecified unspecified unspecified unspecified unspecified 0 
8 הדמיונות דמיון הדמיונות noun masculine plural absolute unspecified unspecified  	O	null
9 , , , punctuation unspecified unspecified unspecified unspecified unspecified  	O	null
10 שרויים שרוי שרויים adjective masculine plural absolute unspecified unspecified  	O	null
11 ב ב באווירת preposition unspecified unspecified unspecified unspecified unspecified 0 
11 אווירת אווירה באווירת noun feminine singular construct unspecified unspecified  	O	null
12 תעתועים תעתוע תעתועים noun masculine plural absolute unspecified unspecified  	O	null
13 . . . punctuation unspecified unspecified unspecified unspecified unspecified  	O	null

0 ה ה העלילה definiteArticle unspecified unspecified unspecified unspecified unspecified 0 
0 העלילה עלילה העלילה noun feminine singular absolute unspecified unspecified  	O	null
1 משתרעת השתרע משתרעת verb feminine singular unspecified any beinoni  	O	null
2 בין בין בין preposition unspecified unspecified unspecified unspecified unspecified  	O	null
3 אלכסנדריה אלכסנדריה אלכסנדריה properName unspecified unspecified unspecified unspecified unspecified  	I_LOC	null
4 ל ל לפטרבורג preposition unspecified unspecified unspecified unspecified unspecified 0 
4 פטרבורג פטרבורג לפטרבורג properName unspecified unspecified unspecified unspecified unspecified  	I_LOC	null
5 . . . punctuation unspecified unspecified unspecified unspecified unspecified  	O	null

0 ב ב ב preposition unspecified unspecified unspecified unspecified unspecified 0 	I_ORG	null
1 - - - punctuation unspecified unspecified unspecified unspecified unspecified  	I_ORG	null
2 ###NUMBER### ###NUMBER### ###NUMBER### numeral unspecified unspecified unspecified unspecified unspecified  	I_DATE	null
3 יצא יצא יצא verb masculine singular unspecified 3 past  	O	null
4 אוסף אוסף אוסף noun masculine singular construct unspecified unspecified  	O	null
5 מסות מסה מסותיו noun feminine plural absolute unspecified unspecified  
5 ו ו מסותיו possessive masculine singular unspecified 3 unspecified 0 	O	null
6 ו ו ומאמריו conjunction unspecified unspecified unspecified unspecified unspecified 0 
6 מאמרי מאמר ומאמריו noun masculine plural absolute unspecified unspecified  
6 ו ו ומאמריו possessive masculine singular unspecified 3 unspecified 0 	O	null
7 ל ל לזכר preposition unspecified unspecified unspecified unspecified unspecified 0 
7 זכר זכר לזכר noun masculine singular construct unspecified unspecified  	O	null
8 ה ה הפאתוס definiteArticle unspecified unspecified unspecified unspecified unspecified 0 
8 הפאתוס פתוס הפאתוס noun masculine singular absolute unspecified unspecified  	O	null
9 . . . punctuation unspecified unspecified unspecified unspecified unspecified  	O	null

0 תרגום תרגום תרגום noun masculine singular absolute unspecified unspecified  	O	null
1 נוסף נוסף נוסף adjective masculine singular absolute unspecified unspecified  	O	null
2 מ מ מיצירתו preposition unspecified unspecified unspecified unspecified unspecified 0 
2 יצירת יצירה מיצירתו noun feminine singular absolute unspecified unspecified  
2 ו ו מיצירתו possessive masculine singular unspecified 3 unspecified 0 	O	null
3 ל ל לעברית preposition unspecified unspecified unspecified unspecified unspecified 0 
3 עברית עברית לעברית properName feminine singular unspecified unspecified unspecified  	I_LOC	null
4 , , , punctuation unspecified unspecified unspecified unspecified unspecified  	O	null
5 " " " punctuation unspecified unspecified unspecified unspecified unspecified  	O	null
6 בית בית בית noun masculine singular absolute unspecified unspecified  	O	null
7 ב ב בסמטה preposition unspecified unspecified unspecified unspecified unspecified 0 
7 ה ה בסמטה definiteArticle unspecified unspecified unspecified unspecified unspecified 0 
7 הסמטה סמטה בסמטה noun feminine singular absolute unspecified unspecified  	O	null
8 " " " punctuation unspecified unspecified unspecified unspecified unspecified  	O	null
9 , , , punctuation unspecified unspecified unspecified unspecified unspecified  	O	null
10 הופיע הופיע הופיע verb masculine singular unspecified 3 past  	O	null
11 ב ב באנתולוגיה preposition unspecified unspecified unspecified unspecified unspecified 0 
11 אנתולוגיה אנתולוגיה באנתולוגיה noun feminine singular absolute unspecified unspecified  	O	null
12 רוחות רוח רוחות noun feminine plural construct unspecified unspecified  	O	null
13 ה ה הרפאים definiteArticle unspecified unspecified unspecified unspecified unspecified 0 
13 הרפאים רפאים הרפאים noun masculine plural absolute unspecified unspecified  	O	null
14 של של של shel-preposition unspecified unspecified unspecified unspecified unspecified  	O	null
15 ישראל ישראל ישראל properName unspecified unspecified unspecified unspecified unspecified  	I_PERS	null
16 ) ) ) punctuation unspecified unspecified unspecified unspecified unspecified  	O	null
17 . . . punctuation unspecified unspecified unspecified unspecified unspecified  	O	null
18 ###NUMBER### ###NUMBER### ###NUMBER### numeral unspecified unspecified unspecified unspecified unspecified  	I_DATE	null
19 חרף חרף חרף preposition unspecified unspecified unspecified unspecified unspecified  	O	null
20 תביעת תביעה תביעתו noun feminine singular absolute unspecified unspecified  
20 ו ו תביעתו possessive masculine singular unspecified 3 unspecified 0 	O	null
21 ה ה המפורשת definiteArticle unspecified unspecified unspecified unspecified unspecified 0 
21 המפורשת מפורש המפורשת adjective feminine singular absolute unspecified unspecified  	O	null
22 להיענות נענה להיענות verb unspecified unspecified unspecified unspecified infinitive  	O	null
23 ל ל לדרישותיו preposition unspecified unspecified unspecified unspecified unspecified 0 
23 דרישות דרישה לדרישותיו noun feminine plural absolute unspecified unspecified  
23 ו ו לדרישותיו possessive masculine singular unspecified 3 unspecified 0 	O	null
24 של של של shel-preposition unspecified unspecified unspecified unspecified unspecified  	O	null
25 ה ה הקורא definiteArticle unspecified unspecified unspecified unspecified unspecified 0 
25 הקורא קורא הקורא noun masculine singular absolute unspecified unspecified  	O	null
26 ה ה הפשוט definiteArticle unspecified unspecified unspecified unspecified unspecified 0 
26 הפשוט פשוט הפשוט adjective masculine singular absolute unspecified unspecified  	O	null
27 , , , punctuation unspecified unspecified unspecified unspecified unspecified  	O	null
28 כתיבת כתיבה כתיבתו noun feminine singular absolute unspecified unspecified  
28 ו ו כתיבתו possessive masculine singular unspecified 3 unspecified 0 	O	null
29 לא לא לא negation unspecified unspecified unspecified unspecified unspecified  	O	null
30 התיימרה התיימר התיימרה verb feminine singular unspecified 3 past  	O	null
31 לסלול סלל לסלול verb unspecified unspecified unspecified unspecified infinitive  	O	null
32 דרך דרך דרך noun feminine singular absolute unspecified unspecified  	O	null
33 אל אל אל preposition unspecified unspecified unspecified unspecified unspecified  	O	null
34 לב לב לבו noun masculine singular absolute unspecified unspecified  
34 ו ו לבו possessive masculine singular unspecified 3 unspecified 0 	O	null
35 של של של shel-preposition unspecified unspecified unspecified unspecified unspecified  	O	null
36 ה ה הקהל definiteArticle unspecified unspecified unspecified unspecified unspecified 0 
36 הקהל קהל הקהל noun masculine singular absolute unspecified unspecified  	O	null
37 ה ה הרחב definiteArticle unspecified unspecified unspecified unspecified unspecified 0 
37 הרחב רחב הרחב adjective masculine singular absolute unspecified unspecified  	O	null
38 , , , punctuation unspecified unspecified unspecified unspecified unspecified  	O	null
39 ו ו ואילו conjunction unspecified unspecified unspecified unspecified unspecified 0 
39 אילו אילו ואילו conjunction unspecified unspecified unspecified unspecified unspecified  	O	null
40 ב ב בחוגים preposition unspecified unspecified unspecified unspecified unspecified 0 
40 ה ה בחוגים definiteArticle unspecified unspecified unspecified unspecified unspecified 0 
40 החוגים חוג בחוגים noun masculine plural absolute unspecified unspecified  	O	null
41 ה ה האינטלקטואליים definiteArticle unspecified unspecified unspecified unspecified unspecified 0 
41 האינטלקטואליים אינטלקטואלי האינטלקטואליים adjective masculine plural absolute unspecified unspecified  	O	null
42 ה ה המצומצמים definiteArticle unspecified unspecified unspecified unspecified unspecified 0 
42 המצומצמים מצומצם המצומצמים adjective masculine plural absolute unspecified unspecified  	O	null
43 היא הוא היא pronoun feminine singular unspecified 3 unspecified  	O	null
44 התקבלה התקבל התקבלה verb feminine singular unspecified 3 past  	O	null
45 ב ב בעניין preposition unspecified unspecified unspecified unspecified unspecified 0 
45 עניין עניין בעניין noun masculine singular absolute unspecified unspecified  	O	null
46 רב רב רב adjective masculine singular absolute unspecified unspecified  	O	null
47 ו ו ובהערכה conjunction unspecified unspecified unspecified unspecified unspecified 0 
47 ב ב ובהערכה preposition unspecified unspecified unspecified unspecified unspecified 0 
47 ה ה ובהערכה definiteArticle unspecified unspecified unspecified unspecified unspecified 0 
47 ההערכה הערכה ובהערכה noun feminine singular absolute unspecified unspecified  	O	null
48 . . . punctuation unspecified unspecified unspecified unspecified unspecified  	O	null

0 סגנון סגנון סגנונו noun masculine singular absolute unspecified unspecified  
0 ו ו סגנונו possessive masculine singular unspecified 3 unspecified 0 	O	null
1 ניסיוני ניסיוני ניסיוני adjective masculine singular absolute unspecified unspecified  	O	null
2 , , , punctuation unspecified unspecified unspecified unspecified unspecified  	O	null
3 גדוש גדוש גדוש adjective masculine singular absolute unspecified unspecified  	O	null
4 ב ב באלמנטים preposition unspecified unspecified unspecified unspecified unspecified 0 
4 אלמנטים אלמנט באלמנטים noun masculine plural absolute unspecified unspecified  	O	null
5 אקזוטיים אקזוטי אקזוטיים adjective masculine plural absolute unspecified unspecified  	O	null
6 , , , punctuation unspecified unspecified unspecified unspecified unspecified  	O	null
7 עשיר עשיר עשיר adjective masculine singular absolute unspecified unspecified  	O	null
8 ב ב באוצר preposition unspecified unspecified unspecified unspecified unspecified 0 
8 אוצר אוצר באוצר noun masculine singular construct unspecified unspecified  	O	null
9 ה ה המילים definiteArticle unspecified unspecified unspecified unspecified unspecified 0 
9 המילים מילה המילים noun feminine plural absolute unspecified unspecified  	O	null
10 ו ו ובאסוציאציות conjunction unspecified unspecified unspecified unspecified unspecified 0 
10 ב ב ובאסוציאציות preposition unspecified unspecified unspecified unspecified unspecified 0 
10 אסוציאציות אסוציאציות ובאסוציאציות noun feminine plural absolute unspecified unspecified  	O	null
11 תרבותיות תרבותי תרבותיות adjective feminine plural absolute unspecified unspecified  	O	null
12 ו ו ויוצר conjunction unspecified unspecified unspecified unspecified unspecified 0 
12 יוצר יוצר ויוצר verb masculine singular unspecified 3 past  	O	null
13 רקמה רקמה רקמה noun feminine singular absolute unspecified unspecified  	O	null
14 ספרותית ספרותי ספרותית adjective feminine singular absolute unspecified unspecified  	O	null
15 אורנמנטלית אורנמנטלית אורנמנטלית adjective feminine singular construct unspecified unspecified  	O	null
16 . . . punctuation unspecified unspecified unspecified unspecified unspecified  	O	null

0 ה ה העלילה definiteArticle unspecified unspecified unspecified unspecified unspecified 0 
0 העלילה עלילה העלילה noun feminine singular absolute unspecified unspecified  	O	null
1 לעתים לעתים לעתים adverb unspecified unspecified unspecified unspecified unspecified  	O	null
2 נשחקת נשחק נשחקת verb feminine singular unspecified any beinoni  	O	null
3 ב ב בפיתולי preposition unspecified unspecified unspecified unspecified unspecified 0 
3 פיתולי פיתול בפיתולי noun masculine plural construct unspecified unspecified  	O	null
4 ה ה הסגנון definiteArticle unspecified unspecified unspecified unspecified unspecified 0 
4 הסגנון סגנון הסגנון noun masculine singular absolute unspecified unspecified  	O	null
5 ה ה הברוקי definiteArticle unspecified unspecified unspecified unspecified unspecified 0 
5 הברוקי הברוקי הברוקי properName unspecified unspecified unspecified unspecified unspecified  	I_PERS	null
6 . . . punctuation unspecified unspecified unspecified unspecified unspecified  	O	null

0 ה ה הנושאים definiteArticle unspecified unspecified unspecified unspecified unspecified 0 
0 הנושאים נושא הנושאים noun masculine plural absolute unspecified unspecified  	O	null
1 ה ה העיקריים definiteArticle unspecified unspecified unspecified unspecified unspecified 0 
1 העיקריים עיקרי העיקריים adjective masculine plural absolute unspecified unspecified  	O	null
2 ב ב בספריו preposition unspecified unspecified unspecified unspecified unspecified 0 
2 ספרי ספר בספריו noun masculine plural absolute unspecified unspecified  
2 ו ו בספריו possessive masculine singular unspecified 3 unspecified 0 	O	null
3 הם הוא הם pronoun masculine plural unspecified 3 unspecified  	O	null
4 בדידות בדידות בדידותו noun feminine singular absolute unspecified unspecified  
4 ו ו בדידותו possessive masculine singular unspecified 3 unspecified 0 	O	null
5 של של של shel-preposition unspecified unspecified unspecified unspecified unspecified  	O	null
6 ה ה האדם definiteArticle unspecified unspecified unspecified unspecified unspecified 0 
6 האדם אדם האדם noun masculine singular absolute unspecified unspecified  	O	null
7 ב ב ביקום preposition unspecified unspecified unspecified unspecified unspecified 0 
7 ה ה ביקום definiteArticle unspecified unspecified unspecified unspecified unspecified 0 
7 היקום יקום ביקום noun masculine singular absolute unspecified unspecified  	O	null
8 ה ה המתפקע definiteArticle unspecified unspecified unspecified unspecified unspecified 0 
8 המתפקע התפקע המתפקע participle masculine singular absolute any unspecified  	O	null
9 מ מ מתרבות preposition unspecified unspecified unspecified unspecified unspecified 0 
9 תרבות תרבות מתרבות noun feminine singular absolute unspecified unspecified  	O	null
10 ו ו וחיפושיו conjunction unspecified unspecified unspecified unspecified unspecified 0 
10 חיפושי חיפוש וחיפושיו noun masculine plural absolute unspecified unspecified  
10 ו ו וחיפושיו possessive masculine singular unspecified 3 unspecified 0 	O	null
11 אחר אחר אחר preposition unspecified unspecified unspecified unspecified unspecified  	O	null
12 ה ה הממשי definiteArticle unspecified unspecified unspecified unspecified unspecified 0 
12 הממשי ממשי הממשי adjective masculine singular absolute unspecified unspecified  	O	null
13 ב ב בעולם preposition unspecified unspecified unspecified unspecified unspecified 0 
13 ה ה בעולם definiteArticle unspecified unspecified unspecified unspecified unspecified 0 
13 העולם עולם בעולם noun masculine singular absolute unspecified unspecified  	O	null
14 של של של shel-preposition unspecified unspecified unspecified unspecified unspecified  	O	null
15 בלהות בלהה בלהות noun feminine plural absolute unspecified unspecified  	O	null
16 . . . punctuation unspecified unspecified unspecified unspecified unspecified  	O	null

0 ה ה הסופר definiteArticle unspecified unspecified unspecified unspecified unspecified 0 
0 הסופר סופר הסופר noun masculine singular absolute unspecified unspecified  	O	null
1 ש ש שגדל relativizer/subordinatingConjunction unspecified unspecified unspecified unspecified unspecified 0 
1 גדל גדל שגדל verb masculine singular unspecified 3 past  	O	null
2 ב ב בבקו preposition unspecified unspecified unspecified unspecified unspecified 0 
2 בקו באקו בבקו properName unspecified unspecified unspecified unspecified unspecified  	O	null
3 – – – punctuation unspecified unspecified unspecified unspecified unspecified  	O	null
4 עיר עיר עיר noun feminine singular construct unspecified unspecified  	O	null
5 אקלקטית אקלקטית אקלקטית adjective feminine singular absolute unspecified unspecified  	O	null
6 , , , punctuation unspecified unspecified unspecified unspecified unspecified  	O	null
7 מזרחית מזרחי מזרחית adjective feminine singular absolute unspecified unspecified  	O	null
8 - - - punctuation unspecified unspecified unspecified unspecified unspecified  	O	null
9 מערבית מערבי מערבית adjective feminine singular absolute unspecified unspecified  	O	null
10 , , , punctuation unspecified unspecified unspecified unspecified unspecified  	O	null
11 ב ב בגבול preposition unspecified unspecified unspecified unspecified unspecified 0 
11 ה ה בגבול definiteArticle unspecified unspecified unspecified unspecified unspecified 0 
11 הגבול גבול בגבול noun masculine singular absolute unspecified unspecified  	O	null
12 ה ה הדרומי definiteArticle unspecified unspecified unspecified unspecified unspecified 0 
12 הדרומי דרומי הדרומי adjective masculine singular absolute unspecified unspecified  	O	null
13 של של של shel-preposition unspecified unspecified unspecified unspecified unspecified  	O	null
14 ה ה האימפריה definiteArticle unspecified unspecified unspecified unspecified unspecified 0 
14 האימפריה אימפריה האימפריה noun feminine singular absolute unspecified unspecified  	O	null
15 ה ה הסובייטית definiteArticle unspecified unspecified unspecified unspecified unspecified 0 
15 הסובייטית סובייטי הסובייטית adjective feminine singular absolute unspecified unspecified  	O	null
16 , , , punctuation unspecified unspecified unspecified unspecified unspecified  	O	null
17 צידד צידד צידד verb masculine singular unspecified 3 past  	O	null
18 ב ב במקומו preposition unspecified unspecified unspecified unspecified unspecified 0 
18 מקום מקום במקומו noun masculine singular absolute unspecified unspecified  
18 ו ו במקומו possessive masculine singular unspecified 3 unspecified 0 	O	null
19 ה ה החדש definiteArticle unspecified unspecified unspecified unspecified unspecified 0 
19 החדש חדש החדש adjective masculine singular absolute unspecified unspecified  	O	null
20 , , , punctuation unspecified unspecified unspecified unspecified unspecified  	O	null
21 ישראל ישראל ישראל properName unspecified unspecified unspecified unspecified unspecified  	I_PERS	null
22 , , , punctuation unspecified unspecified unspecified unspecified unspecified  	O	null
23 ו ו ובאידיאל conjunction unspecified unspecified unspecified unspecified unspecified 0 
23 ב ב ובאידיאל preposition unspecified unspecified unspecified unspecified unspecified 0 
23 אידיאל אידיאל ובאידיאל noun masculine singular construct unspecified unspecified  	O	null
24 ה ה הים definiteArticle unspecified unspecified unspecified unspecified unspecified 0 
24 הים ים הים noun masculine singular absolute unspecified unspecified  	O	null
25 - - - punctuation unspecified unspecified unspecified unspecified unspecified  	O	null
26 תיכוניות תיכוני תיכוניות adjective feminine plural absolute unspecified unspecified  	O	null
27 הקוסמופוליטית הקוסמופוליטית הקוסמופוליטית adverb unspecified unspecified unspecified unspecified unspecified  	O	null
28 . . . punctuation unspecified unspecified unspecified unspecified unspecified  	O	null

0 References References References foreign unspecified unspecified unspecified unspecified unspecified  	O	null
1 : : : punctuation unspecified unspecified unspecified unspecified unspecified  	O	null
2 שביט שביט שביט properName unspecified unspecified unspecified unspecified unspecified  	I_PERS	null
3 , , , punctuation unspecified unspecified unspecified unspecified unspecified  	O	null
4 אוריה אוריה אוריה properName unspecified unspecified unspecified unspecified unspecified  	I_PERS	null
5 . . . punctuation unspecified unspecified unspecified unspecified unspecified  	O	null

0 " " " punctuation unspecified unspecified unspecified unspecified unspecified  	O	null
1 זאת זאת זאת pronoun feminine singular unspecified 3 unspecified  	O	null
2 תרבות תרבות תרבות noun feminine singular absolute unspecified unspecified  	O	null
3 , , , punctuation unspecified unspecified unspecified unspecified unspecified  	O	null
4 זאת זאת זאת pronoun feminine singular unspecified 3 unspecified  	I_ORG	null
5 ? ? ? punctuation unspecified unspecified unspecified unspecified unspecified  	O	null
6 " " " punctuation unspecified unspecified unspecified unspecified unspecified  	O	null
7 . . . punctuation unspecified unspecified unspecified unspecified unspecified  	O	null

0 ה ה הארץ definiteArticle unspecified unspecified unspecified unspecified unspecified 0 
0 הארץ ארץ הארץ noun feminine singular absolute unspecified unspecified  	O	null
1 מוסף מוסף מוסף adjective masculine singular absolute unspecified unspecified  	O	null
2 . . . punctuation unspecified unspecified unspecified unspecified unspecified  	O	null

0 ###NUMEXP### ###NUMEXP### ###NUMEXP### numberExpression unspecified unspecified unspecified unspecified unspecified  	I_DATE	null
1 . . . punctuation unspecified unspecified unspecified unspecified unspecified  	O	null

0 ###NUMBER### ###NUMBER### ###NUMBER### numeral unspecified unspecified unspecified unspecified unspecified  	O	null
1 . . . punctuation unspecified unspecified unspecified unspecified unspecified  	O	null

