0 Name Name Name foreign unspecified unspecified unspecified unspecified unspecified  	O	null
1 : : : punctuation unspecified unspecified unspecified unspecified unspecified  	O	null
2 גורביץ' גורביץ' גורביץ' properName unspecified unspecified unspecified unspecified unspecified  	I_ORG	null
3 , , , punctuation unspecified unspecified unspecified unspecified unspecified  	O	null
4 זלי זלי זלי properName unspecified unspecified unspecified unspecified unspecified  	I_ORG	null
5 ( ( ( punctuation unspecified unspecified unspecified unspecified unspecified  	O	null
6 זלמן זלמן זלמן properName unspecified unspecified unspecified unspecified unspecified  	I_DATE	null
7 ) ) ) punctuation unspecified unspecified unspecified unspecified unspecified  	O	null
8 Birth Birth Birth foreign unspecified unspecified unspecified unspecified unspecified  	O	null
9 Year Year Year foreign unspecified unspecified unspecified unspecified unspecified  	O	null
10 : : : punctuation unspecified unspecified unspecified unspecified unspecified  	O	null
11 ###NUMBER### ###NUMBER### ###NUMBER### numeral unspecified unspecified unspecified unspecified unspecified  	I_DATE	null
12 Birth Birth Birth foreign unspecified unspecified unspecified unspecified unspecified  	O	null
13 Place Place Place foreign unspecified unspecified unspecified unspecified unspecified  	O	null
14 : : : punctuation unspecified unspecified unspecified unspecified unspecified  	O	null
15 ברקלי ברקלי ברקלי properName unspecified unspecified unspecified unspecified unspecified  	I_ORG	null
16 , , , punctuation unspecified unspecified unspecified unspecified unspecified  	O	null
17 קליפורניה קליפורניה קליפורניה properName unspecified unspecified unspecified unspecified unspecified  	I_LOC	null
18 Occupation Occupation Occupation foreign unspecified unspecified unspecified unspecified unspecified  	O	null
19 : : : punctuation unspecified unspecified unspecified unspecified unspecified  	O	null
20 משורר משורר משורר noun masculine singular absolute unspecified unspecified  	O	null
21 , , , punctuation unspecified unspecified unspecified unspecified unspecified  	O	null
22 חוקר חוקר חוקר noun masculine singular absolute unspecified unspecified  	O	null
23 , , , punctuation unspecified unspecified unspecified unspecified unspecified  	O	null
24 מסאי מסאי מסאי noun masculine singular absolute unspecified unspecified  	O	null
25 , , , punctuation unspecified unspecified unspecified unspecified unspecified  	O	null
26 מתרגם מתרגם מתרגם noun masculine singular absolute unspecified unspecified  	O	null
27 Entry Entry Entry foreign unspecified unspecified unspecified unspecified unspecified  	O	null
28 writer writer writer foreign unspecified unspecified unspecified unspecified unspecified  	O	null
29 : : : punctuation unspecified unspecified unspecified unspecified unspecified  	O	null
30 ענת ענת ענת properName unspecified unspecified unspecified unspecified unspecified  	I_PERS	null
31 ויסמן ויסמן ויסמן properName unspecified unspecified unspecified unspecified unspecified  	I_PERS	null
32 Entry Entry Entry foreign unspecified unspecified unspecified unspecified unspecified  	O	null
33 Value Value Value foreign unspecified unspecified unspecified unspecified unspecified  	O	null
34 : : : punctuation unspecified unspecified unspecified unspecified unspecified  	O	null
35 נולד נולד נולד verb masculine singular unspecified 3 past  	O	null
36 ב ב בברקלי preposition unspecified unspecified unspecified unspecified unspecified 0 
36 ברקלי ברקלי בברקלי properName unspecified unspecified unspecified unspecified unspecified  	I_PERS	null
37 , , , punctuation unspecified unspecified unspecified unspecified unspecified  	O	null
38 קליפורניה קליפורניה קליפורניה properName unspecified unspecified unspecified unspecified unspecified  	I_LOC	null
39 . . . punctuation unspecified unspecified unspecified unspecified unspecified  	O	null

0 חצי חץ חצי noun masculine plural construct unspecified unspecified  	O	null
1 שנה שנה שנה noun feminine singular absolute unspecified unspecified  	O	null
2 לאחר לאחר לאחר preposition unspecified unspecified unspecified unspecified unspecified  	O	null
3 הולדת הולדה הולדתו noun feminine singular absolute unspecified unspecified  
3 ו ו הולדתו possessive masculine singular unspecified 3 unspecified 0 	O	null
4 חזרה חזר חזרה verb feminine singular unspecified 3 past  	O	null
5 משפחת משפחה משפחתו noun feminine singular absolute unspecified unspecified  
5 ו ו משפחתו possessive masculine singular unspecified 3 unspecified 0 	O	null
6 ארצה ארצה ארצה adverb unspecified unspecified unspecified unspecified unspecified  	I_LOC	null
7 . . . punctuation unspecified unspecified unspecified unspecified unspecified  	O	null

0 סבת סבה סבתו noun feminine singular absolute unspecified unspecified  
0 ו ו סבתו possessive masculine singular unspecified 3 unspecified 0 	O	null
1 , , , punctuation unspecified unspecified unspecified unspecified unspecified  	O	null
2 יהודית יהודי יהודית adjective feminine singular absolute unspecified unspecified  	O	null
3 גורביץ' גורביץ' גורביץ' properName unspecified unspecified unspecified unspecified unspecified  	I_PERS	null
4 , , , punctuation unspecified unspecified unspecified unspecified unspecified  	O	null
5 הוציאה הוציא הוציאה verb feminine singular unspecified 3 past  	O	null
6 ל ל לאור preposition unspecified unspecified unspecified unspecified unspecified 0 
6 אור אור לאור noun masculine singular absolute unspecified unspecified  	O	null
7 ב ב בשנות preposition unspecified unspecified unspecified unspecified unspecified 0 
7 שנות שנה בשנות noun feminine plural construct unspecified unspecified  	I_DATE	null
8 ה ה החמישים definiteArticle unspecified unspecified unspecified unspecified unspecified 0 
8 החמישים ORD-CARD50 החמישים numeral masculine plural absolute unspecified unspecified  	I_DATE	null
9 את את את at-preposition unspecified unspecified unspecified unspecified unspecified  	O	null
10 סדרת סדרה סדרת noun feminine singular construct unspecified unspecified  	O	null
11 ה ה הספרים definiteArticle unspecified unspecified unspecified unspecified unspecified 0 
11 הספרים ספר הספרים noun masculine plural absolute unspecified unspecified  	O	null
12 מה מה מה interrogative unspecified unspecified unspecified unspecified unspecified  	O	null
13 אספר נספר אספר verb masculine-and-feminine singular unspecified 1 future  	O	null
14 ל ל לילד preposition unspecified unspecified unspecified unspecified unspecified 0 
14 ה ה לילד definiteArticle unspecified unspecified unspecified unspecified unspecified 0 
14 הילד ילד לילד noun masculine singular absolute unspecified unspecified  	O	null
15 . . . punctuation unspecified unspecified unspecified unspecified unspecified  	O	null

0 הוא הוא הוא pronoun masculine singular unspecified 3 unspecified  	O	null
1 קרוי קרוי קרוי adjective masculine singular absolute unspecified unspecified  	O	null
2 על על על preposition unspecified unspecified unspecified unspecified unspecified  	O	null
3 שם שם שם noun masculine singular construct unspecified unspecified  	O	null
4 סב סב סבו noun masculine singular absolute unspecified unspecified  
4 ו ו סבו possessive masculine singular unspecified 3 unspecified 0 	O	null
5 ו ו וכתב conjunction unspecified unspecified unspecified unspecified unspecified 0 
5 כתב כתב וכתב verb masculine singular unspecified 3 past  	O	null
6 על על על preposition unspecified unspecified unspecified unspecified unspecified  	O	null
7 כך כך כך pronoun unspecified unspecified unspecified unspecified unspecified  	O	null
8 שיר שיר שיר noun masculine singular absolute unspecified unspecified  	O	null
9 ( ( ( punctuation unspecified unspecified unspecified unspecified unspecified  	O	null
10 הבל הבל הבל noun masculine singular absolute unspecified unspecified  	O	null
11 , , , punctuation unspecified unspecified unspecified unspecified unspecified  	O	null
12 , , , punctuation unspecified unspecified unspecified unspecified unspecified  	O	null
13 ###NUMBER### ###NUMBER### ###NUMBER### numeral unspecified unspecified unspecified unspecified unspecified  	I_DATE	null
14 שיר שיר שיר noun masculine singular absolute unspecified unspecified  	O	null
15 מס' מספר מס' noun masculine singular absolute unspecified unspecified  	O	null
16 ###NUMBER### ###NUMBER### ###NUMBER### numeral unspecified unspecified unspecified unspecified unspecified  	O	null
17 ) ) ) punctuation unspecified unspecified unspecified unspecified unspecified  	O	null
18 . . . punctuation unspecified unspecified unspecified unspecified unspecified  	O	null

0 גדל גדל גדל verb masculine singular unspecified 3 past  	I_LOC	null
1 ב ב בגבעתיים preposition unspecified unspecified unspecified unspecified unspecified 0 
1 גבעתיים גבעתיים בגבעתיים properName feminine singular unspecified unspecified unspecified  	I_LOC	null
2 ו ו ובצהלה conjunction unspecified unspecified unspecified unspecified unspecified 0 
2 ב ב ובצהלה preposition unspecified unspecified unspecified unspecified unspecified 0 
2 צהלה צהלה ובצהלה properName unspecified unspecified unspecified unspecified unspecified  	I_PERS	null
3 ו ו ושירת conjunction unspecified unspecified unspecified unspecified unspecified 0 
3 שירת שירת ושירת verb masculine singular unspecified 3 past  	O	null
4 ב ב בחיל preposition unspecified unspecified unspecified unspecified unspecified 0 
4 חיל חיל בחיל noun masculine singular construct unspecified unspecified  	I_ORG	null
5 ה ה האוויר definiteArticle unspecified unspecified unspecified unspecified unspecified 0 
5 האוויר אוויר האוויר noun masculine singular absolute unspecified unspecified  	I_ORG	null
6 . . . punctuation unspecified unspecified unspecified unspecified unspecified  	O	null

0 למד למד למד verb masculine singular unspecified 3 past  	O	null
1 סוציולוגיה סוציולוגיה סוציולוגיה properName unspecified unspecified unspecified unspecified unspecified  	I_PERS	null
2 ו ו וכלכלה conjunction unspecified unspecified unspecified unspecified unspecified 0 
2 כלכלה כלכלה וכלכלה noun feminine singular absolute unspecified unspecified  	O	null
3 ב ב באוניברסיטה preposition unspecified unspecified unspecified unspecified unspecified 0 
3 ה ה באוניברסיטה definiteArticle unspecified unspecified unspecified unspecified unspecified 0 
3 האוניברסיטה אוניברסיטה באוניברסיטה noun feminine singular absolute unspecified unspecified  	O	null
4 ה ה העברית definiteArticle unspecified unspecified unspecified unspecified unspecified 0 
4 העברית עברי העברית adjective feminine singular absolute unspecified unspecified  	O	null
5 ב ב בירושלים preposition unspecified unspecified unspecified unspecified unspecified 0 
5 ירושלים ירושלים בירושלים properName unspecified unspecified unspecified unspecified unspecified  	I_LOC	null
6 ו ו וקיבל conjunction unspecified unspecified unspecified unspecified unspecified 0 
6 קיבל קיבל וקיבל verb masculine singular unspecified 3 past  	O	null
7 תואר תואר תואר noun masculine singular absolute unspecified unspecified  	O	null
8 דוקטור דוקטור דוקטור noun masculine singular absolute unspecified unspecified  	O	null
9 ב ב בפסיכולוגיה preposition unspecified unspecified unspecified unspecified unspecified 0 
9 פסיכולוגיה פסיכולוגיה בפסיכולוגיה noun feminine singular absolute unspecified unspecified  	O	null
10 חברתית חברתי חברתית adjective feminine singular absolute unspecified unspecified  	O	null
11 ב ב ב preposition unspecified unspecified unspecified unspecified unspecified 0 	O	null
12 - - - punctuation unspecified unspecified unspecified unspecified unspecified  	O	null
13 ###NUMBER### ###NUMBER### ###NUMBER### numeral unspecified unspecified unspecified unspecified unspecified  	I_DATE	null
14 . . . punctuation unspecified unspecified unspecified unspecified unspecified  	O	null

0 בנוסף בנוסף בנוסף adverb unspecified unspecified unspecified unspecified unspecified  	O	null
1 , , , punctuation unspecified unspecified unspecified unspecified unspecified  	O	null
2 למד למד למד verb masculine singular unspecified 3 past  	O	null
3 ל ל לתואר preposition unspecified unspecified unspecified unspecified unspecified 0 
3 תואר תואר לתואר noun masculine singular construct unspecified unspecified  	O	null
4 שני שני שני noun masculine singular absolute unspecified unspecified  	O	null
5 ב ב בספרות preposition unspecified unspecified unspecified unspecified unspecified 0 
5 ספרות ספרות בספרות noun feminine singular absolute unspecified unspecified  	O	null
6 השוואתית השוואתי השוואתית adjective feminine singular absolute unspecified unspecified  	O	null
7 . . . punctuation unspecified unspecified unspecified unspecified unspecified  	O	null

0 החל החל החל verb masculine singular unspecified 3 past  	O	null
1 מ מ מ preposition unspecified unspecified unspecified unspecified unspecified 0 	O	null
2 - - - punctuation unspecified unspecified unspecified unspecified unspecified  	O	null
3 ###NUMBER### ###NUMBER### ###NUMBER### numeral unspecified unspecified unspecified unspecified unspecified  	I_DATE	null
4 לימד לימד לימד verb masculine singular unspecified 3 past  	O	null
5 ב ב בחוג preposition unspecified unspecified unspecified unspecified unspecified 0 
5 חוג חוג בחוג noun masculine singular construct unspecified unspecified  	O	null
6 לסוציולוגיה לסוציולוגיה לסוציולוגיה noun feminine singular absolute unspecified unspecified  	O	null
7 ואנתרופולוגיה ואנתרופולוגיה ואנתרופולוגיה properName unspecified unspecified unspecified unspecified unspecified  	O	null
8 ב ב באוניברסיטה preposition unspecified unspecified unspecified unspecified unspecified 0 
8 ה ה באוניברסיטה definiteArticle unspecified unspecified unspecified unspecified unspecified 0 
8 האוניברסיטה אוניברסיטה באוניברסיטה noun feminine singular absolute unspecified unspecified  	O	null
9 ה ה העברית definiteArticle unspecified unspecified unspecified unspecified unspecified 0 
9 העברית עברי העברית adjective feminine singular absolute unspecified unspecified  	O	null
10 , , , punctuation unspecified unspecified unspecified unspecified unspecified  	O	null
11 ו ו והיה conjunction unspecified unspecified unspecified unspecified unspecified 0 
11 היה הוא והיה copula masculine singular unspecified 3 past  	O	null
12 ראש ראש ראש noun masculine singular construct unspecified unspecified  	O	null
13 ה ה החוג definiteArticle unspecified unspecified unspecified unspecified unspecified 0 
13 החוג חוג החוג noun masculine singular absolute unspecified unspecified  	O	null
14 ב ב בשנים preposition unspecified unspecified unspecified unspecified unspecified 0 
14 שנים שנה בשנים noun feminine plural absolute unspecified unspecified  	O	null
15 ###NUMBER### ###NUMBER### ###NUMBER### numeral unspecified unspecified unspecified unspecified unspecified  	I_DATE	null
16 - - - punctuation unspecified unspecified unspecified unspecified unspecified  	O	null
17 ###NUMBER### ###NUMBER### ###NUMBER### numeral unspecified unspecified unspecified unspecified unspecified  	I_DATE	null
18 . . . punctuation unspecified unspecified unspecified unspecified unspecified  	O	null

0 יצא יצא יצא verb masculine singular unspecified 3 past  	O	null
1 ל ל לגמלאות preposition unspecified unspecified unspecified unspecified unspecified 0 
1 גמלאות גמלה לגמלאות noun feminine plural absolute unspecified unspecified  	O	null
2 ב ב ב preposition unspecified unspecified unspecified unspecified unspecified 0 	I_ORG	null
3 - - - punctuation unspecified unspecified unspecified unspecified unspecified  	I_ORG	null
4 ###NUMBER### ###NUMBER### ###NUMBER### numeral unspecified unspecified unspecified unspecified unspecified  	I_DATE	null
5 . . . punctuation unspecified unspecified unspecified unspecified unspecified  	O	null

0 פירסם פרסם פירסם verb masculine singular unspecified 3 past  	O	null
1 עשרה CARD10 עשרה numeral masculine plural absolute unspecified unspecified  	O	null
2 ספרי ספר ספרי noun masculine plural construct unspecified unspecified  	O	null
3 שירה שירה שירה noun feminine singular absolute unspecified unspecified  	O	null
4 . . . punctuation unspecified unspecified unspecified unspecified unspecified  	O	null

0 שיר שיר שירו noun masculine singular absolute unspecified unspecified  
0 ו ו שירו possessive masculine singular unspecified 3 unspecified 0 	O	null
1 ה ה הראשון definiteArticle unspecified unspecified unspecified unspecified unspecified 0 
1 הראשון ORD1 הראשון numeral masculine singular absolute unspecified unspecified  	O	null
2 התפרסם התפרסם התפרסם verb masculine singular unspecified 3 past  	O	null
3 ב ב בהיותו preposition unspecified unspecified unspecified unspecified unspecified 0 
3 היות היות בהיותו noun masculine singular absolute unspecified unspecified  
3 ו ו בהיותו possessive masculine singular unspecified 3 unspecified 0 	O	null
4 כ כ כבן preposition unspecified unspecified unspecified unspecified unspecified 0 
4 בן בן כבן noun masculine singular construct unspecified unspecified  	O	null
5 שמונה CARD8 שמונה numeral masculine plural absolute unspecified unspecified  	O	null
6 ב ב בדבר preposition unspecified unspecified unspecified unspecified unspecified 0 
6 דבר דבר בדבר noun masculine singular absolute unspecified unspecified  	O	null
7 ל ל לילדים preposition unspecified unspecified unspecified unspecified unspecified 0 
7 ילדים ילד לילדים noun masculine plural absolute unspecified unspecified  	O	null
8 : : : punctuation unspecified unspecified unspecified unspecified unspecified  	O	null
9 " " " punctuation unspecified unspecified unspecified unspecified unspecified  	O	null
10 שיר שיר שיר noun masculine singular absolute unspecified unspecified  	O	null
11 על על על preposition unspecified unspecified unspecified unspecified unspecified  	O	null
12 ביאליק ביאליק ביאליק properName masculine singular unspecified unspecified unspecified  	I_ORG	null
13 " " " punctuation unspecified unspecified unspecified unspecified unspecified  	O	null
14 ( ( ( punctuation unspecified unspecified unspecified unspecified unspecified  	O	null
15 כרך כרך כרך noun masculine singular absolute unspecified unspecified  	O	null
16 כ"ח כ"ח כ"ח adjective masculine singular absolute unspecified unspecified  	O	null
17 ] ] ] punctuation unspecified unspecified unspecified unspecified unspecified  	O	null
18 , , , punctuation unspecified unspecified unspecified unspecified unspecified  	O	null
19 ###NUMBER### ###NUMBER### ###NUMBER### numeral unspecified unspecified unspecified unspecified unspecified  	O	null
20 ###NUMBER### ###NUMBER### ###NUMBER### numeral unspecified unspecified unspecified unspecified unspecified  	I_DATE	null
21 ) ) ) punctuation unspecified unspecified unspecified unspecified unspecified  	O	null
22 . . . punctuation unspecified unspecified unspecified unspecified unspecified  	O	null

0 ביאליק ביאליק ביאליק properName unspecified unspecified unspecified unspecified unspecified  	I_PERS	null
1 הוא הוא הוא pronoun masculine singular unspecified 3 unspecified  	O	null
2 נושא נושא נושא noun masculine singular absolute unspecified unspecified  	O	null
3 ו ו ומקור conjunction unspecified unspecified unspecified unspecified unspecified 0 
3 מקור מקור ומקור noun masculine singular construct unspecified unspecified  	O	null
4 השראה השראה השראה noun feminine singular absolute unspecified unspecified  	O	null
5 ל ל לאורך preposition unspecified unspecified unspecified unspecified unspecified 0 
5 אורך אורך לאורך noun masculine singular construct unspecified unspecified  	O	null
6 כל כול כל quantifier unspecified unspecified construct unspecified unspecified  	O	null
7 שנות שנה שנות noun feminine plural construct unspecified unspecified  	O	null
8 ה ה היצירה definiteArticle unspecified unspecified unspecified unspecified unspecified 0 
8 היצירה יצירה היצירה noun feminine singular absolute unspecified unspecified  	O	null
9 ב ב בשירתו preposition unspecified unspecified unspecified unspecified unspecified 0 
9 שירת שירה בשירתו noun feminine singular absolute unspecified unspecified  
9 ו ו בשירתו possessive masculine singular unspecified 3 unspecified 0 	O	null
10 , , , punctuation unspecified unspecified unspecified unspecified unspecified  	O	null
11 ב ב במחקריו preposition unspecified unspecified unspecified unspecified unspecified 0 
11 מחקרי מחקר במחקריו noun masculine plural absolute unspecified unspecified  
11 ו ו במחקריו possessive masculine singular unspecified 3 unspecified 0 	O	null
12 ו ו ובמסותיו conjunction unspecified unspecified unspecified unspecified unspecified 0 
12 ב ב ובמסותיו preposition unspecified unspecified unspecified unspecified unspecified 0 
12 מסות מסה ובמסותיו noun feminine plural absolute unspecified unspecified  
12 ו ו ובמסותיו possessive masculine singular unspecified 3 unspecified 0 	O	null
13 על על על preposition unspecified unspecified unspecified unspecified unspecified  	O	null
14 ספרות ספרות ספרות noun feminine singular absolute unspecified unspecified  	O	null
15 . . . punctuation unspecified unspecified unspecified unspecified unspecified  	O	null

0 שירי שיר שיריו noun masculine plural absolute unspecified unspecified  
0 ו ו שיריו possessive masculine singular unspecified 3 unspecified 0 	O	null
1 ה ה הראשונים definiteArticle unspecified unspecified unspecified unspecified unspecified 0 
1 הראשונים ראשונים הראשונים noun masculine plural absolute unspecified unspecified  	O	null
2 ל ל למבוגרים preposition unspecified unspecified unspecified unspecified unspecified 0 
2 ה ה למבוגרים definiteArticle unspecified unspecified unspecified unspecified unspecified 0 
2 המבוגרים מבוגר למבוגרים noun masculine plural absolute unspecified unspecified  	O	null
3 ראו ראה ראו verb masculine-and-feminine plural unspecified 3 past  	O	null
4 אור אור אור noun masculine singular absolute unspecified unspecified  	O	null
5 ב ב בדבר preposition unspecified unspecified unspecified unspecified unspecified 0 
5 דבר דבר בדבר noun masculine singular absolute unspecified unspecified  	O	null
6 ו ו ובהארץ conjunction unspecified unspecified unspecified unspecified unspecified 0 
6 ב ב ובהארץ preposition unspecified unspecified unspecified unspecified unspecified 0 
6 ה ה ובהארץ definiteArticle unspecified unspecified unspecified unspecified unspecified 0 
6 ההארץ ארץ ובהארץ noun feminine singular absolute unspecified unspecified  	O	null
7 ב ב בשנים preposition unspecified unspecified unspecified unspecified unspecified 0 
7 שנים שנה בשנים noun feminine plural absolute unspecified unspecified  	O	null
8 ###NUMBER### ###NUMBER### ###NUMBER### numeral unspecified unspecified unspecified unspecified unspecified  	I_DATE	null
9 - - - punctuation unspecified unspecified unspecified unspecified unspecified  	O	null
10 ###NUMBER### ###NUMBER### ###NUMBER### numeral unspecified unspecified unspecified unspecified unspecified  	I_DATE	null
11 ( ( ( punctuation unspecified unspecified unspecified unspecified unspecified  	O	null
12 " " " punctuation unspecified unspecified unspecified unspecified unspecified  	O	null
13 רקוויאם רקוויאם רקוויאם noun masculine singular absolute unspecified unspecified  	O	null
14 " " " punctuation unspecified unspecified unspecified unspecified unspecified  	O	null
15 , , , punctuation unspecified unspecified unspecified unspecified unspecified  	O	null
16 דבר דבר דבר noun masculine singular absolute unspecified unspecified  	O	null
17 , , , punctuation unspecified unspecified unspecified unspecified unspecified  	O	null
18 ###NUMEXP### ###NUMEXP### ###NUMEXP### numberExpression unspecified unspecified unspecified unspecified unspecified  	I_DATE	null
19 ; ; ; punctuation unspecified unspecified unspecified unspecified unspecified  	O	null
20 " " " punctuation unspecified unspecified unspecified unspecified unspecified  	O	null
21 ה ה המבול definiteArticle unspecified unspecified unspecified unspecified unspecified 0 
21 המבול מבול המבול noun masculine singular absolute unspecified unspecified  	O	null
22 ה ה השני definiteArticle unspecified unspecified unspecified unspecified unspecified 0 
22 השני ORD2 השני numeral masculine singular absolute unspecified unspecified  	O	null
23 " " " punctuation unspecified unspecified unspecified unspecified unspecified  	O	null
24 , , , punctuation unspecified unspecified unspecified unspecified unspecified  	O	null
25 דבר דבר דבר noun masculine singular absolute unspecified unspecified  	O	null
26 , , , punctuation unspecified unspecified unspecified unspecified unspecified  	O	null
27 ###NUMEXP### ###NUMEXP### ###NUMEXP### numberExpression unspecified unspecified unspecified unspecified unspecified  	I_DATE	null
28 ; ; ; punctuation unspecified unspecified unspecified unspecified unspecified  	O	null
29 " " " punctuation unspecified unspecified unspecified unspecified unspecified  	O	null
30 מיכאל מיכאל מיכאל properName unspecified unspecified unspecified unspecified unspecified  	I_ORG	null
31 ה ה הזהוב definiteArticle unspecified unspecified unspecified unspecified unspecified 0 
31 הזהוב זהוב הזהוב adjective masculine singular absolute unspecified unspecified  	O	null
32 " " " punctuation unspecified unspecified unspecified unspecified unspecified  	O	null
33 , , , punctuation unspecified unspecified unspecified unspecified unspecified  	O	null
34 ה ה הארץ definiteArticle unspecified unspecified unspecified unspecified unspecified 0 
34 הארץ ארץ הארץ noun feminine singular absolute unspecified unspecified  	O	null
35 , , , punctuation unspecified unspecified unspecified unspecified unspecified  	O	null
36 ###NUMEXP### ###NUMEXP### ###NUMEXP### numberExpression unspecified unspecified unspecified unspecified unspecified  	I_DATE	null
37 ) ) ) punctuation unspecified unspecified unspecified unspecified unspecified  	O	null
38 . . . punctuation unspecified unspecified unspecified unspecified unspecified  	O	null

0 ספר ספר ספרו noun masculine singular absolute unspecified unspecified  
0 ו ו ספרו possessive masculine singular unspecified 3 unspecified 0 	O	null
1 ה ה הראשון definiteArticle unspecified unspecified unspecified unspecified unspecified 0 
1 הראשון ORD1 הראשון numeral masculine singular absolute unspecified unspecified  	O	null
2 , , , punctuation unspecified unspecified unspecified unspecified unspecified  	O	null
3 קטעים קטע קטעים noun masculine plural absolute unspecified unspecified  	O	null
4 מ מ מחלום preposition unspecified unspecified unspecified unspecified unspecified 0 
4 חלום חלום מחלום noun masculine singular absolute unspecified unspecified  	O	null
5 פתוח פתוח פתוח adjective masculine singular absolute unspecified unspecified  	O	null
6 , , , punctuation unspecified unspecified unspecified unspecified unspecified  	O	null
7 ראה ראה ראה verb masculine singular unspecified 3 past  	O	null
8 אור אור אור noun masculine singular absolute unspecified unspecified  	O	null
9 ב ב ב preposition unspecified unspecified unspecified unspecified unspecified 0 	O	null
10 - - - punctuation unspecified unspecified unspecified unspecified unspecified  	O	null
11 ###NUMBER### ###NUMBER### ###NUMBER### numeral unspecified unspecified unspecified unspecified unspecified  	I_DATE	null
12 ( ( ( punctuation unspecified unspecified unspecified unspecified unspecified  	O	null
13 א' א' א' noun masculine singular absolute unspecified unspecified  	O	null
14 אספי אספי אספיס noun masculine singular absolute unspecified unspecified  
14 י י אספיס possessive masculine-and-feminine singular unspecified 1 unspecified 0 	O	null
15 ) ) ) punctuation unspecified unspecified unspecified unspecified unspecified  	O	null
16 . . . punctuation unspecified unspecified unspecified unspecified unspecified  	O	null

0 שירת שירה שירתו noun feminine singular absolute unspecified unspecified  
0 ו ו שירתו possessive masculine singular unspecified 3 unspecified 0 	O	null
1 מעמידה העמיד מעמידה verb feminine singular unspecified any beinoni  	O	null
2 ב ב במרכזה preposition unspecified unspecified unspecified unspecified unspecified 0 
2 מרכז מרכז במרכזה noun masculine singular absolute unspecified unspecified  
2 ה ה במרכזה possessive feminine singular unspecified 3 unspecified 0 	O	null
3 את את את at-preposition unspecified unspecified unspecified unspecified unspecified  	O	null
4 ה ה השיחה definiteArticle unspecified unspecified unspecified unspecified unspecified 0 
4 השיחה שיחה השיחה noun feminine singular absolute unspecified unspecified  	O	null
5 ה ה האנושית definiteArticle unspecified unspecified unspecified unspecified unspecified 0 
5 האנושית אנושי האנושית adjective feminine singular absolute unspecified unspecified  	O	null
6 , , , punctuation unspecified unspecified unspecified unspecified unspecified  	O	null
7 את את את at-preposition unspecified unspecified unspecified unspecified unspecified  	O	null
8 ה ה ההתנסות definiteArticle unspecified unspecified unspecified unspecified unspecified 0 
8 ההתנסות התנסות ההתנסות noun feminine singular absolute unspecified unspecified  	O	null
9 ה ה החושית definiteArticle unspecified unspecified unspecified unspecified unspecified 0 
9 החושית חושי החושית adjective feminine singular absolute unspecified unspecified  	O	null
10 ו ו ואת conjunction unspecified unspecified unspecified unspecified unspecified 0 
10 את את ואת at-preposition unspecified unspecified unspecified unspecified unspecified  	O	null
11 תהליכי תהליך תהליכי noun masculine plural construct unspecified unspecified  	O	null
12 ה ה ההתמלאות definiteArticle unspecified unspecified unspecified unspecified unspecified 0 
12 ההתמלאות התמלאות ההתמלאות noun feminine singular absolute unspecified unspecified  	O	null
13 ו ו וההתרוקנות conjunction unspecified unspecified unspecified unspecified unspecified 0 
13 ה ה וההתרוקנות definiteArticle unspecified unspecified unspecified unspecified unspecified 0 
13 ההתרוקנות התרוקנות וההתרוקנות noun feminine singular absolute unspecified unspecified  	O	null
14 של של של shel-preposition unspecified unspecified unspecified unspecified unspecified  	O	null
15 ה ה הקריאה definiteArticle unspecified unspecified unspecified unspecified unspecified 0 
15 הקריאה קריאה הקריאה noun feminine singular absolute unspecified unspecified  	O	null
16 ו ו והכתיבה conjunction unspecified unspecified unspecified unspecified unspecified 0 
16 ה ה והכתיבה definiteArticle unspecified unspecified unspecified unspecified unspecified 0 
16 הכתיבה כתיבה והכתיבה noun feminine singular absolute unspecified unspecified  	O	null
17 . . . punctuation unspecified unspecified unspecified unspecified unspecified  	O	null

0 מצד מצד מצד preposition unspecified unspecified unspecified unspecified unspecified  	O	null
1 אחד CARD1 אחד numeral masculine singular construct unspecified unspecified  	O	null
2 , , , punctuation unspecified unspecified unspecified unspecified unspecified  	O	null
3 זוהי זהו זוהי pronoun feminine singular unspecified 3 unspecified  	O	null
4 שירה שירה שירה noun feminine singular absolute unspecified unspecified  	O	null
5 מ מ מושגית preposition unspecified unspecified unspecified unspecified unspecified 0 
5 ושגית ושגית מושגית properName unspecified unspecified unspecified unspecified unspecified  	O	null
6 ו ו ומהותנית conjunction unspecified unspecified unspecified unspecified unspecified 0 
6 מ מ ומהותנית preposition unspecified unspecified unspecified unspecified unspecified 0 
6 הותנית הותנית ומהותנית noun feminine singular construct unspecified unspecified  	O	null
7 ה ה העוסקת definiteArticle unspecified unspecified unspecified unspecified unspecified 0 
7 העוסקת עסק העוסקת participle feminine singular absolute any unspecified  	O	null
8 ב ב בזיקות preposition unspecified unspecified unspecified unspecified unspecified 0 
8 זיקות זיקה בזיקות noun feminine plural construct unspecified unspecified  	O	null
9 בין בין בין conjunction unspecified unspecified unspecified unspecified unspecified  	O	null
10 גוף גוף גוף noun masculine singular construct unspecified unspecified  	O	null
11 - - - punctuation unspecified unspecified unspecified unspecified unspecified  	O	null
12 נפש נפש נפש noun feminine singular construct unspecified unspecified  	O	null
13 , , , punctuation unspecified unspecified unspecified unspecified unspecified  	O	null
14 אדם אדם אדם properName masculine singular unspecified unspecified unspecified  	I_PERS	null
15 - - - punctuation unspecified unspecified unspecified unspecified unspecified  	O	null
16 מקום מקום מקום noun masculine singular construct unspecified unspecified  	O	null
17 , , , punctuation unspecified unspecified unspecified unspecified unspecified  	O	null
18 פנים פני פנים noun masculine plural absolute unspecified unspecified  	O	null
19 - - - punctuation unspecified unspecified unspecified unspecified unspecified  	O	null
20 חוץ חוץ חוץ noun masculine singular construct unspecified unspecified  	O	null
21 , , , punctuation unspecified unspecified unspecified unspecified unspecified  	O	null
22 דיבור דיבור דיבור noun masculine singular construct unspecified unspecified  	O	null
23 - - - punctuation unspecified unspecified unspecified unspecified unspecified  	O	null
24 שתיקה שתיקה שתיקה noun feminine singular absolute unspecified unspecified  	O	null
25 , , , punctuation unspecified unspecified unspecified unspecified unspecified  	O	null
26 עשייה עשייה עשייה noun feminine singular absolute unspecified unspecified  	O	null
27 ו ו ומחשבה conjunction unspecified unspecified unspecified unspecified unspecified 0 
27 מחשבה מחשבה ומחשבה noun feminine singular absolute unspecified unspecified  	O	null
28 , , , punctuation unspecified unspecified unspecified unspecified unspecified  	O	null
29 זמן זמן זמן noun masculine singular construct unspecified unspecified  	O	null
30 ו ו ומרחב conjunction unspecified unspecified unspecified unspecified unspecified 0 
30 מרחב מרחב ומרחב noun masculine singular construct unspecified unspecified  	O	null
31 , , , punctuation unspecified unspecified unspecified unspecified unspecified  	O	null
32 שירה שירה שירה noun feminine singular absolute unspecified unspecified  	O	null
33 ו ו וממשות conjunction unspecified unspecified unspecified unspecified unspecified 0 
33 ממשות ממשות וממשות noun feminine singular construct unspecified unspecified  	O	null
34 חומרית חומרי חומרית adjective feminine singular absolute unspecified unspecified  	O	null
35 . . . punctuation unspecified unspecified unspecified unspecified unspecified  	O	null

0 מן מן מן preposition unspecified unspecified unspecified unspecified unspecified  	O	null
1 ה ה הצד definiteArticle unspecified unspecified unspecified unspecified unspecified 0 
1 הצד צד הצד noun masculine singular absolute unspecified unspecified  	O	null
2 ה ה האחר definiteArticle unspecified unspecified unspecified unspecified unspecified 0 
2 האחר אחר האחר adjective masculine singular absolute unspecified unspecified  	O	null
3 , , , punctuation unspecified unspecified unspecified unspecified unspecified  	O	null
4 שירתו שירת שירתו verb masculine-and-feminine plural unspecified 3 past  	O	null
5 היא הוא היא pronoun feminine singular unspecified 3 unspecified  	O	null
6 פרועה פרוע פרועה adjective feminine singular absolute unspecified unspecified  	O	null
7 , , , punctuation unspecified unspecified unspecified unspecified unspecified  	O	null
8 אסוציאטיבית אסוציאטיבי אסוציאטיבית adjective feminine singular absolute unspecified unspecified  	O	null
9 ו ו ומשחקית conjunction unspecified unspecified unspecified unspecified unspecified 0 
9 מ מ ומשחקית preposition unspecified unspecified unspecified unspecified unspecified 0 
9 שחקית שחקית ומשחקית noun feminine singular absolute unspecified unspecified  	O	null
10 . . . punctuation unspecified unspecified unspecified unspecified unspecified  	O	null

0 לצד לצד לצד preposition unspecified unspecified unspecified unspecified unspecified  	O	null
1 ה ה הדיבור definiteArticle unspecified unspecified unspecified unspecified unspecified 0 
1 הדיבור דיבור הדיבור noun masculine singular absolute unspecified unspecified  	O	null
2 ה ה הפואטי definiteArticle unspecified unspecified unspecified unspecified unspecified 0 
2 הפואטי הפואטי הפואטי adjective masculine singular absolute unspecified unspecified  	O	null
3 ה ה השואף definiteArticle unspecified unspecified unspecified unspecified unspecified 0 
3 השואף שאף השואף participle masculine singular absolute any unspecified  	O	null
4 ל ל לפשטות preposition unspecified unspecified unspecified unspecified unspecified 0 
4 ה ה לפשטות definiteArticle unspecified unspecified unspecified unspecified unspecified 0 
4 הפשטות פשטות לפשטות noun feminine singular absolute unspecified unspecified  	O	null
5 , , , punctuation unspecified unspecified unspecified unspecified unspecified  	O	null
6 לצלילוּת לצלילוּת לצלילוּת properName unspecified unspecified unspecified unspecified unspecified  	I_PERS	null
7 ו ו ולמוזיקליות conjunction unspecified unspecified unspecified unspecified unspecified 0 
7 ל ל ולמוזיקליות preposition unspecified unspecified unspecified unspecified unspecified 0 
7 ה ה ולמוזיקליות definiteArticle unspecified unspecified unspecified unspecified unspecified 0 
7 המוזיקליות מוזיקליות ולמוזיקליות noun feminine singular absolute unspecified unspecified  	O	null
8 , , , punctuation unspecified unspecified unspecified unspecified unspecified  	O	null
9 זוהי זהו זוהי pronoun feminine singular unspecified 3 unspecified  	O	null
10 שירה שירה שירה noun feminine singular absolute unspecified unspecified  	O	null
11 ה ה התובעת definiteArticle unspecified unspecified unspecified unspecified unspecified 0 
11 התובעת תבע התובעת participle feminine singular absolute any unspecified  	O	null
12 מן מן מן preposition unspecified unspecified unspecified unspecified unspecified  	O	null
13 ה ה הקורא definiteArticle unspecified unspecified unspecified unspecified unspecified 0 
13 הקורא קורא הקורא noun masculine singular absolute unspecified unspecified  	O	null
14 מעקב מעקב מעקב noun masculine singular absolute unspecified unspecified  	O	null
15 מפותל מפותל מפותל adjective masculine singular absolute unspecified unspecified  	O	null
16 אחר אחר אחר preposition unspecified unspecified unspecified unspecified unspecified  	O	null
17 ה ה ההקשרים definiteArticle unspecified unspecified unspecified unspecified unspecified 0 
17 ההקשרים הקשר ההקשרים noun masculine plural absolute unspecified unspecified  	O	null
18 ו ו והטענות conjunction unspecified unspecified unspecified unspecified unspecified 0 
18 ה ה והטענות definiteArticle unspecified unspecified unspecified unspecified unspecified 0 
18 הטענות טענה והטענות noun feminine plural absolute unspecified unspecified  	O	null
19 ה ה התרבותיות definiteArticle unspecified unspecified unspecified unspecified unspecified 0 
19 התרבותיות תרבותי התרבותיות adjective feminine plural absolute unspecified unspecified  	O	null
20 , , , punctuation unspecified unspecified unspecified unspecified unspecified  	O	null
21 ה ה הפואטיות definiteArticle unspecified unspecified unspecified unspecified unspecified 0 
21 הפואטיות הפואטיות הפואטיות adjective feminine plural absolute unspecified unspecified  	O	null
22 ו ו והפילוסופיות conjunction unspecified unspecified unspecified unspecified unspecified 0 
22 ה ה והפילוסופיות definiteArticle unspecified unspecified unspecified unspecified unspecified 0 
22 הפילוסופיות פילוסוף והפילוסופיות adjective feminine plural absolute unspecified unspecified  	O	null
23 ה ה המהדהדות definiteArticle unspecified unspecified unspecified unspecified unspecified 0 
23 המהדהדות הידהד המהדהדות participle feminine plural absolute any unspecified  	O	null
24 ב ב בשיר preposition unspecified unspecified unspecified unspecified unspecified 0 
24 ה ה בשיר definiteArticle unspecified unspecified unspecified unspecified unspecified 0 
24 השיר שיר בשיר noun masculine singular absolute unspecified unspecified  	O	null
25 . . . punctuation unspecified unspecified unspecified unspecified unspecified  	O	null

0 ה ה החטיבה definiteArticle unspecified unspecified unspecified unspecified unspecified 0 
0 החטיבה חטיבה החטיבה noun feminine singular absolute unspecified unspecified  	O	null
1 ה ה הראשונה definiteArticle unspecified unspecified unspecified unspecified unspecified 0 
1 הראשונה ORD1 הראשונה numeral feminine singular absolute unspecified unspecified  	O	null
2 ב ב בשירתו preposition unspecified unspecified unspecified unspecified unspecified 0 
2 שירת שירה בשירתו noun feminine singular absolute unspecified unspecified  
2 ו ו בשירתו possessive masculine singular unspecified 3 unspecified 0 	O	null
3 , , , punctuation unspecified unspecified unspecified unspecified unspecified  	O	null
4 ב ב בשנים preposition unspecified unspecified unspecified unspecified unspecified 0 
4 ה ה בשנים definiteArticle unspecified unspecified unspecified unspecified unspecified 0 
4 השנים שנה בשנים noun feminine plural absolute unspecified unspecified  	O	null
5 - - - punctuation unspecified unspecified unspecified unspecified unspecified  	O	null
6 ###NUMBER### ###NUMBER### ###NUMBER### numeral unspecified unspecified unspecified unspecified unspecified  	I_DATE	null
7 , , , punctuation unspecified unspecified unspecified unspecified unspecified  	O	null
8 ###NUMBER### ###NUMBER### ###NUMBER### numeral unspecified unspecified unspecified unspecified unspecified  	I_DATE	null
9 כללה כלל כללה verb feminine singular unspecified 3 past  	O	null
10 שירים שיר שירים noun masculine plural absolute unspecified unspecified  	O	null
11 לא לא לא negation unspecified unspecified unspecified unspecified unspecified  	O	null
12 מ מ מחורזים preposition unspecified unspecified unspecified unspecified unspecified 0 
12 חורזים חרז מחורזים participle masculine plural absolute any unspecified  	I_ORG	null
13 , , , punctuation unspecified unspecified unspecified unspecified unspecified  	O	null
14 ה ה המאורגנים definiteArticle unspecified unspecified unspecified unspecified unspecified 0 
14 המאורגנים אורגן המאורגנים participle masculine plural absolute any unspecified  	O	null
15 ב ב במבנים preposition unspecified unspecified unspecified unspecified unspecified 0 
15 ה ה במבנים definiteArticle unspecified unspecified unspecified unspecified unspecified 0 
15 המבנים מבנה במבנים noun masculine plural absolute unspecified unspecified  	O	null
16 מורכבים הורכב מורכבים verb masculine plural unspecified any beinoni  	O	null
17 , , , punctuation unspecified unspecified unspecified unspecified unspecified  	O	null
18 ל ל לעתים preposition unspecified unspecified unspecified unspecified unspecified 0 
18 ה ה לעתים definiteArticle unspecified unspecified unspecified unspecified unspecified 0 
18 העתים עת לעתים noun feminine plural absolute unspecified unspecified  	O	null
19 קשים קשה קשים adjective masculine plural absolute unspecified unspecified  	O	null
20 ל ל לפענוח preposition unspecified unspecified unspecified unspecified unspecified 0 
20 פענוח פענוח לפענוח noun masculine singular construct unspecified unspecified  	O	null
21 , , , punctuation unspecified unspecified unspecified unspecified unspecified  	O	null
22 למשל למשל למשל conjunction unspecified unspecified unspecified unspecified unspecified  	O	null
23 ב ב בספרים preposition unspecified unspecified unspecified unspecified unspecified 0 
23 ה ה בספרים definiteArticle unspecified unspecified unspecified unspecified unspecified 0 
23 הספרים ספר בספרים noun masculine plural absolute unspecified unspecified  	O	null
24 יבשה יבש יבשה adjective feminine singular absolute unspecified unspecified  	O	null
25 ( ( ( punctuation unspecified unspecified unspecified unspecified unspecified  	O	null
26 ###NUMBER### ###NUMBER### ###NUMBER### numeral unspecified unspecified unspecified unspecified unspecified  	I_DATE	null
27 ) ) ) punctuation unspecified unspecified unspecified unspecified unspecified  	O	null
28 ו ו והבל conjunction unspecified unspecified unspecified unspecified unspecified 0 
28 ה ה והבל definiteArticle unspecified unspecified unspecified unspecified unspecified 0 
28 הבל בל והבל negation unspecified unspecified unspecified unspecified unspecified  	O	null
29 ) ) ) punctuation unspecified unspecified unspecified unspecified unspecified  	O	null
30 . . . punctuation unspecified unspecified unspecified unspecified unspecified  	O	null
31 ###NUMBER### ###NUMBER### ###NUMBER### numeral unspecified unspecified unspecified unspecified unspecified  	I_DATE	null
32 אחת CARD1 אחת numeral feminine singular construct unspecified unspecified  	O	null
33 מן מן מן preposition unspecified unspecified unspecified unspecified unspecified  	O	null
34 ה ה התופעות definiteArticle unspecified unspecified unspecified unspecified unspecified 0 
34 התופעות תופעה התופעות noun feminine plural absolute unspecified unspecified  	O	null
35 ה ה הפואטיות definiteArticle unspecified unspecified unspecified unspecified unspecified 0 
35 הפואטיות הפואטיות הפואטיות noun feminine singular absolute unspecified unspecified  	O	null
36 ה ה המרכזיות definiteArticle unspecified unspecified unspecified unspecified unspecified 0 
36 המרכזיות מרכזי המרכזיות adjective feminine plural absolute unspecified unspecified  	O	null
37 ו ו והמקוריות conjunction unspecified unspecified unspecified unspecified unspecified 0 
37 ה ה והמקוריות definiteArticle unspecified unspecified unspecified unspecified unspecified 0 
37 המקוריות מקורי והמקוריות adjective feminine plural absolute unspecified unspecified  	O	null
38 ב ב בשירתו preposition unspecified unspecified unspecified unspecified unspecified 0 
38 שירת שירה בשירתו noun feminine singular absolute unspecified unspecified  
38 ו ו בשירתו possessive masculine singular unspecified 3 unspecified 0 	O	null
39 היא הוא היא pronoun feminine singular unspecified 3 unspecified  	O	null
40 ה ה השימוש definiteArticle unspecified unspecified unspecified unspecified unspecified 0 
40 השימוש שימוש השימוש noun masculine singular absolute unspecified unspecified  	O	null
41 ב ב בשירי preposition unspecified unspecified unspecified unspecified unspecified 0 
41 שירי שיר בשירי noun masculine plural construct unspecified unspecified  	O	null
42 ילדים ילד ילדים noun masculine plural absolute unspecified unspecified  	O	null
43 עבריים עברי עבריים adjective masculine plural absolute unspecified unspecified  	O	null
44 מ מ מחורזים preposition unspecified unspecified unspecified unspecified unspecified 0 
44 חורזים חרז מחורזים participle masculine plural absolute any unspecified  	O	null
45 ו ו ובעלי conjunction unspecified unspecified unspecified unspecified unspecified 0 
45 בעלי בעל ובעלי noun masculine plural construct unspecified unspecified  	O	null
46 מ מ מקצב preposition unspecified unspecified unspecified unspecified unspecified 0 
46 קצב קצב מקצב properName unspecified unspecified unspecified unspecified unspecified  	I_LOC	null
47 פשוט פשוט פשוט adverb unspecified unspecified unspecified unspecified unspecified  	O	null
48 כ כ כהשראה preposition unspecified unspecified unspecified unspecified unspecified 0 
48 ה ה כהשראה definiteArticle unspecified unspecified unspecified unspecified unspecified 0 
48 ההשראה השראה כהשראה noun feminine singular absolute unspecified unspecified  	O	null
49 רעיונית רעיוני רעיונית adjective feminine singular absolute unspecified unspecified  	O	null
50 ו ו וצורנית conjunction unspecified unspecified unspecified unspecified unspecified 0 
50 צורנית צורני וצורנית adjective feminine singular absolute unspecified unspecified  	O	null
51 , , , punctuation unspecified unspecified unspecified unspecified unspecified  	O	null
52 ב ב בעיקר preposition unspecified unspecified unspecified unspecified unspecified 0 
52 עיקר עיקר בעיקר quantifier unspecified unspecified construct unspecified unspecified  	O	null
53 ב ב בספרים preposition unspecified unspecified unspecified unspecified unspecified 0 
53 ה ה בספרים definiteArticle unspecified unspecified unspecified unspecified unspecified 0 
53 הספרים ספר בספרים noun masculine plural absolute unspecified unspecified  	O	null
54 הא הא הא properName unspecified unspecified unspecified unspecified unspecified  	I_PERS	null
55 ודא וידא ודא verb masculine singular unspecified 2 imperative  	O	null
56 ( ( ( punctuation unspecified unspecified unspecified unspecified unspecified  	O	null
57 ###NUMBER### ###NUMBER### ###NUMBER### numeral unspecified unspecified unspecified unspecified unspecified  	I_DATE	null
58 ) ) ) punctuation unspecified unspecified unspecified unspecified unspecified  	O	null
59 ו ו וספר conjunction unspecified unspecified unspecified unspecified unspecified 0 
59 ספר סיפר וספר verb masculine singular unspecified 3 past  	O	null
60 ה ה הירח definiteArticle unspecified unspecified unspecified unspecified unspecified 0 
60 הירח ירח הירח noun masculine singular absolute unspecified unspecified  	O	null
61 ( ( ( punctuation unspecified unspecified unspecified unspecified unspecified  	O	null
62 ) ) ) punctuation unspecified unspecified unspecified unspecified unspecified  	O	null
63 . . . punctuation unspecified unspecified unspecified unspecified unspecified  	O	null
64 ###NUMBER### ###NUMBER### ###NUMBER### numeral unspecified unspecified unspecified unspecified unspecified  	I_DATE	null
65 תופעה תופעה תופעה noun feminine singular absolute unspecified unspecified  	O	null
66 זו זו זו pronoun feminine singular unspecified 3 unspecified  	O	null
67 מתקשרת התקשר מתקשרת verb feminine singular unspecified any beinoni  	O	null
68 הן הוא הן pronoun feminine plural unspecified 3 unspecified  	O	null
69 ל ל להיבט preposition unspecified unspecified unspecified unspecified unspecified 0 
69 היבט היבט להיבט noun masculine singular construct unspecified unspecified  	O	null
70 ה ה המטפיזי definiteArticle unspecified unspecified unspecified unspecified unspecified 0 
70 המטפיזי מטפיזי המטפיזי adjective masculine singular absolute unspecified unspecified  	O	null
71 של של של shel-preposition unspecified unspecified unspecified unspecified unspecified  	O	null
72 ה ה המעשה definiteArticle unspecified unspecified unspecified unspecified unspecified 0 
72 המעשה מעשה המעשה noun masculine singular absolute unspecified unspecified  	O	null
73 השירי השיר השירי verb feminine singular unspecified 2 imperative  	O	null
74 ו ו והן conjunction unspecified unspecified unspecified unspecified unspecified 0 
74 הן הוא והן pronoun feminine plural unspecified 3 unspecified  	O	null
75 ל ל לתפקיד preposition unspecified unspecified unspecified unspecified unspecified 0 
75 תפקיד תפקיד לתפקיד noun masculine singular construct unspecified unspecified  	O	null
76 ה ה הפולחני definiteArticle unspecified unspecified unspecified unspecified unspecified 0 
76 הפולחני פולחני הפולחני adjective masculine singular absolute unspecified unspecified  	O	null
77 , , , punctuation unspecified unspecified unspecified unspecified unspecified  	O	null
78 ה ה המשחקי definiteArticle unspecified unspecified unspecified unspecified unspecified 0 
78 המשחקי המשחקי המשחקי noun masculine singular absolute unspecified unspecified  	O	null
79 ו ו והביצועי conjunction unspecified unspecified unspecified unspecified unspecified 0 
79 ה ה והביצועי definiteArticle unspecified unspecified unspecified unspecified unspecified 0 
79 הביצועי הביצועי והביצועי adjective masculine singular absolute unspecified unspecified  	O	null
80 של של של shel-preposition unspecified unspecified unspecified unspecified unspecified  	O	null
81 השירה השיר השירה verb feminine singular unspecified 3 past  	O	null
82 . . . punctuation unspecified unspecified unspecified unspecified unspecified  	O	null

0 שיר שיר שיר noun masculine singular construct unspecified unspecified  	O	null
1 ה ה הנדנדה definiteArticle unspecified unspecified unspecified unspecified unspecified 0 
1 הנדנדה נדנדה הנדנדה noun feminine singular absolute unspecified unspecified  	O	null
2 של של של shel-preposition unspecified unspecified unspecified unspecified unspecified  	O	null
3 ביאליק ביאליק ביאליק properName unspecified unspecified unspecified unspecified unspecified  	I_PERS	null
4 הוא הוא הוא pronoun masculine singular unspecified 3 unspecified  	O	null
5 מעין מעיין מעין noun masculine singular construct unspecified unspecified  	O	null
6 מוטו מוטו מוטו noun masculine singular absolute unspecified unspecified  	O	null
7 , , , punctuation unspecified unspecified unspecified unspecified unspecified  	O	null
8 או או או conjunction unspecified unspecified unspecified unspecified unspecified  	O	null
9 שיר שיר שיר properName unspecified unspecified unspecified unspecified unspecified  	I_PERS	null
10 מנחה הנחה מנחה verb masculine singular unspecified any beinoni  	O	null
11 , , , punctuation unspecified unspecified unspecified unspecified unspecified  	O	null
12 גם גם גם conjunction unspecified unspecified unspecified unspecified unspecified  	O	null
13 ב ב במסה preposition unspecified unspecified unspecified unspecified unspecified 0 
13 מס מס במסה noun masculine singular absolute unspecified unspecified  
13 ה ה במסה possessive feminine singular unspecified 3 unspecified 0 	O	null
14 המנשרית המנשרית המנשרית verb masculine plural unspecified any beinoni  	O	null
15 " " " punctuation unspecified unspecified unspecified unspecified unspecified  	O	null
16 רחבת רחבה רחבת noun feminine singular construct unspecified unspecified  	O	null
17 ה ה השירה definiteArticle unspecified unspecified unspecified unspecified unspecified 0 
17 השירה שירה השירה noun feminine singular absolute unspecified unspecified  	O	null
18 " " " punctuation unspecified unspecified unspecified unspecified unspecified  	O	null
19 ( ( ( punctuation unspecified unspecified unspecified unspecified unspecified  	O	null
20 חדרים חדר חדרים noun masculine plural absolute unspecified unspecified  	O	null
21 , , , punctuation unspecified unspecified unspecified unspecified unspecified  	O	null
22 ###NUMBER### ###NUMBER### ###NUMBER### numeral unspecified unspecified unspecified unspecified unspecified  	O	null
23 ###NUMBER### ###NUMBER### ###NUMBER### numeral unspecified unspecified unspecified unspecified unspecified  	I_DATE	null
24 ) ) ) punctuation unspecified unspecified unspecified unspecified unspecified  	O	null
25 . . . punctuation unspecified unspecified unspecified unspecified unspecified  	O	null

0 שמעון שמעון שמעון properName unspecified unspecified unspecified unspecified unspecified  	I_PERS	null
1 זנדבנק זנדבנק זנדבנק properName unspecified unspecified unspecified unspecified unspecified  	I_PERS	null
2 ( ( ( punctuation unspecified unspecified unspecified unspecified unspecified  	O	null
3 ###NUMBER### ###NUMBER### ###NUMBER### numeral unspecified unspecified unspecified unspecified unspecified  	I_DATE	null
4 ) ) ) punctuation unspecified unspecified unspecified unspecified unspecified  	O	null
5 משייך שייך משייך verb masculine singular unspecified any beinoni  	O	null
6 את את את at-preposition unspecified unspecified unspecified unspecified unspecified  	O	null
7 שירת שירה שירתו noun feminine singular absolute unspecified unspecified  
7 ו ו שירתו possessive masculine singular unspecified 3 unspecified 0 	O	null
8 לאחד איחד לאחד verb unspecified unspecified unspecified unspecified infinitive  	O	null
9 מן מן מן preposition unspecified unspecified unspecified unspecified unspecified  	O	null
10 ה ה הנוסחים definiteArticle unspecified unspecified unspecified unspecified unspecified 0 
10 הנוסחים נוסח הנוסחים noun masculine plural absolute unspecified unspecified  	O	null
11 של של של shel-preposition unspecified unspecified unspecified unspecified unspecified  	O	null
12 ה ה הפוסט definiteArticle unspecified unspecified unspecified unspecified unspecified 0 
12 הפוסט פוסט הפוסט wPrefix unspecified unspecified unspecified unspecified unspecified  	O	null
13 - - - punctuation unspecified unspecified unspecified unspecified unspecified  	O	null
14 מודרניזם מודרניזם מודרניזם noun masculine singular absolute unspecified unspecified  	O	null
15 ב ב בשירה preposition unspecified unspecified unspecified unspecified unspecified 0 
15 ה ה בשירה definiteArticle unspecified unspecified unspecified unspecified unspecified 0 
15 השירה שירה בשירה noun feminine singular absolute unspecified unspecified  	O	null
16 ה ה העברית definiteArticle unspecified unspecified unspecified unspecified unspecified 0 
16 העברית עברי העברית adjective feminine singular absolute unspecified unspecified  	O	null
17 , , , punctuation unspecified unspecified unspecified unspecified unspecified  	O	null
18 ה ה היוצא definiteArticle unspecified unspecified unspecified unspecified unspecified 0 
18 היוצא יצא היוצא participle masculine singular absolute any unspecified  	O	null
19 כנגד כנגד כנגד preposition unspecified unspecified unspecified unspecified unspecified  	O	null
20 " " " punctuation unspecified unspecified unspecified unspecified unspecified  	O	null
21 שירת שירה שירת noun feminine singular construct unspecified unspecified  	O	null
22 ה ה הסובייקט definiteArticle unspecified unspecified unspecified unspecified unspecified 0 
22 הסובייקט הסובייקט הסובייקט noun masculine singular absolute unspecified unspecified  	O	null
23 " " " punctuation unspecified unspecified unspecified unspecified unspecified  	O	null
24 של של של shel-preposition unspecified unspecified unspecified unspecified unspecified  	O	null
25 ה ה המודרניזם definiteArticle unspecified unspecified unspecified unspecified unspecified 0 
25 המודרניזם מודרניזם המודרניזם noun masculine singular absolute unspecified unspecified  	O	null
26 ה ה העברי definiteArticle unspecified unspecified unspecified unspecified unspecified 0 
26 העברי עברי העברי adjective masculine singular absolute unspecified unspecified  	O	null
27 , , , punctuation unspecified unspecified unspecified unspecified unspecified  	O	null
28 " " " punctuation unspecified unspecified unspecified unspecified unspecified  	O	null
29 לצאת יצא לצאת verb unspecified unspecified unspecified unspecified infinitive  	O	null
30 מן מן מן preposition unspecified unspecified unspecified unspecified unspecified  	O	null
31 ה ה הטרנס definiteArticle unspecified unspecified unspecified unspecified unspecified 0 
31 הטרנס הטרנס הטרנס noun masculine singular absolute unspecified unspecified  	O	null
32 של של של shel-preposition unspecified unspecified unspecified unspecified unspecified  	O	null
33 ה ה האני definiteArticle unspecified unspecified unspecified unspecified unspecified 0 
33 האני אני האני noun masculine singular absolute unspecified unspecified  	O	null
34 " " " punctuation unspecified unspecified unspecified unspecified unspecified  	O	null
35 , , , punctuation unspecified unspecified unspecified unspecified unspecified  	O	null
36 ב ב בלשונו preposition unspecified unspecified unspecified unspecified unspecified 0 
36 לשון לשון בלשונו noun feminine singular absolute unspecified unspecified  
36 ו ו בלשונו possessive masculine singular unspecified 3 unspecified 0 	O	null
37 של של של shel-preposition unspecified unspecified unspecified unspecified unspecified  	O	null
38 גורביץ' גורביץ' גורביץ' properName unspecified unspecified unspecified unspecified unspecified  	I_PERS	null
39 . . . punctuation unspecified unspecified unspecified unspecified unspecified  	O	null

0 מבשרי מבשר מבשריו noun masculine plural absolute unspecified unspecified  
0 ו ו מבשריו possessive masculine singular unspecified 3 unspecified 0 	O	null
1 של של של shel-preposition unspecified unspecified unspecified unspecified unspecified  	O	null
2 נוסח נוסח נוסח noun masculine singular construct unspecified unspecified  	O	null
3 זה זה זה pronoun masculine singular unspecified 3 unspecified  	O	null
4 הם הוא הם pronoun masculine plural unspecified 3 unspecified  	O	null
5 דוד דוד דוד properName unspecified unspecified unspecified unspecified unspecified  	I_PERS	null
6 אבידן אבידן אבידן properName unspecified unspecified unspecified unspecified unspecified  	I_PERS	null
7 ו ו ומאיר conjunction unspecified unspecified unspecified unspecified unspecified 0 
7 מאיר מאיר ומאיר properName unspecified unspecified unspecified unspecified unspecified  	I_PERS	null
8 ויזלטיר ויזלטיר ויזלטיר properName unspecified unspecified unspecified unspecified unspecified  	I_PERS	null
9 ו ו וראשון conjunction unspecified unspecified unspecified unspecified unspecified 0 
9 ראשון ראשון וראשון properName unspecified unspecified unspecified unspecified unspecified  	B_PERS	null
10 דוברי דובר דובריו noun masculine plural absolute unspecified unspecified  
10 ו ו דובריו possessive masculine singular unspecified 3 unspecified 0 	O	null
11 הוא הוא הוא pronoun masculine singular unspecified 3 unspecified  	O	null
12 אהרן אהרן אהרן properName unspecified unspecified unspecified unspecified unspecified  	I_PERS	null
13 שבתאי שבתאי שבתאי properName unspecified unspecified unspecified unspecified unspecified  	I_PERS	null
14 . . . punctuation unspecified unspecified unspecified unspecified unspecified  	O	null

0 ה ה הספר definiteArticle unspecified unspecified unspecified unspecified unspecified 0 
0 הספר ספר הספר noun masculine singular absolute unspecified unspecified  	O	null
1 יום יום יום noun masculine singular construct unspecified unspecified  	O	null
2 יום יום יום noun masculine singular absolute unspecified unspecified  	O	null
3 ( ( ( punctuation unspecified unspecified unspecified unspecified unspecified  	O	null
4 ###NUMBER### ###NUMBER### ###NUMBER### numeral unspecified unspecified unspecified unspecified unspecified  	I_DATE	null
5 ) ) ) punctuation unspecified unspecified unspecified unspecified unspecified  	O	null
6 פותח פותח פותח verb masculine singular unspecified 3 past  	O	null
7 מהלך מהלך מהלך noun masculine singular construct unspecified unspecified  	O	null
8 פואטי פואטי פואטי noun masculine singular absolute unspecified unspecified  	O	null
9 חדש חדש חדש adjective masculine singular absolute unspecified unspecified  	O	null
10 ב ב בשירתו preposition unspecified unspecified unspecified unspecified unspecified 0 
10 שירת שירה בשירתו noun feminine singular absolute unspecified unspecified  
10 ו ו בשירתו possessive masculine singular unspecified 3 unspecified 0 	O	null
11 , , , punctuation unspecified unspecified unspecified unspecified unspecified  	O	null
12 של של של shel-preposition unspecified unspecified unspecified unspecified unspecified  	O	null
13 רצפים רצף רצפים noun masculine plural absolute unspecified unspecified  	O	null
14 יומניים יומניים יומניים noun masculine dual absolute unspecified unspecified  	O	null
15 ו ו וכמו conjunction unspecified unspecified unspecified unspecified unspecified 0 
15 כמו כמו וכמו preposition unspecified unspecified unspecified unspecified unspecified  	O	null
16 - - - punctuation unspecified unspecified unspecified unspecified unspecified  	O	null
17 יומניים יומניים יומניים noun masculine dual absolute unspecified unspecified  	O	null
18 . . . punctuation unspecified unspecified unspecified unspecified unspecified  	O	null

0 ב ב בספרים preposition unspecified unspecified unspecified unspecified unspecified 0 
0 ספרים ספר בספרים noun masculine plural absolute unspecified unspecified  	O	null
1 זמן זמן זמן noun masculine singular construct unspecified unspecified  	O	null
2 בָּב בָּב בָּב properName unspecified unspecified unspecified unspecified unspecified  	I_ORG	null
3 ּ ּ ּ punctuation unspecified unspecified unspecified unspecified unspecified  	O	null
4 ָ ָ ָ punctuation unspecified unspecified unspecified unspecified unspecified  	O	null
5 ( ( ( punctuation unspecified unspecified unspecified unspecified unspecified  	O	null
6 ###NUMBER### ###NUMBER### ###NUMBER### numeral unspecified unspecified unspecified unspecified unspecified  	I_DATE	null
7 ) ) ) punctuation unspecified unspecified unspecified unspecified unspecified  	O	null
8 ו ו ודבּל conjunction unspecified unspecified unspecified unspecified unspecified 0 
8 דבּל דבּל ודבּל properName unspecified unspecified unspecified unspecified unspecified  	I_PERS	null
9 קליק קליק קליק properName unspecified unspecified unspecified unspecified unspecified  	I_PERS	null
10 ( ( ( punctuation unspecified unspecified unspecified unspecified unspecified  	O	null
11 ###NUMBER### ###NUMBER### ###NUMBER### numeral unspecified unspecified unspecified unspecified unspecified  	I_DATE	null
12 ) ) ) punctuation unspecified unspecified unspecified unspecified unspecified  	O	null
13 גובר גבר גובר verb masculine singular unspecified any beinoni  	O	null
14 ממד ממד ממד noun masculine singular construct unspecified unspecified  	O	null
15 ה ה האלתור definiteArticle unspecified unspecified unspecified unspecified unspecified 0 
15 האלתור אלתור האלתור noun masculine singular absolute unspecified unspecified  	O	null
16 ו ו והאיכות conjunction unspecified unspecified unspecified unspecified unspecified 0 
16 ה ה והאיכות definiteArticle unspecified unspecified unspecified unspecified unspecified 0 
16 האיכות איכות והאיכות noun feminine singular absolute unspecified unspecified  	O	null
17 המיצגית המיצגית המיצגית verb masculine plural unspecified any beinoni  	O	null
18 ( ( ( punctuation unspecified unspecified unspecified unspecified unspecified  	O	null
19 פרפורמנס פרפורמנס פרפורמנס properName unspecified unspecified unspecified unspecified unspecified  	O	null
20 ) ) ) punctuation unspecified unspecified unspecified unspecified unspecified  	O	null
21 ו ו ועבודת conjunction unspecified unspecified unspecified unspecified unspecified 0 
21 עבודת עבודה ועבודת noun feminine singular construct unspecified unspecified  	O	null
22 ה ה השפה definiteArticle unspecified unspecified unspecified unspecified unspecified 0 
22 השפה שפה השפה noun feminine singular absolute unspecified unspecified  	O	null
23 ה ה העברית definiteArticle unspecified unspecified unspecified unspecified unspecified 0 
23 העברית עברי העברית adjective feminine singular absolute unspecified unspecified  	O	null
24 ל ל לדורותיה preposition unspecified unspecified unspecified unspecified unspecified 0 
24 דורותי דור לדורותיה noun masculine plural absolute unspecified unspecified  
24 ה ה לדורותיה possessive feminine singular unspecified 3 unspecified 0 	O	null
25 , , , punctuation unspecified unspecified unspecified unspecified unspecified  	O	null
26 ה ה החיבור definiteArticle unspecified unspecified unspecified unspecified unspecified 0 
26 החיבור חיבור החיבור noun masculine singular absolute unspecified unspecified  	O	null
27 בין בין בין preposition unspecified unspecified unspecified unspecified unspecified  	O	null
28 אווירה אווירה אווירה noun feminine singular absolute unspecified unspecified  	O	null
29 מש מש משברית temporalSubConj unspecified unspecified unspecified unspecified unspecified 0 
29 ברית ברית משברית noun feminine singular absolute unspecified unspecified  	O	null
30 ל ל לעליצות preposition unspecified unspecified unspecified unspecified unspecified 0 
30 ה ה לעליצות definiteArticle unspecified unspecified unspecified unspecified unspecified 0 
30 העליצות עליצות לעליצות noun feminine singular absolute unspecified unspecified  	O	null
31 ו ו ומרכיב conjunction unspecified unspecified unspecified unspecified unspecified 0 
31 מרכיב מרכיב ומרכיב noun masculine singular construct unspecified unspecified  	O	null
32 ה ה התגובה definiteArticle unspecified unspecified unspecified unspecified unspecified 0 
32 התגובה תגובה התגובה noun feminine singular absolute unspecified unspecified  	O	null
33 ה ה המיידית definiteArticle unspecified unspecified unspecified unspecified unspecified 0 
33 המיידית מיידי המיידית adjective feminine singular absolute unspecified unspecified  	O	null
34 ל ל לשינויים preposition unspecified unspecified unspecified unspecified unspecified 0 
34 שינויים שינוי לשינויים noun masculine plural absolute unspecified unspecified  	O	null
35 ב ב בממד preposition unspecified unspecified unspecified unspecified unspecified 0 
35 ממד ממד בממד noun masculine singular construct unspecified unspecified  	O	null
36 ה ה הזמן definiteArticle unspecified unspecified unspecified unspecified unspecified 0 
36 הזמן זמן הזמן noun masculine singular absolute unspecified unspecified  	O	null
37 ( ( ( punctuation unspecified unspecified unspecified unspecified unspecified  	O	null
38 למשל למשל למשל conjunction unspecified unspecified unspecified unspecified unspecified  	O	null
39 , , , punctuation unspecified unspecified unspecified unspecified unspecified  	O	null
40 ה ה האינטרנט definiteArticle unspecified unspecified unspecified unspecified unspecified 0 
40 האינטרנט אינטרנט האינטרנט noun masculine singular absolute unspecified unspecified  	O	null
41 ) ) ) punctuation unspecified unspecified unspecified unspecified unspecified  	O	null
42 . . . punctuation unspecified unspecified unspecified unspecified unspecified  	O	null

0 ה ה הספר definiteArticle unspecified unspecified unspecified unspecified unspecified 0 
0 הספר ספר הספר noun masculine singular absolute unspecified unspecified  	O	null
1 פסוקים פסוק פסוקים noun masculine plural absolute unspecified unspecified  	O	null
2 ( ( ( punctuation unspecified unspecified unspecified unspecified unspecified  	O	null
3 ###NUMBER### ###NUMBER### ###NUMBER### numeral unspecified unspecified unspecified unspecified unspecified  	I_DATE	null
4 ) ) ) punctuation unspecified unspecified unspecified unspecified unspecified  	O	null
5 כתוב כתוב כתוב adjective masculine singular absolute unspecified unspecified  	O	null
6 ב ב במורשת preposition unspecified unspecified unspecified unspecified unspecified 0 
6 מורשת מורשה במורשת noun feminine singular construct unspecified unspecified  	O	null
7 ה ה הפסוק definiteArticle unspecified unspecified unspecified unspecified unspecified 0 
7 הפסוק פסוק הפסוק noun masculine singular absolute unspecified unspecified  	O	null
8 ה ה המקראי definiteArticle unspecified unspecified unspecified unspecified unspecified 0 
8 המקראי מקראי המקראי adjective masculine singular absolute unspecified unspecified  	O	null
9 ו ו ולשון conjunction unspecified unspecified unspecified unspecified unspecified 0 
9 לשון לשון ולשון noun feminine singular construct unspecified unspecified  	O	null
10 שירת שירה שירת noun feminine singular construct unspecified unspecified  	O	null
11 ימי יום ימי noun masculine plural construct unspecified unspecified  	O	null
12 ה ה הביניים definiteArticle unspecified unspecified unspecified unspecified unspecified 0 
12 הביניים ביניים הביניים noun masculine singular absolute unspecified unspecified  	O	null
13 . . . punctuation unspecified unspecified unspecified unspecified unspecified  	O	null

0 על על על preposition unspecified unspecified unspecified unspecified unspecified  	O	null
1 ספר ספר ספרו noun masculine singular absolute unspecified unspecified  
1 ו ו ספרו possessive masculine singular unspecified 3 unspecified 0 	O	null
2 הא הא הא properName unspecified unspecified unspecified unspecified unspecified  	I_PERS	null
3 ודא וידא ודא verb masculine singular unspecified 2 imperative  	O	null
4 ו ו ועל conjunction unspecified unspecified unspecified unspecified unspecified 0 
4 על על ועל preposition unspecified unspecified unspecified unspecified unspecified  	O	null
5 ספר ספר ספרו noun masculine singular absolute unspecified unspecified  
5 ו ו ספרו possessive masculine singular unspecified 3 unspecified 0 	O	null
6 יום יום יום noun masculine singular construct unspecified unspecified  	O	null
7 יום יום יום noun masculine singular absolute unspecified unspecified  	O	null
8 הוענקו הוענק הוענקו verb masculine-and-feminine plural unspecified 3 past  	O	null
9 לזלי לזלי לזלי properName unspecified unspecified unspecified unspecified unspecified  	I_PERS	null
10 גורביץ' גורביץ' גורביץ' properName unspecified unspecified unspecified unspecified unspecified  	I_PERS	null
11 פרסי פרס פרסי noun masculine plural construct unspecified unspecified  	O	null
12 עיריית עירייה עיריית noun feminine singular construct unspecified unspecified  	I_ORG	null
13 חולון חולון חולון properName unspecified unspecified unspecified unspecified unspecified  	I_ORG	null
14 ל ל לספרות preposition unspecified unspecified unspecified unspecified unspecified 0 
14 ספרות ספרות לספרות noun feminine singular absolute unspecified unspecified  	O	null
15 יפה יפה יפה adjective feminine singular absolute unspecified unspecified  	O	null
16 על על על preposition unspecified unspecified unspecified unspecified unspecified  	O	null
17 שם שם שם noun masculine singular construct unspecified unspecified  	O	null
18 ד"ר ד"ר ד"ר title unspecified singular unspecified unspecified unspecified  	O	null
19 קוגל קוגל קוגל properName unspecified unspecified unspecified unspecified unspecified  	I_PERS	null
20 ב ב ב preposition unspecified unspecified unspecified unspecified unspecified 0 	I_DATE	null
21 - - - punctuation unspecified unspecified unspecified unspecified unspecified  	O	null
22 ###NUMBER### ###NUMBER### ###NUMBER### numeral unspecified unspecified unspecified unspecified unspecified  	I_DATE	null
23 ו ו וב conjunction unspecified unspecified unspecified unspecified unspecified 0 
23 ב ב וב preposition unspecified unspecified unspecified unspecified unspecified 0 	O	null
24 - - - punctuation unspecified unspecified unspecified unspecified unspecified  	O	null
25 ###NUMBER### ###NUMBER### ###NUMBER### numeral unspecified unspecified unspecified unspecified unspecified  	I_DATE	null
26 . . . punctuation unspecified unspecified unspecified unspecified unspecified  	O	null

0 תירגם תרגם תירגם verb masculine singular unspecified 3 past  	O	null
1 מן מן מן preposition unspecified unspecified unspecified unspecified unspecified  	O	null
2 ה ה השירה definiteArticle unspecified unspecified unspecified unspecified unspecified 0 
2 השירה שירה השירה noun feminine singular absolute unspecified unspecified  	O	null
3 ה ה האמריקנית definiteArticle unspecified unspecified unspecified unspecified unspecified 0 
3 האמריקנית אמריקני האמריקנית adjective feminine singular absolute unspecified unspecified  	O	null
4 ( ( ( punctuation unspecified unspecified unspecified unspecified unspecified  	O	null
5 ג'ון ג'ון ג'ון properName unspecified unspecified unspecified unspecified unspecified  	I_PERS	null
6 אשברי אשברי אשברי properName unspecified unspecified unspecified unspecified unspecified  	I_PERS	null
7 , , , punctuation unspecified unspecified unspecified unspecified unspecified  	O	null
8 צ'רלס צארלס צ'רלס properName unspecified unspecified unspecified unspecified unspecified  	I_PERS	null
9 אולסון אולסון אולסון properName unspecified unspecified unspecified unspecified unspecified  	I_PERS	null
10 ו ו ואחרים conjunction unspecified unspecified unspecified unspecified unspecified 0 
10 אחרים אחר ואחרים adjective masculine plural absolute unspecified unspecified  	O	null
11 ) ) ) punctuation unspecified unspecified unspecified unspecified unspecified  	O	null
12 , , , punctuation unspecified unspecified unspecified unspecified unspecified  	O	null
13 פירסם פרסם פירסם verb masculine singular unspecified 3 past  	O	null
14 מסות מסה מסות noun feminine plural absolute unspecified unspecified  	O	null
15 ו ו וספרים conjunction unspecified unspecified unspecified unspecified unspecified 0 
15 ספרים ספר וספרים noun masculine plural absolute unspecified unspecified  	O	null
16 על על על preposition unspecified unspecified unspecified unspecified unspecified  	O	null
17 מקום מקום מקום noun masculine singular absolute unspecified unspecified  	O	null
18 , , , punctuation unspecified unspecified unspecified unspecified unspecified  	O	null
19 על על על preposition unspecified unspecified unspecified unspecified unspecified  	O	null
20 שיחה שיחה שיחה noun feminine singular absolute unspecified unspecified  	O	null
21 ו ו ועל conjunction unspecified unspecified unspecified unspecified unspecified 0 
21 על על ועל preposition unspecified unspecified unspecified unspecified unspecified  	O	null
22 כתיבה כתיבה כתיבה noun feminine singular absolute unspecified unspecified  	O	null
23 ה ה המשלבים definiteArticle unspecified unspecified unspecified unspecified unspecified 0 
23 המשלבים שילב המשלבים participle masculine plural absolute any unspecified  	O	null
24 פילוסופיה פילוסופיה פילוסופיה noun feminine singular absolute unspecified unspecified  	O	null
25 , , , punctuation unspecified unspecified unspecified unspecified unspecified  	O	null
26 אנתרופולוגיה אנתרופולוגיה אנתרופולוגיה noun feminine singular absolute unspecified unspecified  	O	null
27 ו ו ופואטיקה conjunction unspecified unspecified unspecified unspecified unspecified 0 
27 פואטיקה פואטיקה ופואטיקה noun feminine singular absolute unspecified unspecified  	O	null
28 , , , punctuation unspecified unspecified unspecified unspecified unspecified  	O	null
29 ו ו וכן conjunction unspecified unspecified unspecified unspecified unspecified 0 
29 כן כן וכן conjunction unspecified unspecified unspecified unspecified unspecified  	O	null
30 כתב כתב כתב noun masculine singular construct unspecified unspecified  	O	null
31 רשימות רשימה רשימות noun feminine plural absolute unspecified unspecified  	O	null
32 ביקורת ביקורת ביקורת noun feminine singular absolute unspecified unspecified  	O	null
33 על על על preposition unspecified unspecified unspecified unspecified unspecified  	O	null
34 משוררים משורר משוררים noun masculine plural absolute unspecified unspecified  	O	null
35 ב ב בעיתונות preposition unspecified unspecified unspecified unspecified unspecified 0 
35 ה ה בעיתונות definiteArticle unspecified unspecified unspecified unspecified unspecified 0 
35 העיתונות עיתונות בעיתונות noun feminine singular absolute unspecified unspecified  	O	null
36 ה ה היומית definiteArticle unspecified unspecified unspecified unspecified unspecified 0 
36 היומית יומי היומית adjective feminine singular absolute unspecified unspecified  	O	null
37 ( ( ( punctuation unspecified unspecified unspecified unspecified unspecified  	O	null
38 על על על preposition unspecified unspecified unspecified unspecified unspecified  	O	null
39 דוד דוד דוד properName unspecified unspecified unspecified unspecified unspecified  	I_PERS	null
40 אבידן אבידן אבידן properName unspecified unspecified unspecified unspecified unspecified  	I_PERS	null
41 , , , punctuation unspecified unspecified unspecified unspecified unspecified  	O	null
42 יונה יונה יונה properName unspecified unspecified unspecified unspecified unspecified  	I_PERS	null
43 וולך וולך וולך properName unspecified unspecified unspecified unspecified unspecified  	I_PERS	null
44 , , , punctuation unspecified unspecified unspecified unspecified unspecified  	O	null
45 אהרן אהרן אהרן properName unspecified unspecified unspecified unspecified unspecified  	I_PERS	null
46 שבתאי שבתאי שבתאי properName unspecified unspecified unspecified unspecified unspecified  	I_PERS	null
47 ו ו ואחרים conjunction unspecified unspecified unspecified unspecified unspecified 0 
47 אחרים אחר ואחרים adjective masculine plural absolute unspecified unspecified  	O	null
48 ) ) ) punctuation unspecified unspecified unspecified unspecified unspecified  	O	null
49 ו ו ומסות conjunction unspecified unspecified unspecified unspecified unspecified 0 
49 מסות מסה ומסות noun feminine plural absolute unspecified unspecified  	O	null
50 על על על preposition unspecified unspecified unspecified unspecified unspecified  	O	null
51 יוצרים יוצר יוצרים noun masculine plural absolute unspecified unspecified  	O	null
52 ב ב באמנות preposition unspecified unspecified unspecified unspecified unspecified 0 
52 ה ה באמנות definiteArticle unspecified unspecified unspecified unspecified unspecified 0 
52 האמנות אמנות באמנות noun feminine singular absolute unspecified unspecified  	O	null
53 ה ה הפלסטית definiteArticle unspecified unspecified unspecified unspecified unspecified 0 
53 הפלסטית פלסטי הפלסטית adjective feminine singular absolute unspecified unspecified  	O	null
54 ( ( ( punctuation unspecified unspecified unspecified unspecified unspecified  	O	null
55 מיכאל מיכאל מיכאל properName unspecified unspecified unspecified unspecified unspecified  	I_PERS	null
56 סגן סגן סגן noun masculine singular construct unspecified unspecified  	O	null
57 כהן כהן כהן properName unspecified unspecified unspecified unspecified unspecified  	I_PERS	null
58 , , , punctuation unspecified unspecified unspecified unspecified unspecified  	O	null
59 אברהם אברהם אברהם properName unspecified unspecified unspecified unspecified unspecified  	I_PERS	null
60 אופק אופק אופק properName unspecified unspecified unspecified unspecified unspecified  	I_PERS	null
61 ו ו ואחרים conjunction unspecified unspecified unspecified unspecified unspecified 0 
61 אחרים אחר ואחרים adjective masculine plural absolute unspecified unspecified  	O	null
62 ) ) ) punctuation unspecified unspecified unspecified unspecified unspecified  	O	null
63 . . . punctuation unspecified unspecified unspecified unspecified unspecified  	O	null

0 ה ה המאמר definiteArticle unspecified unspecified unspecified unspecified unspecified 0 
0 המאמר מאמר המאמר noun masculine singular absolute unspecified unspecified  	O	null
1 ש ש שכתב relativizer/subordinatingConjunction unspecified unspecified unspecified unspecified unspecified 0 
1 כתב כתב שכתב verb masculine singular unspecified 3 past  	O	null
2 עם עם עם preposition unspecified unspecified unspecified unspecified unspecified  	O	null
3 גדעון גדעון גדעון properName unspecified unspecified unspecified unspecified unspecified  	I_PERS	null
4 ארן ארן ארן properName unspecified unspecified unspecified unspecified unspecified  	I_PERS	null
5 , , , punctuation unspecified unspecified unspecified unspecified unspecified  	O	null
6 " " " punctuation unspecified unspecified unspecified unspecified unspecified  	O	null
7 על על על preposition unspecified unspecified unspecified unspecified unspecified  	O	null
8 ה ה המקום definiteArticle unspecified unspecified unspecified unspecified unspecified 0 
8 המקום מקום המקום noun masculine singular absolute unspecified unspecified  	O	null
9 " " " punctuation unspecified unspecified unspecified unspecified unspecified  	O	null
10 , , , punctuation unspecified unspecified unspecified unspecified unspecified  	O	null
11 ###NUMBER### ###NUMBER### ###NUMBER### numeral unspecified unspecified unspecified unspecified unspecified  	I_DATE	null
12 פורסם פורסם פורסם verb masculine singular unspecified 3 past  	O	null
13 מחדש מחדש מחדש adverb unspecified unspecified unspecified unspecified unspecified  	O	null
14 ב ב בספרו preposition unspecified unspecified unspecified unspecified unspecified 0 
14 ספר ספר בספרו noun masculine singular absolute unspecified unspecified  
14 ו ו בספרו possessive masculine singular unspecified 3 unspecified 0 	O	null
15 על על על preposition unspecified unspecified unspecified unspecified unspecified  	O	null
16 ה ה המקום definiteArticle unspecified unspecified unspecified unspecified unspecified 0 
16 המקום מקום המקום noun masculine singular absolute unspecified unspecified  	O	null
17 , , , punctuation unspecified unspecified unspecified unspecified unspecified  	O	null
18 ) ) ) punctuation unspecified unspecified unspecified unspecified unspecified  	O	null
19 , , , punctuation unspecified unspecified unspecified unspecified unspecified  	O	null
20 ###NUMBER### ###NUMBER### ###NUMBER### numeral unspecified unspecified unspecified unspecified unspecified  	I_DATE	null
21 הוא הוא הוא pronoun masculine singular unspecified 3 unspecified  	O	null
22 אחד איחד אחד verb masculine singular unspecified 3 past  	O	null
23 מן מן מן preposition unspecified unspecified unspecified unspecified unspecified  	O	null
24 ה ה המאמרים definiteArticle unspecified unspecified unspecified unspecified unspecified 0 
24 המאמרים מאמר המאמרים noun masculine plural absolute unspecified unspecified  	O	null
25 ה ה המשפיעים definiteArticle unspecified unspecified unspecified unspecified unspecified 0 
25 המשפיעים השפיע המשפיעים participle masculine plural absolute any unspecified  	O	null
26 ו ו והמצוטטים conjunction unspecified unspecified unspecified unspecified unspecified 0 
26 ה ה והמצוטטים definiteArticle unspecified unspecified unspecified unspecified unspecified 0 
26 המצוטטים צוטט והמצוטטים participle masculine plural absolute any unspecified  	O	null
27 ביותר ביותר ביותר adverb unspecified unspecified unspecified unspecified unspecified  	O	null
28 ב ב במחקר preposition unspecified unspecified unspecified unspecified unspecified 0 
28 ה ה במחקר definiteArticle unspecified unspecified unspecified unspecified unspecified 0 
28 המחקר מחקר במחקר noun masculine singular absolute unspecified unspecified  	O	null
29 ה ה הספרותי definiteArticle unspecified unspecified unspecified unspecified unspecified 0 
29 הספרותי ספרותי הספרותי adjective masculine singular absolute unspecified unspecified  	O	null
30 ו ו והחברתי conjunction unspecified unspecified unspecified unspecified unspecified 0 
30 ה ה והחברתי definiteArticle unspecified unspecified unspecified unspecified unspecified 0 
30 החברתי חברתי והחברתי adjective masculine singular absolute unspecified unspecified  	O	null
31 . . . punctuation unspecified unspecified unspecified unspecified unspecified  	O	null

0 ספרי ספר ספריו noun masculine plural absolute unspecified unspecified  
0 ו ו ספריו possessive masculine singular unspecified 3 unspecified 0 	O	null
1 ה ה העיוניים definiteArticle unspecified unspecified unspecified unspecified unspecified 0 
1 העיוניים עיוני העיוניים adjective masculine plural absolute unspecified unspecified  	O	null
2 ה ה האחרונים definiteArticle unspecified unspecified unspecified unspecified unspecified 0 
2 האחרונים אחרון האחרונים adjective masculine plural absolute unspecified unspecified  	O	null
3 הם הוא הם pronoun masculine plural unspecified 3 unspecified  	O	null
4 חשבון חשבון חשבונו noun masculine singular absolute unspecified unspecified  
4 ו ו חשבונו possessive masculine singular unspecified 3 unspecified 0 	O	null
5 של של של shel-preposition unspecified unspecified unspecified unspecified unspecified  	O	null
6 קהלת קהלת קהלת properName unspecified unspecified unspecified unspecified unspecified  	I_PERS	null
7 ) ) ) punctuation unspecified unspecified unspecified unspecified unspecified  	O	null
8 , , , punctuation unspecified unspecified unspecified unspecified unspecified  	O	null
9 ###NUMBER### ###NUMBER### ###NUMBER### numeral unspecified unspecified unspecified unspecified unspecified  	I_DATE	null
10 קריאה קריאה קריאה noun feminine singular absolute unspecified unspecified  	O	null
11 חדשה חדש חדשה adjective feminine singular absolute unspecified unspecified  	O	null
12 ב ב בספר preposition unspecified unspecified unspecified unspecified unspecified 0 
12 ה ה בספר definiteArticle unspecified unspecified unspecified unspecified unspecified 0 
12 הספר ספר בספר noun masculine singular absolute unspecified unspecified  	O	null
13 קהלת קהלת קהלת properName unspecified unspecified unspecified unspecified unspecified  	I_PERS	null
14 , , , punctuation unspecified unspecified unspecified unspecified unspecified  	O	null
15 ו ו ושיחה conjunction unspecified unspecified unspecified unspecified unspecified 0 
15 שיחה שיחה ושיחה noun feminine singular absolute unspecified unspecified  	O	null
16 ) ) ) punctuation unspecified unspecified unspecified unspecified unspecified  	O	null
17 . . . punctuation unspecified unspecified unspecified unspecified unspecified  	O	null
18 ###NUMBER### ###NUMBER### ###NUMBER### numeral unspecified unspecified unspecified unspecified unspecified  	I_DATE	null
19 References References References foreign unspecified unspecified unspecified unspecified unspecified  	O	null
20 : : : punctuation unspecified unspecified unspecified unspecified unspecified  	O	null
21 בן בן בן properName unspecified unspecified unspecified unspecified unspecified  	I_PERS	null
22 משה משה משה properName unspecified unspecified unspecified unspecified unspecified  	I_PERS	null
23 , , , punctuation unspecified unspecified unspecified unspecified unspecified  	O	null
24 יקיר יקיר יקיר properName unspecified unspecified unspecified unspecified unspecified  	I_PERS	null
25 . . . punctuation unspecified unspecified unspecified unspecified unspecified  	O	null

0 " " " punctuation unspecified unspecified unspecified unspecified unspecified  	O	null
1 אחלה איחל אחלה verb feminine singular unspecified 3 past  	O	null
2 שיר שיר שיר noun masculine singular absolute unspecified unspecified  	O	null
3 ש ש שבעולם relativizer/subordinatingConjunction unspecified unspecified unspecified unspecified unspecified 0 
3 ב ב שבעולם preposition unspecified unspecified unspecified unspecified unspecified 0 
3 ה ה שבעולם definiteArticle unspecified unspecified unspecified unspecified unspecified 0 
3 העולם עולם שבעולם noun masculine singular absolute unspecified unspecified  	O	null
4 " " " punctuation unspecified unspecified unspecified unspecified unspecified  	O	null
5 . . . punctuation unspecified unspecified unspecified unspecified unspecified  	O	null

0 ה ה הארץ definiteArticle unspecified unspecified unspecified unspecified unspecified 0 
0 הארץ ארץ הארץ noun feminine singular absolute unspecified unspecified  	O	null
1 ספרים ספר ספרים noun masculine plural absolute unspecified unspecified  	O	null
2 . . . punctuation unspecified unspecified unspecified unspecified unspecified  	O	null

0 ###NUMEXP### ###NUMEXP### ###NUMEXP### numberExpression unspecified unspecified unspecified unspecified unspecified  	I_DATE	null
1 ; ; ; punctuation unspecified unspecified unspecified unspecified unspecified  	O	null
2 זנדבנק זנדבנק זנדבנק properName unspecified unspecified unspecified unspecified unspecified  	I_PERS	null
3 , , , punctuation unspecified unspecified unspecified unspecified unspecified  	O	null
4 שמעון שמעון שמעון properName unspecified unspecified unspecified unspecified unspecified  	I_PERS	null
5 . . . punctuation unspecified unspecified unspecified unspecified unspecified  	O	null

0 " " " punctuation unspecified unspecified unspecified unspecified unspecified  	O	null
1 ה ה הקול definiteArticle unspecified unspecified unspecified unspecified unspecified 0 
1 הקול קול הקול noun masculine singular absolute unspecified unspecified  	O	null
2 הוא הוא הוא pronoun masculine singular unspecified 3 unspecified  	O	null
3 ה ה האחר definiteArticle unspecified unspecified unspecified unspecified unspecified 0 
3 האחר אחר האחר adjective masculine singular absolute unspecified unspecified  	O	null
4 : : : punctuation unspecified unspecified unspecified unspecified unspecified  	O	null
5 שני CARD2 שני numeral masculine dual construct unspecified unspecified  	O	null
6 נוסחים נוסח נוסחים noun masculine plural absolute unspecified unspecified  	O	null
7 של של של shel-preposition unspecified unspecified unspecified unspecified unspecified  	O	null
8 פוסטמודרניזם פוסטמודרניזם פוסטמודרניזם properName unspecified unspecified unspecified unspecified unspecified  	I_PERS	null
9 עברי עברי עברי adjective masculine singular absolute unspecified unspecified  	O	null
10 " " " punctuation unspecified unspecified unspecified unspecified unspecified  	O	null
11 . . . punctuation unspecified unspecified unspecified unspecified unspecified  	O	null

0 ה ה הקול definiteArticle unspecified unspecified unspecified unspecified unspecified 0 
0 הקול קול הקול noun masculine singular absolute unspecified unspecified  	O	null
1 הוא הוא הוא pronoun masculine singular unspecified 3 unspecified  	O	null
2 ה ה האחר definiteArticle unspecified unspecified unspecified unspecified unspecified 0 
2 האחר אחר האחר adjective masculine singular absolute unspecified unspecified  	O	null
3 . . . punctuation unspecified unspecified unspecified unspecified unspecified  	O	null

0 ירושלים ירושלים ירושלים properName unspecified unspecified unspecified unspecified unspecified  	I_LOC	null
1 : : : punctuation unspecified unspecified unspecified unspecified unspecified  	O	null
2 כרמל כרמל כרמל properName unspecified unspecified unspecified unspecified unspecified  	I_LOC	null
3 ו ו והמכון conjunction unspecified unspecified unspecified unspecified unspecified 0 
3 ה ה והמכון definiteArticle unspecified unspecified unspecified unspecified unspecified 0 
3 המכון מיכון והמכון noun masculine singular absolute unspecified unspecified  	O	null
4 ה ה הישראלי definiteArticle unspecified unspecified unspecified unspecified unspecified 0 
4 הישראלי ישראלי הישראלי adjective masculine singular absolute unspecified unspecified  	O	null
5 ל ל לפואטיקה preposition unspecified unspecified unspecified unspecified unspecified 0 
5 פואטיקה פואטיקה לפואטיקה noun feminine singular absolute unspecified unspecified  	O	null
6 ע"ש ע"ש ע"ש preposition unspecified unspecified unspecified unspecified unspecified  	O	null
7 פורטר פורטר פורטר properName unspecified unspecified unspecified unspecified unspecified  	I_PERS	null
8 , , , punctuation unspecified unspecified unspecified unspecified unspecified  	O	null
9 אוניברסיטת אוניברסיטה אוניברסיטת noun feminine singular construct unspecified unspecified  	I_ORG	null
10 תלאביב תלאביב תלאביב properName unspecified unspecified unspecified unspecified unspecified  	I_ORG	null
11 . . . punctuation unspecified unspecified unspecified unspecified unspecified  	O	null

0 ###NUMBER### ###NUMBER### ###NUMBER### numeral unspecified unspecified unspecified unspecified unspecified  	I_DATE	null
1 . . . punctuation unspecified unspecified unspecified unspecified unspecified  	O	null

0 - - - punctuation unspecified unspecified unspecified unspecified unspecified  	O	null
1 ###NUMBER### ###NUMBER### ###NUMBER### numeral unspecified unspecified unspecified unspecified unspecified  	O	null
2 ; ; ; punctuation unspecified unspecified unspecified unspecified unspecified  	O	null
3 ###NUMBER### ###NUMBER### ###NUMBER### numeral unspecified unspecified unspecified unspecified unspecified  	O	null
4 ליב ליב ליבס noun masculine singular absolute unspecified unspecified  
4 ו ו ליבס possessive masculine singular unspecified 3 unspecified 0 	O	null
5 , , , punctuation unspecified unspecified unspecified unspecified unspecified  	O	null
6 יהודה יהודה יהודה properName unspecified unspecified unspecified unspecified unspecified  	I_PERS	null
7 . . . punctuation unspecified unspecified unspecified unspecified unspecified  	O	null

0 " " " punctuation unspecified unspecified unspecified unspecified unspecified  	I_ORG	null
1 שׂרה שׂרה שׂרה properName unspecified unspecified unspecified unspecified unspecified  	I_ORG	null
2 שׁרה שׁרה שׁרה verb masculine-and-feminine singular unspecified 1 future  	O	null
3 שׁיר שׁיר שׁיר properName unspecified unspecified unspecified unspecified unspecified  	I_ORG	null
4 שׂם שׂם שׂמח noun masculine plural absolute unspecified unspecified  
4 י י שׂמח possessive masculine-and-feminine singular unspecified 1 unspecified 0 	O	null
5 " " " punctuation unspecified unspecified unspecified unspecified unspecified  	O	null
6 . . . punctuation unspecified unspecified unspecified unspecified unspecified  	O	null
7 ה ה הארץ definiteArticle unspecified unspecified unspecified unspecified unspecified 0 
7 הארץ ארץ הארץ noun feminine singular absolute unspecified unspecified  	O	null
8 תרבות תרבות תרבות noun feminine singular absolute unspecified unspecified  	O	null
9 ו ו וספרות conjunction unspecified unspecified unspecified unspecified unspecified 0 
9 ספרות ספרות וספרות noun feminine singular absolute unspecified unspecified  	O	null
10 . . . punctuation unspecified unspecified unspecified unspecified unspecified  	O	null

0 ###NUMEXP### ###NUMEXP### ###NUMEXP### numberExpression unspecified unspecified unspecified unspecified unspecified  	I_DATE	null
1 ; ; ; punctuation unspecified unspecified unspecified unspecified unspecified  	O	null
2 סגןכהן סגןכהן סגןכהן properName unspecified unspecified unspecified unspecified unspecified  	I_PERS	null
3 , , , punctuation unspecified unspecified unspecified unspecified unspecified  	O	null
4 מיכאל מיכאל מיכאל properName unspecified unspecified unspecified unspecified unspecified  	I_PERS	null
5 . . . punctuation unspecified unspecified unspecified unspecified unspecified  	O	null

0 " " " punctuation unspecified unspecified unspecified unspecified unspecified  	O	null
1 ו ו ואני conjunction unspecified unspecified unspecified unspecified unspecified 0 
1 אני הוא ואני pronoun masculine-and-feminine singular unspecified 1 unspecified  	O	null
2 חוזר חזר חוזר verb masculine singular unspecified any beinoni  	O	null
3 לפשט פישט לפשט verb unspecified unspecified unspecified unspecified infinitive  	O	null
4 ( ( ( punctuation unspecified unspecified unspecified unspecified unspecified  	O	null
5 ' ' ' punctuation unspecified unspecified unspecified unspecified unspecified  	O	null
6 על על על preposition unspecified unspecified unspecified unspecified unspecified  	O	null
7 הא הא הא properName unspecified unspecified unspecified unspecified unspecified  	I_PERS	null
8 ודא וידא ודא verb masculine singular unspecified 2 imperative  	O	null
9 ' ' ' punctuation unspecified unspecified unspecified unspecified unspecified  	O	null
10 , , , punctuation unspecified unspecified unspecified unspecified unspecified  	O	null
11 ספר ספר ספר noun masculine singular construct unspecified unspecified  	O	null
12 שירים שיר שירים noun masculine plural absolute unspecified unspecified  	O	null
13 של של של shel-preposition unspecified unspecified unspecified unspecified unspecified  	O	null
14 זלי זלי זלי properName unspecified unspecified unspecified unspecified unspecified  	I_PERS	null
15 גורביץ')" גורביץ')" גורביץ')" properName unspecified unspecified unspecified unspecified unspecified  	I_PERS	null
16 . . . punctuation unspecified unspecified unspecified unspecified unspecified  	O	null
17 סטודיו סטודיו סטודיו properName unspecified unspecified unspecified unspecified unspecified  	I_LOC	null
18 ###NUMBER### ###NUMBER### ###NUMBER### numeral unspecified unspecified unspecified unspecified unspecified  	O	null
19 . . . punctuation unspecified unspecified unspecified unspecified unspecified  	O	null

0 ###NUMBER### ###NUMBER### ###NUMBER### numeral unspecified unspecified unspecified unspecified unspecified  	I_DATE	null
1 . . . punctuation unspecified unspecified unspecified unspecified unspecified  	O	null

0 ###NUMBER### ###NUMBER### ###NUMBER### numeral unspecified unspecified unspecified unspecified unspecified  	O	null
1 ־ ־ ־ punctuation unspecified unspecified unspecified unspecified unspecified  	O	null
2 ###NUMBER### ###NUMBER### ###NUMBER### numeral unspecified unspecified unspecified unspecified unspecified  	O	null
3 . . . punctuation unspecified unspecified unspecified unspecified unspecified  	O	null

