0 Name Name Name foreign unspecified unspecified unspecified unspecified unspecified  	O	null
1 : : : punctuation unspecified unspecified unspecified unspecified unspecified  	O	null
2 גורדון גורדון גורדון properName unspecified unspecified unspecified unspecified unspecified  	I_ORG	null
3 - - - properName unspecified unspecified unspecified unspecified unspecified  	I_ORG	null
4 קנכט קנכט קנכט properName unspecified unspecified unspecified unspecified unspecified  	I_ORG	null
5 , , , punctuation unspecified unspecified unspecified unspecified unspecified  	O	null
6 לידי לידי לידיה preposition unspecified unspecified unspecified unspecified unspecified  
6 ה ה לידיה pronomial feminine singular unspecified 3 unspecified 0 	O	null
7 Birth Birth Birth foreign unspecified unspecified unspecified unspecified unspecified  	O	null
8 Year Year Year foreign unspecified unspecified unspecified unspecified unspecified  	O	null
9 : : : punctuation unspecified unspecified unspecified unspecified unspecified  	O	null
10 ###NUMBER### ###NUMBER### ###NUMBER### numeral unspecified unspecified unspecified unspecified unspecified  	I_DATE	null
11 Birth Birth Birth foreign unspecified unspecified unspecified unspecified unspecified  	O	null
12 Place Place Place foreign unspecified unspecified unspecified unspecified unspecified  	O	null
13 : : : punctuation unspecified unspecified unspecified unspecified unspecified  	O	null
14 מונטווידאו מונטווידאו מונטווידאו properName unspecified unspecified unspecified unspecified unspecified  	I_ORG	null
15 , , , punctuation unspecified unspecified unspecified unspecified unspecified  	O	null
16 אורוגוואי אורוגוואי אורוגוואי properName unspecified unspecified unspecified unspecified unspecified  	I_LOC	null
17 Occupation Occupation Occupation foreign unspecified unspecified unspecified unspecified unspecified  	O	null
18 : : : punctuation unspecified unspecified unspecified unspecified unspecified  	O	null
19 סופרת סופר סופרת noun feminine singular construct unspecified unspecified  	O	null
20 Entry Entry Entry foreign unspecified unspecified unspecified unspecified unspecified  	O	null
21 writer writer writer foreign unspecified unspecified unspecified unspecified unspecified  	O	null
22 : : : punctuation unspecified unspecified unspecified unspecified unspecified  	O	null
23 רותם רותם רותם properName unspecified unspecified unspecified unspecified unspecified  	I_PERS	null
24 רז רז רז properName unspecified unspecified unspecified unspecified unspecified  	I_PERS	null
25 Entry Entry Entry foreign unspecified unspecified unspecified unspecified unspecified  	O	null
26 Value Value Value foreign unspecified unspecified unspecified unspecified unspecified  	O	null
27 : : : punctuation unspecified unspecified unspecified unspecified unspecified  	O	null
28 נולדה נולד נולדה verb feminine singular unspecified 3 past  	O	null
29 ב ב במונטווידאו preposition unspecified unspecified unspecified unspecified unspecified 0 
29 מונטווידאו מונטווידאו במונטווידאו properName unspecified unspecified unspecified unspecified unspecified  	I_PERS	null
30 , , , punctuation unspecified unspecified unspecified unspecified unspecified  	O	null
31 אורוגוואי אורוגוואי אורוגוואי properName unspecified unspecified unspecified unspecified unspecified  	I_LOC	null
32 . . . punctuation unspecified unspecified unspecified unspecified unspecified  	O	null

0 ב ב ב preposition unspecified unspecified unspecified unspecified unspecified 0 	I_ORG	null
1 - - - punctuation unspecified unspecified unspecified unspecified unspecified  	I_ORG	null
2 ###NUMBER### ###NUMBER### ###NUMBER### numeral unspecified unspecified unspecified unspecified unspecified  	I_DATE	null
3 עלתה עלה עלתה verb feminine singular unspecified 3 past  	O	null
4 ל ל לארץ preposition unspecified unspecified unspecified unspecified unspecified 0 
4 ה ה לארץ definiteArticle unspecified unspecified unspecified unspecified unspecified 0 
4 הארץ ארץ לארץ noun feminine singular absolute unspecified unspecified  	O	null
5 עם עם עם preposition unspecified unspecified unspecified unspecified unspecified  	O	null
6 גרעין גרעין גרעין noun masculine singular absolute unspecified unspecified  	O	null
7 של של של shel-preposition unspecified unspecified unspecified unspecified unspecified  	O	null
8 " " " punctuation unspecified unspecified unspecified unspecified unspecified  	I_ORG	null
9 ה ה השומר definiteArticle unspecified unspecified unspecified unspecified unspecified 0 
9 השומר שומר השומר properName unspecified unspecified unspecified unspecified unspecified  	I_ORG	null
10 ה ה הצעיר definiteArticle unspecified unspecified unspecified unspecified unspecified 0 
10 הצעיר צעיר הצעיר adjective masculine singular absolute unspecified unspecified  	O	null
11 " " " punctuation unspecified unspecified unspecified unspecified unspecified  	O	null
12 ו ו והתיישבה conjunction unspecified unspecified unspecified unspecified unspecified 0 
12 התיישבה התיישב והתיישבה verb feminine singular unspecified 3 past  	I_LOC	null
13 ב ב בקיבוץ preposition unspecified unspecified unspecified unspecified unspecified 0 
13 קיבוץ קיבוץ בקיבוץ noun masculine singular construct unspecified unspecified  	I_LOC	null
14 געתון געתון געתון properName unspecified unspecified unspecified unspecified unspecified  	I_LOC	null
15 . . . punctuation unspecified unspecified unspecified unspecified unspecified  	O	null

0 בוגרת בוגר בוגרת noun feminine singular construct unspecified unspecified  	O	null
1 ה ה החוג definiteArticle unspecified unspecified unspecified unspecified unspecified 0 
1 החוג חוג החוג noun masculine singular absolute unspecified unspecified  	O	null
2 ל ל לספרות preposition unspecified unspecified unspecified unspecified unspecified 0 
2 ספרות ספרות לספרות noun feminine singular absolute unspecified unspecified  	O	null
3 כללית כללי כללית adjective feminine singular absolute unspecified unspecified  	O	null
4 ב ב באוניברסיטת preposition unspecified unspecified unspecified unspecified unspecified 0 
4 אוניברסיטת אוניברסיטה באוניברסיטת noun feminine singular construct unspecified unspecified  	I_ORG	null
5 חיפה חיפה חיפה properName unspecified unspecified unspecified unspecified unspecified  	I_ORG	null
6 , , , punctuation unspecified unspecified unspecified unspecified unspecified  	O	null
7 בעלת בעל בעלת noun feminine singular construct unspecified unspecified  	O	null
8 תואר תואר תואר noun masculine singular construct unspecified unspecified  	O	null
9 שני שני שני noun masculine singular absolute unspecified unspecified  	I_ORG	null
10 מ מ מאוניברסיטת preposition unspecified unspecified unspecified unspecified unspecified 0 
10 אוניברסיטת אוניברסיטה מאוניברסיטת noun feminine singular construct unspecified unspecified  	I_ORG	null
11 תל תל תל properName unspecified unspecified unspecified unspecified unspecified  	I_ORG	null
12 אביב אביב אביב properName unspecified unspecified unspecified unspecified unspecified  	I_ORG	null
13 ו ו ותואר conjunction unspecified unspecified unspecified unspecified unspecified 0 
13 תואר תואר ותואר noun masculine singular absolute unspecified unspecified  	O	null
14 דוקטור דוקטור דוקטור noun masculine singular absolute unspecified unspecified  	O	null
15 מטעם מטעם מטעם preposition unspecified unspecified unspecified unspecified unspecified  	O	null
16 ה ה החוג definiteArticle unspecified unspecified unspecified unspecified unspecified 0 
16 החוג חוג החוג noun masculine singular absolute unspecified unspecified  	O	null
17 ל ל ללימודים preposition unspecified unspecified unspecified unspecified unspecified 0 
17 ה ה ללימודים definiteArticle unspecified unspecified unspecified unspecified unspecified 0 
17 הלימודים לימוד ללימודים noun masculine plural absolute unspecified unspecified  	O	null
18 היספנו היספנו היספנו verb masculine-and-feminine plural unspecified 1 past  	O	null
19 - - - punctuation unspecified unspecified unspecified unspecified unspecified  	O	null
20 אמריקניים אמריקני אמריקניים adjective masculine plural absolute unspecified unspecified  	O	null
21 ב ב באוניברסיטה preposition unspecified unspecified unspecified unspecified unspecified 0 
21 ה ה באוניברסיטה definiteArticle unspecified unspecified unspecified unspecified unspecified 0 
21 האוניברסיטה אוניברסיטה באוניברסיטה noun feminine singular absolute unspecified unspecified  	O	null
22 ה ה העברית definiteArticle unspecified unspecified unspecified unspecified unspecified 0 
22 העברית עברי העברית adjective feminine singular absolute unspecified unspecified  	O	null
23 ב ב בירושלים preposition unspecified unspecified unspecified unspecified unspecified 0 
23 ירושלים ירושלים בירושלים properName unspecified unspecified unspecified unspecified unspecified  	I_LOC	null
24 . . . punctuation unspecified unspecified unspecified unspecified unspecified  	O	null

0 למדה למד למדה verb feminine singular unspecified 3 past  	O	null
1 הוראה הוראה הוראה noun feminine singular absolute unspecified unspecified  	O	null
2 ב ב בסמינר preposition unspecified unspecified unspecified unspecified unspecified 0 
2 סמינר סמינר בסמינר noun masculine singular absolute unspecified unspecified  	O	null
3 ב ב בירושלים preposition unspecified unspecified unspecified unspecified unspecified 0 
3 ירושלים ירושלים בירושלים properName unspecified unspecified unspecified unspecified unspecified  	I_LOC	null
4 ו ו ועבדה conjunction unspecified unspecified unspecified unspecified unspecified 0 
4 עבדה עבד ועבדה verb feminine singular unspecified 3 past  	O	null
5 כמורה כמורה כמורה noun feminine singular absolute unspecified unspecified  	O	null
6 . . . punctuation unspecified unspecified unspecified unspecified unspecified  	O	null

0 סיפורי סיפור סיפוריה noun masculine plural absolute unspecified unspecified  
0 ה ה סיפוריה possessive feminine singular unspecified 3 unspecified 0 	O	null
1 פורסמו פורסם פורסמו verb masculine-and-feminine plural unspecified 3 past  	O	null
2 ב ב בכתבי preposition unspecified unspecified unspecified unspecified unspecified 0 
2 כתבי כתב בכתבי noun masculine plural construct unspecified unspecified  	O	null
3 עת עת עת noun feminine singular absolute unspecified unspecified  	O	null
4 ל ל לספרות preposition unspecified unspecified unspecified unspecified unspecified 0 
4 ה ה לספרות definiteArticle unspecified unspecified unspecified unspecified unspecified 0 
4 הספרות ספרות לספרות noun feminine singular absolute unspecified unspecified  	O	null
5 ו ו וב conjunction unspecified unspecified unspecified unspecified unspecified 0 
5 ב ב וב preposition unspecified unspecified unspecified unspecified unspecified 0 	O	null
6 - - - punctuation unspecified unspecified unspecified unspecified unspecified  	O	null
7 ###NUMBER### ###NUMBER### ###NUMBER### numeral unspecified unspecified unspecified unspecified unspecified  	I_DATE	null
8 ראה ראה ראה verb masculine singular unspecified 3 past  	O	null
9 אור אור אור noun masculine singular construct unspecified unspecified  	O	null
10 ספר ספר ספר noun masculine singular construct unspecified unspecified  	O	null
11 סיפורי סיפור סיפוריה noun masculine plural absolute unspecified unspecified  
11 ה ה סיפוריה possessive feminine singular unspecified 3 unspecified 0 	O	null
12 ה ה הראשון definiteArticle unspecified unspecified unspecified unspecified unspecified 0 
12 הראשון ORD1 הראשון numeral masculine singular absolute unspecified unspecified  	O	null
13 , , , punctuation unspecified unspecified unspecified unspecified unspecified  	O	null
14 ל ל לאטלנטיס preposition unspecified unspecified unspecified unspecified unspecified 0 
14 ה ה לאטלנטיס definiteArticle unspecified unspecified unspecified unspecified unspecified 0 
14 האטלנטיס האטלנטיס לאטלנטיס noun feminine singular absolute unspecified unspecified  	O	null
15 ו ו ובחזרה conjunction unspecified unspecified unspecified unspecified unspecified 0 
15 ב ב ובחזרה preposition unspecified unspecified unspecified unspecified unspecified 0 
15 חזרה חזרה ובחזרה noun feminine singular absolute unspecified unspecified  	O	null
16 ( ( ( punctuation unspecified unspecified unspecified unspecified unspecified  	O	null
17 ספרית ספר ספרית noun feminine singular construct unspecified unspecified  	O	null
18 פועלים פועל פועלים noun masculine plural absolute unspecified unspecified  	O	null
19 ) ) ) punctuation unspecified unspecified unspecified unspecified unspecified  	O	null
20 . . . punctuation unspecified unspecified unspecified unspecified unspecified  	O	null

0 פירסמה פרסם פירסמה verb feminine singular unspecified 3 past  	O	null
1 שני CARD2 שני numeral masculine dual construct unspecified unspecified  	O	null
2 קובצי קבץ קובצי participle masculine plural construct any unspecified  	O	null
3 סיפורים סיפור סיפורים noun masculine plural absolute unspecified unspecified  	O	null
4 נוספים נוסף נוספים adjective masculine plural absolute unspecified unspecified  	O	null
5 : : : punctuation unspecified unspecified unspecified unspecified unspecified  	O	null
6 תסריט תסריט תסריט noun masculine singular absolute unspecified unspecified  	O	null
7 דרום דרום דרום noun masculine singular absolute unspecified unspecified  	O	null
8 אמריקני אמריקני אמריקני adjective masculine singular absolute unspecified unspecified  	O	null
9 ( ( ( punctuation unspecified unspecified unspecified unspecified unspecified  	O	null
10 ###NUMBER### ###NUMBER### ###NUMBER### numeral unspecified unspecified unspecified unspecified unspecified  	I_DATE	null
11 ) ) ) punctuation unspecified unspecified unspecified unspecified unspecified  	O	null
12 ו ו וטנגו conjunction unspecified unspecified unspecified unspecified unspecified 0 
12 טנגו טנגו וטנגו noun masculine singular absolute unspecified unspecified  	O	null
13 ל ל למאחרים preposition unspecified unspecified unspecified unspecified unspecified 0 
13 ה ה למאחרים definiteArticle unspecified unspecified unspecified unspecified unspecified 0 
13 המאחרים איחר למאחרים participle masculine plural absolute any unspecified  	O	null
14 ( ( ( punctuation unspecified unspecified unspecified unspecified unspecified  	O	null
15 ###NUMBER### ###NUMBER### ###NUMBER### numeral unspecified unspecified unspecified unspecified unspecified  	I_DATE	null
16 ) ) ) punctuation unspecified unspecified unspecified unspecified unspecified  	O	null
17 ו ו וכן conjunction unspecified unspecified unspecified unspecified unspecified 0 
17 כן כן וכן conjunction unspecified unspecified unspecified unspecified unspecified  	O	null
18 רומן רומן רומן properName unspecified unspecified unspecified unspecified unspecified  	I_PERS	null
19 , , , punctuation unspecified unspecified unspecified unspecified unspecified  	O	null
20 ה ה הסיפור definiteArticle unspecified unspecified unspecified unspecified unspecified 0 
20 הסיפור סיפור הסיפור noun masculine singular absolute unspecified unspecified  	O	null
21 של של של shel-preposition unspecified unspecified unspecified unspecified unspecified  	O	null
22 מרתה מרתה מרתה properName unspecified unspecified unspecified unspecified unspecified  	I_PERS	null
23 ( ( ( punctuation unspecified unspecified unspecified unspecified unspecified  	O	null
24 גוונים גוון גוונים noun masculine plural absolute unspecified unspecified  	O	null
25 , , , punctuation unspecified unspecified unspecified unspecified unspecified  	O	null
26 ###NUMBER### ###NUMBER### ###NUMBER### numeral unspecified unspecified unspecified unspecified unspecified  	I_DATE	null
27 ) ) ) punctuation unspecified unspecified unspecified unspecified unspecified  	O	null
28 . . . punctuation unspecified unspecified unspecified unspecified unspecified  	O	null

0 סיפורי סיפור סיפוריה noun masculine plural absolute unspecified unspecified  
0 ה ה סיפוריה possessive feminine singular unspecified 3 unspecified 0 	O	null
1 תורגמו תורגם תורגמו verb masculine-and-feminine plural unspecified 3 past  	O	null
2 ל ל לאנגלית preposition unspecified unspecified unspecified unspecified unspecified 0 
2 אנגלית אנגלית לאנגלית properName feminine singular unspecified unspecified unspecified  	I_PERS	null
3 ו ו ולספרדית conjunction unspecified unspecified unspecified unspecified unspecified 0 
3 ל ל ולספרדית preposition unspecified unspecified unspecified unspecified unspecified 0 
3 ה ה ולספרדית definiteArticle unspecified unspecified unspecified unspecified unspecified 0 
3 הספרדית ספרדית ולספרדית properName feminine singular unspecified unspecified unspecified  	I_PERS	null
4 , , , punctuation unspecified unspecified unspecified unspecified unspecified  	O	null
5 ו ו ותרגום conjunction unspecified unspecified unspecified unspecified unspecified 0 
5 תרגום תרגום ותרגום noun masculine singular construct unspecified unspecified  	O	null
6 סיפור סיפור סיפורה noun masculine singular absolute unspecified unspecified  
6 ה ה סיפורה possessive feminine singular unspecified 3 unspecified 0 	O	null
7 " " " punctuation unspecified unspecified unspecified unspecified unspecified  	O	null
8 ה ה האישה definiteArticle unspecified unspecified unspecified unspecified unspecified 0 
8 האישה איש האישה noun feminine singular absolute unspecified unspecified  	O	null
9 ש ש שגידלה relativizer/subordinatingConjunction unspecified unspecified unspecified unspecified unspecified 0 
9 גידלה גידל שגידלה verb feminine singular unspecified 3 past  	O	null
10 חד חד חד wPrefix unspecified unspecified unspecified unspecified unspecified  	O	null
11 - - - punctuation unspecified unspecified unspecified unspecified unspecified  	O	null
12 קרן קרן קרן noun feminine singular absolute unspecified unspecified  	O	null
13 ב ב במטבח preposition unspecified unspecified unspecified unspecified unspecified 0 
13 ה ה במטבח definiteArticle unspecified unspecified unspecified unspecified unspecified 0 
13 המטבח מטבח במטבח noun masculine singular absolute unspecified unspecified  	O	null
14 " " " punctuation unspecified unspecified unspecified unspecified unspecified  	O	null
15 ( ( ( punctuation unspecified unspecified unspecified unspecified unspecified  	O	null
16 על על על preposition unspecified unspecified unspecified unspecified unspecified  	O	null
17 ידי יד ידי noun feminine plural construct unspecified unspecified  	O	null
18 אשר אשר אשר properName masculine singular unspecified unspecified unspecified  	I_PERS	null
19 ה ה הריס definiteArticle unspecified unspecified unspecified unspecified unspecified 0 
19 הריס ריס הריס noun masculine singular absolute unspecified unspecified  	O	null
20 ) ) ) punctuation unspecified unspecified unspecified unspecified unspecified  	O	null
21 אף אף אף conjunction unspecified unspecified unspecified unspecified unspecified  	O	null
22 זכה זכה זכה verb masculine singular unspecified 3 past  	O	null
23 ב ב בפרס preposition unspecified unspecified unspecified unspecified unspecified 0 
23 פרס פרס בפרס noun masculine singular construct unspecified unspecified  	O	null
24 תרגום תרגום תרגום noun masculine singular absolute unspecified unspecified  	O	null
25 בינלאומי בינלאומי בינלאומי adjective masculine singular absolute unspecified unspecified  	O	null
26 . . . punctuation unspecified unspecified unspecified unspecified unspecified  	O	null

0 זכתה זכה זכתה verb feminine singular unspecified 3 past  	O	null
1 ב ב בפרס preposition unspecified unspecified unspecified unspecified unspecified 0 
1 פרס פרס בפרס noun masculine singular absolute unspecified unspecified  	O	null
2 אריכא אריכא אריכא properName unspecified unspecified unspecified unspecified unspecified  	I_PERS	null
3 ל ל לסיפור preposition unspecified unspecified unspecified unspecified unspecified 0 
3 ה ה לסיפור definiteArticle unspecified unspecified unspecified unspecified unspecified 0 
3 הסיפור סיפור לסיפור noun masculine singular absolute unspecified unspecified  	O	null
4 ה ה הקצר definiteArticle unspecified unspecified unspecified unspecified unspecified 0 
4 הקצר קצר הקצר adjective masculine singular absolute unspecified unspecified  	O	null
5 ) ) ) punctuation unspecified unspecified unspecified unspecified unspecified  	O	null
6 , , , punctuation unspecified unspecified unspecified unspecified unspecified  	O	null
7 ###NUMBER### ###NUMBER### ###NUMBER### numeral unspecified unspecified unspecified unspecified unspecified  	I_DATE	null
8 ב ב בפרס preposition unspecified unspecified unspecified unspecified unspecified 0 
8 פרס פרס בפרס properName masculine singular unspecified unspecified unspecified  	I_LOC	null
9 חנו חנה חנו verb masculine-and-feminine plural unspecified 3 past  	O	null
10 מטעם מטעם מטעם preposition unspecified unspecified unspecified unspecified unspecified  	O	null
11 ה ה הקהילה definiteArticle unspecified unspecified unspecified unspecified unspecified 0 
11 הקהילה קהילה הקהילה noun feminine singular absolute unspecified unspecified  	O	null
12 ה ה היהודית definiteArticle unspecified unspecified unspecified unspecified unspecified 0 
12 היהודית יהודי היהודית adjective feminine singular absolute unspecified unspecified  	O	null
13 ב ב במקסיקו preposition unspecified unspecified unspecified unspecified unspecified 0 
13 מקסיקו מקסיקו במקסיקו properName unspecified unspecified unspecified unspecified unspecified  	I_LOC	null
14 ( ( ( punctuation unspecified unspecified unspecified unspecified unspecified  	O	null
15 ###NUMBER### ###NUMBER### ###NUMBER### numeral unspecified unspecified unspecified unspecified unspecified  	I_DATE	null
16 ) ) ) punctuation unspecified unspecified unspecified unspecified unspecified  	O	null
17 ו ו ובפרס conjunction unspecified unspecified unspecified unspecified unspecified 0 
17 ב ב ובפרס preposition unspecified unspecified unspecified unspecified unspecified 0 
17 פרס פרס ובפרס noun masculine singular construct unspecified unspecified  	O	null
18 נאש נאש נאש verb masculine singular unspecified 3 past  	O	null
19 ל ל לשהיית preposition unspecified unspecified unspecified unspecified unspecified 0 
19 שהיית שהייה לשהיית noun feminine singular construct unspecified unspecified  	O	null
20 יצירה יצירה יצירה noun feminine singular absolute unspecified unspecified  	O	null
21 ב ב בארצות preposition unspecified unspecified unspecified unspecified unspecified 0 
21 ארצות ארץ בארצות properName unspecified unspecified unspecified unspecified unspecified  	I_LOC	null
22 הברית ברית הברית properName unspecified unspecified unspecified unspecified unspecified  	I_LOC	null
23 ) ) ) punctuation unspecified unspecified unspecified unspecified unspecified  	O	null
24 . . . punctuation unspecified unspecified unspecified unspecified unspecified  	O	null
25 ###NUMBER### ###NUMBER### ###NUMBER### numeral unspecified unspecified unspecified unspecified unspecified  	I_DATE	null
26 סיפורי סיפור סיפוריה noun masculine plural absolute unspecified unspecified  
26 ה ה סיפוריה possessive feminine singular unspecified 3 unspecified 0 	O	null
27 , , , punctuation unspecified unspecified unspecified unspecified unspecified  	O	null
28 ש ש שחלקם relativizer/subordinatingConjunction unspecified unspecified unspecified unspecified unspecified 0 
28 חלק חלק שחלקם noun masculine singular absolute unspecified unspecified  
28 ם ם שחלקם possessive masculine plural unspecified 3 unspecified 0 	O	null
29 נעים נע נעים verb masculine plural unspecified any beinoni  	O	null
30 בין בין בין preposition unspecified unspecified unspecified unspecified unspecified  	O	null
31 ה ה הריאלי definiteArticle unspecified unspecified unspecified unspecified unspecified 0 
31 הריאלי ריאלי הריאלי adjective masculine singular absolute unspecified unspecified  	O	null
32 ל ל לפנטסטי preposition unspecified unspecified unspecified unspecified unspecified 0 
32 פנטסטי פנטסטי לפנטסטי noun masculine singular absolute unspecified unspecified  	O	null
33 ו ו וחלקם conjunction unspecified unspecified unspecified unspecified unspecified 0 
33 חלק חלק וחלקם noun masculine singular absolute unspecified unspecified  
33 ם ם וחלקם possessive masculine plural unspecified 3 unspecified 0 	O	null
34 ריאליסטיים ריאליסטי ריאליסטיים adjective masculine plural absolute unspecified unspecified  	O	null
35 במובהק במובהק במובהק adverb unspecified unspecified unspecified unspecified unspecified  	O	null
36 , , , punctuation unspecified unspecified unspecified unspecified unspecified  	O	null
37 מתרחשים התרחש מתרחשים verb masculine plural unspecified any beinoni  	O	null
38 על על על preposition unspecified unspecified unspecified unspecified unspecified  	O	null
39 ה ה הקו definiteArticle unspecified unspecified unspecified unspecified unspecified 0 
39 הקו קו הקו noun masculine singular absolute unspecified unspecified  	O	null
40 ה ה המטפורי definiteArticle unspecified unspecified unspecified unspecified unspecified 0 
40 המטפורי המטפורי המטפורי adjective masculine singular absolute unspecified unspecified  	O	null
41 ש ש שבין relativizer/subordinatingConjunction unspecified unspecified unspecified unspecified unspecified 0 
41 בין בין שבין preposition unspecified unspecified unspecified unspecified unspecified  	O	null
42 ישראל ישראל ישראל properName unspecified unspecified unspecified unspecified unspecified  	I_PERS	null
43 ל ל לאמריקה preposition unspecified unspecified unspecified unspecified unspecified 0 
43 אמריקה אמריקה לאמריקה properName unspecified unspecified unspecified unspecified unspecified  	I_LOC	null
44 ה ה הלטינית definiteArticle unspecified unspecified unspecified unspecified unspecified 0 
44 הלטינית לטיני הלטינית adjective feminine singular absolute unspecified unspecified  	O	null
45 ו ו ועוסקים conjunction unspecified unspecified unspecified unspecified unspecified 0 
45 עוסקים עסק ועוסקים verb masculine plural unspecified any beinoni  	O	null
46 ב ב בחוויות preposition unspecified unspecified unspecified unspecified unspecified 0 
46 חוויות חוויה בחוויות noun feminine plural absolute unspecified unspecified  	O	null
47 של של של shel-preposition unspecified unspecified unspecified unspecified unspecified  	O	null
48 הגירה הגירה הגירה noun feminine singular absolute unspecified unspecified  	O	null
49 ו ו ונשיות conjunction unspecified unspecified unspecified unspecified unspecified 0 
49 נשיות נשיות ונשיות noun feminine singular absolute unspecified unspecified  	O	null
50 . . . punctuation unspecified unspecified unspecified unspecified unspecified  	O	null

0 ל ל ליצירתה preposition unspecified unspecified unspecified unspecified unspecified 0 
0 יצירת יצירה ליצירתה noun feminine singular absolute unspecified unspecified  
0 ה ה ליצירתה possessive feminine singular unspecified 3 unspecified 0 	O	null
1 זיקה זיקה זיקה noun feminine singular absolute unspecified unspecified  	O	null
2 עזה עז עזה properName unspecified unspecified unspecified unspecified unspecified  	I_LOC	null
3 ל ל לספרות preposition unspecified unspecified unspecified unspecified unspecified 0 
3 ה ה לספרות definiteArticle unspecified unspecified unspecified unspecified unspecified 0 
3 הספרות ספרות לספרות noun feminine singular absolute unspecified unspecified  	O	null
4 ה ה הלטינו definiteArticle unspecified unspecified unspecified unspecified unspecified 0 
4 הלטינו לטינו הלטינו wPrefix unspecified unspecified unspecified unspecified unspecified  	I_ORG	null
5 - - - punctuation unspecified unspecified unspecified unspecified unspecified  	I_ORG	null
6 אמריקנית אמריקני אמריקנית adjective feminine singular absolute unspecified unspecified  	I_ORG	null
7 ו ו וניכרים conjunction unspecified unspecified unspecified unspecified unspecified 0 
7 ניכרים ניכר וניכרים verb masculine plural unspecified any beinoni  	O	null
8 ב ב בה preposition unspecified unspecified unspecified unspecified unspecified  
8 ה ה בה pronomial feminine singular unspecified 3 unspecified 0 	O	null
9 עקבות עקב עקבות noun masculine plural absolute unspecified unspecified  	O	null
10 של של של shel-preposition unspecified unspecified unspecified unspecified unspecified  	O	null
11 ז'אנר ז'אנר ז'אנר noun masculine singular construct unspecified unspecified  	O	null
12 ה ה הריאליזם definiteArticle unspecified unspecified unspecified unspecified unspecified 0 
12 הריאליזם ריאליזם הריאליזם noun masculine singular absolute unspecified unspecified  	O	null
13 ה ה הפנטסטי definiteArticle unspecified unspecified unspecified unspecified unspecified 0 
13 הפנטסטי הפנטסטי הפנטסטי adjective masculine singular absolute unspecified unspecified  	O	null
14 . . . punctuation unspecified unspecified unspecified unspecified unspecified  	O	null

0 References References References foreign unspecified unspecified unspecified unspecified unspecified  	O	null
1 : : : punctuation unspecified unspecified unspecified unspecified unspecified  	O	null
2 ניצן ניצן ניצן properName unspecified unspecified unspecified unspecified unspecified  	I_ORG	null
3 - - - punctuation unspecified unspecified unspecified unspecified unspecified  	O	null
4 קרן קרן קרן properName feminine singular unspecified unspecified unspecified  	I_PERS	null
5 , , , punctuation unspecified unspecified unspecified unspecified unspecified  	I_ORG	null
6 טל טל טל properName unspecified unspecified unspecified unspecified unspecified  	I_PERS	null
7 . . . punctuation unspecified unspecified unspecified unspecified unspecified  	O	null

0 " " " punctuation unspecified unspecified unspecified unspecified unspecified  	O	null
1 עקרת עקר עקרת noun feminine singular construct unspecified unspecified  	O	null
2 בית בית בית noun masculine singular absolute unspecified unspecified  	O	null
3 ב ב בארץ preposition unspecified unspecified unspecified unspecified unspecified 0 
3 ארץ ארץ בארץ noun feminine singular construct unspecified unspecified  	O	null
4 ה ה הפלאות definiteArticle unspecified unspecified unspecified unspecified unspecified 0 
4 הפלאות פלא הפלאות noun masculine plural absolute unspecified unspecified  	O	null
5 " " " punctuation unspecified unspecified unspecified unspecified unspecified  	O	null
6 . . . punctuation unspecified unspecified unspecified unspecified unspecified  	O	null

0 ידיעות ידיעה ידיעות noun feminine plural absolute unspecified unspecified  	I_ORG	null
1 אחרונות אחרון אחרונות adjective feminine plural absolute unspecified unspecified  	I_ORG	null
2 ל ל לשבת preposition unspecified unspecified unspecified unspecified unspecified 0 
2 ה ה לשבת definiteArticle unspecified unspecified unspecified unspecified unspecified 0 
2 השבת שבת לשבת noun feminine singular absolute unspecified unspecified  	O	null
3 . . . punctuation unspecified unspecified unspecified unspecified unspecified  	O	null

0 ###NUMEXP### ###NUMEXP### ###NUMEXP### numberExpression unspecified unspecified unspecified unspecified unspecified  	I_DATE	null
1 . . . punctuation unspecified unspecified unspecified unspecified unspecified  	O	null

0 ; ; ; punctuation unspecified unspecified unspecified unspecified unspecified  	O	null
1 ###NUMBER### ###NUMBER### ###NUMBER### numeral unspecified unspecified unspecified unspecified unspecified  	O	null
2 צור צור צור properName unspecified unspecified unspecified unspecified unspecified  	I_PERS	null
3 , , , punctuation unspecified unspecified unspecified unspecified unspecified  	O	null
4 יגאל יגאל יגאל properName unspecified unspecified unspecified unspecified unspecified  	I_PERS	null
5 . . . punctuation unspecified unspecified unspecified unspecified unspecified  	O	null

0 " " " punctuation unspecified unspecified unspecified unspecified unspecified  	O	null
1 ה ה החד definiteArticle unspecified unspecified unspecified unspecified unspecified 0 
1 החד חד החד wPrefix unspecified unspecified unspecified unspecified unspecified  	I_ORG	null
2 - - - punctuation unspecified unspecified unspecified unspecified unspecified  	I_ORG	null
3 קרן קרן קרן properName feminine singular unspecified unspecified unspecified  	I_ORG	null
4 ו ו ואמנות conjunction unspecified unspecified unspecified unspecified unspecified 0 
4 אמנות אמנות ואמנות noun feminine singular construct unspecified unspecified  	O	null
5 ה ה הסיפר definiteArticle unspecified unspecified unspecified unspecified unspecified 0 
5 הסיפר סיפר הסיפר noun masculine singular absolute unspecified unspecified  	O	null
6 " " " punctuation unspecified unspecified unspecified unspecified unspecified  	O	null
7 . . . punctuation unspecified unspecified unspecified unspecified unspecified  	O	null

0 על על על preposition unspecified unspecified unspecified unspecified unspecified  	O	null
1 ה ה המשמר definiteArticle unspecified unspecified unspecified unspecified unspecified 0 
1 המשמר משמר המשמר noun masculine singular absolute unspecified unspecified  	O	null
2 . . . punctuation unspecified unspecified unspecified unspecified unspecified  	O	null

0 ###NUMEXP### ###NUMEXP### ###NUMEXP### numberExpression unspecified unspecified unspecified unspecified unspecified  	I_DATE	null
1 . . . punctuation unspecified unspecified unspecified unspecified unspecified  	O	null

0 ###NUMBER### ###NUMBER### ###NUMBER### numeral unspecified unspecified unspecified unspecified unspecified  	O	null
1 . . . punctuation unspecified unspecified unspecified unspecified unspecified  	O	null

