0 Name Name Name foreign unspecified unspecified unspecified unspecified unspecified  	O	null
1 : : : punctuation unspecified unspecified unspecified unspecified unspecified  	O	null
2 גילולה גילולה גילולה properName unspecified unspecified unspecified unspecified unspecified  	I_ORG	null
3 , , , punctuation unspecified unspecified unspecified unspecified unspecified  	O	null
4 דבורה דבורה דבורה properName unspecified unspecified unspecified unspecified unspecified  	I_PERS	null
5 Birth Birth Birth foreign unspecified unspecified unspecified unspecified unspecified  	O	null
6 Year Year Year foreign unspecified unspecified unspecified unspecified unspecified  	O	null
7 : : : punctuation unspecified unspecified unspecified unspecified unspecified  	O	null
8 ###NUMBER### ###NUMBER### ###NUMBER### numeral unspecified unspecified unspecified unspecified unspecified  	I_DATE	null
9 Birth Birth Birth foreign unspecified unspecified unspecified unspecified unspecified  	O	null
10 Place Place Place foreign unspecified unspecified unspecified unspecified unspecified  	O	null
11 : : : punctuation unspecified unspecified unspecified unspecified unspecified  	O	null
12 לובלין לובלין לובלין properName unspecified unspecified unspecified unspecified unspecified  	I_ORG	null
13 , , , punctuation unspecified unspecified unspecified unspecified unspecified  	O	null
14 פולין פולין פולין properName unspecified unspecified unspecified unspecified unspecified  	I_LOC	null
15 Occupation Occupation Occupation foreign unspecified unspecified unspecified unspecified unspecified  	O	null
16 : : : punctuation unspecified unspecified unspecified unspecified unspecified  	O	null
17 חוקרת חוקר חוקרת noun feminine singular absolute unspecified unspecified  	O	null
18 ו ו ומתרגמת conjunction unspecified unspecified unspecified unspecified unspecified 0 
18 מתרגמת מתרגם ומתרגמת noun feminine singular construct unspecified unspecified  	O	null
19 Entry Entry Entry foreign unspecified unspecified unspecified unspecified unspecified  	O	null
20 writer writer writer foreign unspecified unspecified unspecified unspecified unspecified  	O	null
21 : : : punctuation unspecified unspecified unspecified unspecified unspecified  	O	null
22 חיים חיים חיים properName unspecified unspecified unspecified unspecified unspecified  	I_PERS	null
23 וייס וייס וייס properName unspecified unspecified unspecified unspecified unspecified  	I_PERS	null
24 Entry Entry Entry foreign unspecified unspecified unspecified unspecified unspecified  	O	null
25 Value Value Value foreign unspecified unspecified unspecified unspecified unspecified  	O	null
26 : : : punctuation unspecified unspecified unspecified unspecified unspecified  	O	null
27 נולדה נולד נולדה verb feminine singular unspecified 3 past  	O	null
28 ב ב בלובלין preposition unspecified unspecified unspecified unspecified unspecified 0 
28 לובלין לובלין בלובלין properName unspecified unspecified unspecified unspecified unspecified  	I_PERS	null
29 , , , punctuation unspecified unspecified unspecified unspecified unspecified  	O	null
30 פולין פולין פולין properName unspecified unspecified unspecified unspecified unspecified  	I_LOC	null
31 . . . punctuation unspecified unspecified unspecified unspecified unspecified  	O	null

0 עלתה עלה עלתה verb feminine singular unspecified 3 past  	I_LOC	null
1 ל ל לישראל preposition unspecified unspecified unspecified unspecified unspecified 0 
1 ישראל ישראל לישראל properName unspecified unspecified unspecified unspecified unspecified  	I_LOC	null
2 ב ב ב preposition unspecified unspecified unspecified unspecified unspecified 0 	I_ORG	null
3 - - - punctuation unspecified unspecified unspecified unspecified unspecified  	I_ORG	null
4 ###NUMBER### ###NUMBER### ###NUMBER### numeral unspecified unspecified unspecified unspecified unspecified  	I_DATE	null
5 . . . punctuation unspecified unspecified unspecified unspecified unspecified  	O	null

0 את את את at-preposition unspecified unspecified unspecified unspecified unspecified  	O	null
1 לימודי לימוד לימודי noun masculine plural construct unspecified unspecified  	O	null
2 ה ה התיכון definiteArticle unspecified unspecified unspecified unspecified unspecified 0 
2 התיכון תיכון התיכון noun masculine singular absolute unspecified unspecified  	O	null
3 עשתה עשה עשתה verb feminine singular unspecified 3 past  	I_LOC	null
4 ב ב בקיבוץ preposition unspecified unspecified unspecified unspecified unspecified 0 
4 קיבוץ קיבוץ בקיבוץ noun masculine singular construct unspecified unspecified  	I_LOC	null
5 כפר כפר כפר noun masculine singular absolute unspecified unspecified  	I_LOC	null
6 מסריק מסריק מסריק properName unspecified unspecified unspecified unspecified unspecified  	I_LOC	null
7 ו ו ולאחר conjunction unspecified unspecified unspecified unspecified unspecified 0 
7 לאחר לאחר ולאחר conjunction unspecified unspecified unspecified unspecified unspecified  	O	null
8 מכן מיכן מכן verb masculine singular unspecified 2 imperative  	O	null
9 למדה למד למדה verb feminine singular unspecified 3 past  	O	null
10 ב ב באוניברסיטה preposition unspecified unspecified unspecified unspecified unspecified 0 
10 ה ה באוניברסיטה definiteArticle unspecified unspecified unspecified unspecified unspecified 0 
10 האוניברסיטה אוניברסיטה באוניברסיטה noun feminine singular absolute unspecified unspecified  	O	null
11 ה ה העברית definiteArticle unspecified unspecified unspecified unspecified unspecified 0 
11 העברית עברי העברית adjective feminine singular absolute unspecified unspecified  	O	null
12 ב ב בירושלים preposition unspecified unspecified unspecified unspecified unspecified 0 
12 ירושלים ירושלים בירושלים properName unspecified unspecified unspecified unspecified unspecified  	I_LOC	null
13 ב ב בשלושה preposition unspecified unspecified unspecified unspecified unspecified 0 
13 שלושה CARD3 בשלושה numeral masculine plural absolute unspecified unspecified  	O	null
14 חוגים חוג חוגים noun masculine plural absolute unspecified unspecified  	O	null
15 : : : punctuation unspecified unspecified unspecified unspecified unspecified  	O	null
16 לימודים לימוד לימודים noun masculine plural absolute unspecified unspecified  	O	null
17 קלאסיים קלאסי קלאסיים adjective masculine plural absolute unspecified unspecified  	O	null
18 , , , punctuation unspecified unspecified unspecified unspecified unspecified  	O	null
19 תיאטרון תיאטרון תיאטרון properName unspecified unspecified unspecified unspecified unspecified  	I_ORG	null
20 ו ו וספרות conjunction unspecified unspecified unspecified unspecified unspecified 0 
20 ספרות ספרות וספרות noun feminine singular absolute unspecified unspecified  	O	null
21 עברית עברי עברית adjective feminine singular absolute unspecified unspecified  	O	null
22 . . . punctuation unspecified unspecified unspecified unspecified unspecified  	O	null

0 מונתה מונה מונתה verb feminine singular unspecified 3 past  	O	null
1 ל ל למרצה preposition unspecified unspecified unspecified unspecified unspecified 0 
1 מרץ מרץ למרצה noun masculine singular absolute unspecified unspecified  
1 ה ה למרצה possessive feminine singular unspecified 3 unspecified 0 	O	null
2 ב ב במחלקה preposition unspecified unspecified unspecified unspecified unspecified 0 
2 ה ה במחלקה definiteArticle unspecified unspecified unspecified unspecified unspecified 0 
2 המחלקה מחלקה במחלקה noun feminine singular absolute unspecified unspecified  	O	null
3 ל ל ללימודים preposition unspecified unspecified unspecified unspecified unspecified 0 
3 לימודים לימוד ללימודים noun masculine plural absolute unspecified unspecified  	O	null
4 קלאסיים קלאסי קלאסיים adjective masculine plural absolute unspecified unspecified  	O	null
5 ב ב באוניברסיטה preposition unspecified unspecified unspecified unspecified unspecified 0 
5 ה ה באוניברסיטה definiteArticle unspecified unspecified unspecified unspecified unspecified 0 
5 האוניברסיטה אוניברסיטה באוניברסיטה noun feminine singular absolute unspecified unspecified  	O	null
6 ה ה העברית definiteArticle unspecified unspecified unspecified unspecified unspecified 0 
6 העברית עברי העברית adjective feminine singular absolute unspecified unspecified  	O	null
7 ו ו ולימדה conjunction unspecified unspecified unspecified unspecified unspecified 0 
7 לימדה לימד ולימדה verb feminine singular unspecified 3 past  	O	null
8 שם שם שם adverb unspecified unspecified unspecified unspecified unspecified  	O	null
9 עד עד עד noun masculine singular absolute unspecified unspecified  	O	null
10 ל ל לפרישתה preposition unspecified unspecified unspecified unspecified unspecified 0 
10 פרישת פרישה לפרישתה noun feminine singular absolute unspecified unspecified  
10 ה ה לפרישתה possessive feminine singular unspecified 3 unspecified 0 	O	null
11 , , , punctuation unspecified unspecified unspecified unspecified unspecified  	O	null
12 ב ב בדרגת preposition unspecified unspecified unspecified unspecified unspecified 0 
12 דרגת דרגה בדרגת noun feminine singular construct unspecified unspecified  	O	null
13 פרופסור פרופסור פרופסור noun masculine singular absolute unspecified unspecified  	O	null
14 מן מן מן preposition unspecified unspecified unspecified unspecified unspecified  	O	null
15 ה ה המניין definiteArticle unspecified unspecified unspecified unspecified unspecified 0 
15 המניין מניין המניין noun masculine singular absolute unspecified unspecified  	O	null
16 , , , punctuation unspecified unspecified unspecified unspecified unspecified  	O	null
17 ב ב ב preposition unspecified unspecified unspecified unspecified unspecified 0 	I_ORG	null
18 - - - punctuation unspecified unspecified unspecified unspecified unspecified  	I_ORG	null
19 ###NUMBER### ###NUMBER### ###NUMBER### numeral unspecified unspecified unspecified unspecified unspecified  	I_DATE	null
20 . . . punctuation unspecified unspecified unspecified unspecified unspecified  	O	null

0 תחומי תחום תחומי noun masculine plural construct unspecified unspecified  	O	null
1 מחקר מחקר מחקרה noun masculine singular absolute unspecified unspecified  
1 ה ה מחקרה possessive feminine singular unspecified 3 unspecified 0 	O	null
2 ה ה המגוונים definiteArticle unspecified unspecified unspecified unspecified unspecified 0 
2 המגוונים מגוון המגוונים adjective masculine plural absolute unspecified unspecified  	O	null
3 הניבו הניב הניבו verb masculine-and-feminine plural unspecified 3 past  	O	null
4 עשייה עשייה עשייה noun feminine singular absolute unspecified unspecified  	O	null
5 עשירה עשיר עשירה adjective feminine singular absolute unspecified unspecified  	O	null
6 ש ש שבמרכזה relativizer/subordinatingConjunction unspecified unspecified unspecified unspecified unspecified 0 
6 ב ב שבמרכזה preposition unspecified unspecified unspecified unspecified unspecified 0 
6 מרכז מרכז שבמרכזה noun masculine singular absolute unspecified unspecified  
6 ה ה שבמרכזה possessive feminine singular unspecified 3 unspecified 0 	O	null
7 ה ה התיאטרון definiteArticle unspecified unspecified unspecified unspecified unspecified 0 
7 התיאטרון תיאטרון התיאטרון noun masculine singular absolute unspecified unspecified  	O	null
8 . . . punctuation unspecified unspecified unspecified unspecified unspecified  	O	null

0 את את את at-preposition unspecified unspecified unspecified unspecified unspecified  	O	null
1 מרב מרב מרב noun masculine singular construct unspecified unspecified  	O	null
2 אונה אונה אונה noun feminine singular absolute unspecified unspecified  	O	null
3 הקדישה הקדיש הקדישה verb feminine singular unspecified 3 past  	O	null
4 ל ל לתרגום preposition unspecified unspecified unspecified unspecified unspecified 0 
4 תרגום תרגום לתרגום noun masculine singular absolute unspecified unspecified  	O	null
5 ו ו ועריכה conjunction unspecified unspecified unspecified unspecified unspecified 0 
5 עריכה עריכה ועריכה noun feminine singular absolute unspecified unspecified  	O	null
6 של של של shel-preposition unspecified unspecified unspecified unspecified unspecified  	O	null
7 יצירות יצירה יצירות noun feminine plural absolute unspecified unspecified  	O	null
8 תיאטרון תיאטרון תיאטרון noun masculine singular absolute unspecified unspecified  	O	null
9 מ מ מהעולם preposition unspecified unspecified unspecified unspecified unspecified 0 
9 ה ה מהעולם definiteArticle unspecified unspecified unspecified unspecified unspecified 0 
9 העולם עולם מהעולם noun masculine singular absolute unspecified unspecified  	O	null
10 ה ה היווני definiteArticle unspecified unspecified unspecified unspecified unspecified 0 
10 היווני יווני היווני adjective masculine singular absolute unspecified unspecified  	O	null
11 ו ו והרומי conjunction unspecified unspecified unspecified unspecified unspecified 0 
11 ה ה והרומי definiteArticle unspecified unspecified unspecified unspecified unspecified 0 
11 הרומי רומי והרומי adjective masculine singular absolute unspecified unspecified  	O	null
12 . . . punctuation unspecified unspecified unspecified unspecified unspecified  	O	null

0 בין בין בין preposition unspecified unspecified unspecified unspecified unspecified  	O	null
1 ה ה השאר definiteArticle unspecified unspecified unspecified unspecified unspecified 0 
1 השאר שאר השאר noun masculine singular absolute unspecified unspecified  	O	null
2 תירגמה תרגם תירגמה verb feminine singular unspecified 3 past  	O	null
3 את את את at-preposition unspecified unspecified unspecified unspecified unspecified  	O	null
4 יצירות יצירה יצירותיהם noun feminine plural absolute unspecified unspecified  
4 הם הם יצירותיהם possessive masculine plural unspecified 3 unspecified 0 	O	null
5 של של של shel-preposition unspecified unspecified unspecified unspecified unspecified  	O	null
6 אריסטופנס אריסטופנס אריסטופנס properName unspecified unspecified unspecified unspecified unspecified  	I_PERS	null
7 ( ( ( punctuation unspecified unspecified unspecified unspecified unspecified  	O	null
8 מ מ מחבר preposition unspecified unspecified unspecified unspecified unspecified 0 
8 חבר חבר מחבר noun masculine singular construct unspecified unspecified  	O	null
9 קומדיות קומדיה קומדיות noun feminine plural absolute unspecified unspecified  	I_ORG	null
10 אתונאי אתונאי אתונאי properName unspecified unspecified unspecified unspecified unspecified  	I_ORG	null
11 בן בן בן noun masculine singular construct unspecified unspecified  	O	null
12 ה ה המאה definiteArticle unspecified unspecified unspecified unspecified unspecified 0 
12 המאה ORD-CARD100 המאה numeral feminine plural absolute unspecified unspecified  	O	null
13 ה ה החמישית definiteArticle unspecified unspecified unspecified unspecified unspecified 0 
13 החמישית ORD5 החמישית numeral feminine singular absolute unspecified unspecified  	O	null
14 ו ו והרביעית conjunction unspecified unspecified unspecified unspecified unspecified 0 
14 ה ה והרביעית definiteArticle unspecified unspecified unspecified unspecified unspecified 0 
14 הרביעית ORD4 והרביעית numeral feminine singular absolute unspecified unspecified  	O	null
15 לפני לפני לפני preposition unspecified unspecified unspecified unspecified unspecified  	I_DATE	null
16 ה ה הספירה definiteArticle unspecified unspecified unspecified unspecified unspecified 0 
16 הספירה ספירה הספירה noun feminine singular absolute unspecified unspecified  	I_DATE	null
17 ) ) ) punctuation unspecified unspecified unspecified unspecified unspecified  	O	null
18 ; ; ; punctuation unspecified unspecified unspecified unspecified unspecified  	O	null
19 פלאוטוס פלאוטוס פלאוטוס properName unspecified unspecified unspecified unspecified unspecified  	I_PERS	null
20 ( ( ( punctuation unspecified unspecified unspecified unspecified unspecified  	O	null
21 סופר סופר סופר noun masculine singular absolute unspecified unspecified  	O	null
22 רומי רומי רומי adjective masculine singular absolute unspecified unspecified  	O	null
23 ב ב בן preposition unspecified unspecified unspecified unspecified unspecified  
23 הן הן בן pronomial feminine plural unspecified 3 unspecified 0 	O	null
24 ה ה המאה definiteArticle unspecified unspecified unspecified unspecified unspecified 0 
24 המאה ORD-CARD100 המאה numeral feminine plural absolute unspecified unspecified  	O	null
25 ה ה השלישית definiteArticle unspecified unspecified unspecified unspecified unspecified 0 
25 השלישית ORD3 השלישית numeral feminine singular absolute unspecified unspecified  	O	null
26 ו ו והשנייה conjunction unspecified unspecified unspecified unspecified unspecified 0 
26 ה ה והשנייה definiteArticle unspecified unspecified unspecified unspecified unspecified 0 
26 השנייה ORD2 והשנייה numeral feminine singular absolute unspecified unspecified  	O	null
27 לפני לפני לפני preposition unspecified unspecified unspecified unspecified unspecified  	I_DATE	null
28 ה ה הספירה definiteArticle unspecified unspecified unspecified unspecified unspecified 0 
28 הספירה ספירה הספירה noun feminine singular absolute unspecified unspecified  	I_DATE	null
29 ) ) ) punctuation unspecified unspecified unspecified unspecified unspecified  	O	null
30 ; ; ; punctuation unspecified unspecified unspecified unspecified unspecified  	O	null
31 טרנטיוס טרנטיוס טרנטיוס properName unspecified unspecified unspecified unspecified unspecified  	I_ORG	null
32 ( ( ( punctuation unspecified unspecified unspecified unspecified unspecified  	O	null
33 מחזאי מחזאי מחזאי noun masculine singular absolute unspecified unspecified  	O	null
34 רומי רומי רומי adjective masculine singular absolute unspecified unspecified  	O	null
35 ב ב בן preposition unspecified unspecified unspecified unspecified unspecified  
35 הן הן בן pronomial feminine plural unspecified 3 unspecified 0 	O	null
36 ה ה המאה definiteArticle unspecified unspecified unspecified unspecified unspecified 0 
36 המאה ORD-CARD100 המאה numeral feminine plural absolute unspecified unspecified  	O	null
37 ה ה השנייה definiteArticle unspecified unspecified unspecified unspecified unspecified 0 
37 השנייה ORD2 השנייה numeral feminine singular absolute unspecified unspecified  	O	null
38 לפני לפני לפני preposition unspecified unspecified unspecified unspecified unspecified  	I_DATE	null
39 ה ה הספירה definiteArticle unspecified unspecified unspecified unspecified unspecified 0 
39 הספירה ספירה הספירה noun feminine singular absolute unspecified unspecified  	I_DATE	null
40 ) ) ) punctuation unspecified unspecified unspecified unspecified unspecified  	O	null
41 . . . punctuation unspecified unspecified unspecified unspecified unspecified  	O	null

0 מ מ מ preposition unspecified unspecified unspecified unspecified unspecified 0 	O	null
1 - - - punctuation unspecified unspecified unspecified unspecified unspecified  	O	null
2 ###NUMBER### ###NUMBER### ###NUMBER### numeral unspecified unspecified unspecified unspecified unspecified  	I_DATE	null
3 החלה החל החלה verb feminine singular unspecified 3 past  	O	null
4 להוציא הוציא להוציא verb unspecified unspecified unspecified unspecified infinitive  	O	null
5 לאור לאור לאור preposition unspecified unspecified unspecified unspecified unspecified  	O	null
6 סדרה סדרה סדרה noun feminine singular absolute unspecified unspecified  	O	null
7 של של של shel-preposition unspecified unspecified unspecified unspecified unspecified  	O	null
8 נאומי נאום נאומי noun masculine plural construct unspecified unspecified  	O	null
9 מופת מופת מופת noun feminine singular absolute unspecified unspecified  	O	null
10 מ מ מהעולם preposition unspecified unspecified unspecified unspecified unspecified 0 
10 ה ה מהעולם definiteArticle unspecified unspecified unspecified unspecified unspecified 0 
10 העולם עולם מהעולם noun masculine singular absolute unspecified unspecified  	O	null
11 ה ה היווני definiteArticle unspecified unspecified unspecified unspecified unspecified 0 
11 היווני יווני היווני adjective masculine singular absolute unspecified unspecified  	O	null
12 ו ו והרומי conjunction unspecified unspecified unspecified unspecified unspecified 0 
12 ה ה והרומי definiteArticle unspecified unspecified unspecified unspecified unspecified 0 
12 הרומי רומי והרומי adjective masculine singular absolute unspecified unspecified  	O	null
13 . . . punctuation unspecified unspecified unspecified unspecified unspecified  	O	null

0 ה ה התרגום definiteArticle unspecified unspecified unspecified unspecified unspecified 0 
0 התרגום תרגום התרגום noun masculine singular absolute unspecified unspecified  	O	null
1 ה ה הראשון definiteArticle unspecified unspecified unspecified unspecified unspecified 0 
1 הראשון ORD1 הראשון numeral masculine singular absolute unspecified unspecified  	O	null
2 ב ב בסדרה preposition unspecified unspecified unspecified unspecified unspecified 0 
2 סדרה סדרה בסדרה noun feminine singular absolute unspecified unspecified  	O	null
3 זו זו זו pronoun feminine singular unspecified 3 unspecified  	O	null
4 , , , punctuation unspecified unspecified unspecified unspecified unspecified  	O	null
5 ש ש שזכה relativizer/subordinatingConjunction unspecified unspecified unspecified unspecified unspecified 0 
5 זכה זכה שזכה verb masculine singular unspecified 3 past  	O	null
6 ל ל לעניין preposition unspecified unspecified unspecified unspecified unspecified 0 
6 עניין עניין לעניין noun masculine singular absolute unspecified unspecified  	O	null
7 ציבורי ציבורי ציבורי adjective masculine singular absolute unspecified unspecified  	O	null
8 , , , punctuation unspecified unspecified unspecified unspecified unspecified  	O	null
9 הוא הוא הוא pronoun masculine singular unspecified 3 unspecified  	O	null
10 נאום נאום נאום noun masculine singular construct unspecified unspecified  	O	null
11 ה ה התביעה definiteArticle unspecified unspecified unspecified unspecified unspecified 0 
11 התביעה תביעה התביעה noun feminine singular absolute unspecified unspecified  	O	null
12 של של של shel-preposition unspecified unspecified unspecified unspecified unspecified  	O	null
13 אייסכינסנגד אייסכינסנגד אייסכינסנגד properName unspecified unspecified unspecified unspecified unspecified  	I_PERS	null
14 טימרכוס טימרכוס טימרכוס properName unspecified unspecified unspecified unspecified unspecified  	I_PERS	null
15 ) ) ) punctuation unspecified unspecified unspecified unspecified unspecified  	O	null
16 , , , punctuation unspecified unspecified unspecified unspecified unspecified  	O	null
17 ###NUMBER### ###NUMBER### ###NUMBER### numeral unspecified unspecified unspecified unspecified unspecified  	I_DATE	null
18 ש ש שנישא relativizer/subordinatingConjunction unspecified unspecified unspecified unspecified unspecified 0 
18 נישא נישא שנישא verb masculine singular unspecified 3 past  	O	null
19 ב ב בבית preposition unspecified unspecified unspecified unspecified unspecified 0 
19 בית בית בבית noun masculine singular construct unspecified unspecified  	I_ORG	null
20 ה ה המשפט definiteArticle unspecified unspecified unspecified unspecified unspecified 0 
20 המשפט משפט המשפט noun masculine singular absolute unspecified unspecified  	I_ORG	null
21 ב ב באתונה preposition unspecified unspecified unspecified unspecified unspecified 0 
21 אתונה אתונה באתונה properName unspecified unspecified unspecified unspecified unspecified  	I_LOC	null
22 ב ב בשנת preposition unspecified unspecified unspecified unspecified unspecified 0 
22 שנת שינה בשנת noun feminine singular construct unspecified unspecified  	O	null
23 346/5לפני 346/5לפני 346/5לפני verb masculine singular unspecified any beinoni  	O	null
24 ה ה הספירה definiteArticle unspecified unspecified unspecified unspecified unspecified 0 
24 הספירה ספירה הספירה noun feminine singular absolute unspecified unspecified  	O	null
25 בפני בפני בפני preposition unspecified unspecified unspecified unspecified unspecified  	O	null
26 חבר חיבר חבר verb masculine singular unspecified 2 imperative  	O	null
27 מושבעים הושבע מושבעים verb masculine plural unspecified any beinoni  	O	null
28 ו ו וקהל conjunction unspecified unspecified unspecified unspecified unspecified 0 
28 קהל קהל וקהל noun masculine singular absolute unspecified unspecified  	O	null
29 גדול גדול גדול adjective masculine singular absolute unspecified unspecified  	O	null
30 . . . punctuation unspecified unspecified unspecified unspecified unspecified  	O	null

0 זוהי זהו זוהי pronoun feminine singular unspecified 3 unspecified  	O	null
1 ה ה היצירה definiteArticle unspecified unspecified unspecified unspecified unspecified 0 
1 היצירה יצירה היצירה noun feminine singular absolute unspecified unspecified  	O	null
2 ה ה היחידה definiteArticle unspecified unspecified unspecified unspecified unspecified 0 
2 היחידה יחיד היחידה adjective feminine singular absolute unspecified unspecified  	O	null
3 ש ש ששרדה relativizer/subordinatingConjunction unspecified unspecified unspecified unspecified unspecified 0 
3 שרדה שרד ששרדה verb feminine singular unspecified 3 past  	O	null
4 מן מן מן preposition unspecified unspecified unspecified unspecified unspecified  	O	null
5 ה ה הספרות definiteArticle unspecified unspecified unspecified unspecified unspecified 0 
5 הספרות ספרות הספרות noun feminine singular absolute unspecified unspecified  	O	null
6 ה ה היוונית definiteArticle unspecified unspecified unspecified unspecified unspecified 0 
6 היוונית יווני היוונית adjective feminine singular absolute unspecified unspecified  	O	null
7 ה ה העוסקת definiteArticle unspecified unspecified unspecified unspecified unspecified 0 
7 העוסקת עסק העוסקת participle feminine singular absolute any unspecified  	O	null
8 כול כול כולה quantifier unspecified unspecified unspecified unspecified unspecified  
8 ה ה כולה pronomial feminine singular unspecified 3 unspecified 0 	O	null
9 ב ב ביחסים preposition unspecified unspecified unspecified unspecified unspecified 0 
9 יחסים יחס ביחסים noun masculine plural absolute unspecified unspecified  	O	null
10 חד חד חד wPrefix unspecified unspecified unspecified unspecified unspecified  	I_ORG	null
11 - - - punctuation unspecified unspecified unspecified unspecified unspecified  	I_ORG	null
12 מיניים מיני מיניים adjective masculine plural absolute unspecified unspecified  	I_ORG	null
13 בין בין בין preposition unspecified unspecified unspecified unspecified unspecified  	O	null
14 גברים גבר גברים noun masculine plural absolute unspecified unspecified  	O	null
15 . . . punctuation unspecified unspecified unspecified unspecified unspecified  	O	null

0 תרגומי תרגום תרגומיה noun masculine plural absolute unspecified unspecified  
0 ה ה תרגומיה possessive feminine singular unspecified 3 unspecified 0 	O	null
1 מתאפיינים התאפיין מתאפיינים verb masculine plural unspecified any beinoni  	O	null
2 ב ב בשילוב preposition unspecified unspecified unspecified unspecified unspecified 0 
2 שילוב שילוב בשילוב noun masculine singular absolute unspecified unspecified  	O	null
3 של של של shel-preposition unspecified unspecified unspecified unspecified unspecified  	O	null
4 הקפדה הקפדה הקפדה noun feminine singular absolute unspecified unspecified  	O	null
5 על על על preposition unspecified unspecified unspecified unspecified unspecified  	O	null
6 דיוק דיוק דיוק noun masculine singular absolute unspecified unspecified  	O	null
7 ו ו ושל conjunction unspecified unspecified unspecified unspecified unspecified 0 
7 של של ושל shel-preposition unspecified unspecified unspecified unspecified unspecified  	O	null
8 ה ה הרצון definiteArticle unspecified unspecified unspecified unspecified unspecified 0 
8 הרצון רצון הרצון noun masculine singular absolute unspecified unspecified  	O	null
9 להעמיד העמיד להעמיד verb unspecified unspecified unspecified unspecified infinitive  	O	null
10 ש ש שפה relativizer/subordinatingConjunction unspecified unspecified unspecified unspecified unspecified 0 
10 פה פה שפה adverb unspecified unspecified unspecified unspecified unspecified  	O	null
11 תרגומית תרגומית תרגומית noun masculine-and-feminine singular absolute unspecified unspecified  	O	null
12 קולחת קלח קולחת verb feminine singular unspecified any beinoni  	O	null
13 , , , punctuation unspecified unspecified unspecified unspecified unspecified  	O	null
14 עשירה עשיר עשירה adjective feminine singular absolute unspecified unspecified  	O	null
15 ו ו ונוחה conjunction unspecified unspecified unspecified unspecified unspecified 0 
15 נוחה נוח ונוחה adjective feminine singular absolute unspecified unspecified  	O	null
16 ש ש שאינה relativizer/subordinatingConjunction unspecified unspecified unspecified unspecified unspecified 0 
16 אינה הוא שאינה copula feminine singular unspecified 3 beinoni  	O	null
17 דורשת דרש דורשת verb feminine singular unspecified any beinoni  	O	null
18 מ מ מהקורא preposition unspecified unspecified unspecified unspecified unspecified 0 
18 ה ה מהקורא definiteArticle unspecified unspecified unspecified unspecified unspecified 0 
18 הקורא קורא מהקורא noun masculine singular absolute unspecified unspecified  	O	null
19 היכרות היכרות היכרות noun feminine singular absolute unspecified unspecified  	O	null
20 מקצועית מקצועי מקצועית adjective feminine singular absolute unspecified unspecified  	O	null
21 עם עם עם preposition unspecified unspecified unspecified unspecified unspecified  	O	null
22 ה ה העולם definiteArticle unspecified unspecified unspecified unspecified unspecified 0 
22 העולם עולם העולם noun masculine singular absolute unspecified unspecified  	O	null
23 ה ה היווני definiteArticle unspecified unspecified unspecified unspecified unspecified 0 
23 היווני יווני היווני adjective masculine singular absolute unspecified unspecified  	O	null
24 - - - punctuation unspecified unspecified unspecified unspecified unspecified  	O	null
25 רומי רום רומי noun masculine plural construct unspecified unspecified  	O	null
26 . . . punctuation unspecified unspecified unspecified unspecified unspecified  	O	null

0 בנוסף בנוסף בנוסף adverb unspecified unspecified unspecified unspecified unspecified  	O	null
1 ל ל לתרגומיה preposition unspecified unspecified unspecified unspecified unspecified 0 
1 תרגומי תרגום לתרגומיה noun masculine plural absolute unspecified unspecified  
1 ה ה לתרגומיה possessive feminine singular unspecified 3 unspecified 0 	O	null
2 העמידה העמיד העמידה verb feminine singular unspecified 3 past  	O	null
3 ספרות ספרות ספרות noun feminine singular construct unspecified unspecified  	O	null
4 מחקר מחקר מחקר noun masculine singular absolute unspecified unspecified  	O	null
5 ה ה הכוללת definiteArticle unspecified unspecified unspecified unspecified unspecified 0 
5 הכוללת כלל הכוללת participle feminine singular absolute any unspecified  	O	null
6 ספרים ספר ספרים noun masculine plural absolute unspecified unspecified  	O	null
7 ו ו ומאמרים conjunction unspecified unspecified unspecified unspecified unspecified 0 
7 מאמרים מאמר ומאמרים noun masculine plural absolute unspecified unspecified  	O	null
8 רבים רב רבים adjective masculine plural absolute unspecified unspecified  	O	null
9 , , , punctuation unspecified unspecified unspecified unspecified unspecified  	O	null
10 ב ב בהם preposition unspecified unspecified unspecified unspecified unspecified  
10 הם הם בהם pronomial masculine plural unspecified 3 unspecified 0 	O	null
11 ספרה ספרה ספרה noun feminine singular absolute unspecified unspecified  	O	null
12 גם גם גם conjunction unspecified unspecified unspecified unspecified unspecified  	O	null
13 סוקרטס סוקרטס סוקרטס noun masculine singular absolute unspecified unspecified  	O	null
14 ב ב בעננים preposition unspecified unspecified unspecified unspecified unspecified 0 
14 עננים ענן בעננים noun masculine plural absolute unspecified unspecified  	O	null
15 ( ( ( punctuation unspecified unspecified unspecified unspecified unspecified  	O	null
16 ) ) ) punctuation unspecified unspecified unspecified unspecified unspecified  	O	null
17 , , , punctuation unspecified unspecified unspecified unspecified unspecified  	O	null
18 ###NUMBER### ###NUMBER### ###NUMBER### numeral unspecified unspecified unspecified unspecified unspecified  	I_DATE	null
19 ה ה הבוחן definiteArticle unspecified unspecified unspecified unspecified unspecified 0 
19 הבוחן בחן הבוחן participle masculine singular absolute any unspecified  	O	null
20 את את את at-preposition unspecified unspecified unspecified unspecified unspecified  	O	null
21 חשיבות חשיבות חשיבותו noun feminine singular absolute unspecified unspecified  
21 ו ו חשיבותו possessive masculine singular unspecified 3 unspecified 0 	O	null
22 ו ו ומעמדו conjunction unspecified unspecified unspecified unspecified unspecified 0 
22 מעמד מעמד ומעמדו noun masculine singular absolute unspecified unspecified  
22 ו ו ומעמדו possessive masculine singular unspecified 3 unspecified 0 	O	null
23 של של של shel-preposition unspecified unspecified unspecified unspecified unspecified  	O	null
24 ה ה התיאטרון definiteArticle unspecified unspecified unspecified unspecified unspecified 0 
24 התיאטרון תיאטרון התיאטרון noun masculine singular absolute unspecified unspecified  	O	null
25 ב ב בעולם preposition unspecified unspecified unspecified unspecified unspecified 0 
25 ה ה בעולם definiteArticle unspecified unspecified unspecified unspecified unspecified 0 
25 העולם עולם בעולם noun masculine singular absolute unspecified unspecified  	O	null
26 ה ה היווני definiteArticle unspecified unspecified unspecified unspecified unspecified 0 
26 היווני יווני היווני adjective masculine singular absolute unspecified unspecified  	O	null
27 - - - punctuation unspecified unspecified unspecified unspecified unspecified  	O	null
28 רומי רום רומי noun masculine plural construct unspecified unspecified  	O	null
29 , , , punctuation unspecified unspecified unspecified unspecified unspecified  	O	null
30 ו ו וקובץ conjunction unspecified unspecified unspecified unspecified unspecified 0 
30 קובץ קובץ וקובץ noun masculine singular construct unspecified unspecified  	O	null
31 ה ה המחקרים definiteArticle unspecified unspecified unspecified unspecified unspecified 0 
31 המחקרים מחקר המחקרים noun masculine plural absolute unspecified unspecified  	O	null
32 ש ש שאותו relativizer/subordinatingConjunction unspecified unspecified unspecified unspecified unspecified 0 
32 אותו אותו שאותו quantifier unspecified unspecified construct unspecified unspecified  	O	null
33 ערכה ערכה ערכה noun feminine singular absolute unspecified unspecified  	O	null
34 על על על preposition unspecified unspecified unspecified unspecified unspecified  	O	null
35 ה ה המחזה definiteArticle unspecified unspecified unspecified unspecified unspecified 0 
35 המחזה מחזה המחזה noun masculine singular absolute unspecified unspecified  	O	null
36 אדיפוס אדיפוס אדיפוס properName unspecified unspecified unspecified unspecified unspecified  	O	null
37 ה ה המלך definiteArticle unspecified unspecified unspecified unspecified unspecified 0 
37 המלך מלך המלך noun masculine singular absolute unspecified unspecified  	O	null
38 ו ו ותפקידו conjunction unspecified unspecified unspecified unspecified unspecified 0 
38 תפקיד תפקיד ותפקידו noun masculine singular absolute unspecified unspecified  
38 ו ו ותפקידו possessive masculine singular unspecified 3 unspecified 0 	O	null
39 ה ה התרבותי definiteArticle unspecified unspecified unspecified unspecified unspecified 0 
39 התרבותי תרבותי התרבותי adjective masculine singular absolute unspecified unspecified  	O	null
40 ל ל לאורך preposition unspecified unspecified unspecified unspecified unspecified 0 
40 אורך אורך לאורך noun masculine singular construct unspecified unspecified  	O	null
41 ה ה ההיסטוריה definiteArticle unspecified unspecified unspecified unspecified unspecified 0 
41 ההיסטוריה היסטוריה ההיסטוריה noun feminine singular absolute unspecified unspecified  	O	null
42 ) ) ) punctuation unspecified unspecified unspecified unspecified unspecified  	O	null
43 . . . punctuation unspecified unspecified unspecified unspecified unspecified  	O	null
44 ###NUMBER### ###NUMBER### ###NUMBER### numeral unspecified unspecified unspecified unspecified unspecified  	I_DATE	null
45 תחום תחום תחום noun masculine singular construct unspecified unspecified  	O	null
46 ה ה המחקר definiteArticle unspecified unspecified unspecified unspecified unspecified 0 
46 המחקר מחקר המחקר noun masculine singular absolute unspecified unspecified  	O	null
47 ה ה השני definiteArticle unspecified unspecified unspecified unspecified unspecified 0 
47 השני ORD2 השני numeral masculine singular absolute unspecified unspecified  	O	null
48 שבו ישב שבו verb masculine-and-feminine plural unspecified 2 imperative  	O	null
49 התמקדה התמקד התמקדה verb feminine singular unspecified 3 past  	O	null
50 הוא הוא הוא pronoun masculine singular unspecified 3 unspecified  	O	null
51 יצירת יצירה יצירתו noun feminine singular absolute unspecified unspecified  
51 ו ו יצירתו possessive masculine singular unspecified 3 unspecified 0 	O	null
52 של של של shel-preposition unspecified unspecified unspecified unspecified unspecified  	O	null
53 נתן נתן נתן properName unspecified unspecified unspecified unspecified unspecified  	I_PERS	null
54 אלתרמן אלתרמן אלתרמן properName unspecified unspecified unspecified unspecified unspecified  	I_PERS	null
55 . . . punctuation unspecified unspecified unspecified unspecified unspecified  	O	null

0 ב ב בספרה preposition unspecified unspecified unspecified unspecified unspecified 0 
0 ספר ספר בספרה noun masculine singular absolute unspecified unspecified  
0 ה ה בספרה possessive feminine singular unspecified 3 unspecified 0 	O	null
1 מול מול מול preposition unspecified unspecified unspecified unspecified unspecified  	O	null
2 תגמול תגמול תגמול noun masculine singular construct unspecified unspecified  	O	null
3 מחיאות מחיאה מחיאות noun feminine plural construct unspecified unspecified  	O	null
4 כפיים כף כפיים noun feminine plural absolute unspecified unspecified  	O	null
5 : : : punctuation unspecified unspecified unspecified unspecified unspecified  	O	null
6 נתן נתן נתן properName unspecified unspecified unspecified unspecified unspecified  	I_PERS	null
7 אלתרמן אלתרמן אלתרמן properName unspecified unspecified unspecified unspecified unspecified  	I_PERS	null
8 ו ו והבמה conjunction unspecified unspecified unspecified unspecified unspecified 0 
8 ה ה והבמה definiteArticle unspecified unspecified unspecified unspecified unspecified 0 
8 הבמה במה והבמה noun feminine singular absolute unspecified unspecified  	O	null
9 ה ה העברית definiteArticle unspecified unspecified unspecified unspecified unspecified 0 
9 העברית עברי העברית adjective feminine singular absolute unspecified unspecified  	O	null
10 ( ( ( punctuation unspecified unspecified unspecified unspecified unspecified  	O	null
11 ) ) ) punctuation unspecified unspecified unspecified unspecified unspecified  	O	null
12 ###NUMBER### ###NUMBER### ###NUMBER### numeral unspecified unspecified unspecified unspecified unspecified  	I_DATE	null
13 היא הוא היא pronoun feminine singular unspecified 3 unspecified  	O	null
14 בוחנת בחן בוחנת verb feminine singular unspecified any beinoni  	O	null
15 את את את at-preposition unspecified unspecified unspecified unspecified unspecified  	O	null
16 תרומת תרומה תרומתו noun feminine singular absolute unspecified unspecified  
16 ו ו תרומתו possessive masculine singular unspecified 3 unspecified 0 	O	null
17 של של של shel-preposition unspecified unspecified unspecified unspecified unspecified  	O	null
18 אלתרמן אלתרמן אלתרמן properName unspecified unspecified unspecified unspecified unspecified  	I_PERS	null
19 ל ל לתיאטרון preposition unspecified unspecified unspecified unspecified unspecified 0 
19 ה ה לתיאטרון definiteArticle unspecified unspecified unspecified unspecified unspecified 0 
19 התיאטרון תיאטרון לתיאטרון noun masculine singular absolute unspecified unspecified  	O	null
20 ה ה העברי definiteArticle unspecified unspecified unspecified unspecified unspecified 0 
20 העברי עברי העברי adjective masculine singular absolute unspecified unspecified  	O	null
21 החל החל החל verb masculine singular unspecified 3 past  	O	null
22 מ מ משנות preposition unspecified unspecified unspecified unspecified unspecified 0 
22 שנות שנה משנות noun feminine plural construct unspecified unspecified  	I_DATE	null
23 ה ה השלושים definiteArticle unspecified unspecified unspecified unspecified unspecified 0 
23 השלושים ORD-CARD30 השלושים numeral masculine-and-feminine plural absolute unspecified unspecified  	I_DATE	null
24 ה ה המוקדמות definiteArticle unspecified unspecified unspecified unspecified unspecified 0 
24 המוקדמות מוקדם המוקדמות adjective feminine plural absolute unspecified unspecified  	O	null
25 , , , punctuation unspecified unspecified unspecified unspecified unspecified  	O	null
26 ש ש שבהן relativizer/subordinatingConjunction unspecified unspecified unspecified unspecified unspecified 0 
26 ב ב שבהן preposition unspecified unspecified unspecified unspecified unspecified 0 
26 הן הוא שבהן pronoun feminine plural unspecified 3 unspecified  	O	null
27 כתב כתב כתב verb masculine singular unspecified 3 past  	O	null
28 עבור עבור עבור preposition unspecified unspecified unspecified unspecified unspecified  	O	null
29 תיאטרון תיאטרון תיאטרון noun masculine singular absolute unspecified unspecified  	O	null
30 " " " punctuation unspecified unspecified unspecified unspecified unspecified  	O	null
31 ה ה המטאטא definiteArticle unspecified unspecified unspecified unspecified unspecified 0 
31 המטאטא מטאטא המטאטא noun masculine singular absolute unspecified unspecified  	O	null
32 " " " punctuation unspecified unspecified unspecified unspecified unspecified  	O	null
33 , , , punctuation unspecified unspecified unspecified unspecified unspecified  	O	null
34 ו ו ועד conjunction unspecified unspecified unspecified unspecified unspecified 0 
34 עד עד ועד noun masculine singular absolute unspecified unspecified  	O	null
35 ל ל למחזה preposition unspecified unspecified unspecified unspecified unspecified 0 
35 ה ה למחזה definiteArticle unspecified unspecified unspecified unspecified unspecified 0 
35 המחזה מחזה למחזה noun masculine singular absolute unspecified unspecified  	O	null
36 ה ה האחרון definiteArticle unspecified unspecified unspecified unspecified unspecified 0 
36 האחרון אחרון האחרון adjective masculine singular absolute unspecified unspecified  	O	null
37 ש ש שכתב relativizer/subordinatingConjunction unspecified unspecified unspecified unspecified unspecified 0 
37 כתב כתב שכתב verb masculine singular unspecified 3 past  	O	null
38 ב ב ב preposition unspecified unspecified unspecified unspecified unspecified 0 	O	null
39 - - - punctuation unspecified unspecified unspecified unspecified unspecified  	O	null
40 ###NUMBER### ###NUMBER### ###NUMBER### numeral unspecified unspecified unspecified unspecified unspecified  	I_DATE	null
41 . . . punctuation unspecified unspecified unspecified unspecified unspecified  	O	null

0 כמו כמו כמו conjunction unspecified unspecified unspecified unspecified unspecified  	O	null
1 כן כן כן conjunction unspecified unspecified unspecified unspecified unspecified  	O	null
2 ערכה ערך ערכה verb feminine singular unspecified 3 past  	O	null
3 מחדש מחדש מחדש adverb unspecified unspecified unspecified unspecified unspecified  	O	null
4 את את את at-preposition unspecified unspecified unspecified unspecified unspecified  	O	null
5 שירי שיר שירי noun masculine plural construct unspecified unspecified  	O	null
6 ה ה הטור definiteArticle unspecified unspecified unspecified unspecified unspecified 0 
6 הטור טור הטור noun masculine singular absolute unspecified unspecified  	O	null
7 השביעישל השביעישל השביעישל properName unspecified unspecified unspecified unspecified unspecified  	I_PERS	null
8 אלתרמן אלתרמן אלתרמן properName unspecified unspecified unspecified unspecified unspecified  	I_PERS	null
9 ב ב במהדורה preposition unspecified unspecified unspecified unspecified unspecified 0 
9 מהדורה מהדורה במהדורה noun feminine singular absolute unspecified unspecified  	O	null
10 מוערת הוער מוערת verb feminine singular unspecified any beinoni  	O	null
11 לרגל לרגל לרגל preposition unspecified unspecified unspecified unspecified unspecified  	O	null
12 מאה ORD-CARD100 מאה numeral feminine plural absolute unspecified unspecified  	O	null
13 שנה ישן שנה verb feminine plural unspecified 2 imperative  	O	null
14 ל ל להולדתו preposition unspecified unspecified unspecified unspecified unspecified 0 
14 הולדת הולדה להולדתו noun feminine singular absolute unspecified unspecified  
14 ו ו להולדתו possessive masculine singular unspecified 3 unspecified 0 	O	null
15 . . . punctuation unspecified unspecified unspecified unspecified unspecified  	O	null

0 References References References foreign unspecified unspecified unspecified unspecified unspecified  	O	null
1 : : : punctuation unspecified unspecified unspecified unspecified unspecified  	O	null
2 אור אור אור properName unspecified unspecified unspecified unspecified unspecified  	I_PERS	null
3 , , , punctuation unspecified unspecified unspecified unspecified unspecified  	O	null
4 אמיר אמיר אמיר properName unspecified unspecified unspecified unspecified unspecified  	I_PERS	null
5 . . . punctuation unspecified unspecified unspecified unspecified unspecified  	O	null

0 " " " punctuation unspecified unspecified unspecified unspecified unspecified  	O	null
1 בין בין בין preposition unspecified unspecified unspecified unspecified unspecified  	O	null
2 אמנות אמנות אמנות noun feminine singular construct unspecified unspecified  	O	null
3 ה ה הפיתוי definiteArticle unspecified unspecified unspecified unspecified unspecified 0 
3 הפיתוי פיתוי הפיתוי noun masculine singular absolute unspecified unspecified  	O	null
4 לאמנותהביטוי לאמנותהביטוי לאמנותהביטוי participle feminine plural construct any unspecified  	O	null
5 " " " punctuation unspecified unspecified unspecified unspecified unspecified  	O	null
6 . . . punctuation unspecified unspecified unspecified unspecified unspecified  	O	null

0 ה ה הארץ definiteArticle unspecified unspecified unspecified unspecified unspecified 0 
0 הארץ ארץ הארץ noun feminine singular absolute unspecified unspecified  	O	null
1 ספרים ספר ספרים noun masculine plural absolute unspecified unspecified  	O	null
2 . . . punctuation unspecified unspecified unspecified unspecified unspecified  	O	null

0 ; ; ; punctuation unspecified unspecified unspecified unspecified unspecified  	O	null
1 גלוקר גלוקר גלוקר properName unspecified unspecified unspecified unspecified unspecified  	I_PERS	null
2 , , , punctuation unspecified unspecified unspecified unspecified unspecified  	O	null
3 ###NUMEXP### ###NUMEXP### ###NUMEXP### numberExpression unspecified unspecified unspecified unspecified unspecified  	I_DATE	null
4 יוחנן יוחנן יוחנן properName unspecified unspecified unspecified unspecified unspecified  	I_PERS	null
5 . . . punctuation unspecified unspecified unspecified unspecified unspecified  	O	null

0 " " " punctuation unspecified unspecified unspecified unspecified unspecified  	O	null
1 במה במה במה noun feminine singular absolute unspecified unspecified  	O	null
2 מתרגמין מתרגמין מתרגמין noun masculine-and-feminine singular absolute unspecified unspecified  	O	null
3 : : : punctuation unspecified unspecified unspecified unspecified unspecified  	O	null
4 על על על preposition unspecified unspecified unspecified unspecified unspecified  	O	null
5 תרגומי תרגום תרגומיה noun masculine plural absolute unspecified unspecified  
5 ה ה תרגומיה possessive feminine singular unspecified 3 unspecified 0 	O	null
6 של של של shel-preposition unspecified unspecified unspecified unspecified unspecified  	O	null
7 דבורה דבורה דבורה properName unspecified unspecified unspecified unspecified unspecified  	I_PERS	null
8 גילולה גילולה גילולה adjective feminine singular absolute unspecified unspecified  	O	null
9 ל ל לנאומים preposition unspecified unspecified unspecified unspecified unspecified 0 
9 נאומים נאום לנאומים noun masculine plural absolute unspecified unspecified  	O	null
10 של של של shel-preposition unspecified unspecified unspecified unspecified unspecified  	O	null
11 אנדוקידס אנדוקידס אנדוקידס noun masculine-and-feminine singular absolute unspecified unspecified  	O	null
12 " " " punctuation unspecified unspecified unspecified unspecified unspecified  	O	null
13 . . . punctuation unspecified unspecified unspecified unspecified unspecified  	O	null

0 קתרסיס קתרסיס קתרסיס verb masculine-and-feminine plural unspecified 2 imperative  	O	null
1 . . . punctuation unspecified unspecified unspecified unspecified unspecified  	O	null
2 ###NUMBER### ###NUMBER### ###NUMBER### numeral unspecified unspecified unspecified unspecified unspecified  	I_DATE	null
3 אביב אביב אביב properName unspecified unspecified unspecified unspecified unspecified  	I_DATE	null
4 ###NUMBER### ###NUMBER### ###NUMBER### numeral unspecified unspecified unspecified unspecified unspecified  	I_DATE	null
5 . . . punctuation unspecified unspecified unspecified unspecified unspecified  	O	null

0 - - - punctuation unspecified unspecified unspecified unspecified unspecified  	O	null
1 ###NUMBER### ###NUMBER### ###NUMBER### numeral unspecified unspecified unspecified unspecified unspecified  	O	null
2 ; ; ; punctuation unspecified unspecified unspecified unspecified unspecified  	O	null
3 ###NUMBER### ###NUMBER### ###NUMBER### numeral unspecified unspecified unspecified unspecified unspecified  	O	null
4 ל ל לי preposition unspecified unspecified unspecified unspecified unspecified  
4 י י לי pronomial masculine-and-feminine singular unspecified 1 unspecified 0 	O	null
5 , , , punctuation unspecified unspecified unspecified unspecified unspecified  	O	null
6 ורד ורד ורד properName unspecified unspecified unspecified unspecified unspecified  	I_PERS	null
7 . . . punctuation unspecified unspecified unspecified unspecified unspecified  	O	null

0 " " " punctuation unspecified unspecified unspecified unspecified unspecified  	O	null
1 חמש CARD5 חמש numeral feminine singular absolute unspecified unspecified  	O	null
2 שאלות שאלה שאלות noun feminine plural absolute unspecified unspecified  	O	null
3 ל ל לדבורה preposition unspecified unspecified unspecified unspecified unspecified 0 
3 דבורה דבורה לדבורה noun feminine singular absolute unspecified unspecified  	O	null
4 גילולה גילולה גילולה adjective feminine singular absolute unspecified unspecified  	O	null
5 " " " punctuation unspecified unspecified unspecified unspecified unspecified  	O	null
6 . . . punctuation unspecified unspecified unspecified unspecified unspecified  	O	null

0 ה ה הארץ definiteArticle unspecified unspecified unspecified unspecified unspecified 0 
0 הארץ ארץ הארץ noun feminine singular absolute unspecified unspecified  	O	null
1 ספרים ספר ספרים noun masculine plural absolute unspecified unspecified  	O	null
2 . . . punctuation unspecified unspecified unspecified unspecified unspecified  	O	null

0 ###NUMEXP### ###NUMEXP### ###NUMEXP### numberExpression unspecified unspecified unspecified unspecified unspecified  	I_DATE	null
1 . . . punctuation unspecified unspecified unspecified unspecified unspecified  	O	null

