0 Name Name Name foreign unspecified unspecified unspecified unspecified unspecified  	O	null
1 : : : punctuation unspecified unspecified unspecified unspecified unspecified  	O	null
2 גינוסר גינוסר גינוסר properName unspecified unspecified unspecified unspecified unspecified  	I_ORG	null
3 ( ( ( punctuation unspecified unspecified unspecified unspecified unspecified  	O	null
4 גולדפרב גולדפרב גולדפרב properName unspecified unspecified unspecified unspecified unspecified  	I_ORG	null
5 ) ) ) punctuation unspecified unspecified unspecified unspecified unspecified  	O	null
6 , , , punctuation unspecified unspecified unspecified unspecified unspecified  	O	null
7 פנחס פנחס פנחס properName unspecified unspecified unspecified unspecified unspecified  	I_PERS	null
8 Birth Birth Birth foreign unspecified unspecified unspecified unspecified unspecified  	O	null
9 Year Year Year foreign unspecified unspecified unspecified unspecified unspecified  	O	null
10 : : : punctuation unspecified unspecified unspecified unspecified unspecified  	O	null
11 ###NUMBER### ###NUMBER### ###NUMBER### numeral unspecified unspecified unspecified unspecified unspecified  	I_DATE	null
12 Death Death Death foreign unspecified unspecified unspecified unspecified unspecified  	O	null
13 Year Year Year foreign unspecified unspecified unspecified unspecified unspecified  	O	null
14 : : : punctuation unspecified unspecified unspecified unspecified unspecified  	O	null
15 ###NUMBER### ###NUMBER### ###NUMBER### numeral unspecified unspecified unspecified unspecified unspecified  	I_DATE	null
16 Birth Birth Birth foreign unspecified unspecified unspecified unspecified unspecified  	O	null
17 Place Place Place foreign unspecified unspecified unspecified unspecified unspecified  	O	null
18 : : : punctuation unspecified unspecified unspecified unspecified unspecified  	O	null
19 תל תל תל properName unspecified unspecified unspecified unspecified unspecified  	I_LOC	null
20 אביב אביב אביב properName unspecified unspecified unspecified unspecified unspecified  	B_LOC	null
21 ל ל למשפחה preposition unspecified unspecified unspecified unspecified unspecified 0 
21 משפחה משפחה למשפחה noun feminine singular absolute unspecified unspecified  	O	null
22 Occupation Occupation Occupation foreign unspecified unspecified unspecified unspecified unspecified  	O	null
23 : : : punctuation unspecified unspecified unspecified unspecified unspecified  	O	null
24 חוקר חוקר חוקר noun masculine singular absolute unspecified unspecified  	O	null
25 , , , punctuation unspecified unspecified unspecified unspecified unspecified  	O	null
26 עורך עורך עורך noun masculine singular absolute unspecified unspecified  	O	null
27 ו ו ומבקר conjunction unspecified unspecified unspecified unspecified unspecified 0 
27 מבקר מבקר ומבקר noun masculine singular construct unspecified unspecified  	O	null
28 ספרות ספרות ספרות noun feminine singular construct unspecified unspecified  	O	null
29 Entry Entry Entry foreign unspecified unspecified unspecified unspecified unspecified  	O	null
30 writer writer writer foreign unspecified unspecified unspecified unspecified unspecified  	O	null
31 : : : punctuation unspecified unspecified unspecified unspecified unspecified  	O	null
32 נולדה נולד נולדה verb feminine singular unspecified 3 past  	O	null
33 בתלאביב בתלאביב בתלאביב properName unspecified unspecified unspecified unspecified unspecified  	I_PERS	null
34 . . . punctuation unspecified unspecified unspecified unspecified unspecified  	O	null

0 למדהלדוקטורטבאוניברסיטתתלאביב למדהלדוקטורטבאוניברסיטתתלאביב למדהלדוקטורטבאוניברסיטתתלאביב properName unspecified unspecified unspecified unspecified unspecified  	I_PERS	null
1 , , , punctuation unspecified unspecified unspecified unspecified unspecified  	O	null
2 ש ש שםכתבה relativizer/subordinatingConjunction unspecified unspecified unspecified unspecified unspecified 0 
2 מ מ שםכתבה preposition unspecified unspecified unspecified unspecified unspecified 0 
2 כתבה כתבה שםכתבה noun feminine singular absolute unspecified unspecified  	O	null
3 , , , punctuation unspecified unspecified unspecified unspecified unspecified  	O	null
4 ב ב ב preposition unspecified unspecified unspecified unspecified unspecified 0 	O	null
5 - - - punctuation unspecified unspecified unspecified unspecified unspecified  	O	null
6 , , , punctuation unspecified unspecified unspecified unspecified unspecified  	O	null
7 ###NUMBER### ###NUMBER### ###NUMBER### numeral unspecified unspecified unspecified unspecified unspecified  	I_DATE	null
8 עבודתדוקטורשעסקהבאמילדורקהיים עבודתדוקטורשעסקהבאמילדורקהיים עבודתדוקטורשעסקהבאמילדורקהיים verb masculine singular unspecified 2 imperative  	O	null
9 , , , punctuation unspecified unspecified unspecified unspecified unspecified  	O	null
10 מחלוציהסוציולוגיה מחלוציהסוציולוגיה מחלוציהסוציולוגיה properName unspecified unspecified unspecified unspecified unspecified  	I_PERS	null
11 . . . punctuation unspecified unspecified unspecified unspecified unspecified  	O	null

0 מ מ מלמדתבמכוןלהיסטוריהופילוסופיהשלהמדעיםוהרעיונותע preposition unspecified unspecified unspecified unspecified unspecified 0 
0 למדתבמכוןלהיסטוריהופילוסופיהשלהמדעיםוהרעיונות למדתבמכוןלהיסטוריהופילוסופיהשלהמדעיםוהרעיונות מלמדתבמכוןלהיסטוריהופילוסופיהשלהמדעיםוהרעיונותע noun masculine-and-feminine plural absolute unspecified unspecified  
0 י י מלמדתבמכוןלהיסטוריהופילוסופיהשלהמדעיםוהרעיונותע possessive masculine-and-feminine singular unspecified 1 unspecified 0 	O	null
1 " " " punctuation unspecified unspecified unspecified unspecified unspecified  	O	null
2 שכהןבאוניברסיטתתלאביב שכהןבאוניברסיטתתלאביב שכהןבאוניברסיטתתלאביב properName unspecified unspecified unspecified unspecified unspecified  	O	null
3 . . . punctuation unspecified unspecified unspecified unspecified unspecified  	O	null

0 נושאיהמחקרשלהמשלביםביןההיסטוריהשלהסוציולוגיהלמחשבההביולוגית נושאיהמחקרשלהמשלביםביןההיסטוריהשלהסוציולוגיהלמחשבההביולוגית נושאיהמחקרשלהמשלביםביןההיסטוריהשלהסוציולוגיהלמחשבההביולוגית noun masculine-and-feminine singular absolute unspecified unspecified  	O	null
1 . . . punctuation unspecified unspecified unspecified unspecified unspecified  	O	null

0 חיברהמאמריםעלמושגהגזעועלתיאורייתהלאמארקיזם חיברהמאמריםעלמושגהגזעועלתיאורייתהלאמארקיזם חיברהמאמריםעלמושגהגזעועלתיאורייתהלאמארקיזם participle feminine singular absolute any unspecified  	I_ORG	null
1 – – – punctuation unspecified unspecified unspecified unspecified unspecified  	O	null
2 תורהאבולוציוניתשקדמהלדרוויניזם תורהאבולוציוניתשקדמהלדרוויניזם תורהאבולוציוניתשקדמהלדרוויניזם properName unspecified unspecified unspecified unspecified unspecified  	I_PERS	null
3 . . . punctuation unspecified unspecified unspecified unspecified unspecified  	O	null

0 Entry Entry Entry foreign unspecified unspecified unspecified unspecified unspecified  	O	null
1 Value Value Value foreign unspecified unspecified unspecified unspecified unspecified  	O	null
2 : : : punctuation unspecified unspecified unspecified unspecified unspecified  	O	null
3 נולד נולד נולד verb masculine singular unspecified 3 past  	O	null
4 ב ב בתל preposition unspecified unspecified unspecified unspecified unspecified 0 
4 תל תל בתל properName unspecified unspecified unspecified unspecified unspecified  	I_LOC	null
5 אביב אביב אביב properName unspecified unspecified unspecified unspecified unspecified  	I_LOC	null
6 ל ל למשפחה preposition unspecified unspecified unspecified unspecified unspecified 0 
6 משפחה משפחה למשפחה noun feminine singular absolute unspecified unspecified  	O	null
7 רוויזיוניסטית רוויזיוניסטית רוויזיוניסטית adjective feminine singular absolute unspecified unspecified  	O	null
8 . . . punctuation unspecified unspecified unspecified unspecified unspecified  	O	null

0 ב ב בגיל preposition unspecified unspecified unspecified unspecified unspecified 0 
0 גיל גיל בגיל noun masculine singular construct unspecified unspecified  	O	null
1 ארבע CARD4 ארבע numeral feminine singular absolute unspecified unspecified  	O	null
2 - - - punctuation unspecified unspecified unspecified unspecified unspecified  	O	null
3 עשרה CARD10 עשרה numeral masculine plural absolute unspecified unspecified  	O	null
4 הצטרף הצטרף הצטרף verb masculine singular unspecified 3 past  	O	null
5 ל ל לאצ"ל preposition unspecified unspecified unspecified unspecified unspecified 0 
5 ה ה לאצ"ל definiteArticle unspecified unspecified unspecified unspecified unspecified 0 
5 האצ"ל האצ"ל לאצ"ל noun masculine singular absolute unspecified unspecified  	O	null
6 ו ו ועם conjunction unspecified unspecified unspecified unspecified unspecified 0 
6 עם עם ועם preposition unspecified unspecified unspecified unspecified unspecified  	O	null
7 פילוג פילוג פילוגו noun masculine singular absolute unspecified unspecified  
7 ו ו פילוגו possessive masculine singular unspecified 3 unspecified 0 	O	null
8 ב ב ב preposition unspecified unspecified unspecified unspecified unspecified 0 	I_ORG	null
9 - - - punctuation unspecified unspecified unspecified unspecified unspecified  	I_ORG	null
10 ###NUMBER### ###NUMBER### ###NUMBER### numeral unspecified unspecified unspecified unspecified unspecified  	I_DATE	null
11 נמנה נמנה נמנה verb masculine singular unspecified 3 past  	O	null
12 עם עם עם preposition unspecified unspecified unspecified unspecified unspecified  	O	null
13 גרעין גרעין גרעין noun masculine singular construct unspecified unspecified  	O	null
14 מייסדי מייסד מייסדי noun masculine plural construct unspecified unspecified  	O	null
15 ה ה הלח"י definiteArticle unspecified unspecified unspecified unspecified unspecified 0 
15 הלח"י לח"י הלח"י properName masculine singular unspecified unspecified unspecified  	I_LOC	null
16 . . . punctuation unspecified unspecified unspecified unspecified unspecified  	O	null

0 בשל בשל בשל preposition unspecified unspecified unspecified unspecified unspecified  	O	null
1 פעילות פעילות פעילותו noun feminine singular absolute unspecified unspecified  
1 ו ו פעילותו possessive masculine singular unspecified 3 unspecified 0 	O	null
2 ב ב במחתרת preposition unspecified unspecified unspecified unspecified unspecified 0 
2 ה ה במחתרת definiteArticle unspecified unspecified unspecified unspecified unspecified 0 
2 המחתרת מחתרת במחתרת noun feminine singular absolute unspecified unspecified  	O	null
3 נתפש נתפש נתפש verb masculine singular unspecified 3 past  	O	null
4 ו ו והוגלה conjunction unspecified unspecified unspecified unspecified unspecified 0 
4 הוגלה הוגלה והוגלה verb masculine singular unspecified 3 past  	O	null
5 על על על preposition unspecified unspecified unspecified unspecified unspecified  	O	null
6 ידי יד ידי noun feminine plural construct unspecified unspecified  	O	null
7 ה ה הבריטים definiteArticle unspecified unspecified unspecified unspecified unspecified 0 
7 הבריטים בריטי הבריטים noun masculine plural absolute unspecified unspecified  	O	null
8 ל ל למחנה preposition unspecified unspecified unspecified unspecified unspecified 0 
8 מחנה מחנה למחנה noun masculine singular construct unspecified unspecified  	O	null
9 מעצר מעצר מעצר noun masculine singular absolute unspecified unspecified  	O	null
10 ב ב בקניה preposition unspecified unspecified unspecified unspecified unspecified 0 
10 קניה קנייה בקניה properName unspecified unspecified unspecified unspecified unspecified  	I_LOC	null
11 . . . punctuation unspecified unspecified unspecified unspecified unspecified  	O	null

0 לאחר לאחר לאחר conjunction unspecified unspecified unspecified unspecified unspecified  	O	null
1 חזרת חזרה חזרתו noun feminine singular absolute unspecified unspecified  
1 ו ו חזרתו possessive masculine singular unspecified 3 unspecified 0 	O	null
2 ארצה ארצה ארצה adverb unspecified unspecified unspecified unspecified unspecified  	O	null
3 ב ב ביולי preposition unspecified unspecified unspecified unspecified unspecified 0 
3 יולי יולי ביולי properName unspecified unspecified unspecified unspecified unspecified  	I_DATE	null
4 ###NUMBER### ###NUMBER### ###NUMBER### numeral unspecified unspecified unspecified unspecified unspecified  	I_DATE	null
5 פעל פעל פעל verb masculine singular unspecified 3 past  	O	null
6 ב ב בארגון preposition unspecified unspecified unspecified unspecified unspecified 0 
6 ארגון ארגון בארגון noun masculine singular construct unspecified unspecified  	O	null
7 אגף אגף אגף noun masculine singular construct unspecified unspecified  	O	null
8 ה ה השמאל definiteArticle unspecified unspecified unspecified unspecified unspecified 0 
8 השמאל שמאל השמאל noun masculine singular absolute unspecified unspecified  	O	null
9 ה ה המרקסיסטי definiteArticle unspecified unspecified unspecified unspecified unspecified 0 
9 המרקסיסטי המרקסיסטי המרקסיסטי adjective masculine singular absolute unspecified unspecified  	O	null
10 של של של shel-preposition unspecified unspecified unspecified unspecified unspecified  	O	null
11 לח"י לח"י לח"י properName unspecified unspecified unspecified unspecified unspecified  	I_PERS	null
12 ו ו ועם conjunction unspecified unspecified unspecified unspecified unspecified 0 
12 עם עם ועם preposition unspecified unspecified unspecified unspecified unspecified  	O	null
13 התפוררות התפוררות התפוררותו noun feminine singular absolute unspecified unspecified  
13 ו ו התפוררותו possessive masculine singular unspecified 3 unspecified 0 	O	null
14 הצטרף הצטרף הצטרף verb masculine singular unspecified 3 past  	O	null
15 ל ל לחטיבה preposition unspecified unspecified unspecified unspecified unspecified 0 
15 ה ה לחטיבה definiteArticle unspecified unspecified unspecified unspecified unspecified 0 
15 החטיבה חטיבה לחטיבה noun feminine singular absolute unspecified unspecified  	O	null
16 ה ה הצעירה definiteArticle unspecified unspecified unspecified unspecified unspecified 0 
16 הצעירה צעיר הצעירה adjective feminine singular absolute unspecified unspecified  	O	null
17 של של של shel-preposition unspecified unspecified unspecified unspecified unspecified  	O	null
18 מפ"ם מפ"ם מפ"ם properName unspecified unspecified unspecified unspecified unspecified  	I_ORG	null
19 , , , punctuation unspecified unspecified unspecified unspecified unspecified  	O	null
20 ו ו ומאוחר conjunction unspecified unspecified unspecified unspecified unspecified 0 
20 מאוחר מאוחר ומאוחר adverb unspecified unspecified unspecified unspecified unspecified  	O	null
21 יותר יותר יותר adverb unspecified unspecified unspecified unspecified unspecified  	O	null
22 ל ל למק"י preposition unspecified unspecified unspecified unspecified unspecified 0 
22 מק"י מק"י למק"י properName unspecified unspecified unspecified unspecified unspecified  	I_ORG	null
23 . . . punctuation unspecified unspecified unspecified unspecified unspecified  	O	null

0 ב ב בשנים preposition unspecified unspecified unspecified unspecified unspecified 0 
0 שנים שנה בשנים noun feminine plural absolute unspecified unspecified  	O	null
1 ###NUMBER### ###NUMBER### ###NUMBER### numeral unspecified unspecified unspecified unspecified unspecified  	I_DATE	null
2 - - - punctuation unspecified unspecified unspecified unspecified unspecified  	O	null
3 ###NUMBER### ###NUMBER### ###NUMBER### numeral unspecified unspecified unspecified unspecified unspecified  	I_DATE	null
4 ערך ערך ערך verb masculine singular unspecified 3 past  	O	null
5 את את את at-preposition unspecified unspecified unspecified unspecified unspecified  	O	null
6 ה ה הדף definiteArticle unspecified unspecified unspecified unspecified unspecified 0 
6 הדף דף הדף noun masculine singular absolute unspecified unspecified  	O	null
7 ל ל לספרות preposition unspecified unspecified unspecified unspecified unspecified 0 
7 ספרות ספרות לספרות noun feminine singular absolute unspecified unspecified  	O	null
8 של של של shel-preposition unspecified unspecified unspecified unspecified unspecified  	O	null
9 ביטאון ביטאון ביטאון noun masculine singular construct unspecified unspecified  	O	null
10 מק"י מק"י מק"י properName masculine singular unspecified unspecified unspecified  	I_ORG	null
11 קול קול קול noun masculine singular construct unspecified unspecified  	O	null
12 ה ה העם definiteArticle unspecified unspecified unspecified unspecified unspecified 0 
12 העם עם העם noun masculine singular absolute unspecified unspecified  	O	null
13 . . . punctuation unspecified unspecified unspecified unspecified unspecified  	O	null

0 בעל בעל בעל noun masculine singular construct unspecified unspecified  	O	null
1 תואר תואר תואר noun masculine singular construct unspecified unspecified  	O	null
2 ראשון ORD1 ראשון numeral masculine singular absolute unspecified unspecified  	O	null
3 ) ) ) punctuation unspecified unspecified unspecified unspecified unspecified  	O	null
4 , , , punctuation unspecified unspecified unspecified unspecified unspecified  	O	null
5 ###NUMBER### ###NUMBER### ###NUMBER### numeral unspecified unspecified unspecified unspecified unspecified  	I_DATE	null
6 תואר תואר תואר noun masculine singular absolute unspecified unspecified  	O	null
7 מוסמך מוסמך מוסמך noun masculine singular absolute unspecified unspecified  	O	null
8 ( ( ( punctuation unspecified unspecified unspecified unspecified unspecified  	O	null
9 ###NUMBER### ###NUMBER### ###NUMBER### numeral unspecified unspecified unspecified unspecified unspecified  	I_DATE	null
10 ) ) ) punctuation unspecified unspecified unspecified unspecified unspecified  	O	null
11 ו ו ותואר conjunction unspecified unspecified unspecified unspecified unspecified 0 
11 תואר תואר ותואר noun masculine singular construct unspecified unspecified  	O	null
12 דוקטור דוקטור דוקטור noun masculine singular absolute unspecified unspecified  	O	null
13 ( ( ( punctuation unspecified unspecified unspecified unspecified unspecified  	O	null
14 ###NUMBER### ###NUMBER### ###NUMBER### numeral unspecified unspecified unspecified unspecified unspecified  	I_DATE	null
15 ) ) ) punctuation unspecified unspecified unspecified unspecified unspecified  	O	null
16 מ מ מהמחלקה preposition unspecified unspecified unspecified unspecified unspecified 0 
16 ה ה מהמחלקה definiteArticle unspecified unspecified unspecified unspecified unspecified 0 
16 המחלקה מחלקה מהמחלקה noun feminine singular absolute unspecified unspecified  	O	null
17 ל ל לספרות preposition unspecified unspecified unspecified unspecified unspecified 0 
17 ספרות ספרות לספרות noun feminine singular absolute unspecified unspecified  	O	null
18 עברית עברי עברית adjective feminine singular absolute unspecified unspecified  	O	null
19 ב ב באוניברסיטת preposition unspecified unspecified unspecified unspecified unspecified 0 
19 אוניברסיטת אוניברסיטה באוניברסיטת noun feminine singular construct unspecified unspecified  	I_ORG	null
20 תל תל תל properName unspecified unspecified unspecified unspecified unspecified  	I_ORG	null
21 אביב אביב אביב properName unspecified unspecified unspecified unspecified unspecified  	I_ORG	null
22 . . . punctuation unspecified unspecified unspecified unspecified unspecified  	O	null

0 נושאי נושא נושאי noun masculine plural construct unspecified unspecified  	O	null
1 עבודות עבודה עבודותיו noun feminine plural absolute unspecified unspecified  
1 ו ו עבודותיו possessive masculine singular unspecified 3 unspecified 0 	O	null
2 : : : punctuation unspecified unspecified unspecified unspecified unspecified  	O	null
3 תחנות תחנה תחנות noun feminine plural absolute unspecified unspecified  	O	null
4 ב ב באופני preposition unspecified unspecified unspecified unspecified unspecified 0 
4 אופני אופן באופני noun masculine plural construct unspecified unspecified  	O	null
5 ה ה ההתייחסות definiteArticle unspecified unspecified unspecified unspecified unspecified 0 
5 ההתייחסות התייחסות ההתייחסות noun feminine singular absolute unspecified unspecified  	O	null
6 ל ל לארץ preposition unspecified unspecified unspecified unspecified unspecified 0 
6 ארץ ארץ לארץ noun feminine singular construct unspecified unspecified  	I_LOC	null
7 ישראל ישראל ישראל properName unspecified unspecified unspecified unspecified unspecified  	I_LOC	null
8 ו ו ובתיאור conjunction unspecified unspecified unspecified unspecified unspecified 0 
8 ב ב ובתיאור preposition unspecified unspecified unspecified unspecified unspecified 0 
8 תיאור תיאור ובתיאור noun masculine singular construct unspecified unspecified  	O	null
9 ה ה הריאליה definiteArticle unspecified unspecified unspecified unspecified unspecified 0 
9 הריאליה הריאליה הריאליה noun feminine singular absolute unspecified unspecified  	O	null
10 של של שלה shel-preposition unspecified unspecified unspecified unspecified unspecified  
10 ה ה שלה pronomial feminine singular unspecified 3 unspecified 0 	O	null
11 ב ב בשירה preposition unspecified unspecified unspecified unspecified unspecified 0 
11 ה ה בשירה definiteArticle unspecified unspecified unspecified unspecified unspecified 0 
11 השירה שירה בשירה noun feminine singular absolute unspecified unspecified  	O	null
12 ה ה העברית definiteArticle unspecified unspecified unspecified unspecified unspecified 0 
12 העברית עברי העברית adjective feminine singular absolute unspecified unspecified  	O	null
13 ( ( ( punctuation unspecified unspecified unspecified unspecified unspecified  	O	null
14 ) ) ) punctuation unspecified unspecified unspecified unspecified unspecified  	O	null
15 ###NUMBER### ###NUMBER### ###NUMBER### numeral unspecified unspecified unspecified unspecified unspecified  	I_DATE	null
16 ו ו והספרות conjunction unspecified unspecified unspecified unspecified unspecified 0 
16 ה ה והספרות definiteArticle unspecified unspecified unspecified unspecified unspecified 0 
16 הספרות ספרות והספרות noun feminine singular absolute unspecified unspecified  	O	null
17 ה ה העברית definiteArticle unspecified unspecified unspecified unspecified unspecified 0 
17 העברית עברי העברית adjective feminine singular absolute unspecified unspecified  	O	null
18 ו ו ותנועת conjunction unspecified unspecified unspecified unspecified unspecified 0 
18 תנועת תנועה ותנועת noun feminine singular construct unspecified unspecified  	O	null
19 ה ה הפועלים definiteArticle unspecified unspecified unspecified unspecified unspecified 0 
19 הפועלים פועל הפועלים noun masculine plural absolute unspecified unspecified  	O	null
20 ה ה הארץ definiteArticle unspecified unspecified unspecified unspecified unspecified 0 
20 הארץ ארץ הארץ noun feminine singular absolute unspecified unspecified  	O	null
21 - - - punctuation unspecified unspecified unspecified unspecified unspecified  	O	null
22 ישראלית ישראלי ישראלית adjective feminine singular absolute unspecified unspecified  	O	null
23 ב ב בימי preposition unspecified unspecified unspecified unspecified unspecified 0 
23 ימי יום בימי noun masculine plural construct unspecified unspecified  	O	null
24 ה ה העלייה definiteArticle unspecified unspecified unspecified unspecified unspecified 0 
24 העלייה עלייה העלייה noun feminine singular absolute unspecified unspecified  	O	null
25 ה ה השלישית definiteArticle unspecified unspecified unspecified unspecified unspecified 0 
25 השלישית ORD3 השלישית numeral feminine singular absolute unspecified unspecified  	O	null
26 ) ) ) punctuation unspecified unspecified unspecified unspecified unspecified  	O	null
27 . . . punctuation unspecified unspecified unspecified unspecified unspecified  	O	null
28 ###NUMBER### ###NUMBER### ###NUMBER### numeral unspecified unspecified unspecified unspecified unspecified  	I_DATE	null
29 לימד לימד לימד verb masculine singular unspecified 3 past  	O	null
30 ספרות ספרות ספרות noun feminine singular absolute unspecified unspecified  	O	null
31 ב ב בסמינר preposition unspecified unspecified unspecified unspecified unspecified 0 
31 ה ה בסמינר definiteArticle unspecified unspecified unspecified unspecified unspecified 0 
31 הסמינר סמינר בסמינר noun masculine singular absolute unspecified unspecified  	O	null
32 לוינסקי לוינסקי לוינסקי properName unspecified unspecified unspecified unspecified unspecified  	I_PERS	null
33 , , , punctuation unspecified unspecified unspecified unspecified unspecified  	O	null
34 ב ב ב preposition unspecified unspecified unspecified unspecified unspecified 0 	I_ORG	null
35 " " " punctuation unspecified unspecified unspecified unspecified unspecified  	I_ORG	null
36 אורנים אורן אורנים properName unspecified unspecified unspecified unspecified unspecified  	I_ORG	null
37 " " " punctuation unspecified unspecified unspecified unspecified unspecified  	O	null
38 , , , punctuation unspecified unspecified unspecified unspecified unspecified  	O	null
39 ב ב באוניברסיטת preposition unspecified unspecified unspecified unspecified unspecified 0 
39 אוניברסיטת אוניברסיטה באוניברסיטת noun feminine singular construct unspecified unspecified  	I_ORG	null
40 בן בן בן properName unspecified unspecified unspecified unspecified unspecified  	I_PERS	null
41 - - - properName unspecified unspecified unspecified unspecified unspecified  	I_PERS	null
42 גוריון גוריון גוריון properName unspecified unspecified unspecified unspecified unspecified  	I_PERS	null
43 ב ב בנגב preposition unspecified unspecified unspecified unspecified unspecified 0 
43 ה ה בנגב definiteArticle unspecified unspecified unspecified unspecified unspecified 0 
43 הנגב נגב בנגב properName unspecified unspecified unspecified unspecified unspecified  	I_PERS	null
44 ו ו ובתיכון conjunction unspecified unspecified unspecified unspecified unspecified 0 
44 ב ב ובתיכון preposition unspecified unspecified unspecified unspecified unspecified 0 
44 תיכון תיכון ובתיכון noun masculine singular absolute unspecified unspecified  	O	null
45 ל ל לחינוך preposition unspecified unspecified unspecified unspecified unspecified 0 
45 חינוך חינוך לחינוך noun masculine singular absolute unspecified unspecified  	O	null
46 סביבתי סביבתי סביבתי adjective masculine singular absolute unspecified unspecified  	O	null
47 ב ב במדרשת preposition unspecified unspecified unspecified unspecified unspecified 0 
47 מדרשת מדרשה במדרשת noun feminine singular construct unspecified unspecified  	O	null
48 שדה שדה שדה properName unspecified unspecified unspecified unspecified unspecified  	I_PERS	null
49 בוקר בוקר בוקר noun masculine singular absolute unspecified unspecified  	O	null
50 . . . punctuation unspecified unspecified unspecified unspecified unspecified  	O	null

0 מ מ מ preposition unspecified unspecified unspecified unspecified unspecified 0 	O	null
1 - - - punctuation unspecified unspecified unspecified unspecified unspecified  	O	null
2 ###NUMBER### ###NUMBER### ###NUMBER### numeral unspecified unspecified unspecified unspecified unspecified  	I_DATE	null
3 שימש שימש שימש verb masculine singular unspecified 3 past  	O	null
4 כ כ כחוקר preposition unspecified unspecified unspecified unspecified unspecified 0 
4 חוקר חוקר כחוקר noun masculine singular absolute unspecified unspecified  	O	null
5 ב ב במרכז preposition unspecified unspecified unspecified unspecified unspecified 0 
5 מרכז מרכז במרכז noun masculine singular construct unspecified unspecified  	O	null
6 מורשת מורשה מורשת noun feminine singular construct unspecified unspecified  	O	null
7 בן בן בן properName unspecified unspecified unspecified unspecified unspecified  	I_LOC	null
8 - - - properName unspecified unspecified unspecified unspecified unspecified  	I_LOC	null
9 גוריון גוריון גוריון properName unspecified unspecified unspecified unspecified unspecified  	I_LOC	null
10 ב ב בשדה preposition unspecified unspecified unspecified unspecified unspecified 0 
10 שדה שדה בשדה properName unspecified unspecified unspecified unspecified unspecified  	I_LOC	null
11 בוקר בוקר בוקר noun masculine singular absolute unspecified unspecified  	O	null
12 . . . punctuation unspecified unspecified unspecified unspecified unspecified  	O	null

0 ב ב ב preposition unspecified unspecified unspecified unspecified unspecified 0 	O	null
1 - - - punctuation unspecified unspecified unspecified unspecified unspecified  	O	null
2 ###NUMBER### ###NUMBER### ###NUMBER### numeral unspecified unspecified unspecified unspecified unspecified  	I_DATE	null
3 ייסד ייסד ייסד verb masculine singular unspecified 3 past  	O	null
4 את את את at-preposition unspecified unspecified unspecified unspecified unspecified  	O	null
5 כתב כתב כתב noun masculine singular construct unspecified unspecified  	O	null
6 ה ה העת definiteArticle unspecified unspecified unspecified unspecified unspecified 0 
6 העת עת העת noun feminine singular absolute unspecified unspecified  	O	null
7 עיונים עיון עיונים noun masculine plural absolute unspecified unspecified  	O	null
8 ב ב בתקומת preposition unspecified unspecified unspecified unspecified unspecified 0 
8 תקומת תקומה בתקומת noun feminine singular construct unspecified unspecified  	O	null
9 ישראל ישראל ישראל properName unspecified unspecified unspecified unspecified unspecified  	I_LOC	null
10 שערך שערך שערך verb masculine singular unspecified 3 past  	O	null
11 עד עד עד preposition unspecified unspecified unspecified unspecified unspecified  	O	null
12 ###NUMBER### ###NUMBER### ###NUMBER### numeral unspecified unspecified unspecified unspecified unspecified  	I_DATE	null
13 . . . punctuation unspecified unspecified unspecified unspecified unspecified  	O	null

0 מ מ משנות preposition unspecified unspecified unspecified unspecified unspecified 0 
0 שנות שנה משנות noun feminine plural construct unspecified unspecified  	I_DATE	null
1 ה ה השישים definiteArticle unspecified unspecified unspecified unspecified unspecified 0 
1 השישים ORD-CARD60 השישים numeral masculine-and-feminine plural absolute unspecified unspecified  	I_DATE	null
2 של של של shel-preposition unspecified unspecified unspecified unspecified unspecified  	O	null
3 ה ה המאה definiteArticle unspecified unspecified unspecified unspecified unspecified 0 
3 המאה ORD-CARD100 המאה numeral feminine plural absolute unspecified unspecified  	I_DATE	null
4 ה ה העשרים definiteArticle unspecified unspecified unspecified unspecified unspecified 0 
4 העשרים ORD-CARD20 העשרים numeral masculine-and-feminine plural absolute unspecified unspecified  	I_DATE	null
5 פירסם פרסם פירסם verb masculine singular unspecified 3 past  	O	null
6 גינוסר גינוסר גינוסר properName unspecified unspecified unspecified unspecified unspecified  	I_PERS	null
7 רשימות רשימה רשימות noun feminine plural absolute unspecified unspecified  	O	null
8 ו ו וביקורות conjunction unspecified unspecified unspecified unspecified unspecified 0 
8 ביקורות ביקורת וביקורות noun feminine plural absolute unspecified unspecified  	O	null
9 ספרות ספרות ספרות noun feminine singular absolute unspecified unspecified  	O	null
10 ב ב בקול preposition unspecified unspecified unspecified unspecified unspecified 0 
10 קול קול בקול noun masculine singular construct unspecified unspecified  	O	null
11 ה ה העם definiteArticle unspecified unspecified unspecified unspecified unspecified 0 
11 העם עם העם noun masculine singular absolute unspecified unspecified  	O	null
12 , , , punctuation unspecified unspecified unspecified unspecified unspecified  	O	null
13 עמדה עמדה עמדה noun feminine singular absolute unspecified unspecified  	O	null
14 , , , punctuation unspecified unspecified unspecified unspecified unspecified  	O	null
15 מאזניים מאזניים מאזניים noun masculine plural absolute unspecified unspecified  	O	null
16 , , , punctuation unspecified unspecified unspecified unspecified unspecified  	O	null
17 עתון עיתון עתון noun masculine singular absolute unspecified unspecified  	O	null
18 , , , punctuation unspecified unspecified unspecified unspecified unspecified  	O	null
19 ###NUMBER### ###NUMBER### ###NUMBER### numeral unspecified unspecified unspecified unspecified unspecified  	O	null
20 ה ה הארץ definiteArticle unspecified unspecified unspecified unspecified unspecified 0 
20 הארץ ארץ הארץ noun feminine singular absolute unspecified unspecified  	O	null
21 , , , punctuation unspecified unspecified unspecified unspecified unspecified  	O	null
22 קתדרהועוד קתדרהועוד קתדרהועוד properName unspecified unspecified unspecified unspecified unspecified  	I_PERS	null
23 . . . punctuation unspecified unspecified unspecified unspecified unspecified  	O	null

0 הביא הביא הביא verb masculine singular unspecified 3 past  	O	null
1 ל ל לדפוס preposition unspecified unspecified unspecified unspecified unspecified 0 
1 ה ה לדפוס definiteArticle unspecified unspecified unspecified unspecified unspecified 0 
1 הדפוס דפוס לדפוס noun masculine singular absolute unspecified unspecified  	O	null
2 את את את at-preposition unspecified unspecified unspecified unspecified unspecified  	O	null
3 פרוטוקול פרוטוקול פרוטוקול noun masculine singular construct unspecified unspecified  	O	null
4 ה ה הוועידה definiteArticle unspecified unspecified unspecified unspecified unspecified 0 
4 הוועידה ועידה הוועידה noun feminine singular absolute unspecified unspecified  	O	null
5 ה ה הארצית definiteArticle unspecified unspecified unspecified unspecified unspecified 0 
5 הארצית ארצי הארצית adjective feminine singular absolute unspecified unspecified  	O	null
6 של של של shel-preposition unspecified unspecified unspecified unspecified unspecified  	O	null
7 לח"י לח"י לח"י properName masculine singular unspecified unspecified unspecified  	I_PERS	null
8 לוחמי לוחם לוחמי noun masculine plural construct unspecified unspecified  	O	null
9 חרות חרות חרות adjective masculine singular absolute unspecified unspecified  	O	null
10 ישראל ישראל ישראל properName unspecified unspecified unspecified unspecified unspecified  	I_LOC	null
11 . . . punctuation unspecified unspecified unspecified unspecified unspecified  	O	null

0 ועידה ועידה ועידה noun feminine singular absolute unspecified unspecified  	O	null
1 ) ) ) punctuation unspecified unspecified unspecified unspecified unspecified  	O	null
2 , , , punctuation unspecified unspecified unspecified unspecified unspecified  	O	null
3 ###NUMBER### ###NUMBER### ###NUMBER### numeral unspecified unspecified unspecified unspecified unspecified  	I_DATE	null
4 ערך ערך ערך noun masculine singular absolute unspecified unspecified  	O	null
5 את את את at-preposition unspecified unspecified unspecified unspecified unspecified  	O	null
6 קובץ קובץ קובץ noun masculine singular construct unspecified unspecified  	O	null
7 ה ה המאמרים definiteArticle unspecified unspecified unspecified unspecified unspecified 0 
7 המאמרים מאמר המאמרים noun masculine plural absolute unspecified unspecified  	O	null
8 ה ה הספרות definiteArticle unspecified unspecified unspecified unspecified unspecified 0 
8 הספרות ספרות הספרות noun feminine singular absolute unspecified unspecified  	O	null
9 ה ה העברית definiteArticle unspecified unspecified unspecified unspecified unspecified 0 
9 העברית עברי העברית adjective feminine singular absolute unspecified unspecified  	O	null
10 ו ו ותנועת conjunction unspecified unspecified unspecified unspecified unspecified 0 
10 תנועת תנועה ותנועת noun feminine singular construct unspecified unspecified  	O	null
11 ה ה העבודה definiteArticle unspecified unspecified unspecified unspecified unspecified 0 
11 העבודה עבודה העבודה properName unspecified unspecified unspecified unspecified unspecified  	I_ORG	null
12 ) ) ) punctuation unspecified unspecified unspecified unspecified unspecified  	O	null
13 , , , punctuation unspecified unspecified unspecified unspecified unspecified  	O	null
14 ###NUMBER### ###NUMBER### ###NUMBER### numeral unspecified unspecified unspecified unspecified unspecified  	I_DATE	null
15 השתתף השתתף השתתף verb masculine singular unspecified 3 past  	O	null
16 ב ב בעריכת preposition unspecified unspecified unspecified unspecified unspecified 0 
16 עריכת עריכה בעריכת noun feminine singular construct unspecified unspecified  	O	null
17 כתבי כתב כתביו noun masculine plural absolute unspecified unspecified  
17 ו ו כתביו possessive masculine singular unspecified 3 unspecified 0 	O	null
18 של של של shel-preposition unspecified unspecified unspecified unspecified unspecified  	O	null
19 משה משה משה properName unspecified unspecified unspecified unspecified unspecified  	I_PERS	null
20 סנה סנה סנה properName unspecified unspecified unspecified unspecified unspecified  	I_PERS	null
21 ) ) ) punctuation unspecified unspecified unspecified unspecified unspecified  	O	null
22 , , , punctuation unspecified unspecified unspecified unspecified unspecified  	O	null
23 ###NUMBER### ###NUMBER### ###NUMBER### numeral unspecified unspecified unspecified unspecified unspecified  	I_DATE	null
24 ו ו ובשיתוף conjunction unspecified unspecified unspecified unspecified unspecified 0 
24 ב ב ובשיתוף preposition unspecified unspecified unspecified unspecified unspecified 0 
24 שיתוף שיתוף ובשיתוף noun masculine singular construct unspecified unspecified  	O	null
25 עם עם עם noun masculine singular construct unspecified unspecified  	O	null
26 אבי אבי אבי properName unspecified unspecified unspecified unspecified unspecified  	I_PERS	null
27 בראלי בראלי בראלי properName unspecified unspecified unspecified unspecified unspecified  	I_PERS	null
28 ערך ערך ערך verb masculine singular unspecified 3 past  	O	null
29 את את את at-preposition unspecified unspecified unspecified unspecified unspecified  	O	null
30 קובצי קבץ קובצי participle masculine plural construct any unspecified  	O	null
31 ה ה המאמרים definiteArticle unspecified unspecified unspecified unspecified unspecified 0 
31 המאמרים מאמר המאמרים noun masculine plural absolute unspecified unspecified  	O	null
32 ציונות ציונות ציונות noun feminine singular absolute unspecified unspecified  	O	null
33 : : : punctuation unspecified unspecified unspecified unspecified unspecified  	O	null
34 פולמוס פולמוס פולמוס noun masculine singular construct unspecified unspecified  	O	null
35 בן בן בן noun masculine singular construct unspecified unspecified  	O	null
36 זמן זמן זמננו noun masculine singular absolute unspecified unspecified  
36 נו נו זמננו possessive masculine-and-feminine plural unspecified 1 unspecified 0 	O	null
37 ( ( ( punctuation unspecified unspecified unspecified unspecified unspecified  	O	null
38 ###NUMBER### ###NUMBER### ###NUMBER### numeral unspecified unspecified unspecified unspecified unspecified  	I_DATE	null
39 ) ) ) punctuation unspecified unspecified unspecified unspecified unspecified  	O	null
40 ו ו ואיש conjunction unspecified unspecified unspecified unspecified unspecified 0 
40 איש איש ואיש noun masculine singular absolute unspecified unspecified  	O	null
41 ב ב בסער preposition unspecified unspecified unspecified unspecified unspecified 0 
41 סער סער בסער properName unspecified unspecified unspecified unspecified unspecified  	I_PERS	null
42 : : : punctuation unspecified unspecified unspecified unspecified unspecified  	O	null
43 מחקרים מחקר מחקרים noun masculine plural absolute unspecified unspecified  	O	null
44 ו ו ומסות conjunction unspecified unspecified unspecified unspecified unspecified 0 
44 מסות מסה ומסות noun feminine plural absolute unspecified unspecified  	O	null
45 על על על preposition unspecified unspecified unspecified unspecified unspecified  	O	null
46 זאב זאב זאב properName unspecified unspecified unspecified unspecified unspecified  	I_PERS	null
47 ז'בוטינסקי ז'בוטינסקי ז'בוטינסקי properName unspecified unspecified unspecified unspecified unspecified  	I_PERS	null
48 ) ) ) punctuation unspecified unspecified unspecified unspecified unspecified  	O	null
49 . . . punctuation unspecified unspecified unspecified unspecified unspecified  	O	null
50 ###NUMBER### ###NUMBER### ###NUMBER### numeral unspecified unspecified unspecified unspecified unspecified  	I_DATE	null
51 מחקרי מחקר מחקריו noun masculine plural absolute unspecified unspecified  
51 ו ו מחקריו possessive masculine singular unspecified 3 unspecified 0 	O	null
52 ה ה העצמאיים definiteArticle unspecified unspecified unspecified unspecified unspecified 0 
52 העצמאיים עצמאי העצמאיים adjective masculine plural absolute unspecified unspecified  	O	null
53 עוסקים עסק עוסקים verb masculine plural unspecified any beinoni  	O	null
54 ב ב בתולדות preposition unspecified unspecified unspecified unspecified unspecified 0 
54 תולדות תולדה בתולדות noun feminine plural construct unspecified unspecified  	O	null
55 ה ה הציונות definiteArticle unspecified unspecified unspecified unspecified unspecified 0 
55 הציונות ציונות הציונות noun feminine singular absolute unspecified unspecified  	I_ORG	null
56 , , , punctuation unspecified unspecified unspecified unspecified unspecified  	O	null
57 תולדות תולדה תולדות noun feminine plural construct unspecified unspecified  	O	null
58 ה ה הספרות definiteArticle unspecified unspecified unspecified unspecified unspecified 0 
58 הספרות ספרות הספרות noun feminine singular absolute unspecified unspecified  	O	null
59 של של של shel-preposition unspecified unspecified unspecified unspecified unspecified  	O	null
60 ה ה העלייה definiteArticle unspecified unspecified unspecified unspecified unspecified 0 
60 העלייה עלייה העלייה noun feminine singular absolute unspecified unspecified  	O	null
61 ה ה השנייה definiteArticle unspecified unspecified unspecified unspecified unspecified 0 
61 השנייה ORD2 השנייה numeral feminine singular absolute unspecified unspecified  	O	null
62 , , , punctuation unspecified unspecified unspecified unspecified unspecified  	O	null
63 ה ה השלישית definiteArticle unspecified unspecified unspecified unspecified unspecified 0 
63 השלישית ORD3 השלישית numeral feminine singular absolute unspecified unspecified  	O	null
64 ו ו והרביעית conjunction unspecified unspecified unspecified unspecified unspecified 0 
64 ה ה והרביעית definiteArticle unspecified unspecified unspecified unspecified unspecified 0 
64 הרביעית ORD4 והרביעית numeral feminine singular absolute unspecified unspecified  	O	null
65 , , , punctuation unspecified unspecified unspecified unspecified unspecified  	O	null
66 ו ו ותולדות conjunction unspecified unspecified unspecified unspecified unspecified 0 
66 תולדות תולדה ותולדות noun feminine plural construct unspecified unspecified  	O	null
67 ה ה העיתונות definiteArticle unspecified unspecified unspecified unspecified unspecified 0 
67 העיתונות עיתונות העיתונות noun feminine singular absolute unspecified unspecified  	O	null
68 מ מ מתקופת preposition unspecified unspecified unspecified unspecified unspecified 0 
68 תקופת תקופה מתקופת noun feminine singular construct unspecified unspecified  	O	null
69 ה ה היישוב definiteArticle unspecified unspecified unspecified unspecified unspecified 0 
69 היישוב יישוב היישוב noun masculine singular absolute unspecified unspecified  	O	null
70 . . . punctuation unspecified unspecified unspecified unspecified unspecified  	O	null

0 נמנה נמנה נמנה verb masculine singular unspecified 3 past  	O	null
1 עם עם עם preposition unspecified unspecified unspecified unspecified unspecified  	O	null
2 ראשוני ראשונים ראשוני noun masculine plural construct unspecified unspecified  	O	null
3 חוקרי חוקר חוקרי noun masculine plural construct unspecified unspecified  	O	null
4 שירת שירה שירתם noun feminine singular absolute unspecified unspecified  
4 ם ם שירתם possessive masculine plural unspecified 3 unspecified 0 	O	null
5 של של של shel-preposition unspecified unspecified unspecified unspecified unspecified  	O	null
6 אצ"ג אצ"ג אצ"ג properName unspecified unspecified unspecified unspecified unspecified  	I_PERS	null
7 ו ו ואלכסנדר conjunction unspecified unspecified unspecified unspecified unspecified 0 
7 אלכסנדר אלכסנדר ואלכסנדר properName unspecified unspecified unspecified unspecified unspecified  	I_PERS	null
8 פן פן פן noun masculine singular absolute unspecified unspecified  	O	null
9 . . . punctuation unspecified unspecified unspecified unspecified unspecified  	O	null

0 אבן אבן אבן properName unspecified unspecified unspecified unspecified unspecified  	I_PERS	null
1 , , , punctuation unspecified unspecified unspecified unspecified unspecified  	O	null
2 אפרים אפרים אפרים properName unspecified unspecified unspecified unspecified unspecified  	I_PERS	null
3 . . . punctuation unspecified unspecified unspecified unspecified unspecified  	O	null

0 " " " punctuation unspecified unspecified unspecified unspecified unspecified  	O	null
1 ניסיון ניסיון ניסיון noun masculine singular absolute unspecified unspecified  	O	null
2 פוליטי פוליטי פוליטי adjective masculine singular absolute unspecified unspecified  	O	null
3 מסוים מסוים מסוים adjective masculine singular absolute unspecified unspecified  	O	null
4 " " " punctuation unspecified unspecified unspecified unspecified unspecified  	O	null
5 . . . punctuation unspecified unspecified unspecified unspecified unspecified  	O	null

0 ב ב בארץ preposition unspecified unspecified unspecified unspecified unspecified 0 
0 ארץ ארץ בארץ noun feminine singular construct unspecified unspecified  	I_LOC	null
1 ישראל ישראל ישראל properName unspecified unspecified unspecified unspecified unspecified  	I_LOC	null
2 : : : punctuation unspecified unspecified unspecified unspecified unspecified  	O	null
3 מדיניות מדיניות מדיניות noun feminine singular absolute unspecified unspecified  	O	null
4 , , , punctuation unspecified unspecified unspecified unspecified unspecified  	O	null
5 חברה חבר חברה noun feminine singular absolute unspecified unspecified  	O	null
6 כלכלה כלכלה כלכלה noun feminine singular absolute unspecified unspecified  	O	null
7 . . . punctuation unspecified unspecified unspecified unspecified unspecified  	O	null

0 יוני יוני יוני properName unspecified unspecified unspecified unspecified unspecified  	I_DATE	null
1 ###NUMBER### ###NUMBER### ###NUMBER### numeral unspecified unspecified unspecified unspecified unspecified  	I_DATE	null
2 ; ; ; punctuation unspecified unspecified unspecified unspecified unspecified  	O	null
3 זיו זיו זיו properName unspecified unspecified unspecified unspecified unspecified  	I_PERS	null
4 , , , punctuation unspecified unspecified unspecified unspecified unspecified  	O	null
5 יוסי יוסי יוסי properName unspecified unspecified unspecified unspecified unspecified  	I_PERS	null
6 . . . punctuation unspecified unspecified unspecified unspecified unspecified  	O	null

0 " " " punctuation unspecified unspecified unspecified unspecified unspecified  	O	null
1 אופציות אופציה אופציות noun feminine plural absolute unspecified unspecified  	O	null
2 של של של shel-preposition unspecified unspecified unspecified unspecified unspecified  	O	null
3 זהות זהות זהות noun feminine singular construct unspecified unspecified  	O	null
4 " " " punctuation unspecified unspecified unspecified unspecified unspecified  	O	null
5 . . . punctuation unspecified unspecified unspecified unspecified unspecified  	O	null
6 על על על preposition unspecified unspecified unspecified unspecified unspecified  	O	null
7 ה ה המשמר definiteArticle unspecified unspecified unspecified unspecified unspecified 0 
7 המשמר משמר המשמר noun masculine singular absolute unspecified unspecified  	O	null
8 . . . punctuation unspecified unspecified unspecified unspecified unspecified  	O	null

0 . . . punctuation unspecified unspecified unspecified unspecified unspecified  	O	null
1 ###NUMEXP### ###NUMEXP### ###NUMEXP### numberExpression unspecified unspecified unspecified unspecified unspecified  	I_DATE	null
2 ###NUMBER### ###NUMBER### ###NUMBER### numeral unspecified unspecified unspecified unspecified unspecified  	I_LOC	null
3 . . . punctuation unspecified unspecified unspecified unspecified unspecified  	O	null

0 ‬ ‬ ‬ punctuation unspecified unspecified unspecified unspecified unspecified  	O	null
1 ‬ ‬ ‬ punctuation unspecified unspecified unspecified unspecified unspecified  	O	null
2 ‬ ‬ ‬ punctuation unspecified unspecified unspecified unspecified unspecified  	O	null
3 ‬ ‬ ‬ punctuation unspecified unspecified unspecified unspecified unspecified  	O	null
4 ‬ ‬ ‬ punctuation unspecified unspecified unspecified unspecified unspecified  	O	null
5 ‬ ‬ ‬ punctuation unspecified unspecified unspecified unspecified unspecified  	O	null
6 ‬ ‬ ‬ punctuation unspecified unspecified unspecified unspecified unspecified  	O	null
7 ‬ ‬ ‬ punctuation unspecified unspecified unspecified unspecified unspecified  	O	null
8 ‬ ‬ ‬ punctuation unspecified unspecified unspecified unspecified unspecified  	O	null
9 ‬ ‬ ‬ punctuation unspecified unspecified unspecified unspecified unspecified  	O	null
10 ‬ ‬ ‬ punctuation unspecified unspecified unspecified unspecified unspecified  	O	null
11 ‬ ‬ ‬ punctuation unspecified unspecified unspecified unspecified unspecified  	O	null
12 ‬ ‬ ‬ punctuation unspecified unspecified unspecified unspecified unspecified  	O	null
13 ‬ ‬ ‬ punctuation unspecified unspecified unspecified unspecified unspecified  	O	null
14 ‬ ‬ ‬ punctuation unspecified unspecified unspecified unspecified unspecified  	O	null
15 ‬ ‬ ‬ punctuation unspecified unspecified unspecified unspecified unspecified  	O	null
16 ‬ ‬ ‬ punctuation unspecified unspecified unspecified unspecified unspecified  	O	null
17 ‬ ‬ ‬ punctuation unspecified unspecified unspecified unspecified unspecified  	O	null
18 ‬ ‬ ‬ punctuation unspecified unspecified unspecified unspecified unspecified  	O	null
19 ‬ ‬ ‬ punctuation unspecified unspecified unspecified unspecified unspecified  	O	null
20 ‬ ‬ ‬ punctuation unspecified unspecified unspecified unspecified unspecified  	O	null
21 ‬ ‬ ‬ punctuation unspecified unspecified unspecified unspecified unspecified  	O	null
22 ‬ ‬ ‬ punctuation unspecified unspecified unspecified unspecified unspecified  	O	null
23 ‬ ‬ ‬ punctuation unspecified unspecified unspecified unspecified unspecified  	O	null
24 ‬ ‬ ‬ punctuation unspecified unspecified unspecified unspecified unspecified  	O	null
25 ‬ ‬ ‬ punctuation unspecified unspecified unspecified unspecified unspecified  	O	null
26 ‬ ‬ ‬ punctuation unspecified unspecified unspecified unspecified unspecified  	O	null
27 ‬ ‬ ‬ punctuation unspecified unspecified unspecified unspecified unspecified  	O	null
28 ‬ ‬ ‬ punctuation unspecified unspecified unspecified unspecified unspecified  	O	null
29 ‬ ‬ ‬ punctuation unspecified unspecified unspecified unspecified unspecified  	O	null
30 ‬ ‬ ‬ punctuation unspecified unspecified unspecified unspecified unspecified  	O	null
31 ‬ ‬ ‬ punctuation unspecified unspecified unspecified unspecified unspecified  	O	null
32 ‬ ‬ ‬ punctuation unspecified unspecified unspecified unspecified unspecified  	O	null
33 סבטלנה סבטלנה סבטלנה properName unspecified unspecified unspecified unspecified unspecified  	I_PERS	null
34 נטקוביץ' נטקוביץ' נטקוביץ' properName unspecified unspecified unspecified unspecified unspecified  	I_PERS	null
35 ‬ ‬ ‬ punctuation unspecified unspecified unspecified unspecified unspecified  	O	null
36 ‬ ‬ ‬ punctuation unspecified unspecified unspecified unspecified unspecified  	O	null
37 ‬ ‬ ‬ punctuation unspecified unspecified unspecified unspecified unspecified  	O	null
38 ‬ ‬ ‬ punctuation unspecified unspecified unspecified unspecified unspecified  	O	null
39 ‬ ‬ ‬ punctuation unspecified unspecified unspecified unspecified unspecified  	O	null
40 ‬ ‬ ‬ punctuation unspecified unspecified unspecified unspecified unspecified  	O	null
41 ‬ ‬ ‬ punctuation unspecified unspecified unspecified unspecified unspecified  	O	null
42 ‬ ‬ ‬ punctuation unspecified unspecified unspecified unspecified unspecified  	O	null
43 ‬ ‬ ‬ punctuation unspecified unspecified unspecified unspecified unspecified  	O	null
44 ‬ ‬ ‬ punctuation unspecified unspecified unspecified unspecified unspecified  	O	null
45 ‬ ‬ ‬ punctuation unspecified unspecified unspecified unspecified unspecified  	O	null
46 ‬ ‬ ‬ punctuation unspecified unspecified unspecified unspecified unspecified  	O	null
47 ‬ ‬ ‬ punctuation unspecified unspecified unspecified unspecified unspecified  	O	null
48 ‬ ‬ ‬ punctuation unspecified unspecified unspecified unspecified unspecified  	O	null
49 ‬ ‬ ‬ punctuation unspecified unspecified unspecified unspecified unspecified  	O	null
50 ‬ ‬ ‬ punctuation unspecified unspecified unspecified unspecified unspecified  	O	null
51 ‬ ‬ ‬ punctuation unspecified unspecified unspecified unspecified unspecified  	O	null
52 ‬ ‬ ‬ punctuation unspecified unspecified unspecified unspecified unspecified  	O	null
53 ‬ ‬ ‬ punctuation unspecified unspecified unspecified unspecified unspecified  	O	null
54 ‬ ‬ ‬ punctuation unspecified unspecified unspecified unspecified unspecified  	O	null
55 ‬ ‬ ‬ punctuation unspecified unspecified unspecified unspecified unspecified  	O	null
56 ‬ ‬ ‬ punctuation unspecified unspecified unspecified unspecified unspecified  	O	null
57 ‬ ‬ ‬ punctuation unspecified unspecified unspecified unspecified unspecified  	O	null
58 ‬ ‬ ‬ punctuation unspecified unspecified unspecified unspecified unspecified  	O	null
59 ‬ ‬ ‬ punctuation unspecified unspecified unspecified unspecified unspecified  	O	null
60 ‬ ‬ ‬ punctuation unspecified unspecified unspecified unspecified unspecified  	O	null
61 גיסיס גיסיס גיסיס properName unspecified unspecified unspecified unspecified unspecified  	I_PERS	null
62 , , , punctuation unspecified unspecified unspecified unspecified unspecified  	O	null
63 סנאית סנאית סנאית properName unspecified unspecified unspecified unspecified unspecified  	I_PERS	null
64 ( ( ( punctuation unspecified unspecified unspecified unspecified unspecified  	O	null
65 ###NUMBER### ###NUMBER### ###NUMBER### numeral unspecified unspecified unspecified unspecified unspecified  	I_DATE	null
66 ) ) ) punctuation unspecified unspecified unspecified unspecified unspecified  	O	null
67 פירסמה פרסם פירסמה verb feminine singular unspecified 3 past  	O	null
68 ספר ספר ספר noun masculine singular construct unspecified unspecified  	O	null
69 פרוזה פרוזה פרוזה noun feminine singular absolute unspecified unspecified  	O	null
70 אחד CARD1 אחד numeral masculine singular construct unspecified unspecified  	O	null
71 ב ב ב preposition unspecified unspecified unspecified unspecified unspecified 0 	O	null
72 - - - punctuation unspecified unspecified unspecified unspecified unspecified  	O	null
73 , , , punctuation unspecified unspecified unspecified unspecified unspecified  	O	null
74 ###NUMBER### ###NUMBER### ###NUMBER### numeral unspecified unspecified unspecified unspecified unspecified  	I_DATE	null
75 לחיות חיה לחיות verb unspecified unspecified unspecified unspecified infinitive  	O	null
76 את את איתו at-preposition unspecified unspecified unspecified unspecified unspecified  
76 ו ו איתו pronomial masculine singular unspecified 3 unspecified 0 	O	null
77 כל כול כל quantifier unspecified unspecified construct unspecified unspecified  	O	null
78 חיי חיה חיי verb feminine singular unspecified 2 imperative  	O	null
79 , , , punctuation unspecified unspecified unspecified unspecified unspecified  	O	null
80 שנתיים שנה שנתיים noun feminine dual absolute unspecified unspecified  	O	null
81 ו ו וחצי conjunction unspecified unspecified unspecified unspecified unspecified 0 
81 חצי חצי וחצי numeral masculine singular construct unspecified unspecified  	O	null
82 אחרי אחרי אחרי preposition unspecified unspecified unspecified unspecified unspecified  	O	null
83 ש ש שזכתה relativizer/subordinatingConjunction unspecified unspecified unspecified unspecified unspecified 0 
83 זכתה זכה שזכתה verb feminine singular unspecified 3 past  	O	null
84 ב ב בתחרות preposition unspecified unspecified unspecified unspecified unspecified 0 
84 תחרות תחרות בתחרות noun feminine singular construct unspecified unspecified  	O	null
85 ה ה הסיפור definiteArticle unspecified unspecified unspecified unspecified unspecified 0 
85 הסיפור סיפור הסיפור noun masculine singular absolute unspecified unspecified  	O	null
86 ה ה הקצר definiteArticle unspecified unspecified unspecified unspecified unspecified 0 
86 הקצר קצר הקצר noun masculine singular absolute unspecified unspecified  	O	null
87 של של של shel-preposition unspecified unspecified unspecified unspecified unspecified  	O	null
88 הארץ ארץ הארץ properName unspecified unspecified unspecified unspecified unspecified  	I_LOC	null
89 . . . punctuation unspecified unspecified unspecified unspecified unspecified  	O	null

0 ה ה הספר definiteArticle unspecified unspecified unspecified unspecified unspecified 0 
0 הספר ספר הספר noun masculine singular absolute unspecified unspecified  	O	null
1 יצא יצא יצא verb masculine singular unspecified 3 past  	O	null
2 ב ב בהוצאת preposition unspecified unspecified unspecified unspecified unspecified 0 
2 הוצאת הוצאה בהוצאת noun feminine singular construct unspecified unspecified  	O	null
3 עם עם עם noun masculine singular construct unspecified unspecified  	O	null
4 עובד עובד עובד properName unspecified unspecified unspecified unspecified unspecified  	I_PERS	null
5 , , , punctuation unspecified unspecified unspecified unspecified unspecified  	O	null
6 ב ב בסדרה preposition unspecified unspecified unspecified unspecified unspecified 0 
6 סדרה סדרה בסדרה noun feminine singular absolute unspecified unspecified  	O	null
7 " " " punctuation unspecified unspecified unspecified unspecified unspecified  	O	null
8 פרוזה פרוזה פרוזה noun feminine singular absolute unspecified unspecified  	O	null
9 אחרת אחר אחרת adjective feminine singular absolute unspecified unspecified  	O	null
10 " " " punctuation unspecified unspecified unspecified unspecified unspecified  	O	null
11 ב ב בעריכתה preposition unspecified unspecified unspecified unspecified unspecified 0 
11 עריכת עריכה בעריכתה noun feminine singular absolute unspecified unspecified  
11 ה ה בעריכתה possessive feminine singular unspecified 3 unspecified 0 	O	null
12 של של של shel-preposition unspecified unspecified unspecified unspecified unspecified  	O	null
13 אילנה אילנה אילנה properName unspecified unspecified unspecified unspecified unspecified  	I_PERS	null
14 המרמן המרמן המרמן properName unspecified unspecified unspecified unspecified unspecified  	I_PERS	null
15 . . . punctuation unspecified unspecified unspecified unspecified unspecified  	O	null

0 לחיות חי לחיות verb unspecified unspecified unspecified unspecified infinitive  	O	null
1 את את איתו at-preposition unspecified unspecified unspecified unspecified unspecified  
1 ו ו איתו pronomial masculine singular unspecified 3 unspecified 0 	O	null
2 כל כול כל quantifier unspecified unspecified construct unspecified unspecified  	O	null
3 חיי חיים חיי noun masculine plural construct unspecified unspecified  	O	null
4 הוא הוא הוא pronoun masculine singular unspecified 3 unspecified  	O	null
5 קובץ קובץ קובץ noun masculine singular construct unspecified unspecified  	O	null
6 סיפורים סיפור סיפורים noun masculine plural absolute unspecified unspecified  	O	null
7 קצרים קצר קצרים adjective masculine plural absolute unspecified unspecified  	O	null
8 ו ו וקצרצרים conjunction unspecified unspecified unspecified unspecified unspecified 0 
8 קצרצרים קצרצרים וקצרצרים adjective masculine plural absolute unspecified unspecified  	O	null
9 ש ש שבולטת relativizer/subordinatingConjunction unspecified unspecified unspecified unspecified unspecified 0 
9 בולטת בלט שבולטת verb feminine singular unspecified any beinoni  	O	null
10 ב ב בהם preposition unspecified unspecified unspecified unspecified unspecified  
10 הם הם בהם pronomial masculine plural unspecified 3 unspecified 0 	O	null
11 ה ה הנימה definiteArticle unspecified unspecified unspecified unspecified unspecified 0 
11 הנימה נימה הנימה noun feminine singular absolute unspecified unspecified  	O	null
12 ה ה הפיוטית definiteArticle unspecified unspecified unspecified unspecified unspecified 0 
12 הפיוטית פיוטי הפיוטית adjective feminine singular absolute unspecified unspecified  	O	null
13 ו ו והתודעה conjunction unspecified unspecified unspecified unspecified unspecified 0 
13 ה ה והתודעה definiteArticle unspecified unspecified unspecified unspecified unspecified 0 
13 התודעה תודעה והתודעה noun feminine singular absolute unspecified unspecified  	O	null
14 ה ה המורכבת definiteArticle unspecified unspecified unspecified unspecified unspecified 0 
14 המורכבת מורכב המורכבת adjective feminine singular absolute unspecified unspecified  	O	null
15 , , , punctuation unspecified unspecified unspecified unspecified unspecified  	O	null
16 ב ב בפרוזה preposition unspecified unspecified unspecified unspecified unspecified 0 
16 פרוזה פרוזה בפרוזה noun feminine singular absolute unspecified unspecified  	O	null
17 מרובת מרובה מרובת adjective feminine singular construct unspecified unspecified  	O	null
18 קולות קול קולות noun masculine plural absolute unspecified unspecified  	O	null
19 . . . punctuation unspecified unspecified unspecified unspecified unspecified  	O	null

0 כך כך כך adverb unspecified unspecified unspecified unspecified unspecified  	O	null
1 למשל למשל למשל conjunction unspecified unspecified unspecified unspecified unspecified  	O	null
2 , , , punctuation unspecified unspecified unspecified unspecified unspecified  	O	null
3 ב ב בשלושת preposition unspecified unspecified unspecified unspecified unspecified 0 
3 שלושת CARD3 בשלושת numeral masculine plural construct unspecified unspecified  	O	null
4 ה ה הסיפורים definiteArticle unspecified unspecified unspecified unspecified unspecified 0 
4 הסיפורים סיפור הסיפורים noun masculine plural absolute unspecified unspecified  	O	null
5 ה ה המכונסים definiteArticle unspecified unspecified unspecified unspecified unspecified 0 
5 המכונסים כונס המכונסים participle masculine plural absolute any unspecified  	O	null
6 תחת תחת תחת preposition unspecified unspecified unspecified unspecified unspecified  	O	null
7 ה ה הכותרת definiteArticle unspecified unspecified unspecified unspecified unspecified 0 
7 הכותרת כותרת הכותרת noun feminine singular absolute unspecified unspecified  	O	null
8 " " " punctuation unspecified unspecified unspecified unspecified unspecified  	O	null
9 מתווים התווה מתווים verb masculine plural unspecified any beinoni  	O	null
10 ל ל לדיוקנה preposition unspecified unspecified unspecified unspecified unspecified 0 
10 דיוקן דיוקן לדיוקנה noun masculine singular absolute unspecified unspecified  
10 ה ה לדיוקנה possessive feminine singular unspecified 3 unspecified 0 	O	null
11 של של של shel-preposition unspecified unspecified unspecified unspecified unspecified  	O	null
12 גברת גברת גברת noun feminine singular construct unspecified unspecified  	O	null
13 ג' ג' ג' noun masculine singular absolute unspecified unspecified  	O	null
14 " " " punctuation unspecified unspecified unspecified unspecified unspecified  	O	null
15 נבנות נבנה נבנות verb feminine plural unspecified any beinoni  	O	null
16 שלוש CARD3 שלוש numeral feminine singular absolute unspecified unspecified  	O	null
17 נקודות נקודה נקודות noun feminine plural absolute unspecified unspecified  	O	null
18 מבט מבט מבט noun masculine singular absolute unspecified unspecified  	O	null
19 ל ל לאותה preposition unspecified unspecified unspecified unspecified unspecified 0 
19 אותו אותו לאותה quantifier unspecified unspecified unspecified unspecified unspecified  
19 ה ה לאותה pronomial feminine singular unspecified 3 unspecified 0 	O	null
20 ה ה הסיטואציה definiteArticle unspecified unspecified unspecified unspecified unspecified 0 
20 הסיטואציה סיטואציה הסיטואציה noun feminine singular absolute unspecified unspecified  	O	null
21 . . . punctuation unspecified unspecified unspecified unspecified unspecified  	O	null

0 ב ב בריאיון preposition unspecified unspecified unspecified unspecified unspecified 0 
0 ריאיון ראיון בריאיון noun masculine singular absolute unspecified unspecified  	O	null
1 ל ל לאבי preposition unspecified unspecified unspecified unspecified unspecified 0 
1 אבי אב לאבי properName unspecified unspecified unspecified unspecified unspecified  	I_PERS	null
2 כ כ כצמן preposition unspecified unspecified unspecified unspecified unspecified 0 
2 צם צם כצמן participle masculine singular unspecified any unspecified  
2 ן ן כצמן possessive feminine plural unspecified 3 unspecified 0 	O	null
3 ( ( ( punctuation unspecified unspecified unspecified unspecified unspecified  	O	null
4 ###NUMBER### ###NUMBER### ###NUMBER### numeral unspecified unspecified unspecified unspecified unspecified  	I_DATE	null
5 ) ) ) punctuation unspecified unspecified unspecified unspecified unspecified  	O	null
6 סיפרה סיפר סיפרה verb feminine singular unspecified 3 past  	O	null
7 ש ש שבביתה relativizer/subordinatingConjunction unspecified unspecified unspecified unspecified unspecified 0 
7 ב ב שבביתה preposition unspecified unspecified unspecified unspecified unspecified 0 
7 בית בית שבביתה noun masculine singular absolute unspecified unspecified  
7 ה ה שבביתה possessive feminine singular unspecified 3 unspecified 0 	O	null
8 נשברו נשבר נשברו verb masculine-and-feminine plural unspecified 3 past  	O	null
9 שני CARD2 שני numeral masculine dual construct unspecified unspecified  	O	null
10 ה ה החלומות definiteArticle unspecified unspecified unspecified unspecified unspecified 0 
10 החלומות חלום החלומות noun masculine plural absolute unspecified unspecified  	O	null
11 ה ה המרכזיים definiteArticle unspecified unspecified unspecified unspecified unspecified 0 
11 המרכזיים מרכזי המרכזיים adjective masculine plural absolute unspecified unspecified  	O	null
12 של של של shel-preposition unspecified unspecified unspecified unspecified unspecified  	O	null
13 ה ה המאה definiteArticle unspecified unspecified unspecified unspecified unspecified 0 
13 המאה ORD-CARD100 המאה numeral feminine plural absolute unspecified unspecified  	O	null
14 ה ה הקודמת definiteArticle unspecified unspecified unspecified unspecified unspecified 0 
14 הקודמת קודם הקודמת adjective feminine singular absolute unspecified unspecified  	O	null
15 : : : punctuation unspecified unspecified unspecified unspecified unspecified  	O	null
16 ה ה החלום definiteArticle unspecified unspecified unspecified unspecified unspecified 0 
16 החלום חלום החלום noun masculine singular absolute unspecified unspecified  	O	null
17 ה ה הקומוניסטי definiteArticle unspecified unspecified unspecified unspecified unspecified 0 
17 הקומוניסטי קומוניסטי הקומוניסטי adjective masculine singular absolute unspecified unspecified  	O	null
18 ו ו והחלום conjunction unspecified unspecified unspecified unspecified unspecified 0 
18 ה ה והחלום definiteArticle unspecified unspecified unspecified unspecified unspecified 0 
18 החלום חלום והחלום noun masculine singular absolute unspecified unspecified  	O	null
19 ה ה הציוני definiteArticle unspecified unspecified unspecified unspecified unspecified 0 
19 הציוני ציוני הציוני adjective masculine singular absolute unspecified unspecified  	O	null
20 , , , punctuation unspecified unspecified unspecified unspecified unspecified  	O	null
21 ו ו וכי conjunction unspecified unspecified unspecified unspecified unspecified 0 
21 כי כי וכי conjunction unspecified unspecified unspecified unspecified unspecified  	O	null
22 ה ה הסיפור definiteArticle unspecified unspecified unspecified unspecified unspecified 0 
22 הסיפור סיפור הסיפור noun masculine singular absolute unspecified unspecified  	O	null
23 ה ה היחיד definiteArticle unspecified unspecified unspecified unspecified unspecified 0 
23 היחיד יחיד היחיד adjective masculine singular absolute unspecified unspecified  	O	null
24 ב ב בקובץ preposition unspecified unspecified unspecified unspecified unspecified 0 
24 ה ה בקובץ definiteArticle unspecified unspecified unspecified unspecified unspecified 0 
24 הקובץ קובץ בקובץ noun masculine singular absolute unspecified unspecified  	O	null
25 ש ש שיש relativizer/subordinatingConjunction unspecified unspecified unspecified unspecified unspecified 0 
25 יש יש שיש existential unspecified unspecified unspecified unspecified unspecified  	O	null
26 לו לו לו conjunction unspecified unspecified unspecified unspecified unspecified  	O	null
27 בסיס בסיס בסיס noun masculine singular absolute unspecified unspecified  	O	null
28 קונקרטי קונקרטי קונקרטי adjective masculine singular absolute unspecified unspecified  	O	null
29 הוא הוא הוא pronoun masculine singular unspecified 3 unspecified  	O	null
30 " " " punctuation unspecified unspecified unspecified unspecified unspecified  	O	null
31 פקעת פקעת פקעת noun feminine singular absolute unspecified unspecified  	O	null
32 ש ש שערך relativizer/subordinatingConjunction unspecified unspecified unspecified unspecified unspecified 0 
32 ערך ערך שערך noun masculine singular absolute unspecified unspecified  	O	null
33 ה ה העכברי definiteArticle unspecified unspecified unspecified unspecified unspecified 0 
33 העכברי עכברי העכברי adjective masculine singular absolute unspecified unspecified  	O	null
34 " " " punctuation unspecified unspecified unspecified unspecified unspecified  	O	null
35 , , , punctuation unspecified unspecified unspecified unspecified unspecified  	O	null
36 סיפור סיפור סיפור noun masculine singular absolute unspecified unspecified  	O	null
37 על על על preposition unspecified unspecified unspecified unspecified unspecified  	O	null
38 סבת סבה סבתה noun feminine singular absolute unspecified unspecified  
38 ה ה סבתה possessive feminine singular unspecified 3 unspecified 0 	O	null
39 ש ש שהגיעה relativizer/subordinatingConjunction unspecified unspecified unspecified unspecified unspecified 0 
39 הגיעה הגיע שהגיעה verb feminine singular unspecified 3 past  	O	null
40 ל ל לתל preposition unspecified unspecified unspecified unspecified unspecified 0 
40 תל תל לתל properName unspecified unspecified unspecified unspecified unspecified  	I_LOC	null
41 אביב אביב אביב properName unspecified unspecified unspecified unspecified unspecified  	I_LOC	null
42 מ מ מרוסיה preposition unspecified unspecified unspecified unspecified unspecified 0 
42 רוסיה רוסי מרוסיה properName unspecified unspecified unspecified unspecified unspecified  	I_LOC	null
43 ב ב ב preposition unspecified unspecified unspecified unspecified unspecified 0 	I_ORG	null
44 - - - punctuation unspecified unspecified unspecified unspecified unspecified  	I_ORG	null
45 ###NUMBER### ###NUMBER### ###NUMBER### numeral unspecified unspecified unspecified unspecified unspecified  	I_DATE	null
46 . . . punctuation unspecified unspecified unspecified unspecified unspecified  	O	null

0 References References References foreign unspecified unspecified unspecified unspecified unspecified  	O	null
1 : : : punctuation unspecified unspecified unspecified unspecified unspecified  	O	null

