0 Name Name Name foreign unspecified unspecified unspecified unspecified unspecified  	O	null
1 : : : punctuation unspecified unspecified unspecified unspecified unspecified  	O	null
2 גלעד גלעד גלעד properName unspecified unspecified unspecified unspecified unspecified  	I_ORG	null
3 ( ( ( punctuation unspecified unspecified unspecified unspecified unspecified  	O	null
4 גלס גלס גלס properName unspecified unspecified unspecified unspecified unspecified  	I_ORG	null
5 ) ) ) punctuation unspecified unspecified unspecified unspecified unspecified  	O	null
6 , , , punctuation unspecified unspecified unspecified unspecified unspecified  	O	null
7 זרובבל זרובבל זרובבל properName unspecified unspecified unspecified unspecified unspecified  	I_PERS	null
8 Birth Birth Birth foreign unspecified unspecified unspecified unspecified unspecified  	O	null
9 Year Year Year foreign unspecified unspecified unspecified unspecified unspecified  	O	null
10 : : : punctuation unspecified unspecified unspecified unspecified unspecified  	O	null
11 ###NUMBER### ###NUMBER### ###NUMBER### numeral unspecified unspecified unspecified unspecified unspecified  	I_DATE	null
12 Death Death Death foreign unspecified unspecified unspecified unspecified unspecified  	O	null
13 Year Year Year foreign unspecified unspecified unspecified unspecified unspecified  	O	null
14 : : : punctuation unspecified unspecified unspecified unspecified unspecified  	O	null
15 ###NUMBER### ###NUMBER### ###NUMBER### numeral unspecified unspecified unspecified unspecified unspecified  	I_DATE	null
16 Birth Birth Birth foreign unspecified unspecified unspecified unspecified unspecified  	O	null
17 Place Place Place foreign unspecified unspecified unspecified unspecified unspecified  	O	null
18 : : : punctuation unspecified unspecified unspecified unspecified unspecified  	O	null
19 עיר עיר עיר noun feminine singular absolute unspecified unspecified  	O	null
20 ב ב בנדרי preposition unspecified unspecified unspecified unspecified unspecified 0 
20 נדרי נדר בנדרי noun masculine plural construct unspecified unspecified  	O	null
21 , , , punctuation unspecified unspecified unspecified unspecified unspecified  	O	null
22 ב ב בסרביה preposition unspecified unspecified unspecified unspecified unspecified 0 
22 סרביה סרביה בסרביה properName unspecified unspecified unspecified unspecified unspecified  	I_LOC	null
23 Occupation Occupation Occupation foreign unspecified unspecified unspecified unspecified unspecified  	O	null
24 : : : punctuation unspecified unspecified unspecified unspecified unspecified  	O	null
25 משורר משורר משורר noun masculine singular absolute unspecified unspecified  	O	null
26 , , , punctuation unspecified unspecified unspecified unspecified unspecified  	O	null
27 סופר סופר סופר noun masculine singular absolute unspecified unspecified  	O	null
28 ו ו ועורך conjunction unspecified unspecified unspecified unspecified unspecified 0 
28 עורך עורך ועורך noun masculine singular construct unspecified unspecified  	O	null
29 Entry Entry Entry foreign unspecified unspecified unspecified unspecified unspecified  	O	null
30 writer writer writer foreign unspecified unspecified unspecified unspecified unspecified  	O	null
31 : : : punctuation unspecified unspecified unspecified unspecified unspecified  	O	null
32 שולמית שולמית שולמית properName unspecified unspecified unspecified unspecified unspecified  	I_PERS	null
33 שירן שירן שירן properName unspecified unspecified unspecified unspecified unspecified  	I_PERS	null
34 Entry Entry Entry foreign unspecified unspecified unspecified unspecified unspecified  	O	null
35 Value Value Value foreign unspecified unspecified unspecified unspecified unspecified  	O	null
36 : : : punctuation unspecified unspecified unspecified unspecified unspecified  	O	null
37 נולד נולד נולד verb masculine singular unspecified 3 past  	O	null
38 ב ב בעיר preposition unspecified unspecified unspecified unspecified unspecified 0 
38 ה ה בעיר definiteArticle unspecified unspecified unspecified unspecified unspecified 0 
38 העיר עיר בעיר noun feminine singular absolute unspecified unspecified  	O	null
39 ב ב בנדרי preposition unspecified unspecified unspecified unspecified unspecified 0 
39 נדרי נדר בנדרי noun masculine plural construct unspecified unspecified  	O	null
40 , , , punctuation unspecified unspecified unspecified unspecified unspecified  	O	null
41 ב ב בסרביה preposition unspecified unspecified unspecified unspecified unspecified 0 
41 סרביה סרביה בסרביה properName unspecified unspecified unspecified unspecified unspecified  	I_LOC	null
42 . . . punctuation unspecified unspecified unspecified unspecified unspecified  	O	null

0 בית בית בית noun masculine singular construct unspecified unspecified  	O	null
1 הורי הורה הוריו noun masculine plural absolute unspecified unspecified  
1 ו ו הוריו possessive masculine singular unspecified 3 unspecified 0 	O	null
2 היה הוא היה copula masculine singular unspecified 3 past  	O	null
3 משכיל משכיל משכיל adjective masculine singular absolute unspecified unspecified  	O	null
4 ו ו וציוני conjunction unspecified unspecified unspecified unspecified unspecified 0 
4 ציוני ציוני וציוני adjective masculine singular absolute unspecified unspecified  	O	null
5 , , , punctuation unspecified unspecified unspecified unspecified unspecified  	O	null
6 ו ו והוא conjunction unspecified unspecified unspecified unspecified unspecified 0 
6 הוא הוא והוא pronoun masculine singular unspecified 3 unspecified  	O	null
7 דיבר דיבר דיבר verb masculine singular unspecified 3 past  	O	null
8 עברית עברית עברית properName feminine singular unspecified unspecified unspecified  	I_PERS	null
9 מ מ מילדותו preposition unspecified unspecified unspecified unspecified unspecified 0 
9 ילדות ילדות מילדותו noun feminine singular absolute unspecified unspecified  
9 ו ו מילדותו possessive masculine singular unspecified 3 unspecified 0 	O	null
10 . . . punctuation unspecified unspecified unspecified unspecified unspecified  	O	null

0 עם עם עם preposition unspecified unspecified unspecified unspecified unspecified  	O	null
1 פרוץ פרץ פרוץ verb masculine singular unspecified 2 imperative  	O	null
2 מלחמת מלחמה מלחמת noun feminine singular construct unspecified unspecified  	O	null
3 ה ה העולם definiteArticle unspecified unspecified unspecified unspecified unspecified 0 
3 העולם עולם העולם noun masculine singular absolute unspecified unspecified  	O	null
4 ה ה הראשונה definiteArticle unspecified unspecified unspecified unspecified unspecified 0 
4 הראשונה ORD1 הראשונה numeral feminine singular absolute unspecified unspecified  	O	null
5 נמלטה נמלט נמלטה verb feminine singular unspecified 3 past  	O	null
6 ה ה המשפחה definiteArticle unspecified unspecified unspecified unspecified unspecified 0 
6 המשפחה משפחה המשפחה noun feminine singular absolute unspecified unspecified  	O	null
7 ל ל לאודסה preposition unspecified unspecified unspecified unspecified unspecified 0 
7 אודסה אודסה לאודסה properName unspecified unspecified unspecified unspecified unspecified  	I_LOC	null
8 ו ו וב conjunction unspecified unspecified unspecified unspecified unspecified 0 
8 ב ב וב preposition unspecified unspecified unspecified unspecified unspecified 0 	I_ORG	null
9 - - - punctuation unspecified unspecified unspecified unspecified unspecified  	I_ORG	null
10 ###NUMBER### ###NUMBER### ###NUMBER### numeral unspecified unspecified unspecified unspecified unspecified  	I_DATE	null
11 עלתה עלה עלתה verb feminine singular unspecified 3 past  	O	null
12 ארצה ארצה ארצה adverb unspecified unspecified unspecified unspecified unspecified  	O	null
13 . . . punctuation unspecified unspecified unspecified unspecified unspecified  	O	null

0 ב ב ב preposition unspecified unspecified unspecified unspecified unspecified 0 	I_ORG	null
1 - - - punctuation unspecified unspecified unspecified unspecified unspecified  	I_ORG	null
2 ###NUMBER### ###NUMBER### ###NUMBER### numeral unspecified unspecified unspecified unspecified unspecified  	I_DATE	null
3 הגיע הגיע הגיע verb masculine singular unspecified 3 past  	O	null
4 עם עם עם preposition unspecified unspecified unspecified unspecified unspecified  	O	null
5 אם אם אמו noun feminine singular absolute unspecified unspecified  
5 ו ו אמו possessive masculine singular unspecified 3 unspecified 0 	O	null
6 ל ל לקיבוץ preposition unspecified unspecified unspecified unspecified unspecified 0 
6 קיבוץ קיבוץ לקיבוץ noun masculine singular construct unspecified unspecified  	I_LOC	null
7 עין עין עין properName unspecified unspecified unspecified unspecified unspecified  	I_LOC	null
8 חרוד חרוד חרוד noun masculine singular absolute unspecified unspecified  	O	null
9 , , , punctuation unspecified unspecified unspecified unspecified unspecified  	O	null
10 ו ו ובו conjunction unspecified unspecified unspecified unspecified unspecified 0 
10 ב ב ובו preposition unspecified unspecified unspecified unspecified unspecified  
10 ו ו ובו pronomial masculine singular unspecified 3 unspecified 0 	O	null
11 חי חי חי verb masculine singular unspecified 3 past  	O	null
12 עם עם עם preposition unspecified unspecified unspecified unspecified unspecified  	O	null
13 משפחת משפחה משפחתו noun feminine singular absolute unspecified unspecified  
13 ו ו משפחתו possessive masculine singular unspecified 3 unspecified 0 	O	null
14 עד עד עד preposition unspecified unspecified unspecified unspecified unspecified  	O	null
15 יום יום יומו noun masculine singular absolute unspecified unspecified  
15 ו ו יומו possessive masculine singular unspecified 3 unspecified 0 	O	null
16 ה ה האחרון definiteArticle unspecified unspecified unspecified unspecified unspecified 0 
16 האחרון אחרון האחרון adjective masculine singular absolute unspecified unspecified  	O	null
17 . . . punctuation unspecified unspecified unspecified unspecified unspecified  	O	null

0 היה הוא היה copula masculine singular unspecified 3 past  	O	null
1 מזכיר מזכיר מזכיר noun masculine singular construct unspecified unspecified  	O	null
2 הסתדרות הסתדרות הסתדרות noun feminine singular construct unspecified unspecified  	O	null
3 " " " punctuation unspecified unspecified unspecified unspecified unspecified  	O	null
4 ה ה הנוער definiteArticle unspecified unspecified unspecified unspecified unspecified 0 
4 הנוער נוער הנוער noun masculine singular absolute unspecified unspecified  	O	null
5 ה ה העובד definiteArticle unspecified unspecified unspecified unspecified unspecified 0 
5 העובד עבד העובד participle masculine singular absolute any unspecified  	O	null
6 ו ו והלומד conjunction unspecified unspecified unspecified unspecified unspecified 0 
6 ה ה והלומד definiteArticle unspecified unspecified unspecified unspecified unspecified 0 
6 הלומד למד והלומד participle masculine singular absolute any unspecified  	O	null
7 " " " punctuation unspecified unspecified unspecified unspecified unspecified  	O	null
8 - - - punctuation unspecified unspecified unspecified unspecified unspecified  	O	null
9 ###NUMBER### ###NUMBER### ###NUMBER### numeral unspecified unspecified unspecified unspecified unspecified  	I_DATE	null
10 ) ) ) punctuation unspecified unspecified unspecified unspecified unspecified  	O	null
11 , , , punctuation unspecified unspecified unspecified unspecified unspecified  	O	null
12 ###NUMBER### ###NUMBER### ###NUMBER### numeral unspecified unspecified unspecified unspecified unspecified  	I_DATE	null
13 חבר חבר חבר noun masculine singular construct unspecified unspecified  	O	null
14 מערכת מערכת מערכת noun feminine singular absolute unspecified unspecified  	O	null
15 ב ב במעלה preposition unspecified unspecified unspecified unspecified unspecified 0 
15 מעלה מעלה במעלה noun feminine singular absolute unspecified unspecified  	O	null
16 , , , punctuation unspecified unspecified unspecified unspecified unspecified  	O	null
17 עיתון עיתון עיתון noun masculine singular absolute unspecified unspecified  	O	null
18 " " " punctuation unspecified unspecified unspecified unspecified unspecified  	O	null
19 ה ה הנוער definiteArticle unspecified unspecified unspecified unspecified unspecified 0 
19 הנוער נוער הנוער noun masculine singular absolute unspecified unspecified  	O	null
20 ה ה העובד definiteArticle unspecified unspecified unspecified unspecified unspecified 0 
20 העובד עבד העובד participle masculine singular absolute any unspecified  	O	null
21 " " " punctuation unspecified unspecified unspecified unspecified unspecified  	O	null
22 , , , punctuation unspecified unspecified unspecified unspecified unspecified  	O	null
23 ו ו ושליח conjunction unspecified unspecified unspecified unspecified unspecified 0 
23 שליח שליח ושליח noun masculine singular construct unspecified unspecified  	O	null
24 ה ה ההסתדרות definiteArticle unspecified unspecified unspecified unspecified unspecified 0 
24 ההסתדרות הסתדרות ההסתדרות noun feminine singular absolute unspecified unspecified  	O	null
25 ו ו והקיבוץ conjunction unspecified unspecified unspecified unspecified unspecified 0 
25 ה ה והקיבוץ definiteArticle unspecified unspecified unspecified unspecified unspecified 0 
25 הקיבוץ קיבוץ והקיבוץ noun masculine singular absolute unspecified unspecified  	O	null
26 ה ה המאוחד definiteArticle unspecified unspecified unspecified unspecified unspecified 0 
26 המאוחד מאוחד המאוחד adjective masculine singular absolute unspecified unspecified  	O	null
27 ל ל ל preposition unspecified unspecified unspecified unspecified unspecified 0 	O	null
28 " " " punctuation unspecified unspecified unspecified unspecified unspecified  	O	null
29 ה ה החלוץ definiteArticle unspecified unspecified unspecified unspecified unspecified 0 
29 החלוץ חלוץ החלוץ noun masculine singular absolute unspecified unspecified  	O	null
30 " " " punctuation unspecified unspecified unspecified unspecified unspecified  	O	null
31 ו ו ו conjunction unspecified unspecified unspecified unspecified unspecified 0 	I_ORG	null
32 " " " punctuation unspecified unspecified unspecified unspecified unspecified  	I_ORG	null
33 דרור דרור דרור properName unspecified unspecified unspecified unspecified unspecified  	I_ORG	null
34 – – – punctuation unspecified unspecified unspecified unspecified unspecified  	O	null
35 ה ה החלוץ definiteArticle unspecified unspecified unspecified unspecified unspecified 0 
35 החלוץ חלוץ החלוץ noun masculine singular absolute unspecified unspecified  	O	null
36 ה ה הצעיר definiteArticle unspecified unspecified unspecified unspecified unspecified 0 
36 הצעיר צעיר הצעיר adjective masculine singular absolute unspecified unspecified  	O	null
37 " " " punctuation unspecified unspecified unspecified unspecified unspecified  	O	null
38 ב ב בפולין preposition unspecified unspecified unspecified unspecified unspecified 0 
38 פולין פולין בפולין properName unspecified unspecified unspecified unspecified unspecified  	I_LOC	null
39 - - - punctuation unspecified unspecified unspecified unspecified unspecified  	O	null
40 ###NUMBER### ###NUMBER### ###NUMBER### numeral unspecified unspecified unspecified unspecified unspecified  	I_DATE	null
41 ) ) ) punctuation unspecified unspecified unspecified unspecified unspecified  	O	null
42 . . . punctuation unspecified unspecified unspecified unspecified unspecified  	O	null

0 ###NUMBER### ###NUMBER### ###NUMBER### numeral unspecified unspecified unspecified unspecified unspecified  	I_DATE	null
1 התגייס התגייס התגייס verb masculine singular unspecified 3 past  	O	null
2 ל ל לפלמ"ח preposition unspecified unspecified unspecified unspecified unspecified 0 
2 פלמ"ח פלמ"ח לפלמ"ח properName unspecified unspecified unspecified unspecified unspecified  	I_ORG	null
3 עם עם עם preposition unspecified unspecified unspecified unspecified unspecified  	O	null
4 ייסוד ייסוד ייסודו noun masculine singular absolute unspecified unspecified  
4 ו ו ייסודו possessive masculine singular unspecified 3 unspecified 0 	O	null
5 ) ) ) punctuation unspecified unspecified unspecified unspecified unspecified  	O	null
6 , , , punctuation unspecified unspecified unspecified unspecified unspecified  	O	null
7 ###NUMBER### ###NUMBER### ###NUMBER### numeral unspecified unspecified unspecified unspecified unspecified  	I_DATE	null
8 השתתף השתתף השתתף verb masculine singular unspecified 3 past  	O	null
9 ב ב בפעולות preposition unspecified unspecified unspecified unspecified unspecified 0 
9 פעולות פעולה בפעולות noun feminine plural construct unspecified unspecified  	O	null
10 ה ה המאבק definiteArticle unspecified unspecified unspecified unspecified unspecified 0 
10 המאבק מאבק המאבק noun masculine singular absolute unspecified unspecified  	O	null
11 ו ו וחיבר conjunction unspecified unspecified unspecified unspecified unspecified 0 
11 חיבר חיבר וחיבר verb masculine singular unspecified 3 past  	O	null
12 את את את at-preposition unspecified unspecified unspecified unspecified unspecified  	O	null
13 המנון המנון המנון noun masculine singular construct unspecified unspecified  	O	null
14 הפלמ"ח פלמ"ח הפלמ"ח properName unspecified unspecified unspecified unspecified unspecified  	I_ORG	null
15 . . . punctuation unspecified unspecified unspecified unspecified unspecified  	O	null

0 ב ב ב preposition unspecified unspecified unspecified unspecified unspecified 0 	I_ORG	null
1 - - - punctuation unspecified unspecified unspecified unspecified unspecified  	I_ORG	null
2 ###NUMBER### ###NUMBER### ###NUMBER### numeral unspecified unspecified unspecified unspecified unspecified  	I_DATE	null
3 הצטרף הצטרף הצטרף verb masculine singular unspecified 3 past  	O	null
4 ל ל למטה preposition unspecified unspecified unspecified unspecified unspecified 0 
4 מטה מטה למטה noun masculine singular construct unspecified unspecified  	O	null
5 הפלמ"ח פלמ"ח הפלמ"ח properName unspecified unspecified unspecified unspecified unspecified  	I_ORG	null
6 כ כ כקצין preposition unspecified unspecified unspecified unspecified unspecified 0 
6 קצין קצין כקצין noun masculine singular construct unspecified unspecified  	O	null
7 ה ה התרבות definiteArticle unspecified unspecified unspecified unspecified unspecified 0 
7 התרבות תרבות התרבות noun feminine singular absolute unspecified unspecified  	O	null
8 של של של shel-preposition unspecified unspecified unspecified unspecified unspecified  	O	null
9 ה ה החטיבה definiteArticle unspecified unspecified unspecified unspecified unspecified 0 
9 החטיבה חטיבה החטיבה noun feminine singular absolute unspecified unspecified  	O	null
10 ו ו ועורך conjunction unspecified unspecified unspecified unspecified unspecified 0 
10 עורך עורך ועורך noun masculine singular construct unspecified unspecified  	O	null
11 עלוני עלון עלוניה noun masculine plural absolute unspecified unspecified  
11 ה ה עלוניה possessive feminine singular unspecified 3 unspecified 0 	O	null
12 , , , punctuation unspecified unspecified unspecified unspecified unspecified  	O	null
13 ו ו ועם conjunction unspecified unspecified unspecified unspecified unspecified 0 
13 עם עם ועם preposition unspecified unspecified unspecified unspecified unspecified  	O	null
14 קום קם קום verb masculine singular unspecified 2 imperative  	O	null
15 ה ה המדינה definiteArticle unspecified unspecified unspecified unspecified unspecified 0 
15 המדינה מדינה המדינה noun feminine singular absolute unspecified unspecified  	O	null
16 ו ו ופירוק conjunction unspecified unspecified unspecified unspecified unspecified 0 
16 פירוק פירוק ופירוק noun masculine singular construct unspecified unspecified  	O	null
17 הפלמ"ח פלמ"ח הפלמ"ח properName unspecified unspecified unspecified unspecified unspecified  	I_ORG	null
18 היה הוא היה copula masculine singular unspecified 3 past  	O	null
19 קצין קצין קצין noun masculine singular construct unspecified unspecified  	O	null
20 ה ה הסברה definiteArticle unspecified unspecified unspecified unspecified unspecified 0 
20 הסברה סברה הסברה noun feminine singular absolute unspecified unspecified  	O	null
21 ו ו ותרבות conjunction unspecified unspecified unspecified unspecified unspecified 0 
21 תרבות תרבות ותרבות noun feminine singular absolute unspecified unspecified  	O	null
22 פיקודי פיקודי פיקודי adjective masculine singular absolute unspecified unspecified  	O	null
23 ב ב בחזית preposition unspecified unspecified unspecified unspecified unspecified 0 
23 חזית חזייה בחזית noun feminine singular construct unspecified unspecified  	O	null
24 ה ה הדרום definiteArticle unspecified unspecified unspecified unspecified unspecified 0 
24 הדרום דרום הדרום noun masculine singular absolute unspecified unspecified  	O	null
25 עד עד עד preposition unspecified unspecified unspecified unspecified unspecified  	O	null
26 שחרור שחרור שחרורו noun masculine singular absolute unspecified unspecified  
26 ו ו שחרורו possessive masculine singular unspecified 3 unspecified 0 	O	null
27 ) ) ) punctuation unspecified unspecified unspecified unspecified unspecified  	O	null
28 . . . punctuation unspecified unspecified unspecified unspecified unspecified  	O	null
29 ###NUMBER### ###NUMBER### ###NUMBER### numeral unspecified unspecified unspecified unspecified unspecified  	I_DATE	null
30 ל ל למד preposition unspecified unspecified unspecified unspecified unspecified 0 
30 מד מד למד noun masculine singular construct unspecified unspecified  	O	null
31 היסטוריה היסטוריה היסטוריה noun feminine singular absolute unspecified unspecified  	O	null
32 כללית כללי כללית adjective feminine singular absolute unspecified unspecified  	O	null
33 ו ו וספרות conjunction unspecified unspecified unspecified unspecified unspecified 0 
33 ספרות ספרות וספרות noun feminine singular absolute unspecified unspecified  	O	null
34 ב ב באוניברסיטה preposition unspecified unspecified unspecified unspecified unspecified 0 
34 ה ה באוניברסיטה definiteArticle unspecified unspecified unspecified unspecified unspecified 0 
34 האוניברסיטה אוניברסיטה באוניברסיטה noun feminine singular absolute unspecified unspecified  	O	null
35 ה ה העברית definiteArticle unspecified unspecified unspecified unspecified unspecified 0 
35 העברית עברי העברית adjective feminine singular absolute unspecified unspecified  	O	null
36 ב ב בירושלים preposition unspecified unspecified unspecified unspecified unspecified 0 
36 ירושלים ירושלים בירושלים properName unspecified unspecified unspecified unspecified unspecified  	I_LOC	null
37 - - - punctuation unspecified unspecified unspecified unspecified unspecified  	O	null
38 ###NUMBER### ###NUMBER### ###NUMBER### numeral unspecified unspecified unspecified unspecified unspecified  	I_DATE	null
39 ) ) ) punctuation unspecified unspecified unspecified unspecified unspecified  	O	null
40 . . . punctuation unspecified unspecified unspecified unspecified unspecified  	O	null

0 ###NUMBER### ###NUMBER### ###NUMBER### numeral unspecified unspecified unspecified unspecified unspecified  	I_DATE	null
1 ב ב ב preposition unspecified unspecified unspecified unspecified unspecified 0 	I_ORG	null
2 - - - punctuation unspecified unspecified unspecified unspecified unspecified  	I_ORG	null
3 ###NUMBER### ###NUMBER### ###NUMBER### numeral unspecified unspecified unspecified unspecified unspecified  	I_DATE	null
4 הצטרף הצטרף הצטרף verb masculine singular unspecified 3 past  	O	null
5 ל ל למערכת preposition unspecified unspecified unspecified unspecified unspecified 0 
5 מערכת מערכה למערכת noun feminine singular construct unspecified unspecified  	O	null
6 הוצאת הוצאה הוצאת noun feminine singular construct unspecified unspecified  	O	null
7 ה ה הקיבוץ definiteArticle unspecified unspecified unspecified unspecified unspecified 0 
7 הקיבוץ קיבוץ הקיבוץ noun masculine singular absolute unspecified unspecified  	O	null
8 ה ה המאוחד definiteArticle unspecified unspecified unspecified unspecified unspecified 0 
8 המאוחד מאוחד המאוחד adjective masculine singular absolute unspecified unspecified  	O	null
9 ו ו והיה conjunction unspecified unspecified unspecified unspecified unspecified 0 
9 היה הוא והיה copula masculine singular unspecified 3 past  	O	null
10 עורך ערך עורך verb masculine singular unspecified any beinoni  	O	null
11 מבפנים מבפנים מבפנים adverb unspecified unspecified unspecified unspecified unspecified  	O	null
12 , , , punctuation unspecified unspecified unspecified unspecified unspecified  	O	null
13 רבעון רבעון רבעון noun masculine singular construct unspecified unspecified  	O	null
14 ה ה הקיבוץ definiteArticle unspecified unspecified unspecified unspecified unspecified 0 
14 הקיבוץ קיבוץ הקיבוץ noun masculine singular absolute unspecified unspecified  	O	null
15 ה ה המאוחד definiteArticle unspecified unspecified unspecified unspecified unspecified 0 
15 המאוחד מאוחד המאוחד adjective masculine singular absolute unspecified unspecified  	O	null
16 - - - punctuation unspecified unspecified unspecified unspecified unspecified  	O	null
17 ###NUMBER### ###NUMBER### ###NUMBER### numeral unspecified unspecified unspecified unspecified unspecified  	I_DATE	null
18 ) ) ) punctuation unspecified unspecified unspecified unspecified unspecified  	O	null
19 . . . punctuation unspecified unspecified unspecified unspecified unspecified  	O	null

0 ###NUMBER### ###NUMBER### ###NUMBER### numeral unspecified unspecified unspecified unspecified unspecified  	I_DATE	null
1 מפעל מפעל מפעלו noun masculine singular absolute unspecified unspecified  
1 ו ו מפעלו possessive masculine singular unspecified 3 unspecified 0 	O	null
2 ה ה הספרותי definiteArticle unspecified unspecified unspecified unspecified unspecified 0 
2 הספרותי ספרותי הספרותי adjective masculine singular absolute unspecified unspecified  	O	null
3 כולל כלל כולל verb masculine singular unspecified any beinoni  	O	null
4 שירה שירה שירה noun feminine singular absolute unspecified unspecified  	O	null
5 , , , punctuation unspecified unspecified unspecified unspecified unspecified  	O	null
6 פרוזה פרוזה פרוזה noun feminine singular absolute unspecified unspecified  	O	null
7 , , , punctuation unspecified unspecified unspecified unspecified unspecified  	O	null
8 עריכה עריכה עריכה noun feminine singular absolute unspecified unspecified  	O	null
9 ו ו וכתיבה conjunction unspecified unspecified unspecified unspecified unspecified 0 
9 כתיבה כתיבה וכתיבה noun feminine singular absolute unspecified unspecified  	O	null
10 ל ל לילדים preposition unspecified unspecified unspecified unspecified unspecified 0 
10 ילדים ילד לילדים noun masculine plural absolute unspecified unspecified  	O	null
11 . . . punctuation unspecified unspecified unspecified unspecified unspecified  	O	null

0 סיפור סיפור סיפורו noun masculine singular absolute unspecified unspecified  
0 ו ו סיפורו possessive masculine singular unspecified 3 unspecified 0 	O	null
1 ה ה הראשון definiteArticle unspecified unspecified unspecified unspecified unspecified 0 
1 הראשון ORD1 הראשון numeral masculine singular absolute unspecified unspecified  	O	null
2 , , , punctuation unspecified unspecified unspecified unspecified unspecified  	O	null
3 " " " punctuation unspecified unspecified unspecified unspecified unspecified  	O	null
4 חורף חורף חורף noun masculine singular absolute unspecified unspecified  	O	null
5 אחד CARD1 אחד numeral masculine singular absolute unspecified unspecified  	O	null
6 " " " punctuation unspecified unspecified unspecified unspecified unspecified  	O	null
7 , , , punctuation unspecified unspecified unspecified unspecified unspecified  	O	null
8 התפרסם התפרסם התפרסם verb masculine singular unspecified 3 past  	O	null
9 בבמעלה בבמעלה בבמעלה properName unspecified unspecified unspecified unspecified unspecified  	O	null
10 ( ( ( punctuation unspecified unspecified unspecified unspecified unspecified  	O	null
11 חוברת חוברת חוברת noun feminine singular construct unspecified unspecified  	O	null
12 ז' ז' ז' noun masculine singular absolute unspecified unspecified  	O	null
13 , , , punctuation unspecified unspecified unspecified unspecified unspecified  	O	null
14 ###NUMBER### ###NUMBER### ###NUMBER### numeral unspecified unspecified unspecified unspecified unspecified  	I_DATE	null
15 ) ) ) punctuation unspecified unspecified unspecified unspecified unspecified  	O	null
16 . . . punctuation unspecified unspecified unspecified unspecified unspecified  	O	null

0 ספר ספר ספר noun masculine singular construct unspecified unspecified  	O	null
1 שירי שיר שיריו noun masculine plural absolute unspecified unspecified  
1 ו ו שיריו possessive masculine singular unspecified 3 unspecified 0 	O	null
2 ה ה הראשון definiteArticle unspecified unspecified unspecified unspecified unspecified 0 
2 הראשון ORD1 הראשון numeral masculine singular absolute unspecified unspecified  	O	null
3 , , , punctuation unspecified unspecified unspecified unspecified unspecified  	O	null
4 נעורים נעורים נעורים noun masculine plural absolute unspecified unspecified  	O	null
5 ( ( ( punctuation unspecified unspecified unspecified unspecified unspecified  	O	null
6 ב ב במעלה preposition unspecified unspecified unspecified unspecified unspecified 0 
6 מעלה מעלה במעלה noun feminine singular absolute unspecified unspecified  	O	null
7 ) ) ) punctuation unspecified unspecified unspecified unspecified unspecified  	O	null
8 , , , punctuation unspecified unspecified unspecified unspecified unspecified  	O	null
9 ראה ראה ראה verb masculine singular unspecified 3 past  	O	null
10 אור אור אור noun masculine singular absolute unspecified unspecified  	O	null
11 ב ב ב preposition unspecified unspecified unspecified unspecified unspecified 0 	I_ORG	null
12 - - - punctuation unspecified unspecified unspecified unspecified unspecified  	I_ORG	null
13 ###NUMBER### ###NUMBER### ###NUMBER### numeral unspecified unspecified unspecified unspecified unspecified  	I_DATE	null
14 . . . punctuation unspecified unspecified unspecified unspecified unspecified  	O	null

0 אחרי אחרי אחריו preposition unspecified unspecified unspecified unspecified unspecified  
0 ו ו אחריו pronomial masculine singular unspecified 3 unspecified 0 	O	null
1 הופיעו הופיע הופיעו verb masculine-and-feminine plural unspecified 3 past  	O	null
2 ה ה הספרים definiteArticle unspecified unspecified unspecified unspecified unspecified 0 
2 הספרים ספר הספרים noun masculine plural absolute unspecified unspecified  	O	null
3 על על על preposition unspecified unspecified unspecified unspecified unspecified  	O	null
4 ה ה העין definiteArticle unspecified unspecified unspecified unspecified unspecified 0 
4 העין עין העין noun feminine singular absolute unspecified unspecified  	O	null
5 ) ) ) punctuation unspecified unspecified unspecified unspecified unspecified  	O	null
6 ; ; ; punctuation unspecified unspecified unspecified unspecified unspecified  	O	null
7 ###NUMBER### ###NUMBER### ###NUMBER### numeral unspecified unspecified unspecified unspecified unspecified  	I_DATE	null
8 ניגונים ניגון ניגונים noun masculine plural absolute unspecified unspecified  	O	null
9 ב ב בסער preposition unspecified unspecified unspecified unspecified unspecified 0 
9 סער סער בסער properName unspecified unspecified unspecified unspecified unspecified  	I_DATE	null
10 ) ) ) punctuation unspecified unspecified unspecified unspecified unspecified  	O	null
11 ; ; ; punctuation unspecified unspecified unspecified unspecified unspecified  	O	null
12 ###NUMBER### ###NUMBER### ###NUMBER### numeral unspecified unspecified unspecified unspecified unspecified  	I_DATE	null
13 פריחת פריחה פריחת noun feminine singular construct unspecified unspecified  	O	null
14 ה ה האורנים definiteArticle unspecified unspecified unspecified unspecified unspecified 0 
14 האורנים אורן האורנים noun masculine plural absolute unspecified unspecified  	O	null
15 ) ) ) punctuation unspecified unspecified unspecified unspecified unspecified  	O	null
16 ; ; ; punctuation unspecified unspecified unspecified unspecified unspecified  	O	null
17 ###NUMBER### ###NUMBER### ###NUMBER### numeral unspecified unspecified unspecified unspecified unspecified  	I_DATE	null
18 נהר נהר נהר noun masculine singular absolute unspecified unspecified  	O	null
19 ירוק ירוק ירוק adjective masculine singular absolute unspecified unspecified  	O	null
20 ) ) ) punctuation unspecified unspecified unspecified unspecified unspecified  	O	null
21 . . . punctuation unspecified unspecified unspecified unspecified unspecified  	O	null
22 ###NUMBER### ###NUMBER### ###NUMBER### numeral unspecified unspecified unspecified unspecified unspecified  	I_DATE	null
23 ב ב ב preposition unspecified unspecified unspecified unspecified unspecified 0 	O	null
24 - - - punctuation unspecified unspecified unspecified unspecified unspecified  	O	null
25 ###NUMBER### ###NUMBER### ###NUMBER### numeral unspecified unspecified unspecified unspecified unspecified  	I_DATE	null
26 כינס כינס כינס verb masculine singular unspecified 3 past  	O	null
27 מבחר מבחר מבחר quantifier unspecified unspecified construct unspecified unspecified  	O	null
28 מספרי מספר מספריו noun masculine plural absolute unspecified unspecified  
28 ו ו מספריו possessive masculine singular unspecified 3 unspecified 0 	O	null
29 ה ה הראשונים definiteArticle unspecified unspecified unspecified unspecified unspecified 0 
29 הראשונים ראשונים הראשונים noun masculine plural absolute unspecified unspecified  	O	null
30 ב ב בשם preposition unspecified unspecified unspecified unspecified unspecified 0 
30 שם שם בשם noun masculine singular construct unspecified unspecified  	O	null
31 עפר עפר עפר noun masculine singular absolute unspecified unspecified  	O	null
32 נוהר נהר נוהר verb masculine singular unspecified any beinoni  	O	null
33 . . . punctuation unspecified unspecified unspecified unspecified unspecified  	O	null

0 כבר כבר כבר adverb unspecified unspecified unspecified unspecified unspecified  	O	null
1 ב ב בשירו preposition unspecified unspecified unspecified unspecified unspecified 0 
1 שיר שיר בשירו noun masculine singular absolute unspecified unspecified  
1 ו ו בשירו possessive masculine singular unspecified 3 unspecified 0 	O	null
2 ה ה הראשון definiteArticle unspecified unspecified unspecified unspecified unspecified 0 
2 הראשון ORD1 הראשון numeral masculine singular absolute unspecified unspecified  	O	null
3 , , , punctuation unspecified unspecified unspecified unspecified unspecified  	O	null
4 " " " punctuation unspecified unspecified unspecified unspecified unspecified  	O	null
5 שוב שוב שוב adverb unspecified unspecified unspecified unspecified unspecified  	I_ORG	null
6 עורג ערג עורג verb masculine singular unspecified any beinoni  	O	null
7 לבי ליבה לבי verb feminine singular unspecified 2 imperative  	O	null
8 " " " punctuation unspecified unspecified unspecified unspecified unspecified  	O	null
9 , , , punctuation unspecified unspecified unspecified unspecified unspecified  	O	null
10 אפשר אפשר אפשר modal unspecified unspecified unspecified unspecified unspecified  	O	null
11 למצוא מצא למצוא verb unspecified unspecified unspecified unspecified infinitive  	O	null
12 כמה כמה כמה quantifier unspecified unspecified construct unspecified unspecified  	O	null
13 מ מ ממאפייני preposition unspecified unspecified unspecified unspecified unspecified 0 
13 מאפייני מאפיין ממאפייני noun masculine plural construct unspecified unspecified  	O	null
14 ה ה היסוד definiteArticle unspecified unspecified unspecified unspecified unspecified 0 
14 היסוד יסוד היסוד noun masculine singular absolute unspecified unspecified  	O	null
15 של של של shel-preposition unspecified unspecified unspecified unspecified unspecified  	O	null
16 שירת שירה שירתו noun feminine singular absolute unspecified unspecified  
16 ו ו שירתו possessive masculine singular unspecified 3 unspecified 0 	O	null
17 , , , punctuation unspecified unspecified unspecified unspecified unspecified  	O	null
18 ה ה השואבת definiteArticle unspecified unspecified unspecified unspecified unspecified 0 
18 השואבת שאב השואבת participle feminine singular absolute any unspecified  	O	null
19 את את את at-preposition unspecified unspecified unspecified unspecified unspecified  	O	null
20 חומרי חומר חומריה noun masculine plural absolute unspecified unspecified  
20 ה ה חומריה possessive feminine singular unspecified 3 unspecified 0 	O	null
21 מ מ מהיומיומי preposition unspecified unspecified unspecified unspecified unspecified 0 
21 ה ה מהיומיומי definiteArticle unspecified unspecified unspecified unspecified unspecified 0 
21 היומיומי יומיומי מהיומיומי adjective masculine singular absolute unspecified unspecified  	O	null
22 ו ו והקרוב conjunction unspecified unspecified unspecified unspecified unspecified 0 
22 ה ה והקרוב definiteArticle unspecified unspecified unspecified unspecified unspecified 0 
22 הקרוב קרוב והקרוב adjective masculine singular absolute unspecified unspecified  	O	null
23 , , , punctuation unspecified unspecified unspecified unspecified unspecified  	O	null
24 ו ו וקשורה conjunction unspecified unspecified unspecified unspecified unspecified 0 
24 קשורה קשור וקשורה adjective feminine singular absolute unspecified unspecified  	O	null
25 קשר קשר קשר noun masculine singular absolute unspecified unspecified  	O	null
26 עמוק עמוק עמוק adjective masculine singular absolute unspecified unspecified  	O	null
27 ל ל לחיים preposition unspecified unspecified unspecified unspecified unspecified 0 
27 ה ה לחיים definiteArticle unspecified unspecified unspecified unspecified unspecified 0 
27 החיים חיים לחיים noun masculine plural absolute unspecified unspecified  	O	null
28 ב ב בקיבוץ preposition unspecified unspecified unspecified unspecified unspecified 0 
28 ה ה בקיבוץ definiteArticle unspecified unspecified unspecified unspecified unspecified 0 
28 הקיבוץ קיבוץ בקיבוץ noun masculine singular absolute unspecified unspecified  	I_LOC	null
29 , , , punctuation unspecified unspecified unspecified unspecified unspecified  	I_LOC	null
30 ל ל לנוף preposition unspecified unspecified unspecified unspecified unspecified 0 
30 נוף נוף לנוף noun masculine singular construct unspecified unspecified  	I_LOC	null
31 ה ה העמק definiteArticle unspecified unspecified unspecified unspecified unspecified 0 
31 העמק עמק העמק noun masculine singular absolute unspecified unspecified  	I_LOC	null
32 , , , punctuation unspecified unspecified unspecified unspecified unspecified  	O	null
33 לחי לחי לחי noun masculine singular absolute unspecified unspecified  	O	null
34 , , , punctuation unspecified unspecified unspecified unspecified unspecified  	O	null
35 ל ל לצומח preposition unspecified unspecified unspecified unspecified unspecified 0 
35 ה ה לצומח definiteArticle unspecified unspecified unspecified unspecified unspecified 0 
35 הצומח צומח לצומח noun masculine singular absolute unspecified unspecified  	O	null
36 ו ו ולעבר conjunction unspecified unspecified unspecified unspecified unspecified 0 
36 ל ל ולעבר preposition unspecified unspecified unspecified unspecified unspecified 0 
36 ה ה ולעבר definiteArticle unspecified unspecified unspecified unspecified unspecified 0 
36 העבר עבר ולעבר noun masculine singular absolute unspecified unspecified  	O	null
37 ה ה הרחוק definiteArticle unspecified unspecified unspecified unspecified unspecified 0 
37 הרחוק רחוק הרחוק adjective masculine singular absolute unspecified unspecified  	O	null
38 ו ו והקרוב conjunction unspecified unspecified unspecified unspecified unspecified 0 
38 ה ה והקרוב definiteArticle unspecified unspecified unspecified unspecified unspecified 0 
38 הקרוב קרוב והקרוב adjective masculine singular absolute unspecified unspecified  	O	null
39 של של של shel-preposition unspecified unspecified unspecified unspecified unspecified  	O	null
40 ארץ ארץ ארץ noun feminine singular construct unspecified unspecified  	I_LOC	null
41 ישראל ישראל ישראל properName unspecified unspecified unspecified unspecified unspecified  	I_LOC	null
42 . . . punctuation unspecified unspecified unspecified unspecified unspecified  	O	null

0 תכונות תכונה תכונות noun feminine plural absolute unspecified unspecified  	O	null
1 אלה אלה אלה pronoun masculine-and-feminine plural unspecified 3 unspecified  	O	null
2 שייכו שייך שייכו verb masculine-and-feminine plural unspecified 3 past  	O	null
3 את את אותו at-preposition unspecified unspecified unspecified unspecified unspecified  
3 ו ו אותו pronomial masculine singular unspecified 3 unspecified 0 	O	null
4 ל ל לבני preposition unspecified unspecified unspecified unspecified unspecified 0 
4 בני בן לבני noun masculine plural construct unspecified unspecified  	O	null
5 דור דור דור noun masculine singular construct unspecified unspecified  	O	null
6 ה ה המאבק definiteArticle unspecified unspecified unspecified unspecified unspecified 0 
6 המאבק מאבק המאבק noun masculine singular absolute unspecified unspecified  	O	null
7 ל ל לעצמאות preposition unspecified unspecified unspecified unspecified unspecified 0 
7 ה ה לעצמאות definiteArticle unspecified unspecified unspecified unspecified unspecified 0 
7 העצמאות עצמאות לעצמאות noun feminine singular absolute unspecified unspecified  	O	null
8 ו ו ושיריו conjunction unspecified unspecified unspecified unspecified unspecified 0 
8 שירי שיר ושיריו noun masculine plural absolute unspecified unspecified  
8 ו ו ושיריו possessive masculine singular unspecified 3 unspecified 0 	O	null
9 נכללו נכלל נכללו verb masculine-and-feminine plural unspecified 3 past  	O	null
10 ב ב באנתולוגיה preposition unspecified unspecified unspecified unspecified unspecified 0 
10 ה ה באנתולוגיה definiteArticle unspecified unspecified unspecified unspecified unspecified 0 
10 האנתולוגיה האנתולוגיה באנתולוגיה noun feminine singular absolute unspecified unspecified  	O	null
11 ה ה הייצוגית definiteArticle unspecified unspecified unspecified unspecified unspecified 0 
11 הייצוגית הייצוגית הייצוגית adjective feminine singular absolute unspecified unspecified  	O	null
12 של של שלהם shel-preposition unspecified unspecified unspecified unspecified unspecified  
12 הם הם שלהם pronomial masculine plural unspecified 3 unspecified 0 	O	null
13 , , , punctuation unspecified unspecified unspecified unspecified unspecified  	O	null
14 דור דור דור noun masculine singular absolute unspecified unspecified  	O	null
15 ב ב בארץ preposition unspecified unspecified unspecified unspecified unspecified 0 
15 ה ה בארץ definiteArticle unspecified unspecified unspecified unspecified unspecified 0 
15 הארץ ארץ בארץ noun feminine singular absolute unspecified unspecified  	O	null
16 ) ) ) punctuation unspecified unspecified unspecified unspecified unspecified  	O	null
17 . . . punctuation unspecified unspecified unspecified unspecified unspecified  	O	null
18 ###NUMBER### ###NUMBER### ###NUMBER### numeral unspecified unspecified unspecified unspecified unspecified  	I_DATE	null
19 עם עם עם preposition unspecified unspecified unspecified unspecified unspecified  	O	null
20 ה ה הזמן definiteArticle unspecified unspecified unspecified unspecified unspecified 0 
20 הזמן זמן הזמן noun masculine singular absolute unspecified unspecified  	O	null
21 התרחב התרחב התרחב verb masculine singular unspecified 3 past  	O	null
22 מעגל מעגל מעגל noun masculine singular construct unspecified unspecified  	O	null
23 שירת שירה שירתו noun feminine singular absolute unspecified unspecified  
23 ו ו שירתו possessive masculine singular unspecified 3 unspecified 0 	O	null
24 ו ו וכלל conjunction unspecified unspecified unspecified unspecified unspecified 0 
24 כלל כלל וכלל noun masculine singular construct unspecified unspecified  	O	null
25 נופים נוף נופים noun masculine plural absolute unspecified unspecified  	O	null
26 אחרים אחר אחרים adjective masculine plural absolute unspecified unspecified  	O	null
27 , , , punctuation unspecified unspecified unspecified unspecified unspecified  	O	null
28 ב ב בהם preposition unspecified unspecified unspecified unspecified unspecified  
28 הם הם בהם pronomial masculine plural unspecified 3 unspecified 0 	O	null
29 נופי נוף נופי noun masculine plural construct unspecified unspecified  	O	null
30 ירושלים ירושלים ירושלים properName unspecified unspecified unspecified unspecified unspecified  	I_LOC	null
31 ו ו ונופי conjunction unspecified unspecified unspecified unspecified unspecified 0 
31 נופי נוף ונופי noun masculine plural construct unspecified unspecified  	O	null
32 חו"ל חו"ל חו"ל noun masculine singular absolute unspecified unspecified  	O	null
33 , , , punctuation unspecified unspecified unspecified unspecified unspecified  	O	null
34 שירי שיר שירי noun masculine plural construct unspecified unspecified  	O	null
35 אהבה אהבה אהבה noun feminine singular absolute unspecified unspecified  	O	null
36 בוגרים בוגר בוגרים adjective masculine plural absolute unspecified unspecified  	O	null
37 ו ו ושירים conjunction unspecified unspecified unspecified unspecified unspecified 0 
37 שירים שיר ושירים noun masculine plural absolute unspecified unspecified  	O	null
38 ה ה המתייחסים definiteArticle unspecified unspecified unspecified unspecified unspecified 0 
38 המתייחסים התייחס המתייחסים participle masculine plural absolute any unspecified  	O	null
39 ל ל לאישים preposition unspecified unspecified unspecified unspecified unspecified 0 
39 אישים אישים לאישים noun masculine plural absolute unspecified unspecified  	O	null
40 ו ו ולאירועים conjunction unspecified unspecified unspecified unspecified unspecified 0 
40 ל ל ולאירועים preposition unspecified unspecified unspecified unspecified unspecified 0 
40 אירועים אירוע ולאירועים noun masculine plural absolute unspecified unspecified  	O	null
41 היסטוריים היסטורי היסטוריים adjective masculine plural absolute unspecified unspecified  	O	null
42 . . . punctuation unspecified unspecified unspecified unspecified unspecified  	O	null

0 מתגלות התגלה מתגלות verb feminine plural unspecified any beinoni  	O	null
1 ב ב בהם preposition unspecified unspecified unspecified unspecified unspecified  
1 הם הם בהם pronomial masculine plural unspecified 3 unspecified 0 	O	null
2 מודעות מודעות מודעות noun feminine singular absolute unspecified unspecified  	O	null
3 ל ל לפער preposition unspecified unspecified unspecified unspecified unspecified 0 
3 ה ה לפער definiteArticle unspecified unspecified unspecified unspecified unspecified 0 
3 הפער פער לפער noun masculine singular absolute unspecified unspecified  	O	null
4 בין בין בין preposition unspecified unspecified unspecified unspecified unspecified  	O	null
5 ה ה החזון definiteArticle unspecified unspecified unspecified unspecified unspecified 0 
5 החזון חזון החזון noun masculine singular absolute unspecified unspecified  	O	null
6 ה ה הקיבוצי definiteArticle unspecified unspecified unspecified unspecified unspecified 0 
6 הקיבוצי קיבוצי הקיבוצי adjective masculine singular absolute unspecified unspecified  	O	null
7 ל ל למימושו preposition unspecified unspecified unspecified unspecified unspecified 0 
7 מימוש מימוש למימושו noun masculine singular absolute unspecified unspecified  
7 ו ו למימושו possessive masculine singular unspecified 3 unspecified 0 	O	null
8 ו ו וחרדה conjunction unspecified unspecified unspecified unspecified unspecified 0 
8 חרדה חרדה וחרדה noun feminine singular absolute unspecified unspecified  	O	null
9 ל ל לגורל preposition unspecified unspecified unspecified unspecified unspecified 0 
9 גורל גורל לגורל noun masculine singular construct unspecified unspecified  	O	null
10 ה ה המפעל definiteArticle unspecified unspecified unspecified unspecified unspecified 0 
10 המפעל מפעל המפעל noun masculine singular absolute unspecified unspecified  	O	null
11 ה ה הציוני definiteArticle unspecified unspecified unspecified unspecified unspecified 0 
11 הציוני ציוני הציוני adjective masculine singular absolute unspecified unspecified  	O	null
12 . . . punctuation unspecified unspecified unspecified unspecified unspecified  	O	null

0 ב ב בספרו preposition unspecified unspecified unspecified unspecified unspecified 0 
0 ספר ספר בספרו noun masculine singular absolute unspecified unspecified  
0 ו ו בספרו possessive masculine singular unspecified 3 unspecified 0 	O	null
1 ב ב בצל preposition unspecified unspecified unspecified unspecified unspecified 0 
1 צל צל בצל noun masculine singular construct unspecified unspecified  	O	null
2 תאנה תאנה תאנה noun feminine singular absolute unspecified unspecified  	O	null
3 כינס כינס כינס verb masculine singular unspecified 3 past  	O	null
4 מבחר מבחר מבחר quantifier unspecified unspecified construct unspecified unspecified  	O	null
5 משירי השיר משיריו participle masculine plural unspecified any unspecified  
5 ו ו משיריו possessive masculine singular unspecified 3 unspecified 0 	O	null
6 ש ש שנכתבו relativizer/subordinatingConjunction unspecified unspecified unspecified unspecified unspecified 0 
6 נכתבו נכתב שנכתבו verb masculine-and-feminine plural unspecified 3 past  	O	null
7 ב ב בשנים preposition unspecified unspecified unspecified unspecified unspecified 0 
7 שנים שנה בשנים noun feminine plural absolute unspecified unspecified  	O	null
8 ###NUMBER### ###NUMBER### ###NUMBER### numeral unspecified unspecified unspecified unspecified unspecified  	I_DATE	null
9 - - - punctuation unspecified unspecified unspecified unspecified unspecified  	O	null
10 ###NUMBER### ###NUMBER### ###NUMBER### numeral unspecified unspecified unspecified unspecified unspecified  	I_DATE	null
11 . . . punctuation unspecified unspecified unspecified unspecified unspecified  	O	null

0 ה ה הספר definiteArticle unspecified unspecified unspecified unspecified unspecified 0 
0 הספר ספר הספר noun masculine singular absolute unspecified unspecified  	O	null
1 Pomegranate Pomegranate Pomegranate foreign unspecified unspecified unspecified unspecified unspecified  	O	null
2 Tree Tree Tree foreign unspecified unspecified unspecified unspecified unspecified  	O	null
3 in in in foreign unspecified unspecified unspecified unspecified unspecified  	O	null
4 Jerusalem Jerusalem Jerusalem foreign unspecified unspecified unspecified unspecified unspecified  	O	null
5 ( ( ( punctuation unspecified unspecified unspecified unspecified unspecified  	O	null
6 ###NUMBER### ###NUMBER### ###NUMBER### numeral unspecified unspecified unspecified unspecified unspecified  	I_DATE	null
7 ) ) ) punctuation unspecified unspecified unspecified unspecified unspecified  	O	null
8 כולל כלל כולל verb masculine singular unspecified any beinoni  	O	null
9 מבחר מבחר מבחר quantifier unspecified unspecified construct unspecified unspecified  	O	null
10 מ מ משיריו preposition unspecified unspecified unspecified unspecified unspecified 0 
10 שירי שיר משיריו noun masculine plural absolute unspecified unspecified  
10 ו ו משיריו possessive masculine singular unspecified 3 unspecified 0 	O	null
11 ש ש שתירגמה relativizer/subordinatingConjunction unspecified unspecified unspecified unspecified unspecified 0 
11 תירגמה תרגם שתירגמה verb feminine singular unspecified 3 past  	O	null
12 ל ל לאנגלית preposition unspecified unspecified unspecified unspecified unspecified 0 
12 אנגלית אנגלית לאנגלית properName feminine singular unspecified unspecified unspecified  	O	null
13 רעיית רעייה רעייתו noun feminine singular absolute unspecified unspecified  
13 ו ו רעייתו possessive masculine singular unspecified 3 unspecified 0 	O	null
14 ה ה השנייה definiteArticle unspecified unspecified unspecified unspecified unspecified 0 
14 השנייה ORD2 השנייה numeral feminine singular absolute unspecified unspecified  	O	null
15 , , , punctuation unspecified unspecified unspecified unspecified unspecified  	O	null
16 דורותיאה דורותיאה דורותיאה properName unspecified unspecified unspecified unspecified unspecified  	I_PERS	null
17 קרוק קרוק קרוק properName unspecified unspecified unspecified unspecified unspecified  	I_PERS	null
18 - - - properName unspecified unspecified unspecified unspecified unspecified  	I_PERS	null
19 גלעד גלעד גלעד properName unspecified unspecified unspecified unspecified unspecified  	I_PERS	null
20 , , , punctuation unspecified unspecified unspecified unspecified unspecified  	O	null
21 חוקרת חקר חוקרת verb feminine singular unspecified any beinoni  	O	null
22 ספרות ספרות ספרות noun feminine singular construct unspecified unspecified  	O	null
23 אנגלית אנגלית אנגלית properName feminine singular unspecified unspecified unspecified  	I_LOC	null
24 . . . punctuation unspecified unspecified unspecified unspecified unspecified  	O	null

0 מבט מבט מבט noun masculine singular construct unspecified unspecified  	O	null
1 כולל כולל כולל noun masculine singular absolute unspecified unspecified  	O	null
2 מראה הראה מראה verb masculine singular unspecified any beinoni  	O	null
3 כי כי כי conjunction unspecified unspecified unspecified unspecified unspecified  	O	null
4 שירת שירה שירתו noun feminine singular absolute unspecified unspecified  
4 ו ו שירתו possessive masculine singular unspecified 3 unspecified 0 	O	null
5 נעה נע נעה verb feminine singular unspecified 3 past  	O	null
6 ב ב בשני preposition unspecified unspecified unspecified unspecified unspecified 0 
6 שני CARD2 בשני numeral masculine dual construct unspecified unspecified  	O	null
7 צירים ציר צירים noun masculine plural absolute unspecified unspecified  	O	null
8 מנוגדים מנוגד מנוגדים adjective masculine plural absolute unspecified unspecified  	O	null
9 . . . punctuation unspecified unspecified unspecified unspecified unspecified  	O	null

0 ה ה הציר definiteArticle unspecified unspecified unspecified unspecified unspecified 0 
0 הציר ציר הציר noun masculine singular absolute unspecified unspecified  	O	null
1 האחד האחיד האחד verb masculine singular unspecified 2 imperative  	O	null
2 הוא הוא הוא pronoun masculine singular unspecified 3 unspecified  	O	null
3 שירת שירת שירת verb masculine singular unspecified 3 past  	O	null
4 ה ה הטבע definiteArticle unspecified unspecified unspecified unspecified unspecified 0 
4 הטבע טבע הטבע noun masculine singular absolute unspecified unspecified  	O	null
5 ו ו והאהבה conjunction unspecified unspecified unspecified unspecified unspecified 0 
5 ה ה והאהבה definiteArticle unspecified unspecified unspecified unspecified unspecified 0 
5 האהבה אהבה והאהבה noun feminine singular absolute unspecified unspecified  	O	null
6 , , , punctuation unspecified unspecified unspecified unspecified unspecified  	O	null
7 ש ש שהחוויה relativizer/subordinatingConjunction unspecified unspecified unspecified unspecified unspecified 0 
7 ה ה שהחוויה definiteArticle unspecified unspecified unspecified unspecified unspecified 0 
7 החוויה חוויה שהחוויה noun feminine singular absolute unspecified unspecified  	O	null
8 ה ה המרכזית definiteArticle unspecified unspecified unspecified unspecified unspecified 0 
8 המרכזית מרכזי המרכזית adjective feminine singular absolute unspecified unspecified  	O	null
9 ב ב בה preposition unspecified unspecified unspecified unspecified unspecified  
9 ה ה בה pronomial feminine singular unspecified 3 unspecified 0 	O	null
10 היא הוא היא pronoun feminine singular unspecified 3 unspecified  	O	null
11 צמיחת צמיחה צמיחת noun feminine singular construct unspecified unspecified  	O	null
12 עין עין עין noun feminine singular construct unspecified unspecified  	O	null
13 חרוד חרוד חרוד noun masculine singular absolute unspecified unspecified  	O	null
14 מ מ מהמקום preposition unspecified unspecified unspecified unspecified unspecified 0 
14 ה ה מהמקום definiteArticle unspecified unspecified unspecified unspecified unspecified 0 
14 המקום מקום מהמקום noun masculine singular absolute unspecified unspecified  	O	null
15 ה ה הבודד definiteArticle unspecified unspecified unspecified unspecified unspecified 0 
15 הבודד בודד הבודד adjective masculine singular absolute unspecified unspecified  	O	null
16 ו ו והצחיח conjunction unspecified unspecified unspecified unspecified unspecified 0 
16 ה ה והצחיח definiteArticle unspecified unspecified unspecified unspecified unspecified 0 
16 הצחיח צחיח והצחיח adjective masculine singular absolute unspecified unspecified  	O	null
17 ש ש שאליו relativizer/subordinatingConjunction unspecified unspecified unspecified unspecified unspecified 0 
17 אל אל שאליו preposition unspecified unspecified unspecified unspecified unspecified  
17 ו ו שאליו pronomial masculine singular unspecified 3 unspecified 0 	O	null
18 הגיע הגיע הגיע verb masculine singular unspecified 3 past  	O	null
19 ב ב בילדותו preposition unspecified unspecified unspecified unspecified unspecified 0 
19 ילדות ילדות בילדותו noun feminine singular absolute unspecified unspecified  
19 ו ו בילדותו possessive masculine singular unspecified 3 unspecified 0 	O	null
20 ל ל ליישוב preposition unspecified unspecified unspecified unspecified unspecified 0 
20 יישוב יישוב ליישוב noun masculine singular absolute unspecified unspecified  	O	null
21 פורח פורח פורח adjective masculine singular absolute unspecified unspecified  	O	null
22 ; ; ; punctuation unspecified unspecified unspecified unspecified unspecified  	O	null
23 ו ו והציר conjunction unspecified unspecified unspecified unspecified unspecified 0 
23 ה ה והציר definiteArticle unspecified unspecified unspecified unspecified unspecified 0 
23 הציר ציר והציר noun masculine singular absolute unspecified unspecified  	O	null
24 ה ה האחר definiteArticle unspecified unspecified unspecified unspecified unspecified 0 
24 האחר אחר האחר adjective masculine singular absolute unspecified unspecified  	O	null
25 הוא הוא הוא pronoun masculine singular unspecified 3 unspecified  	O	null
26 שירת שירה שירת noun feminine singular construct unspecified unspecified  	O	null
27 ה ה האובדן definiteArticle unspecified unspecified unspecified unspecified unspecified 0 
27 האובדן אובדן האובדן noun masculine singular absolute unspecified unspecified  	O	null
28 ו ו ואימת conjunction unspecified unspecified unspecified unspecified unspecified 0 
28 אימת אימה ואימת noun feminine singular construct unspecified unspecified  	O	null
29 ה ה המוות definiteArticle unspecified unspecified unspecified unspecified unspecified 0 
29 המוות מוות המוות noun masculine singular absolute unspecified unspecified  	O	null
30 , , , punctuation unspecified unspecified unspecified unspecified unspecified  	O	null
31 ה ה המבכה definiteArticle unspecified unspecified unspecified unspecified unspecified 0 
31 המבכה ביכה המבכה participle masculine singular absolute any unspecified  	O	null
32 את את את at-preposition unspecified unspecified unspecified unspecified unspecified  	O	null
33 מות מוות מות noun masculine singular construct unspecified unspecified  	O	null
34 אבי אב אביו noun masculine singular absolute unspecified unspecified  
34 ו ו אביו possessive masculine singular unspecified 3 unspecified 0 	O	null
35 , , , punctuation unspecified unspecified unspecified unspecified unspecified  	O	null
36 אשת איש אשתו noun feminine singular absolute unspecified unspecified  
36 ו ו אשתו possessive masculine singular unspecified 3 unspecified 0 	O	null
37 ה ה הראשונה definiteArticle unspecified unspecified unspecified unspecified unspecified 0 
37 הראשונה ORD1 הראשונה numeral feminine singular absolute unspecified unspecified  	O	null
38 ו ו ואחיו conjunction unspecified unspecified unspecified unspecified unspecified 0 
38 אחי אח ואחיו noun masculine plural absolute unspecified unspecified  
38 ו ו ואחיו possessive masculine singular unspecified 3 unspecified 0 	O	null
39 ה ה הצעיר definiteArticle unspecified unspecified unspecified unspecified unspecified 0 
39 הצעיר צעיר הצעיר adjective masculine singular absolute unspecified unspecified  	O	null
40 ש ש שהלכו relativizer/subordinatingConjunction unspecified unspecified unspecified unspecified unspecified 0 
40 הלכו הלך שהלכו verb masculine-and-feminine plural unspecified 3 past  	O	null
41 ל ל לעולמם preposition unspecified unspecified unspecified unspecified unspecified 0 
41 עולם עולם לעולמם noun masculine singular absolute unspecified unspecified  
41 ם ם לעולמם possessive masculine plural unspecified 3 unspecified 0 	O	null
42 בטרם בטרם בטרם conjunction unspecified unspecified unspecified unspecified unspecified  	O	null
43 עת עת עת noun feminine singular absolute unspecified unspecified  	O	null
44 , , , punctuation unspecified unspecified unspecified unspecified unspecified  	O	null
45 בני בן בני noun masculine plural construct unspecified unspecified  	O	null
46 ה ה הקיבוץ definiteArticle unspecified unspecified unspecified unspecified unspecified 0 
46 הקיבוץ קיבוץ הקיבוץ noun masculine singular absolute unspecified unspecified  	O	null
47 ו ו וחברים conjunction unspecified unspecified unspecified unspecified unspecified 0 
47 חברים חבר וחברים noun masculine plural absolute unspecified unspecified  	O	null
48 אחרים אחר אחרים adjective masculine plural absolute unspecified unspecified  	O	null
49 ש ש שנפלו relativizer/subordinatingConjunction unspecified unspecified unspecified unspecified unspecified 0 
49 נפלו נפל שנפלו verb masculine-and-feminine plural unspecified 3 past  	O	null
50 ב ב במלחמות preposition unspecified unspecified unspecified unspecified unspecified 0 
50 מלחמות מלחמה במלחמות noun feminine plural absolute unspecified unspecified  	O	null
51 ו ו ובני conjunction unspecified unspecified unspecified unspecified unspecified 0 
51 בני בן ובני noun masculine plural construct unspecified unspecified  	O	null
52 עם עם עמו preposition unspecified unspecified unspecified unspecified unspecified  
52 ו ו עמו pronomial masculine singular unspecified 3 unspecified 0 	O	null
53 ש ש שנספו relativizer/subordinatingConjunction unspecified unspecified unspecified unspecified unspecified 0 
53 נספו נספה שנספו verb masculine-and-feminine plural unspecified 3 past  	O	null
54 ב ב בשואה preposition unspecified unspecified unspecified unspecified unspecified 0 
54 ה ה בשואה definiteArticle unspecified unspecified unspecified unspecified unspecified 0 
54 השואה שואה בשואה noun feminine singular absolute unspecified unspecified  	O	null
55 . . . punctuation unspecified unspecified unspecified unspecified unspecified  	O	null

0 שירת שירה שירתו noun feminine singular absolute unspecified unspecified  
0 ו ו שירתו possessive masculine singular unspecified 3 unspecified 0 	O	null
1 מתאפיינת התאפיין מתאפיינת verb feminine singular unspecified any beinoni  	O	null
2 ב ב בפשטותה preposition unspecified unspecified unspecified unspecified unspecified 0 
2 פשטות פשטות בפשטותה noun feminine singular absolute unspecified unspecified  
2 ה ה בפשטותה possessive feminine singular unspecified 3 unspecified 0 	O	null
3 ה ה הלשונית definiteArticle unspecified unspecified unspecified unspecified unspecified 0 
3 הלשונית לשוני הלשונית adjective feminine singular absolute unspecified unspecified  	O	null
4 ו ו והתחבירית conjunction unspecified unspecified unspecified unspecified unspecified 0 
4 ה ה והתחבירית definiteArticle unspecified unspecified unspecified unspecified unspecified 0 
4 התחבירית תחבירי והתחבירית adjective feminine singular absolute unspecified unspecified  	O	null
5 , , , punctuation unspecified unspecified unspecified unspecified unspecified  	O	null
6 ב ב במבנים preposition unspecified unspecified unspecified unspecified unspecified 0 
6 מבנים מבנה במבנים noun masculine plural absolute unspecified unspecified  	O	null
7 גמישים גמיש גמישים adjective masculine plural absolute unspecified unspecified  	O	null
8 של של של shel-preposition unspecified unspecified unspecified unspecified unspecified  	O	null
9 חרוז חרוז חרוז noun masculine singular absolute unspecified unspecified  	O	null
10 ו ו ובית conjunction unspecified unspecified unspecified unspecified unspecified 0 
10 בית בית ובית noun masculine singular absolute unspecified unspecified  	O	null
11 ו ו ובממד conjunction unspecified unspecified unspecified unspecified unspecified 0 
11 ב ב ובממד preposition unspecified unspecified unspecified unspecified unspecified 0 
11 ממד ממד ובממד noun masculine singular absolute unspecified unspecified  	O	null
12 סמלי סמלי סמלי adjective masculine singular absolute unspecified unspecified  	O	null
13 ה ה הנבנה definiteArticle unspecified unspecified unspecified unspecified unspecified 0 
13 הנבנה נבנה הנבנה participle masculine singular absolute any unspecified  	O	null
14 על על על preposition unspecified unspecified unspecified unspecified unspecified  	O	null
15 ידי יד ידי noun feminine plural construct unspecified unspecified  	O	null
16 דיאלוג דיאלוג דיאלוג noun masculine singular absolute unspecified unspecified  	O	null
17 מורכב מורכב מורכב adjective masculine singular absolute unspecified unspecified  	O	null
18 עם עם עם preposition unspecified unspecified unspecified unspecified unspecified  	O	null
19 ה ה המקרא definiteArticle unspecified unspecified unspecified unspecified unspecified 0 
19 המקרא מקרא המקרא noun masculine singular absolute unspecified unspecified  	O	null
20 ו ו והמדרש conjunction unspecified unspecified unspecified unspecified unspecified 0 
20 ה ה והמדרש definiteArticle unspecified unspecified unspecified unspecified unspecified 0 
20 המדרש מדרש והמדרש noun masculine singular absolute unspecified unspecified  	O	null
21 ו ו ועושר conjunction unspecified unspecified unspecified unspecified unspecified 0 
21 עושר עושר ועושר noun masculine singular absolute unspecified unspecified  	O	null
22 ציורי ציורי ציורי adjective masculine singular absolute unspecified unspecified  	O	null
23 של של של shel-preposition unspecified unspecified unspecified unspecified unspecified  	O	null
24 תיאורי תיאור תיאורי noun masculine plural construct unspecified unspecified  	O	null
25 טבע טבע טבע noun masculine singular absolute unspecified unspecified  	O	null
26 ה ה המשקפים definiteArticle unspecified unspecified unspecified unspecified unspecified 0 
26 המשקפים שיקף המשקפים participle masculine plural absolute any unspecified  	O	null
27 מצבים מצב מצבים noun masculine plural absolute unspecified unspecified  	O	null
28 ו ו ורגשות conjunction unspecified unspecified unspecified unspecified unspecified 0 
28 רגשות רגש ורגשות noun masculine plural absolute unspecified unspecified  	O	null
29 אנושיים אנושי אנושיים adjective masculine plural absolute unspecified unspecified  	O	null
30 . . . punctuation unspecified unspecified unspecified unspecified unspecified  	O	null

0 ספרי ספר ספרי noun masculine plural construct unspecified unspecified  	O	null
1 ה ה הפרוזה definiteArticle unspecified unspecified unspecified unspecified unspecified 0 
1 הפרוזה פרוזה הפרוזה noun feminine singular absolute unspecified unspecified  	O	null
2 של של שלו shel-preposition unspecified unspecified unspecified unspecified unspecified  
2 ו ו שלו pronomial masculine singular unspecified 3 unspecified 0 	O	null
3 מ מ מראות preposition unspecified unspecified unspecified unspecified unspecified 0 
3 ראות ראות מראות noun feminine singular construct unspecified unspecified  	O	null
4 הגלבוע גלבוע הגלבוע properName unspecified unspecified unspecified unspecified unspecified  	I_LOC	null
5 ) ) ) punctuation unspecified unspecified unspecified unspecified unspecified  	O	null
6 , , , punctuation unspecified unspecified unspecified unspecified unspecified  	O	null
7 שיחה שיחה שיחה noun feminine singular absolute unspecified unspecified  	I_DATE	null
8 ###NUMBER### ###NUMBER### ###NUMBER### numeral unspecified unspecified unspecified unspecified unspecified  	I_DATE	null
9 על על על preposition unspecified unspecified unspecified unspecified unspecified  	O	null
10 ה ה החוף definiteArticle unspecified unspecified unspecified unspecified unspecified 0 
10 החוף חוף החוף noun masculine singular absolute unspecified unspecified  	O	null
11 ( ( ( punctuation unspecified unspecified unspecified unspecified unspecified  	O	null
12 ###NUMBER### ###NUMBER### ###NUMBER### numeral unspecified unspecified unspecified unspecified unspecified  	I_DATE	null
13 ) ) ) punctuation unspecified unspecified unspecified unspecified unspecified  	O	null
14 ו ו ושרשי conjunction unspecified unspecified unspecified unspecified unspecified 0 
14 שרשי שירש ושרשי verb feminine singular unspecified 2 imperative  	O	null
15 ה ה הנחל definiteArticle unspecified unspecified unspecified unspecified unspecified 0 
15 הנחל נחל הנחל noun masculine singular absolute unspecified unspecified  	O	null
16 ( ( ( punctuation unspecified unspecified unspecified unspecified unspecified  	O	null
17 ###NUMBER### ###NUMBER### ###NUMBER### numeral unspecified unspecified unspecified unspecified unspecified  	I_DATE	null
18 ) ) ) punctuation unspecified unspecified unspecified unspecified unspecified  	O	null
19 הם הוא הם pronoun masculine plural unspecified 3 unspecified  	O	null
20 סיפורי סיפור סיפורי noun masculine plural construct unspecified unspecified  	O	null
21 ילדות ילדות ילדות noun feminine singular absolute unspecified unspecified  	O	null
22 , , , punctuation unspecified unspecified unspecified unspecified unspecified  	O	null
23 נעורים נעורים נעורים properName unspecified unspecified unspecified unspecified unspecified  	I_PERS	null
24 ו ו ועלומים conjunction unspecified unspecified unspecified unspecified unspecified 0 
24 עלומים עלום ועלומים adjective masculine plural absolute unspecified unspecified  	O	null
25 ה ה המתארים definiteArticle unspecified unspecified unspecified unspecified unspecified 0 
25 המתארים תיאר המתארים participle masculine plural absolute any unspecified  	O	null
26 את את את at-preposition unspecified unspecified unspecified unspecified unspecified  	O	null
27 ה ה החיים definiteArticle unspecified unspecified unspecified unspecified unspecified 0 
27 החיים חיים החיים noun masculine plural absolute unspecified unspecified  	O	null
28 ב ב בקיבוץ preposition unspecified unspecified unspecified unspecified unspecified 0 
28 ה ה בקיבוץ definiteArticle unspecified unspecified unspecified unspecified unspecified 0 
28 הקיבוץ קיבוץ בקיבוץ noun masculine singular absolute unspecified unspecified  	O	null
29 ו ו ואת conjunction unspecified unspecified unspecified unspecified unspecified 0 
29 את את ואת at-preposition unspecified unspecified unspecified unspecified unspecified  	O	null
30 הווי היווה הווי verb feminine singular unspecified 2 imperative  	I_ORG	null
31 הפלמ"ח פלמ"ח הפלמ"ח properName unspecified unspecified unspecified unspecified unspecified  	I_ORG	null
32 ו ו ומשלבים conjunction unspecified unspecified unspecified unspecified unspecified 0 
32 משלבים שילב ומשלבים verb masculine plural unspecified any beinoni  	O	null
33 התבוננות התבוננות התבוננות noun feminine singular absolute unspecified unspecified  	O	null
34 ב ב בטבע preposition unspecified unspecified unspecified unspecified unspecified 0 
34 ה ה בטבע definiteArticle unspecified unspecified unspecified unspecified unspecified 0 
34 הטבע טבע בטבע noun masculine singular absolute unspecified unspecified  	O	null
35 ו ו ובצמיחתו conjunction unspecified unspecified unspecified unspecified unspecified 0 
35 ב ב ובצמיחתו preposition unspecified unspecified unspecified unspecified unspecified 0 
35 צמיחת צמיחה ובצמיחתו noun feminine singular absolute unspecified unspecified  
35 ו ו ובצמיחתו possessive masculine singular unspecified 3 unspecified 0 	O	null
36 של של של shel-preposition unspecified unspecified unspecified unspecified unspecified  	O	null
37 ה ה היישוב definiteArticle unspecified unspecified unspecified unspecified unspecified 0 
37 היישוב יישוב היישוב noun masculine singular absolute unspecified unspecified  	O	null
38 ב ב בנוף preposition unspecified unspecified unspecified unspecified unspecified 0 
38 ה ה בנוף definiteArticle unspecified unspecified unspecified unspecified unspecified 0 
38 הנוף נוף בנוף noun masculine singular absolute unspecified unspecified  	O	null
39 ה ה המתחדש definiteArticle unspecified unspecified unspecified unspecified unspecified 0 
39 המתחדש התחדש המתחדש participle masculine singular absolute any unspecified  	O	null
40 , , , punctuation unspecified unspecified unspecified unspecified unspecified  	O	null
41 עם עם עם preposition unspecified unspecified unspecified unspecified unspecified  	O	null
42 התייחסות התייחסות התייחסות noun feminine singular absolute unspecified unspecified  	O	null
43 ל ל לטבע preposition unspecified unspecified unspecified unspecified unspecified 0 
43 ה ה לטבע definiteArticle unspecified unspecified unspecified unspecified unspecified 0 
43 הטבע טבע לטבע noun masculine singular absolute unspecified unspecified  	O	null
44 כ כ ככלי preposition unspecified unspecified unspecified unspecified unspecified 0 
44 כלי כלי ככלי noun masculine singular absolute unspecified unspecified  	O	null
45 ל ל לביטוי preposition unspecified unspecified unspecified unspecified unspecified 0 
45 ביטוי ביטוי לביטוי noun masculine singular construct unspecified unspecified  	O	null
46 חוויות חוויה חוויות noun feminine plural absolute unspecified unspecified  	O	null
47 אנושיות אנושי אנושיות adjective feminine plural absolute unspecified unspecified  	O	null
48 . . . punctuation unspecified unspecified unspecified unspecified unspecified  	O	null

0 ה ה הסיפורים definiteArticle unspecified unspecified unspecified unspecified unspecified 0 
0 הסיפורים סיפור הסיפורים noun masculine plural absolute unspecified unspecified  	O	null
1 מעלים העלה מעלים verb masculine plural unspecified any beinoni  	O	null
2 סוגיות סוגיה סוגיות noun feminine plural absolute unspecified unspecified  	O	null
3 ה ה הקשורות definiteArticle unspecified unspecified unspecified unspecified unspecified 0 
3 הקשורות קשר הקשורות participle feminine plural absolute any unspecified  	O	null
4 ב ב בקונפליקט preposition unspecified unspecified unspecified unspecified unspecified 0 
4 ה ה בקונפליקט definiteArticle unspecified unspecified unspecified unspecified unspecified 0 
4 הקונפליקט קונפליקט בקונפליקט noun masculine singular absolute unspecified unspecified  	O	null
5 בין בין בין preposition unspecified unspecified unspecified unspecified unspecified  	O	null
6 ה ה היחיד definiteArticle unspecified unspecified unspecified unspecified unspecified 0 
6 היחיד יחיד היחיד adjective masculine singular absolute unspecified unspecified  	O	null
7 ל ל לקבוצה preposition unspecified unspecified unspecified unspecified unspecified 0 
7 ה ה לקבוצה definiteArticle unspecified unspecified unspecified unspecified unspecified 0 
7 הקבוצה קבוצה לקבוצה noun feminine singular absolute unspecified unspecified  	O	null
8 . . . punctuation unspecified unspecified unspecified unspecified unspecified  	O	null

0 ספר ספר ספרו noun masculine singular absolute unspecified unspecified  
0 ו ו ספרו possessive masculine singular unspecified 3 unspecified 0 	O	null
1 ה ה האוטוביוגרפי definiteArticle unspecified unspecified unspecified unspecified unspecified 0 
1 האוטוביוגרפי אוטוביוגרפי האוטוביוגרפי adjective masculine singular absolute unspecified unspecified  	O	null
2 Gideon’s Gideon’s Gideon’s foreign unspecified unspecified unspecified unspecified unspecified  	O	null
3 Spring Spring Spring foreign unspecified unspecified unspecified unspecified unspecified  	O	null
4 A A A foreign unspecified unspecified unspecified unspecified unspecified  	I_ORG	null
5 Man Man Man foreign unspecified unspecified unspecified unspecified unspecified  	I_ORG	null
6 and and and foreign unspecified unspecified unspecified unspecified unspecified  	I_ORG	null
7 his his his foreign unspecified unspecified unspecified unspecified unspecified  	I_ORG	null
8 Kibbutz Kibbutz Kibbutz foreign unspecified unspecified unspecified unspecified unspecified  	I_ORG	null
9 ( ( ( punctuation unspecified unspecified unspecified unspecified unspecified  	O	null
10 ###NUMBER### ###NUMBER### ###NUMBER### numeral unspecified unspecified unspecified unspecified unspecified  	I_DATE	null
11 ) ) ) punctuation unspecified unspecified unspecified unspecified unspecified  	O	null
12 נכתב נכתב נכתב verb masculine singular unspecified 3 past  	O	null
13 ב ב באנגלית preposition unspecified unspecified unspecified unspecified unspecified 0 
13 אנגלית אנגלית באנגלית properName feminine singular unspecified unspecified unspecified  	O	null
14 ב ב בשיתוף preposition unspecified unspecified unspecified unspecified unspecified 0 
14 שיתוף שיתוף בשיתוף noun masculine singular construct unspecified unspecified  	O	null
15 עם עם עם noun masculine singular construct unspecified unspecified  	O	null
16 דורותיאה דורותיאה דורותיאה properName unspecified unspecified unspecified unspecified unspecified  	I_PERS	null
17 קרוק קרוק קרוק properName unspecified unspecified unspecified unspecified unspecified  	I_PERS	null
18 - - - properName unspecified unspecified unspecified unspecified unspecified  	I_PERS	null
19 גלעד גלעד גלעד properName unspecified unspecified unspecified unspecified unspecified  	I_PERS	null
20 , , , punctuation unspecified unspecified unspecified unspecified unspecified  	O	null
21 ב ב במטרה preposition unspecified unspecified unspecified unspecified unspecified 0 
21 ה ה במטרה definiteArticle unspecified unspecified unspecified unspecified unspecified 0 
21 המטרה מטרה במטרה noun feminine singular absolute unspecified unspecified  	O	null
22 להציג הציג להציג verb unspecified unspecified unspecified unspecified infinitive  	O	null
23 דרך דרך דרך preposition unspecified unspecified unspecified unspecified unspecified  	O	null
24 חיי חיים חייו noun masculine plural absolute unspecified unspecified  
24 ו ו חייו possessive masculine singular unspecified 3 unspecified 0 	O	null
25 את את את at-preposition unspecified unspecified unspecified unspecified unspecified  	O	null
26 סיפור סיפור סיפורו noun masculine singular absolute unspecified unspecified  
26 ו ו סיפורו possessive masculine singular unspecified 3 unspecified 0 	O	null
27 של של של shel-preposition unspecified unspecified unspecified unspecified unspecified  	O	null
28 דור דור דור properName unspecified unspecified unspecified unspecified unspecified  	I_PERS	null
29 ה ה החלוצים definiteArticle unspecified unspecified unspecified unspecified unspecified 0 
29 החלוצים חלוץ החלוצים noun masculine plural absolute unspecified unspecified  	O	null
30 ב ב בעמק preposition unspecified unspecified unspecified unspecified unspecified 0 
30 ה ה בעמק definiteArticle unspecified unspecified unspecified unspecified unspecified 0 
30 העמק עמק בעמק noun masculine singular absolute unspecified unspecified  	O	null
31 ו ו ואת conjunction unspecified unspecified unspecified unspecified unspecified 0 
31 את את ואת at-preposition unspecified unspecified unspecified unspecified unspecified  	O	null
32 מאבק מאבק מאבק noun masculine singular construct unspecified unspecified  	O	null
33 ה ה התקומה definiteArticle unspecified unspecified unspecified unspecified unspecified 0 
33 התקומה תקומה התקומה noun feminine singular absolute unspecified unspecified  	O	null
34 של של של shel-preposition unspecified unspecified unspecified unspecified unspecified  	O	null
35 ישראל ישראל ישראל properName unspecified unspecified unspecified unspecified unspecified  	I_LOC	null
36 ( ( ( punctuation unspecified unspecified unspecified unspecified unspecified  	O	null
37 תורגם תורגם תורגם verb masculine singular unspecified 3 past  	O	null
38 ל ל לעברית preposition unspecified unspecified unspecified unspecified unspecified 0 
38 עברית עברית לעברית properName feminine singular unspecified unspecified unspecified  	I_PERS	null
39 , , , punctuation unspecified unspecified unspecified unspecified unspecified  	O	null
40 ###NUMBER### ###NUMBER### ###NUMBER### numeral unspecified unspecified unspecified unspecified unspecified  	I_DATE	null
41 ) ) ) punctuation unspecified unspecified unspecified unspecified unspecified  	O	null
42 . . . punctuation unspecified unspecified unspecified unspecified unspecified  	O	null

0 ה ה הספר definiteArticle unspecified unspecified unspecified unspecified unspecified 0 
0 הספר ספר הספר noun masculine singular absolute unspecified unspecified  	O	null
1 כולל כלל כולל verb masculine singular unspecified any beinoni  	O	null
2 גם גם גם conjunction unspecified unspecified unspecified unspecified unspecified  	O	null
3 זיכרונות זיכרון זיכרונות noun masculine plural absolute unspecified unspecified  	O	null
4 ו ו ורשמים conjunction unspecified unspecified unspecified unspecified unspecified 0 
4 רשמים רושם ורשמים noun masculine plural absolute unspecified unspecified  	O	null
5 מ מ מאישים preposition unspecified unspecified unspecified unspecified unspecified 0 
5 אישים אישים מאישים noun masculine plural absolute unspecified unspecified  	O	null
6 ש ש שהכיר relativizer/subordinatingConjunction unspecified unspecified unspecified unspecified unspecified 0 
6 הכיר הכיר שהכיר verb masculine singular unspecified 3 past  	O	null
7 , , , punctuation unspecified unspecified unspecified unspecified unspecified  	O	null
8 ו ו ובהם conjunction unspecified unspecified unspecified unspecified unspecified 0 
8 ב ב ובהם preposition unspecified unspecified unspecified unspecified unspecified  
8 הם הם ובהם pronomial masculine plural unspecified 3 unspecified 0 	O	null
9 יצחק יצחק יצחק properName unspecified unspecified unspecified unspecified unspecified  	I_PERS	null
10 טבנקין טבנקין טבנקין properName unspecified unspecified unspecified unspecified unspecified  	I_PERS	null
11 , , , punctuation unspecified unspecified unspecified unspecified unspecified  	O	null
12 ברל ברל ברל properName unspecified unspecified unspecified unspecified unspecified  	I_PERS	null
13 כצנלסון כצנלסון כצנלסון properName unspecified unspecified unspecified unspecified unspecified  	I_PERS	null
14 , , , punctuation unspecified unspecified unspecified unspecified unspecified  	O	null
15 יצחק יצחק יצחק properName unspecified unspecified unspecified unspecified unspecified  	I_PERS	null
16 צוקרמן צוקרמן צוקרמן properName unspecified unspecified unspecified unspecified unspecified  	I_PERS	null
17 ו ו וצביה conjunction unspecified unspecified unspecified unspecified unspecified 0 
17 צביה צביה וצביה properName unspecified unspecified unspecified unspecified unspecified  	B_PERS	null
18 לובטקין לובטקין לובטקין properName unspecified unspecified unspecified unspecified unspecified  	I_PERS	null
19 , , , punctuation unspecified unspecified unspecified unspecified unspecified  	O	null
20 יצחק יצחק יצחק properName unspecified unspecified unspecified unspecified unspecified  	I_PERS	null
21 שדה שדה שדה properName unspecified unspecified unspecified unspecified unspecified  	I_PERS	null
22 ו ו ויגאל conjunction unspecified unspecified unspecified unspecified unspecified 0 
22 יגאל יגאל ויגאל properName unspecified unspecified unspecified unspecified unspecified  	B_PERS	null
23 אלון אלון אלון properName unspecified unspecified unspecified unspecified unspecified  	I_PERS	null
24 , , , punctuation unspecified unspecified unspecified unspecified unspecified  	O	null
25 חיים חיים חיים properName unspecified unspecified unspecified unspecified unspecified  	I_PERS	null
26 הזז הזיז הזז verb masculine singular unspecified 2 imperative  	O	null
27 ו ו ואחרים conjunction unspecified unspecified unspecified unspecified unspecified 0 
27 אחרים אחר ואחרים adjective masculine plural absolute unspecified unspecified  	O	null
28 . . . punctuation unspecified unspecified unspecified unspecified unspecified  	O	null

0 שירי שיר שירי noun masculine plural construct unspecified unspecified  	O	null
1 ה ה הילדים definiteArticle unspecified unspecified unspecified unspecified unspecified 0 
1 הילדים ילד הילדים noun masculine plural absolute unspecified unspecified  	O	null
2 של של שלו shel-preposition unspecified unspecified unspecified unspecified unspecified  
2 ו ו שלו pronomial masculine singular unspecified 3 unspecified 0 	O	null
3 , , , punctuation unspecified unspecified unspecified unspecified unspecified  	O	null
4 ש ש שרובם relativizer/subordinatingConjunction unspecified unspecified unspecified unspecified unspecified 0 
4 רוב רוב שרובם noun masculine singular absolute unspecified unspecified  
4 ם ם שרובם possessive masculine plural unspecified 3 unspecified 0 	O	null
5 פורסמו פורסם פורסמו verb masculine-and-feminine plural unspecified 3 past  	O	null
6 ב ב בשבועוני preposition unspecified unspecified unspecified unspecified unspecified 0 
6 שבועוני שבועון בשבועוני noun masculine plural construct unspecified unspecified  	O	null
7 ה ה הילדים definiteArticle unspecified unspecified unspecified unspecified unspecified 0 
7 הילדים ילד הילדים noun masculine plural absolute unspecified unspecified  	O	null
8 ב ב בחתימה preposition unspecified unspecified unspecified unspecified unspecified 0 
8 ה ה בחתימה definiteArticle unspecified unspecified unspecified unspecified unspecified 0 
8 החתימה חתימה בחתימה noun feminine singular absolute unspecified unspecified  	O	null
9 " " " punctuation unspecified unspecified unspecified unspecified unspecified  	O	null
10 זרובבל זרובבל זרובבל properName unspecified unspecified unspecified unspecified unspecified  	I_ORG	null
11 " " " punctuation unspecified unspecified unspecified unspecified unspecified  	O	null
12 , , , punctuation unspecified unspecified unspecified unspecified unspecified  	O	null
13 כונסו כונס כונסו verb masculine-and-feminine plural unspecified 3 past  	O	null
14 ב ב בכמה preposition unspecified unspecified unspecified unspecified unspecified 0 
14 כמה כמה בכמה quantifier unspecified unspecified construct unspecified unspecified  	O	null
15 ספרים ספר ספרים noun masculine plural absolute unspecified unspecified  	O	null
16 . . . punctuation unspecified unspecified unspecified unspecified unspecified  	O	null

0 ב ב ב preposition unspecified unspecified unspecified unspecified unspecified 0 	O	null
1 - - - punctuation unspecified unspecified unspecified unspecified unspecified  	O	null
2 ###NUMBER### ###NUMBER### ###NUMBER### numeral unspecified unspecified unspecified unspecified unspecified  	I_DATE	null
3 כינס כינס כינס verb masculine singular unspecified 3 past  	O	null
4 ו ו וערך conjunction unspecified unspecified unspecified unspecified unspecified 0 
4 ערך ערך וערך verb masculine singular unspecified 3 past  	O	null
5 את את את at-preposition unspecified unspecified unspecified unspecified unspecified  	O	null
6 סיפורים סיפור סיפורים noun masculine plural absolute unspecified unspecified  	O	null
7 ל ל לילדים preposition unspecified unspecified unspecified unspecified unspecified 0 
7 ילדים ילד לילדים noun masculine plural absolute unspecified unspecified  	O	null
8 של של של shel-preposition unspecified unspecified unspecified unspecified unspecified  	O	null
9 יאנוש יאנוש יאנוש properName unspecified unspecified unspecified unspecified unspecified  	I_PERS	null
10 קורצ'אק קורצ'אק קורצ'אק properName unspecified unspecified unspecified unspecified unspecified  	I_PERS	null
11 , , , punctuation unspecified unspecified unspecified unspecified unspecified  	O	null
12 ש ש שאותו relativizer/subordinatingConjunction unspecified unspecified unspecified unspecified unspecified 0 
12 את את שאותו at-preposition unspecified unspecified unspecified unspecified unspecified  
12 ו ו שאותו pronomial masculine singular unspecified 3 unspecified 0 	O	null
13 פגש פגש פגש verb masculine singular unspecified 3 past  	I_LOC	null
14 ב ב בעין preposition unspecified unspecified unspecified unspecified unspecified 0 
14 עין עין בעין properName unspecified unspecified unspecified unspecified unspecified  	I_LOC	null
15 חרוד חרוד חרוד noun masculine singular absolute unspecified unspecified  	O	null
16 ו ו ובפולין conjunction unspecified unspecified unspecified unspecified unspecified 0 
16 ב ב ובפולין preposition unspecified unspecified unspecified unspecified unspecified 0 
16 פולין פולין ובפולין properName unspecified unspecified unspecified unspecified unspecified  	I_LOC	null
17 ב ב בשנים preposition unspecified unspecified unspecified unspecified unspecified 0 
17 שנים שנה בשנים noun feminine plural absolute unspecified unspecified  	O	null
18 ש ש שלפני relativizer/subordinatingConjunction unspecified unspecified unspecified unspecified unspecified 0 
18 לפני לפני שלפני preposition unspecified unspecified unspecified unspecified unspecified  	O	null
19 מלחמת מלחמה מלחמת noun feminine singular construct unspecified unspecified  	O	null
20 ה ה העולם definiteArticle unspecified unspecified unspecified unspecified unspecified 0 
20 העולם עולם העולם noun masculine singular absolute unspecified unspecified  	O	null
21 ה ה השנייה definiteArticle unspecified unspecified unspecified unspecified unspecified 0 
21 השנייה ORD2 השנייה numeral feminine singular absolute unspecified unspecified  	O	null
22 ו ו ואל conjunction unspecified unspecified unspecified unspecified unspecified 0 
22 אל אל ואל preposition unspecified unspecified unspecified unspecified unspecified  	O	null
23 דמות דמות דמותו noun feminine singular absolute unspecified unspecified  
23 ו ו דמותו possessive masculine singular unspecified 3 unspecified 0 	O	null
24 ו ו וגורלה conjunction unspecified unspecified unspecified unspecified unspecified 0 
24 גורל גורל וגורלה noun masculine singular absolute unspecified unspecified  
24 ה ה וגורלה possessive feminine singular unspecified 3 unspecified 0 	O	null
25 התייחס התייחס התייחס verb masculine singular unspecified 3 past  	O	null
26 ב ב ברשימותיו preposition unspecified unspecified unspecified unspecified unspecified 0 
26 רשימות רשימה ברשימותיו noun feminine plural absolute unspecified unspecified  
26 ו ו ברשימותיו possessive masculine singular unspecified 3 unspecified 0 	O	null
27 ו ו ובשיריו conjunction unspecified unspecified unspecified unspecified unspecified 0 
27 ב ב ובשיריו preposition unspecified unspecified unspecified unspecified unspecified 0 
27 שירי שיר ובשיריו noun masculine plural absolute unspecified unspecified  
27 ו ו ובשיריו possessive masculine singular unspecified 3 unspecified 0 	O	null
28 . . . punctuation unspecified unspecified unspecified unspecified unspecified  	O	null

0 היה הוא היה copula masculine singular unspecified 3 past  	O	null
1 פעיל פעיל פעיל adjective masculine singular absolute unspecified unspecified  	O	null
2 שנים שנה שנים noun feminine plural absolute unspecified unspecified  	O	null
3 רבות רב רבות adjective feminine plural absolute unspecified unspecified  	O	null
4 כ כ כעורך preposition unspecified unspecified unspecified unspecified unspecified 0 
4 ה ה כעורך definiteArticle unspecified unspecified unspecified unspecified unspecified 0 
4 העורך עורך כעורך noun masculine singular absolute unspecified unspecified  	O	null
5 : : : punctuation unspecified unspecified unspecified unspecified unspecified  	O	null
6 ערך ערך ערך verb masculine singular unspecified 3 past  	O	null
7 את את את at-preposition unspecified unspecified unspecified unspecified unspecified  	O	null
8 עיתון עיתון עיתון noun masculine singular construct unspecified unspecified  	O	null
9 ה ה הפלמ"ח definiteArticle unspecified unspecified unspecified unspecified unspecified 0 
9 הפלמ"ח פלמ"ח הפלמ"ח properName masculine singular unspecified unspecified unspecified  	I_ORG	null
10 - - - punctuation unspecified unspecified unspecified unspecified unspecified  	O	null
11 ###NUMBER### ###NUMBER### ###NUMBER### numeral unspecified unspecified unspecified unspecified unspecified  	I_DATE	null
12 ) ) ) punctuation unspecified unspecified unspecified unspecified unspecified  	O	null
13 ; ; ; punctuation unspecified unspecified unspecified unspecified unspecified  	O	null
14 ###NUMBER### ###NUMBER### ###NUMBER### numeral unspecified unspecified unspecified unspecified unspecified  	I_DATE	null
15 את את את at-preposition unspecified unspecified unspecified unspecified unspecified  	O	null
16 ה ה הספר definiteArticle unspecified unspecified unspecified unspecified unspecified 0 
16 הספר ספר הספר noun masculine singular absolute unspecified unspecified  	O	null
17 מ מ מגן preposition unspecified unspecified unspecified unspecified unspecified 0 
17 גן גן מגן noun masculine singular absolute unspecified unspecified  	O	null
18 ב ב בסתר preposition unspecified unspecified unspecified unspecified unspecified 0 
18 סתר סתר בסתר noun masculine singular absolute unspecified unspecified  	O	null
19 ו ו ובו conjunction unspecified unspecified unspecified unspecified unspecified 0 
19 ב ב ובו preposition unspecified unspecified unspecified unspecified unspecified  
19 ו ו ובו pronomial masculine singular unspecified 3 unspecified 0 	O	null
20 עדויות עדות עדויות noun feminine plural absolute unspecified unspecified  	O	null
21 ו ו ורשימות conjunction unspecified unspecified unspecified unspecified unspecified 0 
21 רשימות רשימה ורשימות noun feminine plural absolute unspecified unspecified  	O	null
22 ש ש שתיעדו relativizer/subordinatingConjunction unspecified unspecified unspecified unspecified unspecified 0 
22 תיעדו תיעד שתיעדו verb masculine-and-feminine plural unspecified 3 past  	O	null
23 את את את at-preposition unspecified unspecified unspecified unspecified unspecified  	O	null
24 ה ה הפעולות definiteArticle unspecified unspecified unspecified unspecified unspecified 0 
24 הפעולות פעולה הפעולות noun feminine plural absolute unspecified unspecified  	O	null
25 ה ה העלומות definiteArticle unspecified unspecified unspecified unspecified unspecified 0 
25 העלומות עלום העלומות adjective feminine plural absolute unspecified unspecified  	O	null
26 של של של shel-preposition unspecified unspecified unspecified unspecified unspecified  	O	null
27 " " " punctuation unspecified unspecified unspecified unspecified unspecified  	O	null
28 ה ה ההגנה definiteArticle unspecified unspecified unspecified unspecified unspecified 0 
28 ההגנה הגנה ההגנה noun feminine singular absolute unspecified unspecified  	O	null
29 " " " punctuation unspecified unspecified unspecified unspecified unspecified  	O	null
30 נגד נגד נגד preposition unspecified unspecified unspecified unspecified unspecified  	O	null
31 ה ה הנאצים definiteArticle unspecified unspecified unspecified unspecified unspecified 0 
31 הנאצים נאצי הנאצים noun masculine plural absolute unspecified unspecified  	O	null
32 ב ב בשיתוף preposition unspecified unspecified unspecified unspecified unspecified 0 
32 שיתוף שיתוף בשיתוף noun masculine singular construct unspecified unspecified  	O	null
33 בעלות בעלות בעלות noun feminine singular construct unspecified unspecified  	O	null
34 ה ה הברית;את definiteArticle unspecified unspecified unspecified unspecified unspecified 0 
34 הברית;את הברית;את הברית;את adjective feminine plural absolute unspecified unspecified  	O	null
35 ספר ספר ספר noun masculine singular construct unspecified unspecified  	O	null
36 הפלמ"ח פלמ"ח הפלמ"ח properName unspecified unspecified unspecified unspecified unspecified  	I_ORG	null
37 ) ) ) punctuation unspecified unspecified unspecified unspecified unspecified  	O	null
38 ; ; ; punctuation unspecified unspecified unspecified unspecified unspecified  	O	null
39 ###NUMBER### ###NUMBER### ###NUMBER### numeral unspecified unspecified unspecified unspecified unspecified  	I_DATE	null
40 ו ו וכאמור conjunction unspecified unspecified unspecified unspecified unspecified 0 
40 כ כ וכאמור preposition unspecified unspecified unspecified unspecified unspecified 0 
40 ה ה וכאמור definiteArticle unspecified unspecified unspecified unspecified unspecified 0 
40 האמור אמור וכאמור adjective masculine singular absolute unspecified unspecified  	O	null
41 את את את at-preposition unspecified unspecified unspecified unspecified unspecified  	O	null
42 ה ה הרבעון definiteArticle unspecified unspecified unspecified unspecified unspecified 0 
42 הרבעון רבעון הרבעון noun masculine singular absolute unspecified unspecified  	O	null
43 מבפנים מבפנים מבפנים adverb unspecified unspecified unspecified unspecified unspecified  	I_LOC	null
44 , , , punctuation unspecified unspecified unspecified unspecified unspecified  	O	null
45 ש ש שפירסם relativizer/subordinatingConjunction unspecified unspecified unspecified unspecified unspecified 0 
45 פירסם פרסם שפירסם verb masculine singular unspecified 3 past  	O	null
46 ב ב בו preposition unspecified unspecified unspecified unspecified unspecified  
46 ו ו בו pronomial masculine singular unspecified 3 unspecified 0 	O	null
47 מאמרים מאמר מאמרים noun masculine plural absolute unspecified unspecified  	O	null
48 ב ב בסוגיות preposition unspecified unspecified unspecified unspecified unspecified 0 
48 סוגיות סוגיה בסוגיות noun feminine plural absolute unspecified unspecified  	O	null
49 פוליטיות פוליטי פוליטיות adjective feminine plural absolute unspecified unspecified  	O	null
50 , , , punctuation unspecified unspecified unspecified unspecified unspecified  	O	null
51 חברתיות חברתי חברתיות adjective feminine plural absolute unspecified unspecified  	O	null
52 ו ו וכלכליות conjunction unspecified unspecified unspecified unspecified unspecified 0 
52 כלכליות כלכלי וכלכליות adjective feminine plural absolute unspecified unspecified  	O	null
53 עם עם עם preposition unspecified unspecified unspecified unspecified unspecified  	O	null
54 דברי דבר דברי noun masculine plural construct unspecified unspecified  	O	null
55 ספרות ספרות ספרות noun feminine singular absolute unspecified unspecified  	O	null
56 . . . punctuation unspecified unspecified unspecified unspecified unspecified  	O	null

0 זכה זכה זכה verb masculine singular unspecified 3 past  	O	null
1 ב ב בפרס preposition unspecified unspecified unspecified unspecified unspecified 0 
1 פרס פרס בפרס noun masculine singular construct unspecified unspecified  	O	null
2 חולון חולון חולון properName unspecified unspecified unspecified unspecified unspecified  	I_LOC	null
3 ) ) ) punctuation unspecified unspecified unspecified unspecified unspecified  	O	null
4 , , , punctuation unspecified unspecified unspecified unspecified unspecified  	O	null
5 ###NUMBER### ###NUMBER### ###NUMBER### numeral unspecified unspecified unspecified unspecified unspecified  	I_DATE	null
6 ב ב בפרס preposition unspecified unspecified unspecified unspecified unspecified 0 
6 פרס פרס בפרס noun masculine singular construct unspecified unspecified  	O	null
7 ה ה היצירה definiteArticle unspecified unspecified unspecified unspecified unspecified 0 
7 היצירה יצירה היצירה noun feminine singular absolute unspecified unspecified  	O	null
8 על על על preposition unspecified unspecified unspecified unspecified unspecified  	O	null
9 שם שם שם noun masculine singular construct unspecified unspecified  	O	null
10 ראש ראש ראש noun masculine singular construct unspecified unspecified  	O	null
11 ה ה הממשלה definiteArticle unspecified unspecified unspecified unspecified unspecified 0 
11 הממשלה ממשלה הממשלה noun feminine singular absolute unspecified unspecified  	O	null
12 לוי לוי לוי properName unspecified unspecified unspecified unspecified unspecified  	I_PERS	null
13 אשכול אשכול אשכול properName unspecified unspecified unspecified unspecified unspecified  	I_PERS	null
14 ( ( ( punctuation unspecified unspecified unspecified unspecified unspecified  	O	null
15 ###NUMBER### ###NUMBER### ###NUMBER### numeral unspecified unspecified unspecified unspecified unspecified  	I_DATE	null
16 ) ) ) punctuation unspecified unspecified unspecified unspecified unspecified  	O	null
17 ו ו ובפרס conjunction unspecified unspecified unspecified unspecified unspecified 0 
17 ב ב ובפרס preposition unspecified unspecified unspecified unspecified unspecified 0 
17 פרס פרס ובפרס properName unspecified unspecified unspecified unspecified unspecified  	I_PERS	null
18 ביאליק ביאליק ביאליק properName unspecified unspecified unspecified unspecified unspecified  	I_PERS	null
19 ) ) ) punctuation unspecified unspecified unspecified unspecified unspecified  	O	null
20 . . . punctuation unspecified unspecified unspecified unspecified unspecified  	O	null
21 ###NUMBER### ###NUMBER### ###NUMBER### numeral unspecified unspecified unspecified unspecified unspecified  	I_DATE	null
22 References References References foreign unspecified unspecified unspecified unspecified unspecified  	O	null
23 : : : punctuation unspecified unspecified unspecified unspecified unspecified  	O	null
24 גורפיין גורפיין גורפיין properName unspecified unspecified unspecified unspecified unspecified  	I_ORG	null
25 - - - punctuation unspecified unspecified unspecified unspecified unspecified  	O	null
26 אוכמני אוכמני אוכמני properName unspecified unspecified unspecified unspecified unspecified  	I_ORG	null
27 , , , punctuation unspecified unspecified unspecified unspecified unspecified  	O	null
28 רבקה רבקה רבקה properName unspecified unspecified unspecified unspecified unspecified  	I_PERS	null
29 . . . punctuation unspecified unspecified unspecified unspecified unspecified  	O	null

0 " " " punctuation unspecified unspecified unspecified unspecified unspecified  	O	null
1 על על על preposition unspecified unspecified unspecified unspecified unspecified  	O	null
2 שני CARD2 שני numeral masculine dual construct unspecified unspecified  	O	null
3 שירים שיר שירים noun masculine plural absolute unspecified unspecified  	O	null
4 של של של shel-preposition unspecified unspecified unspecified unspecified unspecified  	O	null
5 זרובבל זרובבל זרובבל properName unspecified unspecified unspecified unspecified unspecified  	I_PERS	null
6 גלעד גלעד גלעד properName unspecified unspecified unspecified unspecified unspecified  	I_PERS	null
7 " " " punctuation unspecified unspecified unspecified unspecified unspecified  	O	null
8 . . . punctuation unspecified unspecified unspecified unspecified unspecified  	O	null

0 על על עלי preposition unspecified unspecified unspecified unspecified unspecified  
0 י י עלי pronomial masculine-and-feminine singular unspecified 1 unspecified 0 	O	null
1 שיח שיח שיח noun masculine singular absolute unspecified unspecified  	O	null
2 ###NUMBER### ###NUMBER### ###NUMBER### numeral unspecified unspecified unspecified unspecified unspecified  	O	null
3 . . . punctuation unspecified unspecified unspecified unspecified unspecified  	O	null

0 ###NUMBER### ###NUMBER### ###NUMBER### numeral unspecified unspecified unspecified unspecified unspecified  	I_DATE	null
1 . . . punctuation unspecified unspecified unspecified unspecified unspecified  	O	null

0 - - - punctuation unspecified unspecified unspecified unspecified unspecified  	O	null
1 ###NUMBER### ###NUMBER### ###NUMBER### numeral unspecified unspecified unspecified unspecified unspecified  	O	null
2 ; ; ; punctuation unspecified unspecified unspecified unspecified unspecified  	O	null
3 ###NUMBER### ###NUMBER### ###NUMBER### numeral unspecified unspecified unspecified unspecified unspecified  	O	null
4 זמורה זמורה זמורה noun feminine singular absolute unspecified unspecified  	O	null
5 , , , punctuation unspecified unspecified unspecified unspecified unspecified  	O	null
6 ישראל ישראל ישראל properName unspecified unspecified unspecified unspecified unspecified  	I_LOC	null
7 . . . punctuation unspecified unspecified unspecified unspecified unspecified  	O	null

0 " " " punctuation unspecified unspecified unspecified unspecified unspecified  	O	null
1 זרובבל זרובבל זרובבל properName unspecified unspecified unspecified unspecified unspecified  	I_PERS	null
2 גלעד גלעד גלעד properName unspecified unspecified unspecified unspecified unspecified  	I_PERS	null
3 משורר משורר משורר noun masculine singular construct unspecified unspecified  	O	null
4 ה ה הארץ definiteArticle unspecified unspecified unspecified unspecified unspecified 0 
4 הארץ ארץ הארץ noun feminine singular absolute unspecified unspecified  	O	null
5 " " " punctuation unspecified unspecified unspecified unspecified unspecified  	O	null
6 . . . punctuation unspecified unspecified unspecified unspecified unspecified  	O	null

0 מאזניים מאזניים מאזניים noun masculine plural absolute unspecified unspecified  	O	null
1 י"א י"א י"א properName unspecified unspecified unspecified unspecified unspecified  	I_PERS	null
2 ) ) ) punctuation unspecified unspecified unspecified unspecified unspecified  	O	null
3 . . . punctuation unspecified unspecified unspecified unspecified unspecified  	O	null
4 ###NUMBER### ###NUMBER### ###NUMBER### numeral unspecified unspecified unspecified unspecified unspecified  	O	null
5 ###NUMBER### ###NUMBER### ###NUMBER### numeral unspecified unspecified unspecified unspecified unspecified  	I_DATE	null
6 . . . punctuation unspecified unspecified unspecified unspecified unspecified  	O	null

0 - - - punctuation unspecified unspecified unspecified unspecified unspecified  	O	null
1 ###NUMBER### ###NUMBER### ###NUMBER### numeral unspecified unspecified unspecified unspecified unspecified  	O	null
2 ; ; ; punctuation unspecified unspecified unspecified unspecified unspecified  	O	null
3 ###NUMBER### ###NUMBER### ###NUMBER### numeral unspecified unspecified unspecified unspecified unspecified  	O	null
4 לוריא לוריא לוריא properName unspecified unspecified unspecified unspecified unspecified  	O	null
5 , , , punctuation unspecified unspecified unspecified unspecified unspecified  	O	null
6 שלום שלום שלום noun masculine singular absolute unspecified unspecified  	O	null
7 . . . punctuation unspecified unspecified unspecified unspecified unspecified  	O	null

0 " " " punctuation unspecified unspecified unspecified unspecified unspecified  	O	null
1 ראי ראי ראי noun masculine singular absolute unspecified unspecified  	O	null
2 זה זה זה pronoun masculine singular unspecified 3 unspecified  	O	null
3 כ כ כראי preposition unspecified unspecified unspecified unspecified unspecified 0 
3 ראי ראי כראי noun masculine singular absolute unspecified unspecified  	O	null
4 זה זה זה pronoun masculine singular unspecified 3 unspecified  	O	null
5 : : : punctuation unspecified unspecified unspecified unspecified unspecified  	O	null
6 עיון עיון עיון noun masculine singular absolute unspecified unspecified  	O	null
7 ב ב בספר preposition unspecified unspecified unspecified unspecified unspecified 0 
7 ספר ספר בספר noun masculine singular construct unspecified unspecified  	O	null
8 שירי שיר שיריו noun masculine plural absolute unspecified unspecified  
8 ו ו שיריו possessive masculine singular unspecified 3 unspecified 0 	O	null
9 של של של shel-preposition unspecified unspecified unspecified unspecified unspecified  	O	null
10 זרובבל זרובבל זרובבל properName unspecified unspecified unspecified unspecified unspecified  	I_PERS	null
11 גלעד גלעד גלעד properName unspecified unspecified unspecified unspecified unspecified  	I_PERS	null
12 ' ' ' punctuation unspecified unspecified unspecified unspecified unspecified  	O	null
13 גחלי גחלת גחלי noun feminine plural construct unspecified unspecified  	O	null
14 רתמים רתמים רתמים properName masculine singular unspecified unspecified unspecified  	I_ORG	null
15 ' ' ' punctuation unspecified unspecified unspecified unspecified unspecified  	O	null
16 " " " punctuation unspecified unspecified unspecified unspecified unspecified  	O	null
17 . . . punctuation unspecified unspecified unspecified unspecified unspecified  	O	null

0 עלישיח עלישיח עלישיח verb masculine plural unspecified any beinoni  	O	null
1 ###NUMBER### ###NUMBER### ###NUMBER### numeral unspecified unspecified unspecified unspecified unspecified  	O	null
2 - - - punctuation unspecified unspecified unspecified unspecified unspecified  	O	null
3 ###NUMBER### ###NUMBER### ###NUMBER### numeral unspecified unspecified unspecified unspecified unspecified  	O	null
4 . . . punctuation unspecified unspecified unspecified unspecified unspecified  	O	null

0 ###NUMBER### ###NUMBER### ###NUMBER### numeral unspecified unspecified unspecified unspecified unspecified  	I_DATE	null
1 . . . punctuation unspecified unspecified unspecified unspecified unspecified  	O	null

0 - - - punctuation unspecified unspecified unspecified unspecified unspecified  	O	null
1 ###NUMBER### ###NUMBER### ###NUMBER### numeral unspecified unspecified unspecified unspecified unspecified  	O	null
2 ; ; ; punctuation unspecified unspecified unspecified unspecified unspecified  	O	null
3 ###NUMBER### ###NUMBER### ###NUMBER### numeral unspecified unspecified unspecified unspecified unspecified  	O	null
4 שביט שביט שביט properName unspecified unspecified unspecified unspecified unspecified  	I_PERS	null
5 , , , punctuation unspecified unspecified unspecified unspecified unspecified  	O	null
6 עוזי עוזי עוזי properName unspecified unspecified unspecified unspecified unspecified  	I_PERS	null
7 . . . punctuation unspecified unspecified unspecified unspecified unspecified  	O	null

0 " " " punctuation unspecified unspecified unspecified unspecified unspecified  	O	null
1 אל אל אל preposition unspecified unspecified unspecified unspecified unspecified  	O	null
2 מול מול מול preposition unspecified unspecified unspecified unspecified unspecified  	O	null
3 שרשי שירש שרשי verb feminine singular unspecified 2 imperative  	O	null
4 ה ה הנחל definiteArticle unspecified unspecified unspecified unspecified unspecified 0 
4 הנחל נחל הנחל noun masculine singular absolute unspecified unspecified  	O	null
5 " " " punctuation unspecified unspecified unspecified unspecified unspecified  	O	null
6 . . . punctuation unspecified unspecified unspecified unspecified unspecified  	O	null

0 מאזניים מאזניים מאזניים noun masculine plural absolute unspecified unspecified  	O	null
1 מ"ד מ"ד מ"ד properName unspecified unspecified unspecified unspecified unspecified  	I_PERS	null
2 ) ) ) punctuation unspecified unspecified unspecified unspecified unspecified  	O	null
3 . . . punctuation unspecified unspecified unspecified unspecified unspecified  	O	null
4 ###NUMBER### ###NUMBER### ###NUMBER### numeral unspecified unspecified unspecified unspecified unspecified  	I_ORG	null
5 ###NUMBER### ###NUMBER### ###NUMBER### numeral unspecified unspecified unspecified unspecified unspecified  	I_DATE	null
6 . . . punctuation unspecified unspecified unspecified unspecified unspecified  	O	null

0 - - - punctuation unspecified unspecified unspecified unspecified unspecified  	O	null
1 ###NUMBER### ###NUMBER### ###NUMBER### numeral unspecified unspecified unspecified unspecified unspecified  	O	null
2 ; ; ; punctuation unspecified unspecified unspecified unspecified unspecified  	O	null
3 ###NUMBER### ###NUMBER### ###NUMBER### numeral unspecified unspecified unspecified unspecified unspecified  	O	null
4 שמיר שמיר שמיר properName unspecified unspecified unspecified unspecified unspecified  	I_PERS	null
5 , , , punctuation unspecified unspecified unspecified unspecified unspecified  	O	null
6 משה משה משה properName unspecified unspecified unspecified unspecified unspecified  	I_PERS	null
7 . . . punctuation unspecified unspecified unspecified unspecified unspecified  	O	null

0 " " " punctuation unspecified unspecified unspecified unspecified unspecified  	I_LOC	null
1 טל טל טל properName unspecified unspecified unspecified unspecified unspecified  	I_LOC	null
2 של של של shel-preposition unspecified unspecified unspecified unspecified unspecified  	O	null
3 בגרות בגרות בגרות noun feminine singular absolute unspecified unspecified  	O	null
4 " " " punctuation unspecified unspecified unspecified unspecified unspecified  	O	null
5 עניין עניין עניין noun masculine singular absolute unspecified unspecified  	O	null
6 אישי אישי אישי adjective masculine singular absolute unspecified unspecified  	O	null
7 . . . punctuation unspecified unspecified unspecified unspecified unspecified  	O	null

0 תל תל תל properName unspecified unspecified unspecified unspecified unspecified  	I_LOC	null
1 אביב אביב אביב properName unspecified unspecified unspecified unspecified unspecified  	I_LOC	null
2 : : : punctuation unspecified unspecified unspecified unspecified unspecified  	O	null
3 עם עם עם preposition unspecified unspecified unspecified unspecified unspecified  	O	null
4 עובד עובד עובד noun masculine singular absolute unspecified unspecified  	O	null
5 . . . punctuation unspecified unspecified unspecified unspecified unspecified  	O	null

0 ###NUMBER### ###NUMBER### ###NUMBER### numeral unspecified unspecified unspecified unspecified unspecified  	I_DATE	null
1 . . . punctuation unspecified unspecified unspecified unspecified unspecified  	O	null

0 ###NUMBER### ###NUMBER### ###NUMBER### numeral unspecified unspecified unspecified unspecified unspecified  	O	null
1 - - - punctuation unspecified unspecified unspecified unspecified unspecified  	O	null
2 ###NUMBER### ###NUMBER### ###NUMBER### numeral unspecified unspecified unspecified unspecified unspecified  	O	null
3 . . . punctuation unspecified unspecified unspecified unspecified unspecified  	O	null

