0 Name Name Name foreign unspecified unspecified unspecified unspecified unspecified  	O	null
1 : : : punctuation unspecified unspecified unspecified unspecified unspecified  	O	null
2 דוד דוד דוד properName unspecified unspecified unspecified unspecified unspecified  	I_ORG	null
3 ( ( ( punctuation unspecified unspecified unspecified unspecified unspecified  	O	null
4 דודזון דודזון דודזון properName unspecified unspecified unspecified unspecified unspecified  	I_ORG	null
5 ) ) ) punctuation unspecified unspecified unspecified unspecified unspecified  	O	null
6 , , , punctuation unspecified unspecified unspecified unspecified unspecified  	O	null
7 סנדו סנדו סנדו properName unspecified unspecified unspecified unspecified unspecified  	O	null
8 Birth Birth Birth foreign unspecified unspecified unspecified unspecified unspecified  	O	null
9 Year Year Year foreign unspecified unspecified unspecified unspecified unspecified  	O	null
10 : : : punctuation unspecified unspecified unspecified unspecified unspecified  	O	null
11 ###NUMBER### ###NUMBER### ###NUMBER### numeral unspecified unspecified unspecified unspecified unspecified  	I_DATE	null
12 Death Death Death foreign unspecified unspecified unspecified unspecified unspecified  	O	null
13 Year Year Year foreign unspecified unspecified unspecified unspecified unspecified  	O	null
14 : : : punctuation unspecified unspecified unspecified unspecified unspecified  	O	null
15 ###NUMBER### ###NUMBER### ###NUMBER### numeral unspecified unspecified unspecified unspecified unspecified  	I_DATE	null
16 Birth Birth Birth foreign unspecified unspecified unspecified unspecified unspecified  	O	null
17 Place Place Place foreign unspecified unspecified unspecified unspecified unspecified  	O	null
18 : : : punctuation unspecified unspecified unspecified unspecified unspecified  	O	null
19 טארגובישטה טארגובישטה טארגובישטה properName unspecified unspecified unspecified unspecified unspecified  	I_ORG	null
20 , , , punctuation unspecified unspecified unspecified unspecified unspecified  	O	null
21 רומניה רומני רומניה properName unspecified unspecified unspecified unspecified unspecified  	I_LOC	null
22 Occupation Occupation Occupation foreign unspecified unspecified unspecified unspecified unspecified  	O	null
23 : : : punctuation unspecified unspecified unspecified unspecified unspecified  	O	null
24 משוררומתרגם משוררומתרגם משוררומתרגם adjective masculine singular construct unspecified unspecified  	O	null
25 Entry Entry Entry foreign unspecified unspecified unspecified unspecified unspecified  	O	null
26 writer writer writer foreign unspecified unspecified unspecified unspecified unspecified  	O	null
27 : : : punctuation unspecified unspecified unspecified unspecified unspecified  	O	null
28 משה משה משה properName unspecified unspecified unspecified unspecified unspecified  	I_ORG	null
29 גרנות גורן גרנות noun feminine plural absolute unspecified unspecified  	O	null
30 Entry Entry Entry foreign unspecified unspecified unspecified unspecified unspecified  	O	null
31 Value Value Value foreign unspecified unspecified unspecified unspecified unspecified  	O	null
32 : : : punctuation unspecified unspecified unspecified unspecified unspecified  	O	null
33 נולד נולד נולד noun masculine singular absolute unspecified unspecified  	O	null
34 בטארגובישטה בטארגובישטה בטארגובישטה properName unspecified unspecified unspecified unspecified unspecified  	I_PERS	null
35 , , , punctuation unspecified unspecified unspecified unspecified unspecified  	O	null
36 רומניה רומני רומניה properName unspecified unspecified unspecified unspecified unspecified  	I_LOC	null
37 . . . punctuation unspecified unspecified unspecified unspecified unspecified  	O	null

0 ב ב במלחמת preposition unspecified unspecified unspecified unspecified unspecified 0 
0 מלחמת מלחמה במלחמת noun feminine singular construct unspecified unspecified  	O	null
1 ה ה העולם definiteArticle unspecified unspecified unspecified unspecified unspecified 0 
1 העולם עולם העולם noun masculine singular absolute unspecified unspecified  	O	null
2 ה ה השנייה definiteArticle unspecified unspecified unspecified unspecified unspecified 0 
2 השנייה ORD2 השנייה numeral feminine singular absolute unspecified unspecified  	O	null
3 הוגלה הוגלה הוגלה verb masculine singular unspecified 3 past  	O	null
4 ל ל למחנה preposition unspecified unspecified unspecified unspecified unspecified 0 
4 מחנה מחנה למחנה noun masculine singular construct unspecified unspecified  	O	null
5 ואפיניארקה ואפיניארקה ואפיניארקה properName unspecified unspecified unspecified unspecified unspecified  	I_PERS	null
6 ב ב בטרנסניסטריה preposition unspecified unspecified unspecified unspecified unspecified 0 
6 טרנסניסטריה טרנסניסטריה בטרנסניסטריה properName unspecified unspecified unspecified unspecified unspecified  	I_PERS	null
7 . . . punctuation unspecified unspecified unspecified unspecified unspecified  	O	null

0 עלה עלה עלה verb masculine singular unspecified 3 past  	O	null
1 ארצה ארצה ארצה adverb unspecified unspecified unspecified unspecified unspecified  	O	null
2 ב ב ב preposition unspecified unspecified unspecified unspecified unspecified 0 	I_ORG	null
3 - - - punctuation unspecified unspecified unspecified unspecified unspecified  	I_ORG	null
4 ###NUMBER### ###NUMBER### ###NUMBER### numeral unspecified unspecified unspecified unspecified unspecified  	I_DATE	null
5 . . . punctuation unspecified unspecified unspecified unspecified unspecified  	O	null

0 היה הוא היה copula masculine singular unspecified 3 past  	O	null
1 מ מ ממייסדי preposition unspecified unspecified unspecified unspecified unspecified 0 
1 מייסדי מייסד ממייסדי noun masculine plural construct unspecified unspecified  	O	null
2 מושב מושב מושב noun masculine singular construct unspecified unspecified  	I_LOC	null
3 עדנים עדנים עדנים properName masculine singular unspecified unspecified unspecified  	I_DATE	null
4 ו ו וחבר conjunction unspecified unspecified unspecified unspecified unspecified 0 
4 חבר חיבר וחבר verb masculine singular unspecified 2 imperative  	O	null
5 ב ב בו preposition unspecified unspecified unspecified unspecified unspecified  
5 ו ו בו pronomial masculine singular unspecified 3 unspecified 0 	O	null
6 מ מ מ preposition unspecified unspecified unspecified unspecified unspecified 0 	I_ORG	null
7 - - - punctuation unspecified unspecified unspecified unspecified unspecified  	I_ORG	null
8 ###NUMBER### ###NUMBER### ###NUMBER### numeral unspecified unspecified unspecified unspecified unspecified  	I_DATE	null
9 . . . punctuation unspecified unspecified unspecified unspecified unspecified  	O	null

0 שימש שימש שימש verb masculine singular unspecified 3 past  	O	null
1 כ כ כמנהל preposition unspecified unspecified unspecified unspecified unspecified 0 
1 מנהל מנהל כמנהל noun masculine singular construct unspecified unspecified  	O	null
2 ה ה המחלקה definiteArticle unspecified unspecified unspecified unspecified unspecified 0 
2 המחלקה מחלקה המחלקה noun feminine singular absolute unspecified unspecified  	O	null
3 ל ל להתיישבות preposition unspecified unspecified unspecified unspecified unspecified 0 
3 ה ה להתיישבות definiteArticle unspecified unspecified unspecified unspecified unspecified 0 
3 ההתיישבות התיישבות להתיישבות noun feminine singular absolute unspecified unspecified  	O	null
4 של של של shel-preposition unspecified unspecified unspecified unspecified unspecified  	O	null
5 מרכז מרכז מרכז noun masculine singular construct unspecified unspecified  	O	null
6 מפא"י מפא"י מפא"י properName unspecified unspecified unspecified unspecified unspecified  	I_ORG	null
7 ו ו והיה conjunction unspecified unspecified unspecified unspecified unspecified 0 
7 היה הוא והיה copula masculine singular unspecified 3 past  	O	null
8 פעיל פעיל פעיל adjective masculine singular absolute unspecified unspecified  	O	null
9 ב ב בתנועת preposition unspecified unspecified unspecified unspecified unspecified 0 
9 תנועת תנועה בתנועת noun feminine singular construct unspecified unspecified  	I_ORG	null
10 ה ה המושבים definiteArticle unspecified unspecified unspecified unspecified unspecified 0 
10 המושבים מושב המושבים noun masculine plural absolute unspecified unspecified  	I_ORG	null
11 . . . punctuation unspecified unspecified unspecified unspecified unspecified  	O	null

0 ב ב בשנים preposition unspecified unspecified unspecified unspecified unspecified 0 
0 שנים שנה בשנים noun feminine plural absolute unspecified unspecified  	O	null
1 ###NUMBER### ###NUMBER### ###NUMBER### numeral unspecified unspecified unspecified unspecified unspecified  	I_DATE	null
2 - - - punctuation unspecified unspecified unspecified unspecified unspecified  	O	null
3 ###NUMBER### ###NUMBER### ###NUMBER### numeral unspecified unspecified unspecified unspecified unspecified  	I_DATE	null
4 כיהן כיהן כיהן verb masculine singular unspecified 3 past  	O	null
5 כ כ כראש preposition unspecified unspecified unspecified unspecified unspecified 0 
5 ראש ראש כראש noun masculine singular construct unspecified unspecified  	O	null
6 ה ה המועצה definiteArticle unspecified unspecified unspecified unspecified unspecified 0 
6 המועצה מועצה המועצה noun feminine singular absolute unspecified unspecified  	O	null
7 ה ה האזורית definiteArticle unspecified unspecified unspecified unspecified unspecified 0 
7 האזורית אזורי האזורית adjective feminine singular absolute unspecified unspecified  	O	null
8 ה ה הירקון definiteArticle unspecified unspecified unspecified unspecified unspecified 0 
8 הירקון ירקון הירקון noun masculine singular absolute unspecified unspecified  	O	null
9 . . . punctuation unspecified unspecified unspecified unspecified unspecified  	O	null

0 שיר שיר שירו noun masculine singular absolute unspecified unspecified  
0 ו ו שירו possessive masculine singular unspecified 3 unspecified 0 	I_DATE	null
1 ה ה הראשון definiteArticle unspecified unspecified unspecified unspecified unspecified 0 
1 הראשון ORD1 הראשון numeral masculine singular absolute unspecified unspecified  	I_DATE	null
2 התפרסם התפרסם התפרסם verb masculine singular unspecified 3 past  	O	null
3 ב ב ב preposition unspecified unspecified unspecified unspecified unspecified 0 	O	null
4 - - - punctuation unspecified unspecified unspecified unspecified unspecified  	O	null
5 ###NUMBER### ###NUMBER### ###NUMBER### numeral unspecified unspecified unspecified unspecified unspecified  	I_DATE	null
6 ב ב בכתב preposition unspecified unspecified unspecified unspecified unspecified 0 
6 כתב כתב בכתב noun masculine singular construct unspecified unspecified  	O	null
7 ה ה העת definiteArticle unspecified unspecified unspecified unspecified unspecified 0 
7 העת עת העת noun feminine singular absolute unspecified unspecified  	O	null
8 עתים עת עתים noun feminine plural absolute unspecified unspecified  	O	null
9 ב ב בעריכת preposition unspecified unspecified unspecified unspecified unspecified 0 
9 עריכת עריכה בעריכת noun feminine singular construct unspecified unspecified  	O	null
10 אברהם אברהם אברהם properName unspecified unspecified unspecified unspecified unspecified  	I_PERS	null
11 שלונסקי שלונסקי שלונסקי properName unspecified unspecified unspecified unspecified unspecified  	I_PERS	null
12 , , , punctuation unspecified unspecified unspecified unspecified unspecified  	O	null
13 ו ו ומאז conjunction unspecified unspecified unspecified unspecified unspecified 0 
13 מאז מאז ומאז adverb unspecified unspecified unspecified unspecified unspecified  	O	null
14 פירסם פרסם פירסם verb masculine singular unspecified 3 past  	O	null
15 ב ב בעיתונים preposition unspecified unspecified unspecified unspecified unspecified 0 
15 ה ה בעיתונים definiteArticle unspecified unspecified unspecified unspecified unspecified 0 
15 העיתונים עיתון בעיתונים noun masculine plural absolute unspecified unspecified  	O	null
16 ו ו ובכתבי conjunction unspecified unspecified unspecified unspecified unspecified 0 
16 ב ב ובכתבי preposition unspecified unspecified unspecified unspecified unspecified 0 
16 כתבי כתב ובכתבי noun masculine plural construct unspecified unspecified  	O	null
17 עת עת עת noun feminine singular absolute unspecified unspecified  	O	null
18 שונים שונה שונים adjective masculine plural absolute unspecified unspecified  	O	null
19 . . . punctuation unspecified unspecified unspecified unspecified unspecified  	O	null

0 תירגם תרגם תירגם verb masculine singular unspecified 3 past  	O	null
1 שירה שירה שירה noun feminine singular absolute unspecified unspecified  	O	null
2 מ מ מרומנית preposition unspecified unspecified unspecified unspecified unspecified 0 
2 רומנית רומנית מרומנית properName feminine singular unspecified unspecified unspecified  	I_PERS	null
3 ו ו ומצרפתית conjunction unspecified unspecified unspecified unspecified unspecified 0 
3 מ מ ומצרפתית preposition unspecified unspecified unspecified unspecified unspecified 0 
3 צרפתית צרפתית ומצרפתית properName feminine singular unspecified unspecified unspecified  	I_PERS	null
4 . . . punctuation unspecified unspecified unspecified unspecified unspecified  	O	null

0 נושאי נושא נושאי noun masculine plural construct unspecified unspecified  	O	null
1 שירת שירה שירתו noun feminine singular absolute unspecified unspecified  
1 ו ו שירתו possessive masculine singular unspecified 3 unspecified 0 	O	null
2 : : : punctuation unspecified unspecified unspecified unspecified unspecified  	O	null
3 מצב מצב מצבו noun masculine singular absolute unspecified unspecified  
3 ו ו מצבו possessive masculine singular unspecified 3 unspecified 0 	O	null
4 של של של shel-preposition unspecified unspecified unspecified unspecified unspecified  	O	null
5 ה ה האדם definiteArticle unspecified unspecified unspecified unspecified unspecified 0 
5 האדם אדם האדם noun masculine singular absolute unspecified unspecified  	O	null
6 , , , punctuation unspecified unspecified unspecified unspecified unspecified  	O	null
7 יפי יופי יפי noun masculine singular construct unspecified unspecified  	O	null
8 ה ה הטבע definiteArticle unspecified unspecified unspecified unspecified unspecified 0 
8 הטבע טבע הטבע noun masculine singular absolute unspecified unspecified  	O	null
9 ו ו והנוף conjunction unspecified unspecified unspecified unspecified unspecified 0 
9 ה ה והנוף definiteArticle unspecified unspecified unspecified unspecified unspecified 0 
9 הנוף נוף והנוף noun masculine singular absolute unspecified unspecified  	O	null
10 , , , punctuation unspecified unspecified unspecified unspecified unspecified  	O	null
11 אהבה אהבה אהבה noun feminine singular absolute unspecified unspecified  	O	null
12 , , , punctuation unspecified unspecified unspecified unspecified unspecified  	O	null
13 זקנה זקנה זקנה noun feminine singular absolute unspecified unspecified  	O	null
14 , , , punctuation unspecified unspecified unspecified unspecified unspecified  	O	null
15 אימי אימים אימי noun masculine plural construct unspecified unspecified  	O	null
16 ה ה השואה definiteArticle unspecified unspecified unspecified unspecified unspecified 0 
16 השואה שואה השואה noun feminine singular absolute unspecified unspecified  	O	null
17 . . . punctuation unspecified unspecified unspecified unspecified unspecified  	O	null

0 תבנית תבנית תבנית noun feminine singular construct unspecified unspecified  	O	null
1 שירי שיר שיריו noun masculine plural absolute unspecified unspecified  
1 ו ו שיריו possessive masculine singular unspecified 3 unspecified 0 	O	null
2 על על על preposition unspecified unspecified unspecified unspecified unspecified  	O	null
3 פי פה פי noun masculine singular construct unspecified unspecified  	O	null
4 רוב רוב רוב noun masculine singular absolute unspecified unspecified  	O	null
5 תמציתית תמציתי תמציתית adjective feminine singular absolute unspecified unspecified  	O	null
6 מאוד מאוד מאוד adverb unspecified unspecified unspecified unspecified unspecified  	O	null
7 , , , punctuation unspecified unspecified unspecified unspecified unspecified  	O	null
8 תוך תוך תוך preposition unspecified unspecified unspecified unspecified unspecified  	O	null
9 שמירה שמירה שמירה noun feminine singular absolute unspecified unspecified  	O	null
10 על על על preposition unspecified unspecified unspecified unspecified unspecified  	O	null
11 מארג מארג מארג noun masculine singular absolute unspecified unspecified  	O	null
12 עדין עדין עדין adjective masculine singular absolute unspecified unspecified  	O	null
13 ו ו ומורכב conjunction unspecified unspecified unspecified unspecified unspecified 0 
13 מורכב מורכב ומורכב adjective masculine singular absolute unspecified unspecified  	O	null
14 גם גם גם conjunction unspecified unspecified unspecified unspecified unspecified  	O	null
15 יחד יחד יחד adverb unspecified unspecified unspecified unspecified unspecified  	O	null
16 . . . punctuation unspecified unspecified unspecified unspecified unspecified  	O	null

0 ה ה המסרים definiteArticle unspecified unspecified unspecified unspecified unspecified 0 
0 המסרים מסר המסרים noun masculine plural absolute unspecified unspecified  	O	null
1 של של של shel-preposition unspecified unspecified unspecified unspecified unspecified  	O	null
2 שירת שירה שירתו noun feminine singular absolute unspecified unspecified  
2 ו ו שירתו possessive masculine singular unspecified 3 unspecified 0 	O	null
3 מוגשים הוגש מוגשים verb masculine plural unspecified any beinoni  	O	null
4 ל ל לקורא preposition unspecified unspecified unspecified unspecified unspecified 0 
4 ה ה לקורא definiteArticle unspecified unspecified unspecified unspecified unspecified 0 
4 הקורא קורא לקורא noun masculine singular absolute unspecified unspecified  	O	null
5 ב ב בהבזקים preposition unspecified unspecified unspecified unspecified unspecified 0 
5 הבזקים הבזק בהבזקים noun masculine plural absolute unspecified unspecified  	O	null
6 מ מ מטפוריים preposition unspecified unspecified unspecified unspecified unspecified 0 
6 טפוריים טפוריים מטפוריים adjective masculine singular construct unspecified unspecified  	O	null
7 ייחודיים ייחודי ייחודיים adjective masculine plural absolute unspecified unspecified  	O	null
8 . . . punctuation unspecified unspecified unspecified unspecified unspecified  	O	null

0 קובצי קבץ קובצי participle masculine plural construct any unspecified  	O	null
1 שירי שיר שיריו noun masculine plural absolute unspecified unspecified  
1 ו ו שיריו possessive masculine singular unspecified 3 unspecified 0 	O	null
2 : : : punctuation unspecified unspecified unspecified unspecified unspecified  	O	null
3 אור אור אור properName masculine-and-feminine singular unspecified unspecified unspecified  	I_PERS	null
4 ה ה הלילות definiteArticle unspecified unspecified unspecified unspecified unspecified 0 
4 הלילות לילה הלילות noun masculine plural absolute unspecified unspecified  	O	null
5 ( ( ( punctuation unspecified unspecified unspecified unspecified unspecified  	O	null
6 ספרית ספרייה ספרית noun feminine singular construct unspecified unspecified  	O	null
7 פועלים פועל פועלים noun masculine plural absolute unspecified unspecified  	O	null
8 , , , punctuation unspecified unspecified unspecified unspecified unspecified  	O	null
9 ) ) ) punctuation unspecified unspecified unspecified unspecified unspecified  	O	null
10 ; ; ; punctuation unspecified unspecified unspecified unspecified unspecified  	I_MONEY	null
11 ###NUMBER### ###NUMBER### ###NUMBER### numeral unspecified unspecified unspecified unspecified unspecified  	I_DATE	null
12 בורא בורא בורא noun masculine singular construct unspecified unspecified  	I_MONEY	null
13 ה ה התמונות definiteArticle unspecified unspecified unspecified unspecified unspecified 0 
13 התמונות תמונה התמונות noun feminine plural absolute unspecified unspecified  	O	null
14 ( ( ( punctuation unspecified unspecified unspecified unspecified unspecified  	O	null
15 ) ) ) punctuation unspecified unspecified unspecified unspecified unspecified  	O	null
16 ; ; ; punctuation unspecified unspecified unspecified unspecified unspecified  	O	null
17 ###NUMBER### ###NUMBER### ###NUMBER### numeral unspecified unspecified unspecified unspecified unspecified  	I_DATE	null
18 מראות הראה מראות verb feminine plural unspecified any beinoni  	O	null
19 ב ב בגילופים preposition unspecified unspecified unspecified unspecified unspecified 0 
19 ה ה בגילופים definiteArticle unspecified unspecified unspecified unspecified unspecified 0 
19 הגילופים גילוף בגילופים noun masculine plural absolute unspecified unspecified  	O	null
20 ( ( ( punctuation unspecified unspecified unspecified unspecified unspecified  	O	null
21 ) ) ) punctuation unspecified unspecified unspecified unspecified unspecified  	O	null
22 ; ; ; punctuation unspecified unspecified unspecified unspecified unspecified  	O	null
23 ###NUMBER### ###NUMBER### ###NUMBER### numeral unspecified unspecified unspecified unspecified unspecified  	I_DATE	null
24 פיוטים פיוט פיוטים noun masculine plural absolute unspecified unspecified  	O	null
25 קטנים קטן קטנים verb masculine plural unspecified any beinoni  	O	null
26 ( ( ( punctuation unspecified unspecified unspecified unspecified unspecified  	O	null
27 ) ) ) punctuation unspecified unspecified unspecified unspecified unspecified  	O	null
28 ; ; ; punctuation unspecified unspecified unspecified unspecified unspecified  	O	null
29 ###NUMBER### ###NUMBER### ###NUMBER### numeral unspecified unspecified unspecified unspecified unspecified  	I_DATE	null
30 צבעי צבע צבעי noun masculine plural construct unspecified unspecified  	O	null
31 ה ה הסתיו definiteArticle unspecified unspecified unspecified unspecified unspecified 0 
31 הסתיו סתיו הסתיו noun masculine singular absolute unspecified unspecified  	I_DATE	null
32 , , , punctuation unspecified unspecified unspecified unspecified unspecified  	O	null
33 ###NUMBER### ###NUMBER### ###NUMBER### numeral unspecified unspecified unspecified unspecified unspecified  	I_DATE	null
34 עברית עברית עברית properName feminine singular unspecified unspecified unspecified  	I_PERS	null
35 ו ו ואנגלית conjunction unspecified unspecified unspecified unspecified unspecified 0 
35 אנגלית אנגלית ואנגלית properName feminine singular unspecified unspecified unspecified  	I_PERS	null
36 ; ; ; punctuation unspecified unspecified unspecified unspecified unspecified  	O	null
37 רישום רישום רישום noun masculine singular construct unspecified unspecified  	O	null
38 ה ה המחבר definiteArticle unspecified unspecified unspecified unspecified unspecified 0 
38 המחבר מחבר המחבר noun masculine singular absolute unspecified unspecified  	O	null
39 על על על preposition unspecified unspecified unspecified unspecified unspecified  	O	null
40 ידי יד ידי noun feminine plural construct unspecified unspecified  	O	null
41 ה ה הצייר definiteArticle unspecified unspecified unspecified unspecified unspecified 0 
41 הצייר צייר הצייר noun masculine singular absolute unspecified unspecified  	O	null
42 מ מ מרסל preposition unspecified unspecified unspecified unspecified unspecified 0 
42 רסל רסל מרסל noun masculine singular construct unspecified unspecified  	O	null
43 ינקו ניקה ינקו verb masculine-and-feminine plural unspecified 3 future  	O	null
44 ) ) ) punctuation unspecified unspecified unspecified unspecified unspecified  	O	null
45 ; ; ; punctuation unspecified unspecified unspecified unspecified unspecified  	O	null
46 יהלום יהלום יהלום properName masculine singular unspecified unspecified unspecified  	I_PERS	null
47 שחור שחור שחור adjective masculine singular absolute unspecified unspecified  	O	null
48 ה ה הלילה definiteArticle unspecified unspecified unspecified unspecified unspecified 0 
48 הלילה לילה הלילה noun masculine singular absolute unspecified unspecified  	O	null
49 ( ( ( punctuation unspecified unspecified unspecified unspecified unspecified  	O	null
50 ) ) ) punctuation unspecified unspecified unspecified unspecified unspecified  	O	null
51 ; ; ; punctuation unspecified unspecified unspecified unspecified unspecified  	O	null
52 ###NUMBER### ###NUMBER### ###NUMBER### numeral unspecified unspecified unspecified unspecified unspecified  	I_DATE	null
53 סך סך סך noun masculine singular construct unspecified unspecified  	O	null
54 ה ה הכול definiteArticle unspecified unspecified unspecified unspecified unspecified 0 
54 הכול כול הכול quantifier unspecified unspecified unspecified unspecified unspecified  	O	null
55 ( ( ( punctuation unspecified unspecified unspecified unspecified unspecified  	O	null
56 ) ) ) punctuation unspecified unspecified unspecified unspecified unspecified  	O	null
57 ; ; ; punctuation unspecified unspecified unspecified unspecified unspecified  	I_MONEY	null
58 ###NUMBER### ###NUMBER### ###NUMBER### numeral unspecified unspecified unspecified unspecified unspecified  	I_DATE	null
59 משולשים משולש משולשים noun masculine plural absolute unspecified unspecified  	I_MONEY	null
60 ( ( ( punctuation unspecified unspecified unspecified unspecified unspecified  	O	null
61 ) ) ) punctuation unspecified unspecified unspecified unspecified unspecified  	O	null
62 ; ; ; punctuation unspecified unspecified unspecified unspecified unspecified  	O	null
63 שירי שיר שירי noun masculine plural construct unspecified unspecified  	O	null
64 ###NUMBER### ###NUMBER### ###NUMBER### numeral unspecified unspecified unspecified unspecified unspecified  	I_DATE	null
65 ה ה האור definiteArticle unspecified unspecified unspecified unspecified unspecified 0 
65 האור אור האור noun masculine singular absolute unspecified unspecified  	I_ORG	null
66 ה ה השחור definiteArticle unspecified unspecified unspecified unspecified unspecified 0 
66 השחור שחור השחור properName unspecified unspecified unspecified unspecified unspecified  	I_PERS	null
67 ) ) ) punctuation unspecified unspecified unspecified unspecified unspecified  	O	null
68 , , , punctuation unspecified unspecified unspecified unspecified unspecified  	O	null
69 ###NUMBER### ###NUMBER### ###NUMBER### numeral unspecified unspecified unspecified unspecified unspecified  	I_DATE	null
70 שירים שיר שירים noun masculine plural absolute unspecified unspecified  	O	null
71 ב ב בנושא preposition unspecified unspecified unspecified unspecified unspecified 0 
71 נושא נושא בנושא noun masculine singular construct unspecified unspecified  	O	null
72 ה ה השואה definiteArticle unspecified unspecified unspecified unspecified unspecified 0 
72 השואה שואה השואה noun feminine singular absolute unspecified unspecified  	O	null
73 . . . punctuation unspecified unspecified unspecified unspecified unspecified  	O	null

0 שירי שיר שיריו noun masculine plural absolute unspecified unspecified  
0 ו ו שיריו possessive masculine singular unspecified 3 unspecified 0 	O	null
1 תורגמו תורגם תורגמו verb masculine-and-feminine plural unspecified 3 past  	O	null
2 ל ל לערבית preposition unspecified unspecified unspecified unspecified unspecified 0 
2 ערבית ערבית לערבית properName feminine singular unspecified unspecified unspecified  	I_LOC	null
3 ו ו ולכמה conjunction unspecified unspecified unspecified unspecified unspecified 0 
3 ל ל ולכמה preposition unspecified unspecified unspecified unspecified unspecified 0 
3 כמה כמה ולכמה quantifier unspecified unspecified construct unspecified unspecified  	O	null
4 שפות שפה שפות noun feminine plural absolute unspecified unspecified  	O	null
5 אירופיות אירופי אירופיות adjective feminine plural absolute unspecified unspecified  	O	null
6 . . . punctuation unspecified unspecified unspecified unspecified unspecified  	O	null

0 תירגם תרגם תירגם verb masculine singular unspecified 3 past  	O	null
1 ל ל לעברית preposition unspecified unspecified unspecified unspecified unspecified 0 
1 עברית עברית לעברית properName feminine singular unspecified unspecified unspecified  	O	null
2 מ מ מיצירותיהם preposition unspecified unspecified unspecified unspecified unspecified 0 
2 יצירות יצירה מיצירותיהם noun feminine plural absolute unspecified unspecified  
2 הם הם מיצירותיהם possessive masculine plural unspecified 3 unspecified 0 	O	null
3 של של של shel-preposition unspecified unspecified unspecified unspecified unspecified  	O	null
4 משוררים משורר משוררים noun masculine plural absolute unspecified unspecified  	O	null
5 רומנים רומני רומנים adjective masculine plural absolute unspecified unspecified  	O	null
6 , , , punctuation unspecified unspecified unspecified unspecified unspecified  	O	null
7 ש ש שרובם relativizer/subordinatingConjunction unspecified unspecified unspecified unspecified unspecified 0 
7 רוב רוב שרובם noun masculine singular absolute unspecified unspecified  
7 ם ם שרובם possessive masculine plural unspecified 3 unspecified 0 	O	null
8 היו הוא היו copula masculine plural unspecified 2 imperative  	O	null
9 מ מ מהמתנגדים preposition unspecified unspecified unspecified unspecified unspecified 0 
9 ה ה מהמתנגדים definiteArticle unspecified unspecified unspecified unspecified unspecified 0 
9 המתנגדים מתנגד מהמתנגדים noun masculine plural absolute unspecified unspecified  	O	null
10 ל ל למשטר preposition unspecified unspecified unspecified unspecified unspecified 0 
10 משטר משטר למשטר noun masculine singular construct unspecified unspecified  	O	null
11 ה ה הדיכוי definiteArticle unspecified unspecified unspecified unspecified unspecified 0 
11 הדיכוי דיכוי הדיכוי noun masculine singular absolute unspecified unspecified  	O	null
12 ה ה הקומוניסטי definiteArticle unspecified unspecified unspecified unspecified unspecified 0 
12 הקומוניסטי קומוניסטי הקומוניסטי adjective masculine singular absolute unspecified unspecified  	O	null
13 ב ב בארצם preposition unspecified unspecified unspecified unspecified unspecified 0 
13 ארץ ארץ בארצם noun feminine singular absolute unspecified unspecified  
13 ם ם בארצם possessive masculine plural unspecified 3 unspecified 0 	O	null
14 , , , punctuation unspecified unspecified unspecified unspecified unspecified  	O	null
15 ו ו ומשום conjunction unspecified unspecified unspecified unspecified unspecified 0 
15 משום משום ומשום conjunction unspecified unspecified unspecified unspecified unspecified  	O	null
16 כך כך כך pronoun unspecified unspecified unspecified unspecified unspecified  	O	null
17 נרדפו נרדף נרדפו verb masculine-and-feminine plural unspecified 3 past  	O	null
18 ו ו ואף conjunction unspecified unspecified unspecified unspecified unspecified 0 
18 אף אף ואף conjunction unspecified unspecified unspecified unspecified unspecified  	O	null
19 נאסרו נאסר נאסרו verb masculine-and-feminine plural unspecified 3 past  	O	null
20 . . . punctuation unspecified unspecified unspecified unspecified unspecified  	O	null

0 תרגומי תרגום תרגומיו noun masculine plural absolute unspecified unspecified  
0 ו ו תרגומיו possessive masculine singular unspecified 3 unspecified 0 	O	null
1 מ מ משפה preposition unspecified unspecified unspecified unspecified unspecified 0 
1 שפה שפה משפה noun feminine singular absolute unspecified unspecified  	O	null
2 זו זו זו pronoun feminine singular unspecified 3 unspecified  	O	null
3 : : : punctuation unspecified unspecified unspecified unspecified unspecified  	O	null
4 שלום שלום שלום noun masculine singular absolute unspecified unspecified  	O	null
5 ו ו ולחם conjunction unspecified unspecified unspecified unspecified unspecified 0 
5 לחם לחם ולחם noun masculine singular absolute unspecified unspecified  	O	null
6 , , , punctuation unspecified unspecified unspecified unspecified unspecified  	O	null
7 ###NUMBER### ###NUMBER### ###NUMBER### numeral unspecified unspecified unspecified unspecified unspecified  	I_DATE	null
8 אנתולוגיה אנתולוגיה אנתולוגיה noun feminine singular absolute unspecified unspecified  	O	null
9 מ מ משירת preposition unspecified unspecified unspecified unspecified unspecified 0 
9 שירת שירה משירת noun feminine singular construct unspecified unspecified  	O	null
10 רומניה רומני רומניה properName unspecified unspecified unspecified unspecified unspecified  	I_LOC	null
11 ) ) ) punctuation unspecified unspecified unspecified unspecified unspecified  	O	null
12 ; ; ; punctuation unspecified unspecified unspecified unspecified unspecified  	O	null
13 להיפגש נפגש להיפגש verb unspecified unspecified unspecified unspecified infinitive  	O	null
14 שוב שוב שוב adverb unspecified unspecified unspecified unspecified unspecified  	O	null
15 ) ) ) punctuation unspecified unspecified unspecified unspecified unspecified  	O	null
16 , , , punctuation unspecified unspecified unspecified unspecified unspecified  	O	null
17 ###NUMBER### ###NUMBER### ###NUMBER### numeral unspecified unspecified unspecified unspecified unspecified  	O	null
18 ###NUMBER### ###NUMBER### ###NUMBER### numeral unspecified unspecified unspecified unspecified unspecified  	I_DATE	null
19 משוררים משורר משוררים noun masculine plural absolute unspecified unspecified  	O	null
20 רומנים רומני רומנים adjective masculine plural absolute unspecified unspecified  	O	null
21 ב ב בתרגום preposition unspecified unspecified unspecified unspecified unspecified 0 
21 תרגום תרגום בתרגום noun masculine singular absolute unspecified unspecified  	O	null
22 עברי;עקבות עברי;עקבות עברי;עקבות verb feminine singular unspecified 2 imperative  	O	null
23 ה ה המסע definiteArticle unspecified unspecified unspecified unspecified unspecified 0 
23 המסע מסע המסע noun masculine singular absolute unspecified unspecified  	O	null
24 ( ( ( punctuation unspecified unspecified unspecified unspecified unspecified  	O	null
25 ) ) ) punctuation unspecified unspecified unspecified unspecified unspecified  	O	null
26 , , , punctuation unspecified unspecified unspecified unspecified unspecified  	O	null
27 ###NUMBER### ###NUMBER### ###NUMBER### numeral unspecified unspecified unspecified unspecified unspecified  	I_DATE	null
28 ###NUMBER### ###NUMBER### ###NUMBER### numeral unspecified unspecified unspecified unspecified unspecified  	O	null
29 משוררים משורר משוררים noun masculine plural absolute unspecified unspecified  	O	null
30 רומנים רומני רומנים adjective masculine plural absolute unspecified unspecified  	O	null
31 ב ב בתרגום preposition unspecified unspecified unspecified unspecified unspecified 0 
31 תרגום תרגום בתרגום noun masculine singular absolute unspecified unspecified  	O	null
32 עברי עברי עברי adjective masculine singular absolute unspecified unspecified  	O	null
33 . . . punctuation unspecified unspecified unspecified unspecified unspecified  	O	null

0 References References References foreign unspecified unspecified unspecified unspecified unspecified  	O	null
1 : : : punctuation unspecified unspecified unspecified unspecified unspecified  	O	null
2 גרנות גורן גרנות noun feminine plural absolute unspecified unspecified  	O	null
3 , , , punctuation unspecified unspecified unspecified unspecified unspecified  	O	null
4 משה משה משה properName unspecified unspecified unspecified unspecified unspecified  	I_PERS	null
5 . . . punctuation unspecified unspecified unspecified unspecified unspecified  	O	null

0 " " " punctuation unspecified unspecified unspecified unspecified unspecified  	O	null
1 מסע מסע מסע noun masculine singular absolute unspecified unspecified  	O	null
2 אישי אישי אישי adjective masculine singular absolute unspecified unspecified  	O	null
3 בעקבות בעקבות בעקבות preposition unspecified unspecified unspecified unspecified unspecified  	O	null
4 ה ה האהבה definiteArticle unspecified unspecified unspecified unspecified unspecified 0 
4 האהבה אהבה האהבה noun feminine singular absolute unspecified unspecified  	O	null
5 " " " punctuation unspecified unspecified unspecified unspecified unspecified  	O	null
6 . . . punctuation unspecified unspecified unspecified unspecified unspecified  	O	null

0 מהות מהות מהות noun feminine singular absolute unspecified unspecified  	O	null
1 : : : punctuation unspecified unspecified unspecified unspecified unspecified  	O	null
2 כתב כתב כתב noun masculine singular construct unspecified unspecified  	O	null
3 עת עת עת noun feminine singular absolute unspecified unspecified  	O	null
4 ל ל ליצירה preposition unspecified unspecified unspecified unspecified unspecified 0 
4 יצירה יצירה ליצירה noun feminine singular absolute unspecified unspecified  	O	null
5 יהודית יהודי יהודית adjective feminine singular absolute unspecified unspecified  	O	null
6 ל ל ל"א preposition unspecified unspecified unspecified unspecified unspecified 0 
6 "א "א ל"א properName unspecified unspecified unspecified unspecified unspecified  	I_LOC	null
7 . . . punctuation unspecified unspecified unspecified unspecified unspecified  	O	null

0 ###NUMBER### ###NUMBER### ###NUMBER### numeral unspecified unspecified unspecified unspecified unspecified  	I_DATE	null
1 . . . punctuation unspecified unspecified unspecified unspecified unspecified  	O	null

0 - - - punctuation unspecified unspecified unspecified unspecified unspecified  	O	null
1 ###NUMBER### ###NUMBER### ###NUMBER### numeral unspecified unspecified unspecified unspecified unspecified  	O	null
2 ; ; ; punctuation unspecified unspecified unspecified unspecified unspecified  	O	null
3 ###NUMBER### ###NUMBER### ###NUMBER### numeral unspecified unspecified unspecified unspecified unspecified  	O	null
4 שטרנפלד שטרנפלד שטרנפלד properName unspecified unspecified unspecified unspecified unspecified  	I_PERS	null
5 , , , punctuation unspecified unspecified unspecified unspecified unspecified  	O	null
6 צביקה צביקה צביקה properName unspecified unspecified unspecified unspecified unspecified  	I_PERS	null
7 . . . punctuation unspecified unspecified unspecified unspecified unspecified  	O	null

0 " " " punctuation unspecified unspecified unspecified unspecified unspecified  	O	null
1 מחול מחול מחול noun masculine singular construct unspecified unspecified  	O	null
2 ה ה העיניים definiteArticle unspecified unspecified unspecified unspecified unspecified 0 
2 העיניים עין העיניים noun feminine plural absolute unspecified unspecified  	O	null
3 ו ו והלילה conjunction unspecified unspecified unspecified unspecified unspecified 0 
3 ה ה והלילה definiteArticle unspecified unspecified unspecified unspecified unspecified 0 
3 הלילה לילה והלילה noun masculine singular absolute unspecified unspecified  	O	null
4 " " " punctuation unspecified unspecified unspecified unspecified unspecified  	O	null
5 . . . punctuation unspecified unspecified unspecified unspecified unspecified  	O	null

0 מאזניים מאזניים מאזניים noun masculine plural absolute unspecified unspecified  	O	null
1 ע"ג ע"ג ע"ג preposition unspecified unspecified unspecified unspecified unspecified  	O	null
2 ) ) ) punctuation unspecified unspecified unspecified unspecified unspecified  	O	null
3 . . . punctuation unspecified unspecified unspecified unspecified unspecified  	O	null
4 ###NUMBER### ###NUMBER### ###NUMBER### numeral unspecified unspecified unspecified unspecified unspecified  	O	null
5 ###NUMBER### ###NUMBER### ###NUMBER### numeral unspecified unspecified unspecified unspecified unspecified  	I_DATE	null
6 . . . punctuation unspecified unspecified unspecified unspecified unspecified  	O	null

0 ###NUMBER### ###NUMBER### ###NUMBER### numeral unspecified unspecified unspecified unspecified unspecified  	O	null
1 - - - punctuation unspecified unspecified unspecified unspecified unspecified  	O	null
2 ###NUMBER### ###NUMBER### ###NUMBER### numeral unspecified unspecified unspecified unspecified unspecified  	O	null
3 . . . punctuation unspecified unspecified unspecified unspecified unspecified  	O	null

