0 Name Name Name foreign unspecified unspecified unspecified unspecified unspecified  	O	null
1 : : : punctuation unspecified unspecified unspecified unspecified unspecified  	O	null
2 הדר הדר הדר properName unspecified unspecified unspecified unspecified unspecified  	I_PERS	null
3 , , , punctuation unspecified unspecified unspecified unspecified unspecified  	O	null
4 דאה דאה דאה verb masculine singular unspecified 3 past  	O	null
5 Birth Birth Birth foreign unspecified unspecified unspecified unspecified unspecified  	O	null
6 Year Year Year foreign unspecified unspecified unspecified unspecified unspecified  	O	null
7 : : : punctuation unspecified unspecified unspecified unspecified unspecified  	O	null
8 ###NUMBER### ###NUMBER### ###NUMBER### numeral unspecified unspecified unspecified unspecified unspecified  	I_DATE	null
9 Birth Birth Birth foreign unspecified unspecified unspecified unspecified unspecified  	O	null
10 Place Place Place foreign unspecified unspecified unspecified unspecified unspecified  	O	null
11 : : : punctuation unspecified unspecified unspecified unspecified unspecified  	O	null
12 ניו ניו ניו properName unspecified unspecified unspecified unspecified unspecified  	I_LOC	null
13 יורק הורק יורק properName unspecified unspecified unspecified unspecified unspecified  	I_LOC	null
14 ו ו וגדלה conjunction unspecified unspecified unspecified unspecified unspecified 0 
14 גדלה גדל וגדלה verb feminine singular unspecified 3 past  	O	null
15 Occupation Occupation Occupation foreign unspecified unspecified unspecified unspecified unspecified  	O	null
16 : : : punctuation unspecified unspecified unspecified unspecified unspecified  	O	null
17 סופרת סופר סופרת noun feminine singular absolute unspecified unspecified  	O	null
18 ו ו ועיתונאית conjunction unspecified unspecified unspecified unspecified unspecified 0 
18 עיתונאית עיתונאית ועיתונאית noun feminine singular absolute unspecified unspecified  	O	null
19 Entry Entry Entry foreign unspecified unspecified unspecified unspecified unspecified  	O	null
20 writer writer writer foreign unspecified unspecified unspecified unspecified unspecified  	O	null
21 : : : punctuation unspecified unspecified unspecified unspecified unspecified  	O	null
22 דקל דקל דקל noun masculine singular construct unspecified unspecified  	O	null
23 שי שי שי properName unspecified unspecified unspecified unspecified unspecified  	I_PERS	null
24 ש ש שחורי relativizer/subordinatingConjunction unspecified unspecified unspecified unspecified unspecified 0 
24 חורי חור שחורי noun masculine plural construct unspecified unspecified  	O	null
25 Entry Entry Entry foreign unspecified unspecified unspecified unspecified unspecified  	O	null
26 Value Value Value foreign unspecified unspecified unspecified unspecified unspecified  	O	null
27 : : : punctuation unspecified unspecified unspecified unspecified unspecified  	O	null
28 נולדה נולד נולדה verb feminine singular unspecified 3 past  	O	null
29 בניו בן בניו properName unspecified unspecified unspecified unspecified unspecified  	I_LOC	null
30 יורק הורק יורק properName unspecified unspecified unspecified unspecified unspecified  	I_LOC	null
31 ו ו וגדלה conjunction unspecified unspecified unspecified unspecified unspecified 0 
31 גדלה גדל וגדלה verb feminine singular unspecified 3 past  	O	null
32 ב ב במנהטן preposition unspecified unspecified unspecified unspecified unspecified 0 
32 מנהטן מנהטן במנהטן properName unspecified unspecified unspecified unspecified unspecified  	I_LOC	null
33 ו ו ובתל conjunction unspecified unspecified unspecified unspecified unspecified 0 
33 ב ב ובתל preposition unspecified unspecified unspecified unspecified unspecified 0 
33 תל תל ובתל properName unspecified unspecified unspecified unspecified unspecified  	B_LOC	null
34 אביב אביב אביב properName unspecified unspecified unspecified unspecified unspecified  	I_LOC	null
35 , , , punctuation unspecified unspecified unspecified unspecified unspecified  	O	null
36 בת בת בת noun feminine singular absolute unspecified unspecified  	O	null
37 ל ל לעיתונאי preposition unspecified unspecified unspecified unspecified unspecified 0 
37 ה ה לעיתונאי definiteArticle unspecified unspecified unspecified unspecified unspecified 0 
37 העיתונאי עיתונאי לעיתונאי noun masculine singular absolute unspecified unspecified  	O	null
38 ו ו ולמתרגם conjunction unspecified unspecified unspecified unspecified unspecified 0 
38 ל ל ולמתרגם preposition unspecified unspecified unspecified unspecified unspecified 0 
38 מתרגם מתרגם ולמתרגם noun masculine singular construct unspecified unspecified  	O	null
39 בני בן בני noun masculine plural construct unspecified unspecified  	O	null
40 הדר הדר הדר properName unspecified unspecified unspecified unspecified unspecified  	I_PERS	null
41 ו ו ולשחקנית conjunction unspecified unspecified unspecified unspecified unspecified 0 
41 ל ל ולשחקנית preposition unspecified unspecified unspecified unspecified unspecified 0 
41 שחקנית שחקן ולשחקנית noun feminine singular construct unspecified unspecified  	O	null
42 רחל רחל רחל properName unspecified unspecified unspecified unspecified unspecified  	I_PERS	null
43 הדר הדר הדר properName unspecified unspecified unspecified unspecified unspecified  	I_PERS	null
44 . . . punctuation unspecified unspecified unspecified unspecified unspecified  	O	null

0 שירתה שירת שירתה verb feminine singular unspecified 3 past  	O	null
1 ב ב בצה"ל preposition unspecified unspecified unspecified unspecified unspecified 0 
1 צה"ל צה"ל בצה"ל properName unspecified unspecified unspecified unspecified unspecified  	I_ORG	null
2 . . . punctuation unspecified unspecified unspecified unspecified unspecified  	O	null

0 בעלת בעל בעלת noun feminine singular construct unspecified unspecified  	O	null
1 תואר תואר תואר noun masculine singular absolute unspecified unspecified  	O	null
2 ראשון ORD1 ראשון numeral masculine singular absolute unspecified unspecified  	O	null
3 ב ב ביחסים preposition unspecified unspecified unspecified unspecified unspecified 0 
3 יחסים יחס ביחסים noun masculine plural absolute unspecified unspecified  	O	null
4 בינלאומיים בינלאומי בינלאומיים adjective masculine plural absolute unspecified unspecified  	O	null
5 מ מ מהאוניברסיטה preposition unspecified unspecified unspecified unspecified unspecified 0 
5 ה ה מהאוניברסיטה definiteArticle unspecified unspecified unspecified unspecified unspecified 0 
5 האוניברסיטה אוניברסיטה מהאוניברסיטה noun feminine singular absolute unspecified unspecified  	I_ORG	null
6 ה ה העברית definiteArticle unspecified unspecified unspecified unspecified unspecified 0 
6 העברית עברי העברית adjective feminine singular absolute unspecified unspecified  	I_ORG	null
7 ב ב בירושלים preposition unspecified unspecified unspecified unspecified unspecified 0 
7 ירושלים ירושלים בירושלים properName unspecified unspecified unspecified unspecified unspecified  	I_LOC	null
8 . . . punctuation unspecified unspecified unspecified unspecified unspecified  	O	null

0 עבדה עבד עבדה verb feminine singular unspecified 3 past  	O	null
1 כ כ כעיתונאית preposition unspecified unspecified unspecified unspecified unspecified 0 
1 עיתונאית עיתונאית כעיתונאית noun feminine singular absolute unspecified unspecified  	O	null
2 ב ב בעיתון preposition unspecified unspecified unspecified unspecified unspecified 0 
2 עיתון עיתון בעיתון noun masculine singular construct unspecified unspecified  	O	null
3 ה ה הארץ definiteArticle unspecified unspecified unspecified unspecified unspecified 0 
3 הארץ ארץ הארץ noun feminine singular absolute unspecified unspecified  	O	null
4 ו ו וכתבה conjunction unspecified unspecified unspecified unspecified unspecified 0 
4 כתבה כתב וכתבה verb feminine singular unspecified 3 past  	O	null
5 טור טור טור noun masculine singular absolute unspecified unspecified  	O	null
6 אישי אישי אישי adjective masculine singular absolute unspecified unspecified  	O	null
7 ב ב במוסף preposition unspecified unspecified unspecified unspecified unspecified 0 
7 מוסף מוסף במוסף noun masculine singular construct unspecified unspecified  	O	null
8 ה ה השבת definiteArticle unspecified unspecified unspecified unspecified unspecified 0 
8 השבת שבת השבת properName unspecified unspecified unspecified unspecified unspecified  	I_DATE	null
9 . . . punctuation unspecified unspecified unspecified unspecified unspecified  	O	null

0 היתה הוא היתה copula feminine singular unspecified 3 past  	O	null
1 נשואה נשוי נשואה adjective feminine singular absolute unspecified unspecified  	O	null
2 ל ל לעיתונאי preposition unspecified unspecified unspecified unspecified unspecified 0 
2 עיתונאי עיתונאי לעיתונאי noun masculine singular absolute unspecified unspecified  	O	null
3 שחר שחר שחר properName unspecified unspecified unspecified unspecified unspecified  	I_PERS	null
4 סמוחה סמוחה סמוחה properName unspecified unspecified unspecified unspecified unspecified  	I_PERS	null
5 , , , punctuation unspecified unspecified unspecified unspecified unspecified  	O	null
6 ו ו והיא conjunction unspecified unspecified unspecified unspecified unspecified 0 
6 היא הוא והיא pronoun feminine singular unspecified 3 unspecified  	O	null
7 אם אם אם conjunction unspecified unspecified unspecified unspecified unspecified  	O	null
8 ל ל לבת preposition unspecified unspecified unspecified unspecified unspecified 0 
8 בת בת לבת noun feminine singular absolute unspecified unspecified  	O	null
9 . . . punctuation unspecified unspecified unspecified unspecified unspecified  	O	null

0 על על על preposition unspecified unspecified unspecified unspecified unspecified  	O	null
1 שם שם שמה noun masculine singular absolute unspecified unspecified  
1 ה ה שמה possessive feminine singular unspecified 3 unspecified 0 	O	null
2 ה ה המיוחד definiteArticle unspecified unspecified unspecified unspecified unspecified 0 
2 המיוחד מיוחד המיוחד adjective masculine singular absolute unspecified unspecified  	O	null
3 סיפרה סיפר סיפרה verb feminine singular unspecified 3 past  	O	null
4 ב ב בריאיון preposition unspecified unspecified unspecified unspecified unspecified 0 
4 ריאיון ראיון בריאיון noun masculine singular absolute unspecified unspecified  	O	null
5 ל ל לשירי preposition unspecified unspecified unspecified unspecified unspecified 0 
5 שירי שיר לשירי noun masculine plural construct unspecified unspecified  	O	null
6 לב לב לב noun masculine singular construct unspecified unspecified  	O	null
7 - - - punctuation unspecified unspecified unspecified unspecified unspecified  	I_ORG	null
8 ארי ארי ארי properName unspecified unspecified unspecified unspecified unspecified  	I_PERS	null
9 ( ( ( punctuation unspecified unspecified unspecified unspecified unspecified  	O	null
10 ###NUMBER### ###NUMBER### ###NUMBER### numeral unspecified unspecified unspecified unspecified unspecified  	I_DATE	null
11 ) ) ) punctuation unspecified unspecified unspecified unspecified unspecified  	O	null
12 כי כי כי conjunction unspecified unspecified unspecified unspecified unspecified  	O	null
13 " " " punctuation unspecified unspecified unspecified unspecified unspecified  	O	null
14 איןלופירוש איןלופירוש איןלופירוש noun feminine plural absolute unspecified unspecified  	O	null
15 , , , punctuation unspecified unspecified unspecified unspecified unspecified  	O	null
16 אבאשליפשוטאהבאתהצליל אבאשליפשוטאהבאתהצליל אבאשליפשוטאהבאתהצליל properName unspecified unspecified unspecified unspecified unspecified  	I_PERS	null
17 [ [ [ punctuation unspecified unspecified unspecified unspecified unspecified  	O	null
18 ... ... ... punctuation unspecified unspecified unspecified unspecified unspecified  	O	null
19 ] ] ] punctuation unspecified unspecified unspecified unspecified unspecified  	O	null
20 עדכמהשידועליאיןעודשםכזה עדכמהשידועליאיןעודשםכזה עדכמהשידועליאיןעודשםכזה verb masculine singular unspecified 2 imperative  	O	null
21 " " " punctuation unspecified unspecified unspecified unspecified unspecified  	O	null
22 . . . punctuation unspecified unspecified unspecified unspecified unspecified  	O	null

0 ספר ספר ספרה noun masculine singular absolute unspecified unspecified  
0 ה ה ספרה possessive feminine singular unspecified 3 unspecified 0 	O	null
1 ה ה הראשון definiteArticle unspecified unspecified unspecified unspecified unspecified 0 
1 הראשון ORD1 הראשון numeral masculine singular absolute unspecified unspecified  	O	null
2 , , , punctuation unspecified unspecified unspecified unspecified unspecified  	O	null
3 נומי נם נומי verb feminine singular unspecified 2 imperative  	O	null
4 נומי נם נומי verb feminine singular unspecified 2 imperative  	O	null
5 עיסאוויה עיסאוויה עיסאוויה properName unspecified unspecified unspecified unspecified unspecified  	I_PERS	null
6 ( ( ( punctuation unspecified unspecified unspecified unspecified unspecified  	O	null
7 גוונים גוון גוונים noun masculine plural absolute unspecified unspecified  	O	null
8 , , , punctuation unspecified unspecified unspecified unspecified unspecified  	O	null
9 ) ) ) punctuation unspecified unspecified unspecified unspecified unspecified  	O	null
10 , , , punctuation unspecified unspecified unspecified unspecified unspecified  	O	null
11 ###NUMBER### ###NUMBER### ###NUMBER### numeral unspecified unspecified unspecified unspecified unspecified  	I_DATE	null
12 יצא יצא יצא verb masculine singular unspecified 3 past  	O	null
13 ל ל לאור preposition unspecified unspecified unspecified unspecified unspecified 0 
13 אור אור לאור noun masculine singular absolute unspecified unspecified  	O	null
14 כ כ כשהיתה preposition unspecified unspecified unspecified unspecified unspecified 0 
14 שהית שהייה כשהיתה noun feminine singular absolute unspecified unspecified  
14 ה ה כשהיתה possessive feminine singular unspecified 3 unspecified 0 	O	null
15 בתעשרים בתעשרים בתעשרים verb masculine plural unspecified any beinoni  	O	null
16 ו ו וארבע conjunction unspecified unspecified unspecified unspecified unspecified 0 
16 ארבע CARD4 וארבע numeral feminine singular absolute unspecified unspecified  	O	null
17 . . . punctuation unspecified unspecified unspecified unspecified unspecified  	O	null

0 ה ה הסיפור definiteArticle unspecified unspecified unspecified unspecified unspecified 0 
0 הסיפור סיפור הסיפור noun masculine singular absolute unspecified unspecified  	O	null
1 ש ש שעל relativizer/subordinatingConjunction unspecified unspecified unspecified unspecified unspecified 0 
1 על על שעל preposition unspecified unspecified unspecified unspecified unspecified  	O	null
2 שם שם שמו noun masculine singular absolute unspecified unspecified  
2 ו ו שמו possessive masculine singular unspecified 3 unspecified 0 	O	null
3 נקרא נקרא נקרא verb masculine singular unspecified 3 past  	O	null
4 ה ה הקובץ definiteArticle unspecified unspecified unspecified unspecified unspecified 0 
4 הקובץ קובץ הקובץ noun masculine singular absolute unspecified unspecified  	O	null
5 פורסם פורסם פורסם verb masculine singular unspecified 3 past  	O	null
6 גם גם גם conjunction unspecified unspecified unspecified unspecified unspecified  	O	null
7 ב ב בקובץ preposition unspecified unspecified unspecified unspecified unspecified 0 
7 ה ה בקובץ definiteArticle unspecified unspecified unspecified unspecified unspecified 0 
7 הקובץ קובץ בקובץ noun masculine singular absolute unspecified unspecified  	O	null
8 ה ה הדו definiteArticle unspecified unspecified unspecified unspecified unspecified 0 
8 הדו דו הדו wPrefix unspecified unspecified unspecified unspecified unspecified  	I_ORG	null
9 - - - punctuation unspecified unspecified unspecified unspecified unspecified  	I_ORG	null
10 לשוני לשוני לשוני adjective masculine singular absolute unspecified unspecified  	I_ORG	null
11 עברי עברי עברי adjective masculine singular absolute unspecified unspecified  	O	null
12 - - - punctuation unspecified unspecified unspecified unspecified unspecified  	O	null
13 ערבי ערבי ערבי adjective masculine singular absolute unspecified unspecified  	O	null
14 שני CARD2 שני numeral masculine dual construct unspecified unspecified  	O	null
15 עמים עם עמים noun masculine plural absolute unspecified unspecified  	O	null
16 כותבים כתב כותבים verb masculine plural unspecified any beinoni  	O	null
17 מ מ מימין preposition unspecified unspecified unspecified unspecified unspecified 0 
17 ימין ימין מימין properName unspecified unspecified unspecified unspecified unspecified  	I_PERS	null
18 ל ל לשמאל preposition unspecified unspecified unspecified unspecified unspecified 0 
18 שמאל שמאל לשמאל noun masculine singular absolute unspecified unspecified  	O	null
19 ) ) ) punctuation unspecified unspecified unspecified unspecified unspecified  	O	null
20 . . . punctuation unspecified unspecified unspecified unspecified unspecified  	O	null
21 ###NUMBER### ###NUMBER### ###NUMBER### numeral unspecified unspecified unspecified unspecified unspecified  	I_DATE	null
22 כ כ כמה preposition unspecified unspecified unspecified unspecified unspecified 0 
22 מה מה כמה interrogative unspecified unspecified unspecified unspecified unspecified  	O	null
23 מ מ מהסיפורים preposition unspecified unspecified unspecified unspecified unspecified 0 
23 ה ה מהסיפורים definiteArticle unspecified unspecified unspecified unspecified unspecified 0 
23 הסיפורים סיפור מהסיפורים noun masculine plural absolute unspecified unspecified  	O	null
24 ב ב בקובץ preposition unspecified unspecified unspecified unspecified unspecified 0 
24 קובץ קובץ בקובץ noun masculine singular construct unspecified unspecified  	O	null
25 קשורים קשור קשורים adjective masculine plural absolute unspecified unspecified  	O	null
26 ב ב בחוויות preposition unspecified unspecified unspecified unspecified unspecified 0 
26 חוויות חוויה בחוויות noun feminine plural absolute unspecified unspecified  	O	null
27 צבאיות צבאי צבאיות adjective feminine plural absolute unspecified unspecified  	O	null
28 מורכבות מורכב מורכבות adjective feminine plural absolute unspecified unspecified  	O	null
29 ( ( ( punctuation unspecified unspecified unspecified unspecified unspecified  	O	null
30 חיילת חייל חיילת noun feminine singular absolute unspecified unspecified  	O	null
31 ב ב בתצפית preposition unspecified unspecified unspecified unspecified unspecified 0 
31 תצפית תצפית בתצפית noun feminine singular absolute unspecified unspecified  	O	null
32 לילית לילי לילית adjective feminine singular absolute unspecified unspecified  	O	null
33 על על על preposition unspecified unspecified unspecified unspecified unspecified  	O	null
34 כפר כפר כפר noun masculine singular absolute unspecified unspecified  	O	null
35 פלסטיני פלסטיני פלסטיני adjective masculine singular absolute unspecified unspecified  	O	null
36 , , , punctuation unspecified unspecified unspecified unspecified unspecified  	O	null
37 שיח שיח שיח noun masculine singular absolute unspecified unspecified  	O	null
38 בין בין בין preposition unspecified unspecified unspecified unspecified unspecified  	O	null
39 שוכני שכן שוכני participle masculine plural construct any unspecified  	O	null
40 קברים קבר קברים noun masculine plural absolute unspecified unspecified  	O	null
41 ב ב בבית preposition unspecified unspecified unspecified unspecified unspecified 0 
41 בית בית בבית noun masculine singular construct unspecified unspecified  	O	null
42 עלמין עלמין עלמין noun masculine singular absolute unspecified unspecified  	O	null
43 צבאי צבאי צבאי adjective masculine singular absolute unspecified unspecified  	O	null
44 , , , punctuation unspecified unspecified unspecified unspecified unspecified  	O	null
45 אח אח אח noun masculine singular absolute unspecified unspecified  	O	null
46 חייל חייל חייל noun masculine singular absolute unspecified unspecified  	O	null
47 ש ש שמגיע relativizer/subordinatingConjunction unspecified unspecified unspecified unspecified unspecified 0 
47 מגיע הגיע שמגיע verb masculine singular unspecified any beinoni  	O	null
48 מ מ מהצבא preposition unspecified unspecified unspecified unspecified unspecified 0 
48 ה ה מהצבא definiteArticle unspecified unspecified unspecified unspecified unspecified 0 
48 הצבא צבא מהצבא noun masculine singular absolute unspecified unspecified  	O	null
49 ) ) ) punctuation unspecified unspecified unspecified unspecified unspecified  	O	null
50 או או או conjunction unspecified unspecified unspecified unspecified unspecified  	O	null
51 ב ב בחוויות preposition unspecified unspecified unspecified unspecified unspecified 0 
51 חוויות חוויה בחוויות noun feminine plural absolute unspecified unspecified  	O	null
52 ה ה הקשורות definiteArticle unspecified unspecified unspecified unspecified unspecified 0 
52 הקשורות קשר הקשורות participle feminine plural absolute any unspecified  	O	null
53 ב ב בהתבגרות preposition unspecified unspecified unspecified unspecified unspecified 0 
53 ה ה בהתבגרות definiteArticle unspecified unspecified unspecified unspecified unspecified 0 
53 ההתבגרות התבגרות בהתבגרות noun feminine singular absolute unspecified unspecified  	O	null
54 ו ו ובמיניות conjunction unspecified unspecified unspecified unspecified unspecified 0 
54 ב ב ובמיניות preposition unspecified unspecified unspecified unspecified unspecified 0 
54 ה ה ובמיניות definiteArticle unspecified unspecified unspecified unspecified unspecified 0 
54 המיניות מיניות ובמיניות noun feminine singular absolute unspecified unspecified  	O	null
55 , , , punctuation unspecified unspecified unspecified unspecified unspecified  	O	null
56 ל ל לרוב preposition unspecified unspecified unspecified unspecified unspecified 0 
56 רוב רוב לרוב noun masculine singular absolute unspecified unspecified  	O	null
57 על על על preposition unspecified unspecified unspecified unspecified unspecified  	O	null
58 צדדי צד צדדיהן noun masculine plural absolute unspecified unspecified  
58 הן הן צדדיהן possessive feminine plural unspecified 3 unspecified 0 	O	null
59 ה ה המרתיעים definiteArticle unspecified unspecified unspecified unspecified unspecified 0 
59 המרתיעים הרתיע המרתיעים participle masculine plural absolute any unspecified  	I_ORG	null
60 ו ו והקשים conjunction unspecified unspecified unspecified unspecified unspecified 0 
60 ה ה והקשים definiteArticle unspecified unspecified unspecified unspecified unspecified 0 
60 הקשים קשה והקשים adjective masculine plural absolute unspecified unspecified  	I_ORG	null
61 . . . punctuation unspecified unspecified unspecified unspecified unspecified  	O	null

0 ב ב בכל preposition unspecified unspecified unspecified unspecified unspecified 0 
0 כל כול בכל quantifier unspecified unspecified construct unspecified unspecified  	O	null
1 ה ה הסיפורים definiteArticle unspecified unspecified unspecified unspecified unspecified 0 
1 הסיפורים סיפור הסיפורים noun masculine plural absolute unspecified unspecified  	O	null
2 בולט בלט בולט verb masculine singular unspecified any beinoni  	O	null
3 קול קול קולה noun masculine singular absolute unspecified unspecified  
3 ה ה קולה possessive feminine singular unspecified 3 unspecified 0 	O	null
4 של של של shel-preposition unspecified unspecified unspecified unspecified unspecified  	O	null
5 הדר הדר הדר properName unspecified unspecified unspecified unspecified unspecified  	I_PERS	null
6 , , , punctuation unspecified unspecified unspecified unspecified unspecified  	O	null
7 ש ש שהוא relativizer/subordinatingConjunction unspecified unspecified unspecified unspecified unspecified 0 
7 הוא הוא שהוא pronoun masculine singular unspecified 3 unspecified  	O	null
8 ילדותי ילדותי ילדותי adjective masculine singular absolute unspecified unspecified  	O	null
9 ו ו ותמים conjunction unspecified unspecified unspecified unspecified unspecified 0 
9 תמים תמים ותמים adjective masculine singular absolute unspecified unspecified  	O	null
10 אך אך אך conjunction unspecified unspecified unspecified unspecified unspecified  	O	null
11 ב ב בה preposition unspecified unspecified unspecified unspecified unspecified  
11 ה ה בה pronomial feminine singular unspecified 3 unspecified 0 	O	null
12 ב ב בעת preposition unspecified unspecified unspecified unspecified unspecified 0 
12 עת עת בעת noun feminine singular absolute unspecified unspecified  	O	null
13 גם גם גם conjunction unspecified unspecified unspecified unspecified unspecified  	O	null
14 נוקב נקב נוקב verb masculine singular unspecified any beinoni  	O	null
15 ו ו ומדויק conjunction unspecified unspecified unspecified unspecified unspecified 0 
15 מדויק מדויק ומדויק adjective masculine singular absolute unspecified unspecified  	O	null
16 . . . punctuation unspecified unspecified unspecified unspecified unspecified  	O	null

0 ספר ספר ספרה noun masculine singular absolute unspecified unspecified  
0 ה ה ספרה possessive feminine singular unspecified 3 unspecified 0 	O	null
1 ה ה השני definiteArticle unspecified unspecified unspecified unspecified unspecified 0 
1 השני ORD2 השני numeral masculine singular absolute unspecified unspecified  	O	null
2 , , , punctuation unspecified unspecified unspecified unspecified unspecified  	O	null
3 אצלנו אצל אצלנו verb masculine-and-feminine plural unspecified 1 past  	O	null
4 עכשיו עכשיו עכשיו adverb unspecified unspecified unspecified unspecified unspecified  	O	null
5 בוקר בוקר בוקר noun masculine singular absolute unspecified unspecified  	O	null
6 ( ( ( punctuation unspecified unspecified unspecified unspecified unspecified  	O	null
7 ) ) ) punctuation unspecified unspecified unspecified unspecified unspecified  	O	null
8 , , , punctuation unspecified unspecified unspecified unspecified unspecified  	O	null
9 ###NUMBER### ###NUMBER### ###NUMBER### numeral unspecified unspecified unspecified unspecified unspecified  	I_DATE	null
10 מתאר מתאר מתאר noun masculine singular absolute unspecified unspecified  	O	null
11 משפחה משפחה משפחה noun feminine singular absolute unspecified unspecified  	O	null
12 בורגנית בורגנית בורגנית adjective feminine singular absolute unspecified unspecified  	O	null
13 ישראלית ישראלי ישראלית adjective feminine singular absolute unspecified unspecified  	O	null
14 ו ו ואת conjunction unspecified unspecified unspecified unspecified unspecified 0 
14 את את ואת at-preposition unspecified unspecified unspecified unspecified unspecified  	O	null
15 ה ה הניסיונות definiteArticle unspecified unspecified unspecified unspecified unspecified 0 
15 הניסיונות ניסיון הניסיונות noun masculine plural absolute unspecified unspecified  	O	null
16 של של של shel-preposition unspecified unspecified unspecified unspecified unspecified  	O	null
17 כל כול כל quantifier unspecified unspecified construct unspecified unspecified  	O	null
18 ארבעת CARD4 ארבעת numeral masculine plural construct unspecified unspecified  	O	null
19 חלקי חלק חלקיה noun masculine plural absolute unspecified unspecified  
19 ה ה חלקיה possessive feminine singular unspecified 3 unspecified 0 	O	null
20 להשתלב השתלב להשתלב verb unspecified unspecified unspecified unspecified infinitive  	O	null
21 ב ב במציאות preposition unspecified unspecified unspecified unspecified unspecified 0 
21 ה ה במציאות definiteArticle unspecified unspecified unspecified unspecified unspecified 0 
21 המציאות מציאות במציאות noun feminine singular absolute unspecified unspecified  	O	null
22 ה ה הישראלית definiteArticle unspecified unspecified unspecified unspecified unspecified 0 
22 הישראלית ישראלי הישראלית adjective feminine singular absolute unspecified unspecified  	O	null
23 ו ו ובחלום conjunction unspecified unspecified unspecified unspecified unspecified 0 
23 ב ב ובחלום preposition unspecified unspecified unspecified unspecified unspecified 0 
23 ה ה ובחלום definiteArticle unspecified unspecified unspecified unspecified unspecified 0 
23 החלום חלום ובחלום noun masculine singular absolute unspecified unspecified  	O	null
24 ה ה האמריקני definiteArticle unspecified unspecified unspecified unspecified unspecified 0 
24 האמריקני אמריקני האמריקני adjective masculine singular absolute unspecified unspecified  	O	null
25 . . . punctuation unspecified unspecified unspecified unspecified unspecified  	O	null

0 נקודת נקודה נקודת noun feminine singular construct unspecified unspecified  	O	null
1 ה ה המבט definiteArticle unspecified unspecified unspecified unspecified unspecified 0 
1 המבט מבט המבט noun masculine singular absolute unspecified unspecified  	O	null
2 היא הוא היא copula feminine singular unspecified 3 beinoni  	O	null
3 של של של shel-preposition unspecified unspecified unspecified unspecified unspecified  	O	null
4 ה ה הבת definiteArticle unspecified unspecified unspecified unspecified unspecified 0 
4 הבת בת הבת noun feminine singular absolute unspecified unspecified  	O	null
5 ה ה הצעירה definiteArticle unspecified unspecified unspecified unspecified unspecified 0 
5 הצעירה צעיר הצעירה adjective feminine singular absolute unspecified unspecified  	O	null
6 ש ש שמתארת relativizer/subordinatingConjunction unspecified unspecified unspecified unspecified unspecified 0 
6 מתארת תיאר שמתארת verb feminine singular unspecified any beinoni  	O	null
7 אפיזודות אפיזודה אפיזודות noun feminine plural absolute unspecified unspecified  	O	null
8 , , , punctuation unspecified unspecified unspecified unspecified unspecified  	O	null
9 מוזרות מוזר מוזרות adjective feminine plural absolute unspecified unspecified  	O	null
10 אך אך אך conjunction unspecified unspecified unspecified unspecified unspecified  	O	null
11 ריאליסטיות ריאליסטי ריאליסטיות adjective feminine plural absolute unspecified unspecified  	O	null
12 , , , punctuation unspecified unspecified unspecified unspecified unspecified  	O	null
13 מ מ מילדותה preposition unspecified unspecified unspecified unspecified unspecified 0 
13 ילדות ילדות מילדותה noun feminine singular absolute unspecified unspecified  
13 ה ה מילדותה possessive feminine singular unspecified 3 unspecified 0 	O	null
14 ו ו והתבגרותה conjunction unspecified unspecified unspecified unspecified unspecified 0 
14 התבגרות התבגרות והתבגרותה noun feminine singular absolute unspecified unspecified  
14 ה ה והתבגרותה possessive feminine singular unspecified 3 unspecified 0 	O	null
15 : : : punctuation unspecified unspecified unspecified unspecified unspecified  	O	null
16 החל החל החל verb masculine singular unspecified 3 past  	O	null
17 מ מ מאמה preposition unspecified unspecified unspecified unspecified unspecified 0 
17 אמה אמה מאמה noun masculine singular construct unspecified unspecified  	O	null
18 ה ה המצפה definiteArticle unspecified unspecified unspecified unspecified unspecified 0 
18 המצפה מצפה המצפה noun masculine singular absolute unspecified unspecified  	O	null
19 ל ל למכתב preposition unspecified unspecified unspecified unspecified unspecified 0 
19 מכתב מכתב למכתב noun masculine singular absolute unspecified unspecified  	O	null
20 מ מ מוודי preposition unspecified unspecified unspecified unspecified unspecified 0 
20 וודי וודי מוודי properName unspecified unspecified unspecified unspecified unspecified  	I_PERS	null
21 אלן אלן אלן properName unspecified unspecified unspecified unspecified unspecified  	I_PERS	null
22 ו ו וריביה conjunction unspecified unspecified unspecified unspecified unspecified 0 
22 ריבי ריב וריביה noun masculine plural absolute unspecified unspecified  
22 ה ה וריביה possessive feminine singular unspecified 3 unspecified 0 	O	null
23 עם עם עם preposition unspecified unspecified unspecified unspecified unspecified  	O	null
24 ה ה האב definiteArticle unspecified unspecified unspecified unspecified unspecified 0 
24 האב אב האב noun masculine singular absolute unspecified unspecified  	O	null
25 ה ה הנוכח definiteArticle unspecified unspecified unspecified unspecified unspecified 0 
25 הנוכח נכח הנוכח participle masculine singular absolute any unspecified  	O	null
26 - - - punctuation unspecified unspecified unspecified unspecified unspecified  	O	null
27 נעדר נעדר נעדר adjective masculine singular absolute unspecified unspecified  	O	null
28 , , , punctuation unspecified unspecified unspecified unspecified unspecified  	O	null
29 דרך דרך דרך preposition unspecified unspecified unspecified unspecified unspecified  	O	null
30 משאית משאית משאית noun feminine singular construct unspecified unspecified  	O	null
31 תרנגולות תרנגולת תרנגולות noun feminine plural absolute unspecified unspecified  	O	null
32 המובלות המובלות המובלות adjective feminine plural absolute unspecified unspecified  	O	null
33 ל ל לשחיטה preposition unspecified unspecified unspecified unspecified unspecified 0 
33 שחיטה שחיטה לשחיטה noun feminine singular absolute unspecified unspecified  	O	null
34 על על על preposition unspecified unspecified unspecified unspecified unspecified  	O	null
35 כביש כביש כביש noun masculine singular construct unspecified unspecified  	O	null
36 ה ה ההלכה definiteArticle unspecified unspecified unspecified unspecified unspecified 0 
36 ההלכה הלכה ההלכה noun feminine singular absolute unspecified unspecified  	O	null
37 , , , punctuation unspecified unspecified unspecified unspecified unspecified  	O	null
38 ו ו ועד conjunction unspecified unspecified unspecified unspecified unspecified 0 
38 עד עד ועד preposition unspecified unspecified unspecified unspecified unspecified  	O	null
39 להיחשפותההמוקדמת להיחשפותההמוקדמת להיחשפותההמוקדמת noun masculine-and-feminine singular absolute unspecified unspecified  	O	null
40 ל ל לחיי preposition unspecified unspecified unspecified unspecified unspecified 0 
40 חיי חיים לחיי noun masculine plural construct unspecified unspecified  	O	null
41 ה ה המין definiteArticle unspecified unspecified unspecified unspecified unspecified 0 
41 המין מין המין noun masculine singular absolute unspecified unspecified  	O	null
42 של של של shel-preposition unspecified unspecified unspecified unspecified unspecified  	O	null
43 הוריה הוריה הוריה noun feminine singular absolute unspecified unspecified  	O	null
44 . . . punctuation unspecified unspecified unspecified unspecified unspecified  	O	null

0 References References References foreign unspecified unspecified unspecified unspecified unspecified  	O	null
1 : : : punctuation unspecified unspecified unspecified unspecified unspecified  	O	null
2 גלסנר גלסנר גלסנר properName unspecified unspecified unspecified unspecified unspecified  	I_ORG	null
3 , , , punctuation unspecified unspecified unspecified unspecified unspecified  	O	null
4 אריק אריק אריק properName unspecified unspecified unspecified unspecified unspecified  	I_PERS	null
5 . . . punctuation unspecified unspecified unspecified unspecified unspecified  	O	null

0 " " " punctuation unspecified unspecified unspecified unspecified unspecified  	I_ORG	null
1 אצלנועכשיובוקר אצלנועכשיובוקר אצלנועכשיובוקר properName unspecified unspecified unspecified unspecified unspecified  	I_ORG	null
2 " " " punctuation unspecified unspecified unspecified unspecified unspecified  	O	null
3 . . . punctuation unspecified unspecified unspecified unspecified unspecified  	O	null

0 מעריבספרותוספרים מעריבספרותוספרים מעריבספרותוספרים properName unspecified unspecified unspecified unspecified unspecified  	I_PERS	null
1 . . . punctuation unspecified unspecified unspecified unspecified unspecified  	O	null

0 ; ; ; punctuation unspecified unspecified unspecified unspecified unspecified  	O	null
1 ###NUMEXP### ###NUMEXP### ###NUMEXP### numberExpression unspecified unspecified unspecified unspecified unspecified  	I_DATE	null
2 לב לב לב noun masculine singular construct unspecified unspecified  	O	null
3 - - - punctuation unspecified unspecified unspecified unspecified unspecified  	I_ORG	null
4 ארי ארי ארי properName unspecified unspecified unspecified unspecified unspecified  	I_PERS	null
5 , , , punctuation unspecified unspecified unspecified unspecified unspecified  	O	null
6 ש ש שירי relativizer/subordinatingConjunction unspecified unspecified unspecified unspecified unspecified 0 
6 ירי ירי שירי noun masculine singular absolute unspecified unspecified  	O	null
7 . . . punctuation unspecified unspecified unspecified unspecified unspecified  	O	null

0 " " " punctuation unspecified unspecified unspecified unspecified unspecified  	I_ORG	null
1 זוילדהשהיאבעצםקצתרדופה זוילדהשהיאבעצםקצתרדופה זוילדהשהיאבעצםקצתרדופה properName unspecified unspecified unspecified unspecified unspecified  	I_ORG	null
2 " " " punctuation unspecified unspecified unspecified unspecified unspecified  	O	null
3 . . . punctuation unspecified unspecified unspecified unspecified unspecified  	O	null
4 ה ה הארץ definiteArticle unspecified unspecified unspecified unspecified unspecified 0 
4 הארץ ארץ הארץ noun feminine singular absolute unspecified unspecified  	O	null
5 גלריה גלריה גלריה noun feminine singular absolute unspecified unspecified  	O	null
6 . . . punctuation unspecified unspecified unspecified unspecified unspecified  	O	null

0 ###NUMEXP### ###NUMEXP### ###NUMEXP### numberExpression unspecified unspecified unspecified unspecified unspecified  	I_DATE	null
1 ; ; ; punctuation unspecified unspecified unspecified unspecified unspecified  	O	null
2 מירן מירן מירן properName unspecified unspecified unspecified unspecified unspecified  	I_PERS	null
3 , , , punctuation unspecified unspecified unspecified unspecified unspecified  	O	null
4 ראובן ראובן ראובן properName unspecified unspecified unspecified unspecified unspecified  	I_PERS	null
5 . . . punctuation unspecified unspecified unspecified unspecified unspecified  	O	null

0 " " " punctuation unspecified unspecified unspecified unspecified unspecified  	O	null
1 כולנוכלבים כולנוכלבים כולנוכלבים preposition unspecified unspecified unspecified unspecified unspecified  	O	null
2 , , , punctuation unspecified unspecified unspecified unspecified unspecified  	O	null
3 כולנובנידודים כולנובנידודים כולנובנידודים participle feminine plural construct any unspecified  	O	null
4 " " " punctuation unspecified unspecified unspecified unspecified unspecified  	O	null
5 . . . punctuation unspecified unspecified unspecified unspecified unspecified  	O	null

0 הארץספרים הארץספרים הארץספרים participle masculine singular construct any unspecified  	I_ORG	null
1 . . . punctuation unspecified unspecified unspecified unspecified unspecified  	O	null

0 ###NUMEXP### ###NUMEXP### ###NUMEXP### numberExpression unspecified unspecified unspecified unspecified unspecified  	I_DATE	null
1 . . . punctuation unspecified unspecified unspecified unspecified unspecified  	O	null

0 ###NUMBER### ###NUMBER### ###NUMBER### numeral unspecified unspecified unspecified unspecified unspecified  	O	null
1 . . . punctuation unspecified unspecified unspecified unspecified unspecified  	O	null

