0 Name Name Name foreign unspecified unspecified unspecified unspecified unspecified  	O	null
1 : : : punctuation unspecified unspecified unspecified unspecified unspecified  	O	null
2 אולסבנגר אולסבנגר אולסבנגר properName unspecified unspecified unspecified unspecified unspecified  	I_ORG	null
3 , , , punctuation unspecified unspecified unspecified unspecified unspecified  	O	null
4 עמנואל עמנואל עמנואל properName unspecified unspecified unspecified unspecified unspecified  	I_LOC	null
5 Birth Birth Birth foreign unspecified unspecified unspecified unspecified unspecified  	O	null
6 Year Year Year foreign unspecified unspecified unspecified unspecified unspecified  	O	null
7 : : : punctuation unspecified unspecified unspecified unspecified unspecified  	O	null
8 ###NUMBER### ###NUMBER### ###NUMBER### numeral unspecified unspecified unspecified unspecified unspecified  	I_DATE	null
9 Death Death Death foreign unspecified unspecified unspecified unspecified unspecified  	O	null
10 Year Year Year foreign unspecified unspecified unspecified unspecified unspecified  	O	null
11 : : : punctuation unspecified unspecified unspecified unspecified unspecified  	O	null
12 ###NUMBER### ###NUMBER### ###NUMBER### numeral unspecified unspecified unspecified unspecified unspecified  	I_DATE	null
13 Birth Birth Birth foreign unspecified unspecified unspecified unspecified unspecified  	O	null
14 Place Place Place foreign unspecified unspecified unspecified unspecified unspecified  	O	null
15 : : : punctuation unspecified unspecified unspecified unspecified unspecified  	O	null
16 Occupation Occupation Occupation foreign unspecified unspecified unspecified unspecified unspecified  	O	null
17 : : : punctuation unspecified unspecified unspecified unspecified unspecified  	O	null
18 משורר משורר משורר noun masculine singular absolute unspecified unspecified  	O	null
19 , , , punctuation unspecified unspecified unspecified unspecified unspecified  	O	null
20 חוקר חוקר חוקר noun masculine singular construct unspecified unspecified  	O	null
21 פולקלור פולקלור פולקלור properName unspecified unspecified unspecified unspecified unspecified  	O	null
22 ו ו ומתרגם conjunction unspecified unspecified unspecified unspecified unspecified 0 
22 מתרגם מתרגם ומתרגם noun masculine singular absolute unspecified unspecified  	O	null
23 נולד נולד נולד verb masculine singular unspecified 3 past  	O	null
24 ב ב בגרייבה preposition unspecified unspecified unspecified unspecified unspecified 0 
24 גרייבה גרייבה בגרייבה properName unspecified unspecified unspecified unspecified unspecified  	I_LOC	null
25 , , , punctuation unspecified unspecified unspecified unspecified unspecified  	O	null
26 פולין פולין פולין properName unspecified unspecified unspecified unspecified unspecified  	I_LOC	null
27 , , , punctuation unspecified unspecified unspecified unspecified unspecified  	O	null
28 ו ו ולמד conjunction unspecified unspecified unspecified unspecified unspecified 0 
28 למד למד ולמד verb masculine singular unspecified 3 past  	O	null
29 ב ב באוניברסיטאות preposition unspecified unspecified unspecified unspecified unspecified 0 
29 ה ה באוניברסיטאות definiteArticle unspecified unspecified unspecified unspecified unspecified 0 
29 האוניברסיטאות אוניברסיטה באוניברסיטאות noun feminine plural absolute unspecified unspecified  	O	null
30 קניגסברג קניגסברג קניגסברג properName unspecified unspecified unspecified unspecified unspecified  	I_PERS	null
31 ו ו וברן conjunction unspecified unspecified unspecified unspecified unspecified 0 
31 ב ב וברן preposition unspecified unspecified unspecified unspecified unspecified 0 
31 רן רן וברן properName unspecified unspecified unspecified unspecified unspecified  	I_PERS	null
32 . . . punctuation unspecified unspecified unspecified unspecified unspecified  	O	null

0 מ מ מנעוריו preposition unspecified unspecified unspecified unspecified unspecified 0 
0 נעורי נעורים מנעוריו noun masculine plural absolute unspecified unspecified  
0 ו ו מנעוריו possessive masculine singular unspecified 3 unspecified 0 	O	null
1 היה הוא היה copula masculine singular unspecified 3 past  	O	null
2 פעיל פעיל פעיל adjective masculine singular absolute unspecified unspecified  	O	null
3 ב ב בתנועה preposition unspecified unspecified unspecified unspecified unspecified 0 
3 ה ה בתנועה definiteArticle unspecified unspecified unspecified unspecified unspecified 0 
3 התנועה תנועה בתנועה noun feminine singular absolute unspecified unspecified  	O	null
4 ה ה הציונית definiteArticle unspecified unspecified unspecified unspecified unspecified 0 
4 הציונית ציוני הציונית adjective feminine singular absolute unspecified unspecified  	O	null
5 ו ו ונשלח conjunction unspecified unspecified unspecified unspecified unspecified 0 
5 נשלח נשלח ונשלח verb masculine singular unspecified 3 past  	O	null
6 מטעם מטעם מטעם preposition unspecified unspecified unspecified unspecified unspecified  	O	null
7 קרן קרן קרן noun feminine singular construct unspecified unspecified  	O	null
8 ה ה היסוד definiteArticle unspecified unspecified unspecified unspecified unspecified 0 
8 היסוד יסוד היסוד noun masculine singular absolute unspecified unspecified  	O	null
9 ל ל לארצות preposition unspecified unspecified unspecified unspecified unspecified 0 
9 ארצות ארץ לארצות noun feminine plural absolute unspecified unspecified  	O	null
10 רבות רב רבות adjective feminine plural absolute unspecified unspecified  	O	null
11 . . . punctuation unspecified unspecified unspecified unspecified unspecified  	O	null

0 עלה עלה עלה verb masculine singular unspecified 3 past  	O	null
1 ארצה ארצה ארצה adverb unspecified unspecified unspecified unspecified unspecified  	O	null
2 ב ב ב preposition unspecified unspecified unspecified unspecified unspecified 0 	I_ORG	null
3 - - - punctuation unspecified unspecified unspecified unspecified unspecified  	I_ORG	null
4 ###NUMBER### ###NUMBER### ###NUMBER### numeral unspecified unspecified unspecified unspecified unspecified  	I_DATE	null
5 ו ו והתיישב conjunction unspecified unspecified unspecified unspecified unspecified 0 
5 התיישב התיישב והתיישב verb masculine singular unspecified 3 past  	O	null
6 ב ב בירושלים preposition unspecified unspecified unspecified unspecified unspecified 0 
6 ירושלים ירושלים בירושלים properName unspecified unspecified unspecified unspecified unspecified  	I_LOC	null
7 . . . punctuation unspecified unspecified unspecified unspecified unspecified  	O	null

0 לאחר לאחר לאחר conjunction unspecified unspecified unspecified unspecified unspecified  	O	null
1 קום קם קום verb masculine singular unspecified 2 imperative  	O	null
2 ה ה המדינה definiteArticle unspecified unspecified unspecified unspecified unspecified 0 
2 המדינה מדינה המדינה noun feminine singular absolute unspecified unspecified  	O	null
3 נטל נטל נטל verb masculine singular unspecified 3 past  	O	null
4 חלק חלק חלק noun masculine singular absolute unspecified unspecified  	O	null
5 נכבד נכבד נכבד adjective masculine singular absolute unspecified unspecified  	O	null
6 ב ב בהעלאת preposition unspecified unspecified unspecified unspecified unspecified 0 
6 העלאת העלאה בהעלאת noun feminine singular construct unspecified unspecified  	O	null
7 יהודי יהודי יהודי noun masculine singular absolute unspecified unspecified  	O	null
8 הודו הודה הודו verb masculine-and-feminine plural unspecified 3 past  	O	null
9 ארצה ארצה ארצה adverb unspecified unspecified unspecified unspecified unspecified  	O	null
10 . . . punctuation unspecified unspecified unspecified unspecified unspecified  	O	null

0 פירסם פרסם פירסם verb masculine singular unspecified 3 past  	O	null
1 מאמרים מאמר מאמרים noun masculine plural absolute unspecified unspecified  	O	null
2 ו ו וספרים conjunction unspecified unspecified unspecified unspecified unspecified 0 
2 ספרים ספר וספרים noun masculine plural absolute unspecified unspecified  	O	null
3 ב ב בחקר preposition unspecified unspecified unspecified unspecified unspecified 0 
3 חקר חקר בחקר noun masculine singular construct unspecified unspecified  	O	null
4 ה ה הפולקלור definiteArticle unspecified unspecified unspecified unspecified unspecified 0 
4 הפולקלור הפולקלור הפולקלור noun masculine singular absolute unspecified unspecified  	O	null
5 ה ה היהודי definiteArticle unspecified unspecified unspecified unspecified unspecified 0 
5 היהודי יהודי היהודי adjective masculine singular absolute unspecified unspecified  	O	null
6 ב ב בשפות preposition unspecified unspecified unspecified unspecified unspecified 0 
6 שפות שפה בשפות noun feminine plural absolute unspecified unspecified  	O	null
7 שונות שונה שונות adjective feminine plural absolute unspecified unspecified  	O	null
8 . . . punctuation unspecified unspecified unspecified unspecified unspecified  	O	null

0 נמנה נמנה נמנה verb masculine singular unspecified 3 past  	O	null
1 עם עם עם preposition unspecified unspecified unspecified unspecified unspecified  	O	null
2 תומכי תומך תומכיה noun masculine plural absolute unspecified unspecified  
2 ה ה תומכיה possessive feminine singular unspecified 3 unspecified 0 	O	null
3 ה ה הנלהבים definiteArticle unspecified unspecified unspecified unspecified unspecified 0 
3 הנלהבים נלהב הנלהבים participle masculine plural absolute any unspecified  	O	null
4 של של של shel-preposition unspecified unspecified unspecified unspecified unspecified  	O	null
5 לשון לשון לשון noun feminine singular construct unspecified unspecified  	O	null
6 אספרנטו אספרנטו אספרנטו properName unspecified unspecified unspecified unspecified unspecified  	O	null
7 כ כ ככלי preposition unspecified unspecified unspecified unspecified unspecified 0 
7 כלי כלי ככלי noun masculine singular absolute unspecified unspecified  	O	null
8 ל ל לקידום preposition unspecified unspecified unspecified unspecified unspecified 0 
8 קידום קידום לקידום noun masculine singular construct unspecified unspecified  	O	null
9 ה ה ההבנה definiteArticle unspecified unspecified unspecified unspecified unspecified 0 
9 ההבנה הבנה ההבנה noun feminine singular absolute unspecified unspecified  	O	null
10 ו ו והשלום conjunction unspecified unspecified unspecified unspecified unspecified 0 
10 ה ה והשלום definiteArticle unspecified unspecified unspecified unspecified unspecified 0 
10 השלום שלום והשלום noun masculine singular absolute unspecified unspecified  	O	null
11 בין בין בין preposition unspecified unspecified unspecified unspecified unspecified  	O	null
12 ה ה העמים definiteArticle unspecified unspecified unspecified unspecified unspecified 0 
12 העמים עם העמים noun masculine plural absolute unspecified unspecified  	O	null
13 ו ו וכתב conjunction unspecified unspecified unspecified unspecified unspecified 0 
13 כתב כתב וכתב noun masculine singular construct unspecified unspecified  	O	null
14 שירים שיר שירים noun masculine plural absolute unspecified unspecified  	O	null
15 ב ב בלשון preposition unspecified unspecified unspecified unspecified unspecified 0 
15 לשון לשון בלשון noun feminine singular absolute unspecified unspecified  	O	null
16 זו זו זו pronoun feminine singular unspecified 3 unspecified  	O	null
17 . . . punctuation unspecified unspecified unspecified unspecified unspecified  	O	null

0 ב ב בעברית preposition unspecified unspecified unspecified unspecified unspecified 0 
0 עברית עברית בעברית properName feminine singular unspecified unspecified unspecified  	I_PERS	null
1 כתב כתב כתב verb masculine singular unspecified 3 past  	O	null
2 את את את at-preposition unspecified unspecified unspecified unspecified unspecified  	O	null
3 ה ה הפואמה definiteArticle unspecified unspecified unspecified unspecified unspecified 0 
3 הפואמה פואמה הפואמה noun feminine singular absolute unspecified unspecified  	O	null
4 " " " punctuation unspecified unspecified unspecified unspecified unspecified  	O	null
5 בין בין בין preposition unspecified unspecified unspecified unspecified unspecified  	O	null
6 אדם אדם אדם noun masculine singular absolute unspecified unspecified  	O	null
7 ל ל לקונו preposition unspecified unspecified unspecified unspecified unspecified 0 
7 קון קונה לקונו noun masculine singular absolute unspecified unspecified  
7 ו ו לקונו possessive masculine singular unspecified 3 unspecified 0 	O	null
8 " " " punctuation unspecified unspecified unspecified unspecified unspecified  	O	null
9 ( ( ( punctuation unspecified unspecified unspecified unspecified unspecified  	I_LOC	null
10 יבנה יבנה יבנה properName feminine singular unspecified unspecified unspecified  	I_LOC	null
11 , , , punctuation unspecified unspecified unspecified unspecified unspecified  	O	null
12 ###NUMBER### ###NUMBER### ###NUMBER### numeral unspecified unspecified unspecified unspecified unspecified  	I_DATE	null
13 ) ) ) punctuation unspecified unspecified unspecified unspecified unspecified  	O	null
14 . . . punctuation unspecified unspecified unspecified unspecified unspecified  	O	null

0 Entry Entry Entry foreign unspecified unspecified unspecified unspecified unspecified  	O	null
1 writer writer writer foreign unspecified unspecified unspecified unspecified unspecified  	O	null
2 : : : punctuation unspecified unspecified unspecified unspecified unspecified  	O	null
3 דורון דורון דורון properName unspecified unspecified unspecified unspecified unspecified  	I_PERS	null
4 ב' ב' ב' noun masculine singular absolute unspecified unspecified  	I_DATE	null
5 כהן כהן כהן properName unspecified unspecified unspecified unspecified unspecified  	I_PERS	null
6 Entry Entry Entry foreign unspecified unspecified unspecified unspecified unspecified  	O	null
7 Value Value Value foreign unspecified unspecified unspecified unspecified unspecified  	O	null
8 : : : punctuation unspecified unspecified unspecified unspecified unspecified  	O	null
9 אולסבנגר אולסבנגר אולסבנגר verb masculine singular unspecified any beinoni  	O	null
10 זכור זכור זכור adjective masculine singular absolute unspecified unspecified  	O	null
11 במיוחד במיוחד במיוחד adverb unspecified unspecified unspecified unspecified unspecified  	O	null
12 ב ב בזכות preposition unspecified unspecified unspecified unspecified unspecified 0 
12 זכות זכות בזכות noun feminine singular construct unspecified unspecified  	O	null
13 תרגומי תרגום תרגומיו noun masculine plural absolute unspecified unspecified  
13 ו ו תרגומיו possessive masculine singular unspecified 3 unspecified 0 	O	null
14 ה ה החלוציים definiteArticle unspecified unspecified unspecified unspecified unspecified 0 
14 החלוציים החלוציים החלוציים adjective masculine plural absolute unspecified unspecified  	O	null
15 מ מ מכמה preposition unspecified unspecified unspecified unspecified unspecified 0 
15 כמה כמה מכמה quantifier unspecified unspecified construct unspecified unspecified  	O	null
16 לשונות לשון לשונות noun feminine plural absolute unspecified unspecified  	O	null
17 . . . punctuation unspecified unspecified unspecified unspecified unspecified  	O	null

0 הוא הוא הוא pronoun masculine singular unspecified 3 unspecified  	O	null
1 היה הוא היה copula masculine singular unspecified 3 past  	O	null
2 ה ה המתרגם definiteArticle unspecified unspecified unspecified unspecified unspecified 0 
2 המתרגם מתרגם המתרגם noun masculine singular absolute unspecified unspecified  	O	null
3 ה ה הראשון definiteArticle unspecified unspecified unspecified unspecified unspecified 0 
3 הראשון ORD1 הראשון numeral masculine singular absolute unspecified unspecified  	O	null
4 , , , punctuation unspecified unspecified unspecified unspecified unspecified  	O	null
5 ו ו ושנים conjunction unspecified unspecified unspecified unspecified unspecified 0 
5 שנים שנה ושנים noun feminine plural absolute unspecified unspecified  	O	null
6 רבות רב רבות adjective feminine plural absolute unspecified unspecified  	O	null
7 ה ה היחיד definiteArticle unspecified unspecified unspecified unspecified unspecified 0 
7 היחיד יחיד היחיד adjective masculine singular absolute unspecified unspecified  	O	null
8 , , , punctuation unspecified unspecified unspecified unspecified unspecified  	O	null
9 ש ש שתירגם relativizer/subordinatingConjunction unspecified unspecified unspecified unspecified unspecified 0 
9 תירגם תרגם שתירגם verb masculine singular unspecified 3 past  	O	null
10 ספר ספר ספר noun masculine singular absolute unspecified unspecified  	O	null
11 מ מ מיפנית preposition unspecified unspecified unspecified unspecified unspecified 0 
11 יפנית יפני מיפנית noun feminine singular absolute unspecified unspecified  	O	null
12 ל ל לעברית preposition unspecified unspecified unspecified unspecified unspecified 0 
12 עברית עברית לעברית properName feminine singular unspecified unspecified unspecified  	O	null
13 : : : punctuation unspecified unspecified unspecified unspecified unspecified  	O	null
14 מ מ מוּקַשִי preposition unspecified unspecified unspecified unspecified unspecified 0 
14 וּקַשִי וּקַשִי מוּקַשִי properName unspecified unspecified unspecified unspecified unspecified  	I_LOC	null
15 בַּנַשִי בַּנַשִי בַּנַשִי verb feminine singular unspecified 2 imperative  	O	null
16 – – – punctuation unspecified unspecified unspecified unspecified unspecified  	O	null
17 סיפורים סיפור סיפורים noun masculine plural absolute unspecified unspecified  	O	null
18 מ מ מימי preposition unspecified unspecified unspecified unspecified unspecified 0 
18 ימי יום מימי noun masculine plural construct unspecified unspecified  	O	null
19 קדם קדם קדם verb masculine singular unspecified 3 past  	O	null
20 ( ( ( punctuation unspecified unspecified unspecified unspecified unspecified  	O	null
21 , , , punctuation unspecified unspecified unspecified unspecified unspecified  	O	null
22 ###NUMBER### ###NUMBER### ###NUMBER### numeral unspecified unspecified unspecified unspecified unspecified  	I_DATE	null
23 הדפסה הדפסה הדפסה noun feminine singular absolute unspecified unspecified  	O	null
24 שנייה ORD2 שנייה numeral feminine singular absolute unspecified unspecified  	O	null
25 ###NUMBER### ###NUMBER### ###NUMBER### numeral unspecified unspecified unspecified unspecified unspecified  	I_DATE	null
26 ) ) ) punctuation unspecified unspecified unspecified unspecified unspecified  	O	null
27 . . . punctuation unspecified unspecified unspecified unspecified unspecified  	O	null

0 היה הוא היה copula masculine singular unspecified 3 past  	O	null
1 מ מ מחלוצי preposition unspecified unspecified unspecified unspecified unspecified 0 
1 חלוצי חלוץ מחלוצי noun masculine plural construct unspecified unspecified  	O	null
2 ה ה התרגום definiteArticle unspecified unspecified unspecified unspecified unspecified 0 
2 התרגום תרגום התרגום noun masculine singular absolute unspecified unspecified  	O	null
3 מ מ מסנסקריט preposition unspecified unspecified unspecified unspecified unspecified 0 
3 סנסקריט סנסקריט מסנסקריט properName unspecified unspecified unspecified unspecified unspecified  	I_LOC	null
4 ל ל לעברית preposition unspecified unspecified unspecified unspecified unspecified 0 
4 עברית עברית לעברית properName feminine singular unspecified unspecified unspecified  	I_LOC	null
5 . . . punctuation unspecified unspecified unspecified unspecified unspecified  	O	null

0 תירגם תרגם תירגם verb masculine singular unspecified 3 past  	O	null
1 את את את at-preposition unspecified unspecified unspecified unspecified unspecified  	O	null
2 יצירת יצירה יצירת noun feminine singular construct unspecified unspecified  	O	null
3 ה ה המופת definiteArticle unspecified unspecified unspecified unspecified unspecified 0 
3 המופת מופת המופת noun feminine singular absolute unspecified unspecified  	O	null
4 של של של shel-preposition unspecified unspecified unspecified unspecified unspecified  	O	null
5 ה ה התרבות definiteArticle unspecified unspecified unspecified unspecified unspecified 0 
5 התרבות תרבות התרבות noun feminine singular absolute unspecified unspecified  	O	null
6 ה ה ההודית definiteArticle unspecified unspecified unspecified unspecified unspecified 0 
6 ההודית הודי ההודית adjective feminine singular absolute unspecified unspecified  	O	null
7 ב ב בהגודגיטה preposition unspecified unspecified unspecified unspecified unspecified 0 
7 ה ה בהגודגיטה definiteArticle unspecified unspecified unspecified unspecified unspecified 0 
7 ההגודגיטה ההגודגיטה בהגודגיטה noun feminine singular absolute unspecified unspecified  	O	null
8 : : : punctuation unspecified unspecified unspecified unspecified unspecified  	O	null
9 שירת שירה שירת noun feminine singular construct unspecified unspecified  	O	null
10 ה ה המבורך definiteArticle unspecified unspecified unspecified unspecified unspecified 0 
10 המבורך בורך המבורך participle masculine singular absolute any unspecified  	O	null
11 , , , punctuation unspecified unspecified unspecified unspecified unspecified  	O	null
12 ###NUMBER### ###NUMBER### ###NUMBER### numeral unspecified unspecified unspecified unspecified unspecified  	I_DATE	null
13 עם עם עם preposition unspecified unspecified unspecified unspecified unspecified  	O	null
14 הקדמה הקדמה הקדמה noun feminine singular absolute unspecified unspecified  	O	null
15 מאת מאת מאת preposition unspecified unspecified unspecified unspecified unspecified  	O	null
16 מרטין מרטין מרטין properName unspecified unspecified unspecified unspecified unspecified  	I_PERS	null
17 בובר בובר בובר properName unspecified unspecified unspecified unspecified unspecified  	I_PERS	null
18 ) ) ) punctuation unspecified unspecified unspecified unspecified unspecified  	O	null
19 , , , punctuation unspecified unspecified unspecified unspecified unspecified  	O	null
20 ו ו וכן conjunction unspecified unspecified unspecified unspecified unspecified 0 
20 כן כן וכן conjunction unspecified unspecified unspecified unspecified unspecified  	O	null
21 את את את at-preposition unspecified unspecified unspecified unspecified unspecified  	O	null
22 ה ה הכרך definiteArticle unspecified unspecified unspecified unspecified unspecified 0 
22 הכרך כרך הכרך noun masculine singular absolute unspecified unspecified  	O	null
23 מ מ משירת preposition unspecified unspecified unspecified unspecified unspecified 0 
23 שירת שירה משירת noun feminine singular construct unspecified unspecified  	O	null
24 הודו הודו הודו properName feminine singular unspecified unspecified unspecified  	I_LOC	null
25 : : : punctuation unspecified unspecified unspecified unspecified unspecified  	O	null
26 הגות הגות הגות noun feminine singular construct unspecified unspecified  	O	null
27 ו ו ושירה conjunction unspecified unspecified unspecified unspecified unspecified 0 
27 שירה שירה ושירה noun feminine singular absolute unspecified unspecified  	O	null
28 ) ) ) punctuation unspecified unspecified unspecified unspecified unspecified  	O	null
29 . . . punctuation unspecified unspecified unspecified unspecified unspecified  	O	null
30 ###NUMBER### ###NUMBER### ###NUMBER### numeral unspecified unspecified unspecified unspecified unspecified  	I_DATE	null
31 תירגם תרגם תירגם verb masculine singular unspecified 3 past  	O	null
32 גם גם גם conjunction unspecified unspecified unspecified unspecified unspecified  	O	null
33 יצירות יצירה יצירות noun feminine plural construct unspecified unspecified  	O	null
34 מופת מופת מופת noun feminine singular construct unspecified unspecified  	O	null
35 מ מ מהספרות preposition unspecified unspecified unspecified unspecified unspecified 0 
35 ה ה מהספרות definiteArticle unspecified unspecified unspecified unspecified unspecified 0 
35 הספרות ספרה מהספרות noun feminine plural absolute unspecified unspecified  	O	null
36 ה ה האיטלקית definiteArticle unspecified unspecified unspecified unspecified unspecified 0 
36 האיטלקית איטלקי האיטלקית adjective feminine singular absolute unspecified unspecified  	O	null
37 , , , punctuation unspecified unspecified unspecified unspecified unspecified  	O	null
38 ה ה הספרדית definiteArticle unspecified unspecified unspecified unspecified unspecified 0 
38 הספרדית ספרדי הספרדית adjective feminine singular absolute unspecified unspecified  	O	null
39 ו ו והגרמנית conjunction unspecified unspecified unspecified unspecified unspecified 0 
39 ה ה והגרמנית definiteArticle unspecified unspecified unspecified unspecified unspecified 0 
39 הגרמנית גרמני והגרמנית adjective feminine singular absolute unspecified unspecified  	O	null
40 , , , punctuation unspecified unspecified unspecified unspecified unspecified  	O	null
41 ב ב בהן preposition unspecified unspecified unspecified unspecified unspecified  
41 הן הן בהן pronomial feminine plural unspecified 3 unspecified 0 	O	null
42 יצירות יצירה יצירותיו noun feminine plural absolute unspecified unspecified  
42 ו ו יצירותיו possessive masculine singular unspecified 3 unspecified 0 	O	null
43 של של של shel-preposition unspecified unspecified unspecified unspecified unspecified  	O	null
44 דנטה דנטה דנטה properName unspecified unspecified unspecified unspecified unspecified  	I_PERS	null
45 אליגיירי אליגיירי אליגיירי adjective masculine singular absolute unspecified unspecified  	O	null
46 ה ה הקומדיה definiteArticle unspecified unspecified unspecified unspecified unspecified 0 
46 הקומדיה קומדיה הקומדיה noun feminine singular absolute unspecified unspecified  	O	null
47 ה ה האלוהית definiteArticle unspecified unspecified unspecified unspecified unspecified 0 
47 האלוהית אלוהי האלוהית adjective feminine singular absolute unspecified unspecified  	O	null
48 ( ( ( punctuation unspecified unspecified unspecified unspecified unspecified  	O	null
49 שלושה CARD3 שלושה numeral masculine plural absolute unspecified unspecified  	O	null
50 כרכים כרך כרכים noun masculine plural absolute unspecified unspecified  	O	null
51 , , , punctuation unspecified unspecified unspecified unspecified unspecified  	O	null
52 ###NUMBER### ###NUMBER### ###NUMBER### numeral unspecified unspecified unspecified unspecified unspecified  	I_DATE	null
53 עד עד עד preposition unspecified unspecified unspecified unspecified unspecified  	O	null
54 ) ) ) punctuation unspecified unspecified unspecified unspecified unspecified  	O	null
55 ###NUMBER### ###NUMBER### ###NUMBER### numeral unspecified unspecified unspecified unspecified unspecified  	I_DATE	null
56 ו ו וחיים conjunction unspecified unspecified unspecified unspecified unspecified 0 
56 חיים חיים וחיים noun masculine plural absolute unspecified unspecified  	O	null
57 חדשים חדש חדשים adjective masculine plural absolute unspecified unspecified  	O	null
58 ) ) ) punctuation unspecified unspecified unspecified unspecified unspecified  	O	null
59 ; ; ; punctuation unspecified unspecified unspecified unspecified unspecified  	O	null
60 ###NUMBER### ###NUMBER### ###NUMBER### numeral unspecified unspecified unspecified unspecified unspecified  	I_DATE	null
61 דקמרון דקמרון דקמרון properName masculine singular unspecified unspecified unspecified  	O	null
62 : : : punctuation unspecified unspecified unspecified unspecified unspecified  	O	null
63 ספר ספר ספר noun masculine singular construct unspecified unspecified  	O	null
64 עשרת CARD10 עשרת numeral masculine plural construct unspecified unspecified  	O	null
65 ה ה הימים definiteArticle unspecified unspecified unspecified unspecified unspecified 0 
65 הימים יום הימים noun masculine plural absolute unspecified unspecified  	O	null
66 של של של shel-preposition unspecified unspecified unspecified unspecified unspecified  	O	null
67 ג'ובאני ג'ובאני ג'ובאני properName unspecified unspecified unspecified unspecified unspecified  	I_PERS	null
68 בוקצ'יו בוקצ'יו בוקצ'יו properName unspecified unspecified unspecified unspecified unspecified  	I_PERS	null
69 ) ) ) punctuation unspecified unspecified unspecified unspecified unspecified  	O	null
70 ; ; ; punctuation unspecified unspecified unspecified unspecified unspecified  	O	null
71 ###NUMBER### ###NUMBER### ###NUMBER### numeral unspecified unspecified unspecified unspecified unspecified  	I_DATE	null
72 פלטרו פלטרו פלטרו properName unspecified unspecified unspecified unspecified unspecified  	B_LOC	null
73 ו ו ואני conjunction unspecified unspecified unspecified unspecified unspecified 0 
73 אני הוא ואני pronoun masculine-and-feminine singular unspecified 1 unspecified  	O	null
74 של של של shel-preposition unspecified unspecified unspecified unspecified unspecified  	O	null
75 חואן חואן חואן properName unspecified unspecified unspecified unspecified unspecified  	I_PERS	null
76 רמון רמון רמון properName unspecified unspecified unspecified unspecified unspecified  	I_PERS	null
77 חימנז חימנז חימנז properName unspecified unspecified unspecified unspecified unspecified  	I_PERS	null
78 ) ) ) punctuation unspecified unspecified unspecified unspecified unspecified  	O	null
79 ; ; ; punctuation unspecified unspecified unspecified unspecified unspecified  	O	null
80 לב לב לב properName unspecified unspecified unspecified unspecified unspecified  	O	null
81 ###NUMBER### ###NUMBER### ###NUMBER### numeral unspecified unspecified unspecified unspecified unspecified  	I_DATE	null
82 ה ה הפטדה definiteArticle unspecified unspecified unspecified unspecified unspecified 0 
82 הפטדה הפטדה הפטדה noun feminine singular absolute unspecified unspecified  	O	null
83 : : : punctuation unspecified unspecified unspecified unspecified unspecified  	O	null
84 כוח כוח כוחה noun masculine singular absolute unspecified unspecified  
84 ה ה כוחה possessive feminine singular unspecified 3 unspecified 0 	O	null
85 של של של shel-preposition unspecified unspecified unspecified unspecified unspecified  	O	null
86 אהבהשל אהבהשל אהבהשל properName unspecified unspecified unspecified unspecified unspecified  	I_PERS	null
87 סלוודור סלוודור סלוודור properName unspecified unspecified unspecified unspecified unspecified  	I_PERS	null
88 דה דה דה properName unspecified unspecified unspecified unspecified unspecified  	I_PERS	null
89 מ מ מדריאגה preposition unspecified unspecified unspecified unspecified unspecified 0 
89 דריאגה דריאגה מדריאגה properName unspecified unspecified unspecified unspecified unspecified  	I_PERS	null
90 , , , punctuation unspecified unspecified unspecified unspecified unspecified  	O	null
91 ###NUMBER### ###NUMBER### ###NUMBER### numeral unspecified unspecified unspecified unspecified unspecified  	I_DATE	null
92 ) ) ) punctuation unspecified unspecified unspecified unspecified unspecified  	O	null
93 ; ; ; punctuation unspecified unspecified unspecified unspecified unspecified  	O	null
94 מ מ משירי preposition unspecified unspecified unspecified unspecified unspecified 0 
94 שירי שיר משירי noun masculine plural construct unspecified unspecified  	I_DATE	null
95 ###NUMBER### ###NUMBER### ###NUMBER### numeral unspecified unspecified unspecified unspecified unspecified  	I_DATE	null
96 גתה גתה גתה properName unspecified unspecified unspecified unspecified unspecified  	I_DATE	null
97 ( ( ( punctuation unspecified unspecified unspecified unspecified unspecified  	O	null
98 , , , punctuation unspecified unspecified unspecified unspecified unspecified  	O	null
99 ###NUMBER### ###NUMBER### ###NUMBER### numeral unspecified unspecified unspecified unspecified unspecified  	I_DATE	null
100 ) ) ) punctuation unspecified unspecified unspecified unspecified unspecified  	O	null
101 ###NUMBER### ###NUMBER### ###NUMBER### numeral unspecified unspecified unspecified unspecified unspecified  	I_DATE	null
102 ועוד ועוד ועוד conjunction unspecified unspecified unspecified unspecified unspecified  	O	null
103 . . . punctuation unspecified unspecified unspecified unspecified unspecified  	O	null

0 רוב רוב רוב noun masculine singular construct unspecified unspecified  	O	null
1 ספרי ספר ספרי noun masculine plural construct unspecified unspecified  	O	null
2 תרגומי תרגום תרגומיו noun masculine plural absolute unspecified unspecified  
2 ו ו תרגומיו possessive masculine singular unspecified 3 unspecified 0 	O	null
3 קשים קשה קשים adjective masculine plural absolute unspecified unspecified  	O	null
4 ל ל להשגה preposition unspecified unspecified unspecified unspecified unspecified 0 
4 ה ה להשגה definiteArticle unspecified unspecified unspecified unspecified unspecified 0 
4 ההשגה השגה להשגה noun feminine singular absolute unspecified unspecified  	O	null
5 , , , punctuation unspecified unspecified unspecified unspecified unspecified  	O	null
6 ו ו ולחלקם conjunction unspecified unspecified unspecified unspecified unspecified 0 
6 ל ל ולחלקם preposition unspecified unspecified unspecified unspecified unspecified 0 
6 חלק חלק ולחלקם noun masculine singular absolute unspecified unspecified  
6 ם ם ולחלקם possessive masculine plural unspecified 3 unspecified 0 	O	null
7 נכתבו נכתב נכתבו verb masculine-and-feminine plural unspecified 3 past  	O	null
8 בינתיים בינתיים בינתיים adverb unspecified unspecified unspecified unspecified unspecified  	O	null
9 תרגומים תרגום תרגומים noun masculine plural absolute unspecified unspecified  	O	null
10 חדשים חדש חדשים adjective masculine plural absolute unspecified unspecified  	O	null
11 , , , punctuation unspecified unspecified unspecified unspecified unspecified  	O	null
12 אבל אבל אבל conjunction unspecified unspecified unspecified unspecified unspecified  	O	null
13 הוא הוא הוא pronoun masculine singular unspecified 3 unspecified  	O	null
14 ראוי ראוי ראוי modal masculine singular unspecified any unspecified  	O	null
15 להיזכר נזכר להיזכר verb unspecified unspecified unspecified unspecified infinitive  	O	null
16 ב ב בזכות preposition unspecified unspecified unspecified unspecified unspecified 0 
16 זכות זכות בזכות noun feminine singular construct unspecified unspecified  	O	null
17 עבודת עבודה עבודתו noun feminine singular absolute unspecified unspecified  
17 ו ו עבודתו possessive masculine singular unspecified 3 unspecified 0 	O	null
18 ה ה החלוצית definiteArticle unspecified unspecified unspecified unspecified unspecified 0 
18 החלוצית החלוצית החלוצית adjective feminine singular absolute unspecified unspecified  	O	null
19 ו ו והקפדנית conjunction unspecified unspecified unspecified unspecified unspecified 0 
19 ה ה והקפדנית definiteArticle unspecified unspecified unspecified unspecified unspecified 0 
19 הקפדנית קפדן והקפדנית adjective feminine singular absolute unspecified unspecified  	O	null
20 , , , punctuation unspecified unspecified unspecified unspecified unspecified  	O	null
21 ש ש שהביאה relativizer/subordinatingConjunction unspecified unspecified unspecified unspecified unspecified 0 
21 הביאה הביא שהביאה verb feminine singular unspecified 3 past  	O	null
22 אל אל אל preposition unspecified unspecified unspecified unspecified unspecified  	O	null
23 ה ה העברית definiteArticle unspecified unspecified unspecified unspecified unspecified 0 
23 העברית עברי העברית adjective feminine singular absolute unspecified unspecified  	O	null
24 מגוון מגוון מגוון noun masculine singular absolute unspecified unspecified  	O	null
25 רחב רחב רחב adjective masculine singular absolute unspecified unspecified  	O	null
26 של של של shel-preposition unspecified unspecified unspecified unspecified unspecified  	O	null
27 יצירות יצירה יצירות noun feminine plural absolute unspecified unspecified  	O	null
28 מופת מופת מופת noun feminine singular absolute unspecified unspecified  	O	null
29 מ מ מספרות preposition unspecified unspecified unspecified unspecified unspecified 0 
29 ספרות ספרות מספרות noun feminine singular construct unspecified unspecified  	O	null
30 ה ה העולם definiteArticle unspecified unspecified unspecified unspecified unspecified 0 
30 העולם עולם העולם noun masculine singular absolute unspecified unspecified  	O	null
31 . . . punctuation unspecified unspecified unspecified unspecified unspecified  	O	null

0 References References References foreign unspecified unspecified unspecified unspecified unspecified  	O	null
1 : : : punctuation unspecified unspecified unspecified unspecified unspecified  	O	null
2 שזר שזר שזר properName unspecified unspecified unspecified unspecified unspecified  	I_PERS	null
3 , , , punctuation unspecified unspecified unspecified unspecified unspecified  	O	null
4 זלמן זלמן זלמן properName unspecified unspecified unspecified unspecified unspecified  	I_PERS	null
5 . . . punctuation unspecified unspecified unspecified unspecified unspecified  	O	null

0 אור אור אור noun masculine singular construct unspecified unspecified  	O	null
1 אישים אישים אישים noun masculine plural absolute unspecified unspecified  	O	null
2 א א א properName unspecified unspecified unspecified unspecified unspecified  	I_LOC	null
3 ' ' ' punctuation unspecified unspecified unspecified unspecified unspecified  	O	null
4 . . . punctuation unspecified unspecified unspecified unspecified unspecified  	I_LOC	null
5 ירושלים ירושלים ירושלים properName unspecified unspecified unspecified unspecified unspecified  	I_LOC	null
6 : : : punctuation unspecified unspecified unspecified unspecified unspecified  	O	null
7 ה ה הספרייה definiteArticle unspecified unspecified unspecified unspecified unspecified 0 
7 הספרייה ספרייה הספרייה noun feminine singular absolute unspecified unspecified  	O	null
8 ה ה הציונית definiteArticle unspecified unspecified unspecified unspecified unspecified 0 
8 הציונית ציוני הציונית adjective feminine singular absolute unspecified unspecified  	O	null
9 . . . punctuation unspecified unspecified unspecified unspecified unspecified  	O	null

0 ###NUMBER### ###NUMBER### ###NUMBER### numeral unspecified unspecified unspecified unspecified unspecified  	I_DATE	null
1 . . . punctuation unspecified unspecified unspecified unspecified unspecified  	O	null

0 - - - punctuation unspecified unspecified unspecified unspecified unspecified  	O	null
1 ###NUMBER### ###NUMBER### ###NUMBER### numeral unspecified unspecified unspecified unspecified unspecified  	O	null
2 ; ; ; punctuation unspecified unspecified unspecified unspecified unspecified  	O	null
3 ###NUMBER### ###NUMBER### ###NUMBER### numeral unspecified unspecified unspecified unspecified unspecified  	O	null
4 כהן כהן כהן properName unspecified unspecified unspecified unspecified unspecified  	I_PERS	null
5 , , , punctuation unspecified unspecified unspecified unspecified unspecified  	O	null
6 דורון דורון דורון properName unspecified unspecified unspecified unspecified unspecified  	I_PERS	null
7 ב ב ב preposition unspecified unspecified unspecified unspecified unspecified  	O	null
8 ' ' ' punctuation unspecified unspecified unspecified unspecified unspecified  	O	null
9 . . . punctuation unspecified unspecified unspecified unspecified unspecified  	O	null
10 יש יש יש existential unspecified unspecified unspecified unspecified unspecified  	O	null
11 לך הלך לך verb masculine singular unspecified 2 imperative  	O	null
12 משהו משהו משהו noun masculine singular absolute unspecified unspecified  	O	null
13 לקרוא קרא לקרוא verb unspecified unspecified unspecified unspecified infinitive  	O	null
14 ? ? ? punctuation unspecified unspecified unspecified unspecified unspecified  	O	null

0 ביקורות ביקורת ביקורות noun feminine plural absolute unspecified unspecified  	O	null
1 ו ו ומאמרים conjunction unspecified unspecified unspecified unspecified unspecified 0 
1 מאמרים מאמר ומאמרים noun masculine plural absolute unspecified unspecified  	O	null
2 על על על preposition unspecified unspecified unspecified unspecified unspecified  	O	null
3 ספרים ספר ספרים noun masculine plural absolute unspecified unspecified  	O	null
4 ו ו וסופרים conjunction unspecified unspecified unspecified unspecified unspecified 0 
4 סופרים סופר וסופרים noun masculine plural absolute unspecified unspecified  	O	null
5 . . . punctuation unspecified unspecified unspecified unspecified unspecified  	O	null

0 ירושלים ירושלים ירושלים properName unspecified unspecified unspecified unspecified unspecified  	I_LOC	null
1 : : : punctuation unspecified unspecified unspecified unspecified unspecified  	O	null
2 כרמל כרמל כרמל properName unspecified unspecified unspecified unspecified unspecified  	I_LOC	null
3 . . . punctuation unspecified unspecified unspecified unspecified unspecified  	O	null

0 ###NUMBER### ###NUMBER### ###NUMBER### numeral unspecified unspecified unspecified unspecified unspecified  	I_DATE	null
1 . . . punctuation unspecified unspecified unspecified unspecified unspecified  	O	null

0 ###NUMBER### ###NUMBER### ###NUMBER### numeral unspecified unspecified unspecified unspecified unspecified  	O	null
1 - - - punctuation unspecified unspecified unspecified unspecified unspecified  	O	null
2 ###NUMBER### ###NUMBER### ###NUMBER### numeral unspecified unspecified unspecified unspecified unspecified  	O	null
3 . . . punctuation unspecified unspecified unspecified unspecified unspecified  	O	null

