0 Name Name Name foreign unspecified unspecified unspecified unspecified unspecified  	O	null
1 : : : punctuation unspecified unspecified unspecified unspecified unspecified  	O	null
2 זמיר זמיר זמיר properName unspecified unspecified unspecified unspecified unspecified  	I_PERS	null
3 ( ( ( punctuation unspecified unspecified unspecified unspecified unspecified  	O	null
4 זינגר זינגר זינגר properName unspecified unspecified unspecified unspecified unspecified  	I_PERS	null
5 ) ) ) punctuation unspecified unspecified unspecified unspecified unspecified  	O	null
6 , , , punctuation unspecified unspecified unspecified unspecified unspecified  	I_LOC	null
7 ישראל ישראל ישראל properName unspecified unspecified unspecified unspecified unspecified  	I_LOC	null
8 Birth Birth Birth foreign unspecified unspecified unspecified unspecified unspecified  	O	null
9 Year Year Year foreign unspecified unspecified unspecified unspecified unspecified  	O	null
10 : : : punctuation unspecified unspecified unspecified unspecified unspecified  	O	null
11 ###NUMBER### ###NUMBER### ###NUMBER### numeral unspecified unspecified unspecified unspecified unspecified  	I_DATE	null
12 Birth Birth Birth foreign unspecified unspecified unspecified unspecified unspecified  	O	null
13 Place Place Place foreign unspecified unspecified unspecified unspecified unspecified  	O	null
14 : : : punctuation unspecified unspecified unspecified unspecified unspecified  	O	null
15 וורשה ורשה וורשה properName unspecified unspecified unspecified unspecified unspecified  	I_LOC	null
16 , , , punctuation unspecified unspecified unspecified unspecified unspecified  	O	null
17 פולין פולין פולין properName unspecified unspecified unspecified unspecified unspecified  	I_LOC	null
18 , , , punctuation unspecified unspecified unspecified unspecified unspecified  	O	null
19 ב ב בנם preposition unspecified unspecified unspecified unspecified unspecified 0 
19 נם נם בנם participle masculine singular construct any unspecified  	O	null
20 Occupation Occupation Occupation foreign unspecified unspecified unspecified unspecified unspecified  	O	null
21 : : : punctuation unspecified unspecified unspecified unspecified unspecified  	O	null
22 סופר סופר סופר noun masculine singular absolute unspecified unspecified  	O	null
23 , , , punctuation unspecified unspecified unspecified unspecified unspecified  	O	null
24 מתרגם מתרגם מתרגם noun masculine singular absolute unspecified unspecified  	O	null
25 , , , punctuation unspecified unspecified unspecified unspecified unspecified  	O	null
26 עורך עורך עורך noun masculine singular absolute unspecified unspecified  	O	null
27 ו ו ועיתונאי conjunction unspecified unspecified unspecified unspecified unspecified 0 
27 עיתונאי עיתונאי ועיתונאי noun masculine singular absolute unspecified unspecified  	O	null
28 Entry Entry Entry foreign unspecified unspecified unspecified unspecified unspecified  	O	null
29 writer writer writer foreign unspecified unspecified unspecified unspecified unspecified  	O	null
30 : : : punctuation unspecified unspecified unspecified unspecified unspecified  	O	null
31 אלישע אלישע אלישע properName unspecified unspecified unspecified unspecified unspecified  	I_PERS	null
32 פורת פורת פורת properName unspecified unspecified unspecified unspecified unspecified  	I_PERS	null
33 Entry Entry Entry foreign unspecified unspecified unspecified unspecified unspecified  	O	null
34 Value Value Value foreign unspecified unspecified unspecified unspecified unspecified  	O	null
35 : : : punctuation unspecified unspecified unspecified unspecified unspecified  	O	null
36 נולד נולד נולד verb masculine singular unspecified 3 past  	O	null
37 ב ב בוורשה preposition unspecified unspecified unspecified unspecified unspecified 0 
37 וורשה ורשה בוורשה properName unspecified unspecified unspecified unspecified unspecified  	I_LOC	null
38 , , , punctuation unspecified unspecified unspecified unspecified unspecified  	O	null
39 פולין פולין פולין properName unspecified unspecified unspecified unspecified unspecified  	I_LOC	null
40 , , , punctuation unspecified unspecified unspecified unspecified unspecified  	O	null
41 בן בן בנם noun masculine singular absolute unspecified unspecified  
41 ם ם בנם possessive masculine plural unspecified 3 unspecified 0 	O	null
42 ה ה היחיד definiteArticle unspecified unspecified unspecified unspecified unspecified 0 
42 היחיד יחיד היחיד adjective masculine singular absolute unspecified unspecified  	O	null
43 של של של shel-preposition unspecified unspecified unspecified unspecified unspecified  	O	null
44 אבי אב אביו noun masculine singular absolute unspecified unspecified  
44 ו ו אביו possessive masculine singular unspecified 3 unspecified 0 	O	null
45 , , , punctuation unspecified unspecified unspecified unspecified unspecified  	O	null
46 ה ה הסופר definiteArticle unspecified unspecified unspecified unspecified unspecified 0 
46 הסופר סופר הסופר noun masculine singular absolute unspecified unspecified  	O	null
47 חתן חיתן חתן verb masculine singular unspecified 3 past  	O	null
48 פרס פרס פרס properName masculine singular unspecified unspecified unspecified  	I_PERS	null
49 נובל נבל נובל verb masculine singular unspecified any beinoni  	O	null
50 ל ל לספרות preposition unspecified unspecified unspecified unspecified unspecified 0 
50 ספרות ספרות לספרות noun feminine singular construct unspecified unspecified  	O	null
51 יצחק יצחק יצחק properName unspecified unspecified unspecified unspecified unspecified  	I_PERS	null
52 ב ב בשביס preposition unspecified unspecified unspecified unspecified unspecified 0 
52 שביס שביס בשביס noun masculine singular construct unspecified unspecified  	O	null
53 - - - punctuation unspecified unspecified unspecified unspecified unspecified  	O	null
54 זינגר זינגר זינגר properName unspecified unspecified unspecified unspecified unspecified  	I_PERS	null
55 , , , punctuation unspecified unspecified unspecified unspecified unspecified  	O	null
56 ו ו ואמו conjunction unspecified unspecified unspecified unspecified unspecified 0 
56 אם אם ואמו noun feminine singular absolute unspecified unspecified  
56 ו ו ואמו possessive masculine singular unspecified 3 unspecified 0 	O	null
57 רחל רחל רחל properName feminine singular unspecified unspecified unspecified  	I_PERS	null
58 ( ( ( punctuation unspecified unspecified unspecified unspecified unspecified  	O	null
59 רוני רון רוניה noun masculine plural absolute unspecified unspecified  
59 ה ה רוניה possessive feminine singular unspecified 3 unspecified 0 	O	null
60 ) ) ) punctuation unspecified unspecified unspecified unspecified unspecified  	O	null
61 שפירא שפירא שפירא properName unspecified unspecified unspecified unspecified unspecified  	I_PERS	null
62 . . . punctuation unspecified unspecified unspecified unspecified unspecified  	O	null

0 כש כש כשהיה temporalSubConj unspecified unspecified unspecified unspecified unspecified 0 
0 היה הוא כשהיה copula masculine singular unspecified 3 past  	O	null
1 ב ב בן preposition unspecified unspecified unspecified unspecified unspecified  
1 הן הן בן pronomial feminine plural unspecified 3 unspecified 0 	O	null
2 חמש CARD5 חמש numeral feminine singular absolute unspecified unspecified  	O	null
3 נפרדו נפרד נפרדו verb masculine-and-feminine plural unspecified 3 past  	O	null
4 הורי הורה הוריו noun masculine plural absolute unspecified unspecified  
4 ו ו הוריו possessive masculine singular unspecified 3 unspecified 0 	O	null
5 , , , punctuation unspecified unspecified unspecified unspecified unspecified  	O	null
6 ו ו ואביו conjunction unspecified unspecified unspecified unspecified unspecified 0 
6 אבי אב ואביו noun masculine singular absolute unspecified unspecified  
6 ו ו ואביו possessive masculine singular unspecified 3 unspecified 0 	O	null
7 היגר היגר היגר verb masculine singular unspecified 3 past  	O	null
8 ל ל לניויורק preposition unspecified unspecified unspecified unspecified unspecified 0 
8 ה ה לניויורק definiteArticle unspecified unspecified unspecified unspecified unspecified 0 
8 הניויורק הניויורק לניויורק noun masculine singular absolute unspecified unspecified  	O	null
9 , , , punctuation unspecified unspecified unspecified unspecified unspecified  	O	null
10 ש ש שבה relativizer/subordinatingConjunction unspecified unspecified unspecified unspecified unspecified 0 
10 ב ב שבה preposition unspecified unspecified unspecified unspecified unspecified  
10 ה ה שבה pronomial feminine singular unspecified 3 unspecified 0 	O	null
11 ישב ישב ישב verb masculine singular unspecified 3 past  	O	null
12 אחי אח אחיו noun masculine plural absolute unspecified unspecified  
12 ו ו אחיו possessive masculine singular unspecified 3 unspecified 0 	O	null
13 , , , punctuation unspecified unspecified unspecified unspecified unspecified  	O	null
14 ה ה הסופר definiteArticle unspecified unspecified unspecified unspecified unspecified 0 
14 הסופר סופר הסופר noun masculine singular absolute unspecified unspecified  	O	null
15 ישראל ישראל ישראל properName unspecified unspecified unspecified unspecified unspecified  	I_PERS	null
16 יהושע יהושע יהושע properName unspecified unspecified unspecified unspecified unspecified  	I_PERS	null
17 זינגר זינגר זינגר properName unspecified unspecified unspecified unspecified unspecified  	I_PERS	null
18 . . . punctuation unspecified unspecified unspecified unspecified unspecified  	O	null

0 זמיר זמיר זמיר properName unspecified unspecified unspecified unspecified unspecified  	I_PERS	null
1 ו ו ואמו conjunction unspecified unspecified unspecified unspecified unspecified 0 
1 אם אם ואמו noun feminine singular absolute unspecified unspecified  
1 ו ו ואמו possessive masculine singular unspecified 3 unspecified 0 	O	null
2 עברו עבר עברו verb masculine-and-feminine plural unspecified 3 past  	O	null
3 ל ל למוסקבה preposition unspecified unspecified unspecified unspecified unspecified 0 
3 מוסקבה מוסקבה למוסקבה properName unspecified unspecified unspecified unspecified unspecified  	I_LOC	null
4 , , , punctuation unspecified unspecified unspecified unspecified unspecified  	O	null
5 ו ו וב conjunction unspecified unspecified unspecified unspecified unspecified 0 
5 ב ב וב preposition unspecified unspecified unspecified unspecified unspecified 0 	I_ORG	null
6 - - - punctuation unspecified unspecified unspecified unspecified unspecified  	I_ORG	null
7 ###NUMBER### ###NUMBER### ###NUMBER### numeral unspecified unspecified unspecified unspecified unspecified  	I_DATE	null
8 עלו עלה עלו verb masculine-and-feminine plural unspecified 3 past  	O	null
9 ארצה ארצה ארצה adverb unspecified unspecified unspecified unspecified unspecified  	O	null
10 . . . punctuation unspecified unspecified unspecified unspecified unspecified  	O	null

0 בסוף בסוף בסוף adverb unspecified unspecified unspecified unspecified unspecified  	O	null
1 נשלח נשלח נשלח verb masculine singular unspecified 3 past  	O	null
2 ###NUMBER### ###NUMBER### ###NUMBER### numeral unspecified unspecified unspecified unspecified unspecified  	I_DATE	null
3 ל ל לקיבוץ preposition unspecified unspecified unspecified unspecified unspecified 0 
3 קיבוץ קיבוץ לקיבוץ noun masculine singular construct unspecified unspecified  	I_LOC	null
4 ביתאלף ביתאלף ביתאלפא noun masculine-and-feminine plural absolute unspecified unspecified  
4 י י ביתאלפא possessive masculine-and-feminine singular unspecified 1 unspecified 0 	I_LOC	null
5 כ כ כילד preposition unspecified unspecified unspecified unspecified unspecified 0 
5 ילד ילד כילד noun masculine singular construct unspecified unspecified  	O	null
6 חוץ חוץ חוץ noun masculine singular absolute unspecified unspecified  	O	null
7 , , , punctuation unspecified unspecified unspecified unspecified unspecified  	O	null
8 ו ו והצטרף conjunction unspecified unspecified unspecified unspecified unspecified 0 
8 הצטרף הצטרף והצטרף verb masculine singular unspecified 3 past  	O	null
9 ל ל לכיתת preposition unspecified unspecified unspecified unspecified unspecified 0 
9 כיתת כיתה לכיתת noun feminine singular construct unspecified unspecified  	O	null
10 בני בן בני noun masculine plural construct unspecified unspecified  	O	null
11 ה ה הקיבוץ definiteArticle unspecified unspecified unspecified unspecified unspecified 0 
11 הקיבוץ קיבוץ הקיבוץ noun masculine singular absolute unspecified unspecified  	O	null
12 . . . punctuation unspecified unspecified unspecified unspecified unspecified  	O	null

0 ב ב בעת preposition unspecified unspecified unspecified unspecified unspecified 0 
0 עת עת בעת noun feminine singular absolute unspecified unspecified  	O	null
1 ש ש שלמד relativizer/subordinatingConjunction unspecified unspecified unspecified unspecified unspecified 0 
1 למד למד שלמד verb masculine singular unspecified 3 past  	O	null
2 ב ב בכיתה preposition unspecified unspecified unspecified unspecified unspecified 0 
2 כיתה כיתה בכיתה noun feminine singular absolute unspecified unspecified  	O	null
3 י"ב י"ב י"ב properName unspecified unspecified unspecified unspecified unspecified  	I_PERS	null
4 , , , punctuation unspecified unspecified unspecified unspecified unspecified  	O	null
5 במאי במאי במאי noun masculine singular absolute unspecified unspecified  	O	null
6 , , , punctuation unspecified unspecified unspecified unspecified unspecified  	O	null
7 ###NUMBER### ###NUMBER### ###NUMBER### numeral unspecified unspecified unspecified unspecified unspecified  	I_DATE	null
8 פרצה פרץ פרצה verb feminine singular unspecified 3 past  	O	null
9 מלחמת מלחמה מלחמת noun feminine singular construct unspecified unspecified  	O	null
10 ה ה העצמאות definiteArticle unspecified unspecified unspecified unspecified unspecified 0 
10 העצמאות עצמאות העצמאות noun feminine singular absolute unspecified unspecified  	O	null
11 , , , punctuation unspecified unspecified unspecified unspecified unspecified  	O	null
12 ה ה הכיתה definiteArticle unspecified unspecified unspecified unspecified unspecified 0 
12 הכיתה כיתה הכיתה noun feminine singular absolute unspecified unspecified  	O	null
13 הפסיקה הפסיק הפסיקה verb feminine singular unspecified 3 past  	O	null
14 את את את at-preposition unspecified unspecified unspecified unspecified unspecified  	O	null
15 לימודי לימוד לימודיה noun masculine plural absolute unspecified unspecified  
15 ה ה לימודיה possessive feminine singular unspecified 3 unspecified 0 	O	null
16 , , , punctuation unspecified unspecified unspecified unspecified unspecified  	O	null
17 ו ו והנערים conjunction unspecified unspecified unspecified unspecified unspecified 0 
17 ה ה והנערים definiteArticle unspecified unspecified unspecified unspecified unspecified 0 
17 הנערים נוער והנערים noun masculine plural absolute unspecified unspecified  	O	null
18 גויסו גויס גויסו verb masculine-and-feminine plural unspecified 3 past  	O	null
19 ל ל למלחמה preposition unspecified unspecified unspecified unspecified unspecified 0 
19 ה ה למלחמה definiteArticle unspecified unspecified unspecified unspecified unspecified 0 
19 המלחמה מלחמה למלחמה noun feminine singular absolute unspecified unspecified  	O	null
20 . . . punctuation unspecified unspecified unspecified unspecified unspecified  	O	null

0 לאחר לאחר לאחר conjunction unspecified unspecified unspecified unspecified unspecified  	O	null
1 ה ה המלחמה definiteArticle unspecified unspecified unspecified unspecified unspecified 0 
1 המלחמה מלחמה המלחמה noun feminine singular absolute unspecified unspecified  	O	null
2 שב שב שב verb masculine singular unspecified 3 past  	O	null
3 ל ל לבית preposition unspecified unspecified unspecified unspecified unspecified 0 
3 בית בית לבית properName unspecified unspecified unspecified unspecified unspecified  	O	null
4 אלפא אלפא אלפא properName unspecified unspecified unspecified unspecified unspecified  	I_PERS	null
5 ו ו והקים conjunction unspecified unspecified unspecified unspecified unspecified 0 
5 הקים הקים והקים verb masculine singular unspecified 3 past  	O	null
6 שם שם שם adverb unspecified unspecified unspecified unspecified unspecified  	O	null
7 את את את at-preposition unspecified unspecified unspecified unspecified unspecified  	O	null
8 בית בית ביתו noun masculine singular absolute unspecified unspecified  
8 ו ו ביתו possessive masculine singular unspecified 3 unspecified 0 	O	null
9 . . . punctuation unspecified unspecified unspecified unspecified unspecified  	O	null

0 ב ב ב preposition unspecified unspecified unspecified unspecified unspecified 0 	I_ORG	null
1 - - - punctuation unspecified unspecified unspecified unspecified unspecified  	I_ORG	null
2 ###NUMBER### ###NUMBER### ###NUMBER### numeral unspecified unspecified unspecified unspecified unspecified  	I_DATE	null
3 נשלח נשלח נשלח verb masculine singular unspecified 3 past  	O	null
4 ל ל לארצות preposition unspecified unspecified unspecified unspecified unspecified 0 
4 ארצות ארץ לארצות properName unspecified unspecified unspecified unspecified unspecified  	I_LOC	null
5 הברית ברית הברית properName unspecified unspecified unspecified unspecified unspecified  	I_LOC	null
6 מטעם מטעם מטעם preposition unspecified unspecified unspecified unspecified unspecified  	O	null
7 תנועת תנועה תנועת noun feminine singular construct unspecified unspecified  	O	null
8 " " " punctuation unspecified unspecified unspecified unspecified unspecified  	O	null
9 השומר שומר השומר properName unspecified unspecified unspecified unspecified unspecified  	I_ORG	null
10 ה ה הצעיר definiteArticle unspecified unspecified unspecified unspecified unspecified 0 
10 הצעיר צעיר הצעיר adjective masculine singular absolute unspecified unspecified  	O	null
11 " " " punctuation unspecified unspecified unspecified unspecified unspecified  	O	null
12 ו ו וחידש conjunction unspecified unspecified unspecified unspecified unspecified 0 
12 חידש חידש וחידש verb masculine singular unspecified 3 past  	O	null
13 את את את at-preposition unspecified unspecified unspecified unspecified unspecified  	O	null
14 ה ה הקשר definiteArticle unspecified unspecified unspecified unspecified unspecified 0 
14 הקשר קשר הקשר noun masculine singular absolute unspecified unspecified  	O	null
15 עם עם עם preposition unspecified unspecified unspecified unspecified unspecified  	O	null
16 אבי אב אביו noun masculine singular absolute unspecified unspecified  
16 ו ו אביו possessive masculine singular unspecified 3 unspecified 0 	O	null
17 , , , punctuation unspecified unspecified unspecified unspecified unspecified  	O	null
18 לאחר לאחר לאחר conjunction unspecified unspecified unspecified unspecified unspecified  	O	null
19 כ כ כעשרים preposition unspecified unspecified unspecified unspecified unspecified 0 
19 עשרים ORD-CARD20 כעשרים numeral masculine-and-feminine plural construct unspecified unspecified  	O	null
20 שנות שנה שנות noun feminine plural construct unspecified unspecified  	O	null
21 ניתוק ניתוק ניתוק noun masculine singular absolute unspecified unspecified  	O	null
22 מוחלט מוחלט מוחלט adjective masculine singular absolute unspecified unspecified  	O	null
23 . . . punctuation unspecified unspecified unspecified unspecified unspecified  	O	null

0 עם עם עם preposition unspecified unspecified unspecified unspecified unspecified  	O	null
1 שוב שוב שובו noun masculine singular absolute unspecified unspecified  
1 ו ו שובו possessive masculine singular unspecified 3 unspecified 0 	O	null
2 ארצה ארצה ארצה adverb unspecified unspecified unspecified unspecified unspecified  	O	null
3 נשלח נשלח נשלח verb masculine singular unspecified 3 past  	O	null
4 ב ב ב preposition unspecified unspecified unspecified unspecified unspecified 0 	O	null
5 - - - punctuation unspecified unspecified unspecified unspecified unspecified  	O	null
6 ###NUMBER### ###NUMBER### ###NUMBER### numeral unspecified unspecified unspecified unspecified unspecified  	I_DATE	null
7 ל ל ללימודי preposition unspecified unspecified unspecified unspecified unspecified 0 
7 לימודי לימוד ללימודי noun masculine plural construct unspecified unspecified  	O	null
8 הוראה הוראה הוראה noun feminine singular absolute unspecified unspecified  	O	null
9 ב ב ב preposition unspecified unspecified unspecified unspecified unspecified 0 	I_ORG	null
10 " " " punctuation unspecified unspecified unspecified unspecified unspecified  	I_ORG	null
11 סמינר סמינר סמינר noun masculine singular construct unspecified unspecified  	I_ORG	null
12 אורנים אורנים אורנים properName unspecified unspecified unspecified unspecified unspecified  	I_ORG	null
13 " " " punctuation unspecified unspecified unspecified unspecified unspecified  	O	null
14 , , , punctuation unspecified unspecified unspecified unspecified unspecified  	O	null
15 ו ו ושימש conjunction unspecified unspecified unspecified unspecified unspecified 0 
15 שימש שימש ושימש verb masculine singular unspecified 3 past  	O	null
16 מורה מורה מורה noun masculine singular absolute unspecified unspecified  	O	null
17 ב ב בכיתות preposition unspecified unspecified unspecified unspecified unspecified 0 
17 ה ה בכיתות definiteArticle unspecified unspecified unspecified unspecified unspecified 0 
17 הכיתות כיתה בכיתות noun feminine plural absolute unspecified unspecified  	O	null
18 ה ה הגבוהות definiteArticle unspecified unspecified unspecified unspecified unspecified 0 
18 הגבוהות גבוה הגבוהות adjective feminine plural absolute unspecified unspecified  	O	null
19 של של של shel-preposition unspecified unspecified unspecified unspecified unspecified  	O	null
20 ה ה המוסד definiteArticle unspecified unspecified unspecified unspecified unspecified 0 
20 המוסד מוסד המוסד noun masculine singular absolute unspecified unspecified  	O	null
21 ה ה החינוכי definiteArticle unspecified unspecified unspecified unspecified unspecified 0 
21 החינוכי חינוכי החינוכי adjective masculine singular absolute unspecified unspecified  	O	null
22 ב ב בבית preposition unspecified unspecified unspecified unspecified unspecified 0 
22 בית בית בבית properName unspecified unspecified unspecified unspecified unspecified  	I_PERS	null
23 אלפא אלפא אלפא properName unspecified unspecified unspecified unspecified unspecified  	I_PERS	null
24 , , , punctuation unspecified unspecified unspecified unspecified unspecified  	O	null
25 בית בית בית noun masculine singular construct unspecified unspecified  	O	null
26 ה ה הספר definiteArticle unspecified unspecified unspecified unspecified unspecified 0 
26 הספר ספר הספר noun masculine singular absolute unspecified unspecified  	O	null
27 ה ה התיכון definiteArticle unspecified unspecified unspecified unspecified unspecified 0 
27 התיכון תיכון התיכון adjective masculine singular absolute unspecified unspecified  	O	null
28 האזורי.ב האזורי.ב האזורי.ב properName unspecified unspecified unspecified unspecified unspecified  	I_ORG	null
29 - - - punctuation unspecified unspecified unspecified unspecified unspecified  	O	null
30 יצא יצא יצא verb masculine singular unspecified 3 past  	O	null
31 שוב שוב שוב adverb unspecified unspecified unspecified unspecified unspecified  	O	null
32 , , , punctuation unspecified unspecified unspecified unspecified unspecified  	O	null
33 עם עם עם preposition unspecified unspecified unspecified unspecified unspecified  	O	null
34 משפחת משפחה משפחתו noun feminine singular absolute unspecified unspecified  
34 ו ו משפחתו possessive masculine singular unspecified 3 unspecified 0 	O	null
35 , , , punctuation unspecified unspecified unspecified unspecified unspecified  	O	null
36 ל ל לארצות preposition unspecified unspecified unspecified unspecified unspecified 0 
36 ארצות ארץ לארצות properName unspecified unspecified unspecified unspecified unspecified  	I_LOC	null
37 הברית ברית הברית properName unspecified unspecified unspecified unspecified unspecified  	I_LOC	null
38 כ כ כשליח preposition unspecified unspecified unspecified unspecified unspecified 0 
38 שליח שליח כשליח noun masculine singular construct unspecified unspecified  	O	null
39 תנועת תנועה תנועתו noun feminine singular absolute unspecified unspecified  
39 ו ו תנועתו possessive masculine singular unspecified 3 unspecified 0 	O	null
40 ו ו ושהה conjunction unspecified unspecified unspecified unspecified unspecified 0 
40 שהה שהה ושהה verb masculine singular unspecified 3 past  	O	null
41 שם שם שם adverb unspecified unspecified unspecified unspecified unspecified  	O	null
42 כ כ כשלוש preposition unspecified unspecified unspecified unspecified unspecified 0 
42 שלוש CARD3 כשלוש numeral feminine singular absolute unspecified unspecified  	O	null
43 שנים שנה שנים noun feminine plural absolute unspecified unspecified  	O	null
44 , , , punctuation unspecified unspecified unspecified unspecified unspecified  	O	null
45 ש ש שבמהלכן relativizer/subordinatingConjunction unspecified unspecified unspecified unspecified unspecified 0 
45 ב ב שבמהלכן preposition unspecified unspecified unspecified unspecified unspecified 0 
45 מהלך מהלך שבמהלכן noun masculine singular absolute unspecified unspecified  
45 ן ן שבמהלכן possessive feminine plural unspecified 3 unspecified 0 	O	null
46 שב שב שב verb masculine singular unspecified 3 past  	O	null
47 ו ו ונפגש conjunction unspecified unspecified unspecified unspecified unspecified 0 
47 נפגש נפגש ונפגש verb masculine singular unspecified 3 past  	O	null
48 עם עם עם preposition unspecified unspecified unspecified unspecified unspecified  	O	null
49 אבי אב אביו noun masculine singular absolute unspecified unspecified  
49 ו ו אביו possessive masculine singular unspecified 3 unspecified 0 	O	null
50 ב ב בניויורק preposition unspecified unspecified unspecified unspecified unspecified 0 
50 ה ה בניויורק definiteArticle unspecified unspecified unspecified unspecified unspecified 0 
50 הניויורק הניויורק בניויורק noun masculine singular absolute unspecified unspecified  	O	null
51 . . . punctuation unspecified unspecified unspecified unspecified unspecified  	O	null

0 משם משם משם adverb unspecified unspecified unspecified unspecified unspecified  	O	null
1 שלח שלח שלח verb masculine singular unspecified 3 past  	O	null
2 כתבות כתב כתבות noun feminine plural absolute unspecified unspecified  	O	null
3 ל ל לעיתון preposition unspecified unspecified unspecified unspecified unspecified 0 
3 ה ה לעיתון definiteArticle unspecified unspecified unspecified unspecified unspecified 0 
3 העיתון עיתון לעיתון noun masculine singular absolute unspecified unspecified  	O	null
4 על על על preposition unspecified unspecified unspecified unspecified unspecified  	O	null
5 ה ה המשמר definiteArticle unspecified unspecified unspecified unspecified unspecified 0 
5 המשמר משמר המשמר noun masculine singular absolute unspecified unspecified  	O	null
6 , , , punctuation unspecified unspecified unspecified unspecified unspecified  	O	null
7 ו ו וכך conjunction unspecified unspecified unspecified unspecified unspecified 0 
7 כך כך וכך pronoun unspecified unspecified unspecified unspecified unspecified  	O	null
8 החל החל החל verb masculine singular unspecified 3 past  	O	null
9 ב ב בקריירה preposition unspecified unspecified unspecified unspecified unspecified 0 
9 ה ה בקריירה definiteArticle unspecified unspecified unspecified unspecified unspecified 0 
9 הקריירה קריירה בקריירה noun feminine singular absolute unspecified unspecified  	O	null
10 ה ה העיתונאית definiteArticle unspecified unspecified unspecified unspecified unspecified 0 
10 העיתונאית עיתונאי העיתונאית adjective feminine singular absolute unspecified unspecified  	O	null
11 של של שלו shel-preposition unspecified unspecified unspecified unspecified unspecified  
11 ו ו שלו pronomial masculine singular unspecified 3 unspecified 0 	O	null
12 . . . punctuation unspecified unspecified unspecified unspecified unspecified  	O	null

0 ב ב באותן preposition unspecified unspecified unspecified unspecified unspecified 0 
0 אותו אותו באותן quantifier unspecified unspecified unspecified unspecified unspecified  
0 הן הן באותן pronomial feminine plural unspecified 3 unspecified 0 	O	null
1 שנים שנה שנים noun feminine plural absolute unspecified unspecified  	O	null
2 התוודע התוודע התוודע verb masculine singular unspecified 3 past  	O	null
3 ל ל לכתבי preposition unspecified unspecified unspecified unspecified unspecified 0 
3 כתבי כתב לכתבי noun masculine plural construct unspecified unspecified  	O	null
4 אבי אב אביו noun masculine singular absolute unspecified unspecified  
4 ו ו אביו possessive masculine singular unspecified 3 unspecified 0 	O	null
5 ו ו והחל conjunction unspecified unspecified unspecified unspecified unspecified 0 
5 החל החל והחל verb masculine singular unspecified 3 past  	O	null
6 ב ב בניסיונות preposition unspecified unspecified unspecified unspecified unspecified 0 
6 ה ה בניסיונות definiteArticle unspecified unspecified unspecified unspecified unspecified 0 
6 הניסיונות ניסיון בניסיונות noun masculine plural absolute unspecified unspecified  	O	null
7 לתרגם תרגם לתרגמם verb unspecified unspecified unspecified unspecified infinitive  
7 ם ם לתרגמם accusative-or-nominative masculine plural unspecified 3 unspecified 0 	O	null
8 ל ל לעברית preposition unspecified unspecified unspecified unspecified unspecified 0 
8 עברית עברית לעברית properName feminine singular unspecified unspecified unspecified  	I_LOC	null
9 . . . punctuation unspecified unspecified unspecified unspecified unspecified  	O	null

0 ל ל לימים preposition unspecified unspecified unspecified unspecified unspecified 0 
0 ה ה לימים definiteArticle unspecified unspecified unspecified unspecified unspecified 0 
0 הימים יום לימים noun masculine plural absolute unspecified unspecified  	O	null
1 תירגם תרגם תירגם verb masculine singular unspecified 3 past  	O	null
2 מספרי מספר מספרי noun masculine plural construct unspecified unspecified  	O	null
3 אבי אב אביו noun masculine singular absolute unspecified unspecified  
3 ו ו אביו possessive masculine singular unspecified 3 unspecified 0 	O	null
4 ל ל לעברית preposition unspecified unspecified unspecified unspecified unspecified 0 
4 עברית עברית לעברית properName feminine singular unspecified unspecified unspecified  	I_LOC	null
5 , , , punctuation unspecified unspecified unspecified unspecified unspecified  	O	null
6 ו ו ובהם conjunction unspecified unspecified unspecified unspecified unspecified 0 
6 ב ב ובהם preposition unspecified unspecified unspecified unspecified unspecified  
6 הם הם ובהם pronomial masculine plural unspecified 3 unspecified 0 	O	null
7 קובץ קובץ קובץ noun masculine singular construct unspecified unspecified  	O	null
8 ה ה הסיפורים definiteArticle unspecified unspecified unspecified unspecified unspecified 0 
8 הסיפורים סיפור הסיפורים noun masculine plural absolute unspecified unspecified  	O	null
9 ה ה המפתח definiteArticle unspecified unspecified unspecified unspecified unspecified 0 
9 המפתח מפתח המפתח noun masculine singular absolute unspecified unspecified  	O	null
10 ) ) ) punctuation unspecified unspecified unspecified unspecified unspecified  	O	null
11 , , , punctuation unspecified unspecified unspecified unspecified unspecified  	O	null
12 ###NUMBER### ###NUMBER### ###NUMBER### numeral unspecified unspecified unspecified unspecified unspecified  	I_DATE	null
13 ה ה הרומן definiteArticle unspecified unspecified unspecified unspecified unspecified 0 
13 הרומן רומן הרומן noun masculine singular absolute unspecified unspecified  	O	null
14 שונאים שנא שונאים verb masculine plural unspecified any beinoni  	O	null
15 סיפור סיפור סיפור noun masculine singular construct unspecified unspecified  	O	null
16 אהבה אהבה אהבה noun feminine singular absolute unspecified unspecified  	O	null
17 ( ( ( punctuation unspecified unspecified unspecified unspecified unspecified  	O	null
18 ###NUMBER### ###NUMBER### ###NUMBER### numeral unspecified unspecified unspecified unspecified unspecified  	I_DATE	null
19 ) ) ) punctuation unspecified unspecified unspecified unspecified unspecified  	O	null
20 ו ו והנובלה conjunction unspecified unspecified unspecified unspecified unspecified 0 
20 ה ה והנובלה definiteArticle unspecified unspecified unspecified unspecified unspecified 0 
20 הנובלה נובלה והנובלה noun feminine singular absolute unspecified unspecified  	O	null
21 ה ה החוזר definiteArticle unspecified unspecified unspecified unspecified unspecified 0 
21 החוזר חוזר החוזר noun masculine singular absolute unspecified unspecified  	O	null
22 ב ב בתשובה preposition unspecified unspecified unspecified unspecified unspecified 0 
22 ה ה בתשובה definiteArticle unspecified unspecified unspecified unspecified unspecified 0 
22 התשובה תשובה בתשובה noun feminine singular absolute unspecified unspecified  	O	null
23 ) ) ) punctuation unspecified unspecified unspecified unspecified unspecified  	O	null
24 . . . punctuation unspecified unspecified unspecified unspecified unspecified  	O	null
25 ###NUMBER### ###NUMBER### ###NUMBER### numeral unspecified unspecified unspecified unspecified unspecified  	I_DATE	null
26 כמו כמו כמו conjunction unspecified unspecified unspecified unspecified unspecified  	O	null
27 כן כן כן conjunction unspecified unspecified unspecified unspecified unspecified  	O	null
28 תירגם תרגם תירגם verb masculine singular unspecified 3 past  	O	null
29 את את את at-preposition unspecified unspecified unspecified unspecified unspecified  	O	null
30 ספר ספר ספרו noun masculine singular absolute unspecified unspecified  
30 ו ו ספרו possessive masculine singular unspecified 3 unspecified 0 	O	null
31 של של של shel-preposition unspecified unspecified unspecified unspecified unspecified  	O	null
32 ריצ'רד ריצ'רד ריצ'רד properName unspecified unspecified unspecified unspecified unspecified  	I_PERS	null
33 בורגין בורגין בורגין properName unspecified unspecified unspecified unspecified unspecified  	I_PERS	null
34 שיחות שיחה שיחות noun feminine plural construct unspecified unspecified  	O	null
35 עם עם עם preposition unspecified unspecified unspecified unspecified unspecified  	O	null
36 יצחק יצחק יצחק properName unspecified unspecified unspecified unspecified unspecified  	I_PERS	null
37 ב ב בשביס preposition unspecified unspecified unspecified unspecified unspecified 0 
37 שביס שביס בשביס noun masculine singular construct unspecified unspecified  	O	null
38 - - - punctuation unspecified unspecified unspecified unspecified unspecified  	O	null
39 זינגר זינגר זינגר properName unspecified unspecified unspecified unspecified unspecified  	I_PERS	null
40 ) ) ) punctuation unspecified unspecified unspecified unspecified unspecified  	O	null
41 . . . punctuation unspecified unspecified unspecified unspecified unspecified  	O	null
42 ###NUMBER### ###NUMBER### ###NUMBER### numeral unspecified unspecified unspecified unspecified unspecified  	I_DATE	null
43 ב ב בשיתוף preposition unspecified unspecified unspecified unspecified unspecified 0 
43 שיתוף שיתוף בשיתוף noun masculine singular construct unspecified unspecified  	O	null
44 עם עם עם preposition unspecified unspecified unspecified unspecified unspecified  	O	null
45 אוריאל אוריאל אוריאל properName unspecified unspecified unspecified unspecified unspecified  	I_PERS	null
46 אופק אופק אופק properName unspecified unspecified unspecified unspecified unspecified  	I_PERS	null
47 תירגם תרגם תירגם verb masculine singular unspecified 3 past  	O	null
48 ספר ספר ספר noun masculine singular construct unspecified unspecified  	O	null
49 ילדים ילד ילדים noun masculine plural absolute unspecified unspecified  	O	null
50 של של של shel-preposition unspecified unspecified unspecified unspecified unspecified  	O	null
51 אבי אב אביו noun masculine singular absolute unspecified unspecified  
51 ו ו אביו possessive masculine singular unspecified 3 unspecified 0 	O	null
52 , , , punctuation unspecified unspecified unspecified unspecified unspecified  	O	null
53 שלוש CARD3 שלוש numeral feminine singular construct unspecified unspecified  	O	null
54 מ מ משאלות preposition unspecified unspecified unspecified unspecified unspecified 0 
54 שאלות שאלה משאלות noun feminine plural construct unspecified unspecified  	O	null
55 ) ) ) punctuation unspecified unspecified unspecified unspecified unspecified  	O	null
56 . . . punctuation unspecified unspecified unspecified unspecified unspecified  	O	null
57 ###NUMBER### ###NUMBER### ###NUMBER### numeral unspecified unspecified unspecified unspecified unspecified  	I_DATE	null
58 מ מ מ preposition unspecified unspecified unspecified unspecified unspecified 0 	O	null
59 - - - punctuation unspecified unspecified unspecified unspecified unspecified  	O	null
60 ###NUMBER### ###NUMBER### ###NUMBER### numeral unspecified unspecified unspecified unspecified unspecified  	I_DATE	null
61 היה הוא היה copula masculine singular unspecified 3 past  	O	null
62 חבר חבר חבר properName masculine singular unspecified unspecified unspecified  	I_PERS	null
63 מערכת מערכת מערכת noun feminine singular construct unspecified unspecified  	O	null
64 עלהמשמר עלהמשמר עלהמשמר verb masculine singular unspecified 3 past  	O	null
65 , , , punctuation unspecified unspecified unspecified unspecified unspecified  	O	null
66 ו ו והחל conjunction unspecified unspecified unspecified unspecified unspecified 0 
66 החל החל והחל verb masculine singular unspecified 3 past  	O	null
67 ב ב ב preposition unspecified unspecified unspecified unspecified unspecified 0 	O	null
68 - - - punctuation unspecified unspecified unspecified unspecified unspecified  	O	null
69 ###NUMBER### ###NUMBER### ###NUMBER### numeral unspecified unspecified unspecified unspecified unspecified  	I_DATE	null
70 כיהן כיהן כיהן verb masculine singular unspecified 3 past  	O	null
71 כ כ כעורך preposition unspecified unspecified unspecified unspecified unspecified 0 
71 עורך עורך כעורך noun masculine singular construct unspecified unspecified  	O	null
72 ה ה המוסף definiteArticle unspecified unspecified unspecified unspecified unspecified 0 
72 המוסף מוסף המוסף noun masculine singular absolute unspecified unspecified  	O	null
73 חותם חתם חותם participle masculine singular absolute any unspecified  	O	null
74 . . . punctuation unspecified unspecified unspecified unspecified unspecified  	O	null

0 בין בין בין preposition unspecified unspecified unspecified unspecified unspecified  	O	null
1 שאר שאר שאר noun masculine singular construct unspecified unspecified  	O	null
2 תפקידי תפקיד תפקידיו noun masculine plural absolute unspecified unspecified  
2 ו ו תפקידיו possessive masculine singular unspecified 3 unspecified 0 	O	null
3 ב ב בעיתון preposition unspecified unspecified unspecified unspecified unspecified 0 
3 ה ה בעיתון definiteArticle unspecified unspecified unspecified unspecified unspecified 0 
3 העיתון עיתון בעיתון noun masculine singular absolute unspecified unspecified  	O	null
4 הקים הקים הקים verb masculine singular unspecified 3 past  	O	null
5 את את את at-preposition unspecified unspecified unspecified unspecified unspecified  	O	null
6 ה ה המוספים definiteArticle unspecified unspecified unspecified unspecified unspecified 0 
6 המוספים מוסף המוספים noun masculine plural absolute unspecified unspecified  	O	null
7 ה ה הדף definiteArticle unspecified unspecified unspecified unspecified unspecified 0 
7 הדף דף הדף noun masculine singular absolute unspecified unspecified  	O	null
8 ה ה הירוק definiteArticle unspecified unspecified unspecified unspecified unspecified 0 
8 הירוק ירוק הירוק adjective masculine singular absolute unspecified unspecified  	O	null
9 ו ו וקו conjunction unspecified unspecified unspecified unspecified unspecified 0 
9 קו קו וקו noun masculine singular absolute unspecified unspecified  	O	null
10 ל ל למושבושימש preposition unspecified unspecified unspecified unspecified unspecified 0 
10 מושבושים מושבושים למושבושימש noun masculine-and-feminine plural absolute unspecified unspecified  
10 י י למושבושימש possessive masculine-and-feminine singular unspecified 1 unspecified 0 	O	null
11 שנים שנה שנים noun feminine plural absolute unspecified unspecified  	O	null
12 רבות רב רבות adjective feminine plural absolute unspecified unspecified  	O	null
13 כ כ ככתב preposition unspecified unspecified unspecified unspecified unspecified 0 
13 כתב כתב ככתב noun masculine singular construct unspecified unspecified  	O	null
14 וכעורךמשנה וכעורךמשנה וכעורךמשנה verb masculine singular unspecified 2 imperative  	O	null
15 של של של shel-preposition unspecified unspecified unspecified unspecified unspecified  	O	null
16 ה ה העיתון definiteArticle unspecified unspecified unspecified unspecified unspecified 0 
16 העיתון עיתון העיתון noun masculine singular absolute unspecified unspecified  	O	null
17 . . . punctuation unspecified unspecified unspecified unspecified unspecified  	O	null

0 עם עם עם preposition unspecified unspecified unspecified unspecified unspecified  	O	null
1 סגירת סגירה סגירתו noun feminine singular absolute unspecified unspecified  
1 ו ו סגירתו possessive masculine singular unspecified 3 unspecified 0 	O	null
2 של של של shel-preposition unspecified unspecified unspecified unspecified unspecified  	O	null
3 על על על preposition unspecified unspecified unspecified unspecified unspecified  	O	null
4 ה ה המשמר definiteArticle unspecified unspecified unspecified unspecified unspecified 0 
4 המשמר משמר המשמר noun masculine singular absolute unspecified unspecified  	O	null
5 ב ב ב preposition unspecified unspecified unspecified unspecified unspecified 0 	O	null
6 - - - punctuation unspecified unspecified unspecified unspecified unspecified  	O	null
7 ###NUMBER### ###NUMBER### ###NUMBER### numeral unspecified unspecified unspecified unspecified unspecified  	I_DATE	null
8 עבר עבר עבר verb masculine singular unspecified 3 past  	O	null
9 ל ל למעריב preposition unspecified unspecified unspecified unspecified unspecified 0 
9 מעריב מעריב למעריב properName unspecified unspecified unspecified unspecified unspecified  	I_ORG	null
10 ו ו וכתב conjunction unspecified unspecified unspecified unspecified unspecified 0 
10 כתב כתב וכתב verb masculine singular unspecified 3 past  	O	null
11 ב ב ברשת preposition unspecified unspecified unspecified unspecified unspecified 0 
11 רשת רשת ברשת noun feminine singular construct unspecified unspecified  	O	null
12 ה ה המקומונים definiteArticle unspecified unspecified unspecified unspecified unspecified 0 
12 המקומונים מקומון המקומונים noun masculine plural absolute unspecified unspecified  	O	null
13 עד עד עד preposition unspecified unspecified unspecified unspecified unspecified  	O	null
14 פרישת פרישה פרישתו noun feminine singular absolute unspecified unspecified  
14 ו ו פרישתו possessive masculine singular unspecified 3 unspecified 0 	O	null
15 . . . punctuation unspecified unspecified unspecified unspecified unspecified  	O	null

0 הוא הוא הוא pronoun masculine singular unspecified 3 unspecified  	O	null
1 למד למד למד verb masculine singular unspecified 3 past  	O	null
2 עיתונאות עיתונאות עיתונאות noun feminine singular absolute unspecified unspecified  	O	null
3 ב ב באוניברסיטת preposition unspecified unspecified unspecified unspecified unspecified 0 
3 אוניברסיטת אוניברסיטה באוניברסיטת noun feminine singular construct unspecified unspecified  	I_ORG	null
4 תלאביב תלאביב תלאביב properName unspecified unspecified unspecified unspecified unspecified  	I_ORG	null
5 , , , punctuation unspecified unspecified unspecified unspecified unspecified  	O	null
6 ו ו וגם conjunction unspecified unspecified unspecified unspecified unspecified 0 
6 גם גם וגם conjunction unspecified unspecified unspecified unspecified unspecified  	O	null
7 לימד לימד לימד verb masculine singular unspecified 3 past  	O	null
8 כתיבה כתיבה כתיבה noun feminine singular absolute unspecified unspecified  	O	null
9 עיתונאית עיתונאי עיתונאית adjective feminine singular absolute unspecified unspecified  	O	null
10 . . . punctuation unspecified unspecified unspecified unspecified unspecified  	O	null

0 מ מ מספריו preposition unspecified unspecified unspecified unspecified unspecified 0 
0 ספרי ספר מספריו noun masculine plural absolute unspecified unspecified  
0 ו ו מספריו possessive masculine singular unspecified 3 unspecified 0 	O	null
1 : : : punctuation unspecified unspecified unspecified unspecified unspecified  	O	null
2 סנדל סנדל סנדל noun masculine singular construct unspecified unspecified  	O	null
3 של של של shel-preposition unspecified unspecified unspecified unspecified unspecified  	O	null
4 סוס סוס סוס noun masculine singular construct unspecified unspecified  	O	null
5 ( ( ( punctuation unspecified unspecified unspecified unspecified unspecified  	O	null
6 ספרית ספרייה ספרית noun feminine singular construct unspecified unspecified  	O	null
7 פועלים פועל פועלים noun masculine plural absolute unspecified unspecified  	O	null
8 , , , punctuation unspecified unspecified unspecified unspecified unspecified  	O	null
9 ) ) ) punctuation unspecified unspecified unspecified unspecified unspecified  	O	null
10 , , , punctuation unspecified unspecified unspecified unspecified unspecified  	O	null
11 סיפורים סיפור סיפורים noun masculine plural absolute unspecified unspecified  	O	null
12 ###NUMBER### ###NUMBER### ###NUMBER### numeral unspecified unspecified unspecified unspecified unspecified  	I_DATE	null
13 ריאליסטיים ריאליסטי ריאליסטיים adjective masculine plural absolute unspecified unspecified  	O	null
14 מ מ מחיי preposition unspecified unspecified unspecified unspecified unspecified 0 
14 חיי חיים מחיי noun masculine plural construct unspecified unspecified  	O	null
15 ה ה הקיבוץ definiteArticle unspecified unspecified unspecified unspecified unspecified 0 
15 הקיבוץ קיבוץ הקיבוץ noun masculine singular absolute unspecified unspecified  	O	null
16 ו ו והארץ conjunction unspecified unspecified unspecified unspecified unspecified 0 
16 ה ה והארץ definiteArticle unspecified unspecified unspecified unspecified unspecified 0 
16 הארץ ארץ והארץ noun feminine singular absolute unspecified unspecified  	O	null
17 ; ; ; punctuation unspecified unspecified unspecified unspecified unspecified  	O	null
18 אבי אבי אבי properName unspecified unspecified unspecified unspecified unspecified  	I_PERS	null
19 יצחק יצחק יצחק properName unspecified unspecified unspecified unspecified unspecified  	I_PERS	null
20 ב ב בשביס preposition unspecified unspecified unspecified unspecified unspecified 0 
20 שביס שביס בשביס noun masculine singular construct unspecified unspecified  	O	null
21 זינגר זינגר זינגר properName unspecified unspecified unspecified unspecified unspecified  	I_PERS	null
22 ) ) ) punctuation unspecified unspecified unspecified unspecified unspecified  	O	null
23 , , , punctuation unspecified unspecified unspecified unspecified unspecified  	O	null
24 ###NUMBER### ###NUMBER### ###NUMBER### numeral unspecified unspecified unspecified unspecified unspecified  	I_DATE	null
25 ביוגרפיה ביוגרפיה ביוגרפיה noun feminine singular absolute unspecified unspecified  	O	null
26 מ מ ממבט preposition unspecified unspecified unspecified unspecified unspecified 0 
26 מבט מבט ממבט noun masculine singular construct unspecified unspecified  	O	null
27 אישי אייש אישי verb feminine singular unspecified 2 imperative  	O	null
28 , , , punctuation unspecified unspecified unspecified unspecified unspecified  	O	null
29 ש ש שזכתה relativizer/subordinatingConjunction unspecified unspecified unspecified unspecified unspecified 0 
29 זכתה זכה שזכתה verb feminine singular unspecified 3 past  	O	null
30 ל ל להצלחה preposition unspecified unspecified unspecified unspecified unspecified 0 
30 ה ה להצלחה definiteArticle unspecified unspecified unspecified unspecified unspecified 0 
30 ההצלחה הצלחה להצלחה noun feminine singular absolute unspecified unspecified  	O	null
31 ב ב בעיקר preposition unspecified unspecified unspecified unspecified unspecified 0 
31 עיקר עיקר בעיקר quantifier unspecified unspecified construct unspecified unspecified  	O	null
32 ב ב בחו"ל preposition unspecified unspecified unspecified unspecified unspecified 0 
32 חו"ל חו"ל בחו"ל noun masculine singular absolute unspecified unspecified  	O	null
33 ; ; ; punctuation unspecified unspecified unspecified unspecified unspecified  	O	null
34 עגיל עגיל עגיל noun masculine singular construct unspecified unspecified  	O	null
35 ב ב באוזן preposition unspecified unspecified unspecified unspecified unspecified 0 
35 אוזן אוזן באוזן properName unspecified unspecified unspecified unspecified unspecified  	I_PERS	null
36 ( ( ( punctuation unspecified unspecified unspecified unspecified unspecified  	O	null
37 ) ) ) punctuation unspecified unspecified unspecified unspecified unspecified  	O	null
38 , , , punctuation unspecified unspecified unspecified unspecified unspecified  	O	null
39 ###NUMBER### ###NUMBER### ###NUMBER### numeral unspecified unspecified unspecified unspecified unspecified  	I_DATE	null
40 סיפורים סיפור סיפורים noun masculine plural absolute unspecified unspecified  	O	null
41 ; ; ; punctuation unspecified unspecified unspecified unspecified unspecified  	O	null
42 שוקת שוקה שוקת noun feminine singular construct unspecified unspecified  	O	null
43 סדוקה סדק סדוקה participle feminine singular absolute any unspecified  	O	null
44 ( ( ( punctuation unspecified unspecified unspecified unspecified unspecified  	O	null
45 ) ) ) punctuation unspecified unspecified unspecified unspecified unspecified  	O	null
46 , , , punctuation unspecified unspecified unspecified unspecified unspecified  	O	null
47 ###NUMBER### ###NUMBER### ###NUMBER### numeral unspecified unspecified unspecified unspecified unspecified  	I_DATE	null
48 רומן רומן רומן properName unspecified unspecified unspecified unspecified unspecified  	I_PERS	null
49 מחיי חיה מחייו participle masculine plural unspecified any unspecified  
49 ו ו מחייו possessive masculine singular unspecified 3 unspecified 0 	O	null
50 כ כ כשליח preposition unspecified unspecified unspecified unspecified unspecified 0 
50 שליח שליח כשליח noun masculine singular construct unspecified unspecified  	O	null
51 ב ב בארצות preposition unspecified unspecified unspecified unspecified unspecified 0 
51 ארצות ארץ בארצות properName unspecified unspecified unspecified unspecified unspecified  	I_LOC	null
52 הברית ברית הברית properName unspecified unspecified unspecified unspecified unspecified  	I_LOC	null
53 , , , punctuation unspecified unspecified unspecified unspecified unspecified  	O	null
54 עם עם עם preposition unspecified unspecified unspecified unspecified unspecified  	O	null
55 תמונות תמונה תמונות noun feminine plural construct unspecified unspecified  	O	null
56 מ מ מתקופת preposition unspecified unspecified unspecified unspecified unspecified 0 
56 תקופת תקף מתקופת participle feminine singular construct any unspecified  	I_ORG	null
57 ה ה ה properName unspecified unspecified unspecified unspecified unspecified  	I_ORG	null
58 " " " punctuation unspecified unspecified unspecified unspecified unspecified  	O	null
59 ה ה היפים definiteArticle unspecified unspecified unspecified unspecified unspecified 0 
59 היפים יפה היפים adjective masculine plural absolute unspecified unspecified  	O	null
60 " " " punctuation unspecified unspecified unspecified unspecified unspecified  	O	null
61 ו ו וזיכרונות conjunction unspecified unspecified unspecified unspecified unspecified 0 
61 זיכרונות זיכרון וזיכרונות noun masculine plural construct unspecified unspecified  	O	null
62 מ מ מהקיבוץ preposition unspecified unspecified unspecified unspecified unspecified 0 
62 ה ה מהקיבוץ definiteArticle unspecified unspecified unspecified unspecified unspecified 0 
62 הקיבוץ קיבוץ מהקיבוץ noun masculine singular absolute unspecified unspecified  	O	null
63 ; ; ; punctuation unspecified unspecified unspecified unspecified unspecified  	O	null
64 ה ה הנאהבים definiteArticle unspecified unspecified unspecified unspecified unspecified 0 
64 הנאהבים נאהב הנאהבים participle masculine plural absolute any unspecified  	O	null
65 ו ו והנעימים conjunction unspecified unspecified unspecified unspecified unspecified 0 
65 ה ה והנעימים definiteArticle unspecified unspecified unspecified unspecified unspecified 0 
65 הנעימים נעים והנעימים adjective masculine plural absolute unspecified unspecified  	O	null
66 ) ) ) punctuation unspecified unspecified unspecified unspecified unspecified  	O	null
67 , , , punctuation unspecified unspecified unspecified unspecified unspecified  	O	null
68 ###NUMBER### ###NUMBER### ###NUMBER### numeral unspecified unspecified unspecified unspecified unspecified  	I_DATE	null
69 מ מ מחזה preposition unspecified unspecified unspecified unspecified unspecified 0 
69 חזה חזה מחזה properName unspecified unspecified unspecified unspecified unspecified  	I_PERS	null
70 על על על preposition unspecified unspecified unspecified unspecified unspecified  	O	null
71 פי פי פי adverb unspecified unspecified unspecified unspecified unspecified  	O	null
72 סיפור סיפור סיפור noun masculine singular construct unspecified unspecified  	O	null
73 של של של shel-preposition unspecified unspecified unspecified unspecified unspecified  	O	null
74 ב ב בשביס preposition unspecified unspecified unspecified unspecified unspecified 0 
74 שביס שביס בשביס noun masculine singular construct unspecified unspecified  	O	null
75 - - - punctuation unspecified unspecified unspecified unspecified unspecified  	O	null
76 זינגר זינגר זינגר properName unspecified unspecified unspecified unspecified unspecified  	I_PERS	null
77 , , , punctuation unspecified unspecified unspecified unspecified unspecified  	O	null
78 נכתב נכתב נכתב verb masculine singular unspecified 3 past  	O	null
79 ב ב בשיתוף preposition unspecified unspecified unspecified unspecified unspecified 0 
79 שיתוף שיתוף בשיתוף noun masculine singular construct unspecified unspecified  	O	null
80 עם עם עם preposition unspecified unspecified unspecified unspecified unspecified  	O	null
81 ה ה המחזאי definiteArticle unspecified unspecified unspecified unspecified unspecified 0 
81 המחזאי מחזאי המחזאי noun masculine singular absolute unspecified unspecified  	O	null
82 מוטי מוטי מוטי properName unspecified unspecified unspecified unspecified unspecified  	I_PERS	null
83 לרנר לרנר לרנר properName unspecified unspecified unspecified unspecified unspecified  	I_PERS	null
84 ו ו והוצג conjunction unspecified unspecified unspecified unspecified unspecified 0 
84 הוצג הוצג והוצג verb masculine singular unspecified 3 past  	O	null
85 ב ב ב preposition unspecified unspecified unspecified unspecified unspecified 0 	O	null
86 " " " punctuation unspecified unspecified unspecified unspecified unspecified  	O	null
87 ה ה הבימה definiteArticle unspecified unspecified unspecified unspecified unspecified 0 
87 הבימה בימה הבימה noun feminine singular absolute unspecified unspecified  	O	null
88 " " " punctuation unspecified unspecified unspecified unspecified unspecified  	O	null
89 ב ב בבימוי preposition unspecified unspecified unspecified unspecified unspecified 0 
89 בימוי בימוי בבימוי noun masculine singular construct unspecified unspecified  	O	null
90 חן חן חנן noun masculine singular absolute unspecified unspecified  
90 ן ן חנן possessive feminine plural unspecified 3 unspecified 0 	O	null
91 שניר שניר שניר properName unspecified unspecified unspecified unspecified unspecified  	I_PERS	null
92 . . . punctuation unspecified unspecified unspecified unspecified unspecified  	O	null

0 ה ה המחזה definiteArticle unspecified unspecified unspecified unspecified unspecified 0 
0 המחזה מחזה המחזה noun masculine singular absolute unspecified unspecified  	O	null
1 הוצג הוצג הוצג verb masculine singular unspecified 3 past  	O	null
2 גם גם גם conjunction unspecified unspecified unspecified unspecified unspecified  	O	null
3 ב ב בוושינגטון preposition unspecified unspecified unspecified unspecified unspecified 0 
3 וושינגטון ושינגטון בוושינגטון properName unspecified unspecified unspecified unspecified unspecified  	I_LOC	null
4 ) ) ) punctuation unspecified unspecified unspecified unspecified unspecified  	O	null
5 ; ; ; punctuation unspecified unspecified unspecified unspecified unspecified  	O	null
6 ###NUMBER### ###NUMBER### ###NUMBER### numeral unspecified unspecified unspecified unspecified unspecified  	I_DATE	null
7 לכבות כבה לכבות verb unspecified unspecified unspecified unspecified infinitive  	O	null
8 את את את at-preposition unspecified unspecified unspecified unspecified unspecified  	O	null
9 ה ה השמש definiteArticle unspecified unspecified unspecified unspecified unspecified 0 
9 השמש שמש השמש noun feminine singular absolute unspecified unspecified  	O	null
10 ) ) ) punctuation unspecified unspecified unspecified unspecified unspecified  	O	null
11 , , , punctuation unspecified unspecified unspecified unspecified unspecified  	O	null
12 ###NUMBER### ###NUMBER### ###NUMBER### numeral unspecified unspecified unspecified unspecified unspecified  	I_DATE	null
13 רומן רומן רומן noun masculine singular absolute unspecified unspecified  	O	null
14 תיעודי תיעודי תיעודי adjective masculine singular absolute unspecified unspecified  	O	null
15 על על על preposition unspecified unspecified unspecified unspecified unspecified  	O	null
16 תחנות תחנה תחנות noun feminine plural construct unspecified unspecified  	O	null
17 חיי חיים חייו noun masculine plural absolute unspecified unspecified  
17 ו ו חייו possessive masculine singular unspecified 3 unspecified 0 	O	null
18 ה ה השונות definiteArticle unspecified unspecified unspecified unspecified unspecified 0 
18 השונות שונה השונות adjective feminine plural absolute unspecified unspecified  	O	null
19 . . . punctuation unspecified unspecified unspecified unspecified unspecified  	O	null

0 References References References foreign unspecified unspecified unspecified unspecified unspecified  	O	null
1 : : : punctuation unspecified unspecified unspecified unspecified unspecified  	O	null
2 אדמון אדמון אדמון properName unspecified unspecified unspecified unspecified unspecified  	I_PERS	null
3 , , , punctuation unspecified unspecified unspecified unspecified unspecified  	O	null
4 תלמה תלמה תלמה properName unspecified unspecified unspecified unspecified unspecified  	I_PERS	null
5 . . . punctuation unspecified unspecified unspecified unspecified unspecified  	O	null

0 " " " punctuation unspecified unspecified unspecified unspecified unspecified  	O	null
1 ה ה הצד definiteArticle unspecified unspecified unspecified unspecified unspecified 0 
1 הצד צד הצד noun masculine singular absolute unspecified unspecified  	O	null
2 ה ה האפל definiteArticle unspecified unspecified unspecified unspecified unspecified 0 
2 האפל אפל האפל adjective masculine singular absolute unspecified unspecified  	O	null
3 של של של shel-preposition unspecified unspecified unspecified unspecified unspecified  	O	null
4 ה ה האב definiteArticle unspecified unspecified unspecified unspecified unspecified 0 
4 האב אב האב noun masculine singular absolute unspecified unspecified  	O	null
5 " " " punctuation unspecified unspecified unspecified unspecified unspecified  	O	null
6 . . . punctuation unspecified unspecified unspecified unspecified unspecified  	O	null
7 מעריב מעריב מעריב properName unspecified unspecified unspecified unspecified unspecified  	I_ORG	null
8 ספרות ספרות ספרות noun feminine singular absolute unspecified unspecified  	O	null
9 . . . punctuation unspecified unspecified unspecified unspecified unspecified  	O	null

0 ; ; ; punctuation unspecified unspecified unspecified unspecified unspecified  	O	null
1 ###NUMEXP### ###NUMEXP### ###NUMEXP### numberExpression unspecified unspecified unspecified unspecified unspecified  	I_DATE	null
2 אורן אורן אורן properName unspecified unspecified unspecified unspecified unspecified  	I_PERS	null
3 , , , punctuation unspecified unspecified unspecified unspecified unspecified  	O	null
4 יוסף יוסף יוסף properName unspecified unspecified unspecified unspecified unspecified  	I_PERS	null
5 . . . punctuation unspecified unspecified unspecified unspecified unspecified  	O	null

0 " " " punctuation unspecified unspecified unspecified unspecified unspecified  	O	null
1 פגישה פגישה פגישה noun feminine singular absolute unspecified unspecified  	O	null
2 בין בין בין preposition unspecified unspecified unspecified unspecified unspecified  	O	null
3 אב אב אב noun masculine singular absolute unspecified unspecified  	O	null
4 ל ל לבנו preposition unspecified unspecified unspecified unspecified unspecified 0 
4 בן בן לבנו noun masculine singular absolute unspecified unspecified  
4 ו ו לבנו possessive masculine singular unspecified 3 unspecified 0 	O	null
5 " " " punctuation unspecified unspecified unspecified unspecified unspecified  	O	null
6 . . . punctuation unspecified unspecified unspecified unspecified unspecified  	O	null

0 ידיעות ידיעה ידיעות noun feminine plural absolute unspecified unspecified  	I_ORG	null
1 אחרונות אחרון אחרונות adjective feminine plural absolute unspecified unspecified  	I_ORG	null
2 ספרות ספרות ספרות noun feminine singular absolute unspecified unspecified  	O	null
3 . . . punctuation unspecified unspecified unspecified unspecified unspecified  	O	null

0 ###NUMEXP### ###NUMEXP### ###NUMEXP### numberExpression unspecified unspecified unspecified unspecified unspecified  	I_DATE	null
1 ; ; ; punctuation unspecified unspecified unspecified unspecified unspecified  	O	null
2 זהב זהב זהבי noun masculine singular absolute unspecified unspecified  
2 י י זהבי possessive masculine-and-feminine singular unspecified 1 unspecified 0 	O	null
3 , , , punctuation unspecified unspecified unspecified unspecified unspecified  	O	null
4 אלכס אלכס אלכס properName unspecified unspecified unspecified unspecified unspecified  	I_PERS	null
5 . . . punctuation unspecified unspecified unspecified unspecified unspecified  	O	null

0 " " " punctuation unspecified unspecified unspecified unspecified unspecified  	O	null
1 אבי אבי אבי properName unspecified unspecified unspecified unspecified unspecified  	I_ORG	null
2 " " " punctuation unspecified unspecified unspecified unspecified unspecified  	O	null
3 . . . punctuation unspecified unspecified unspecified unspecified unspecified  	O	null
4 הארץספרים הארץספרים הארץספרים participle masculine singular construct any unspecified  	O	null
5 . . . punctuation unspecified unspecified unspecified unspecified unspecified  	O	null

0 ###NUMEXP### ###NUMEXP### ###NUMEXP### numberExpression unspecified unspecified unspecified unspecified unspecified  	I_DATE	null
1 ; ; ; punctuation unspecified unspecified unspecified unspecified unspecified  	O	null
2 רובינשטיין רובינשטיין רובינשטיין properName unspecified unspecified unspecified unspecified unspecified  	I_PERS	null
3 , , , punctuation unspecified unspecified unspecified unspecified unspecified  	O	null
4 בלהה בלהה בלהה properName unspecified unspecified unspecified unspecified unspecified  	I_PERS	null
5 . . . punctuation unspecified unspecified unspecified unspecified unspecified  	O	null

0 " " " punctuation unspecified unspecified unspecified unspecified unspecified  	O	null
1 אבא אבא אבא properName unspecified unspecified unspecified unspecified unspecified  	O	null
2 הוא הוא הוא pronoun masculine singular unspecified 3 unspecified  	O	null
3 אבא אבא אבא noun masculine singular absolute unspecified unspecified  	O	null
4 " " " punctuation unspecified unspecified unspecified unspecified unspecified  	O	null
5 . . . punctuation unspecified unspecified unspecified unspecified unspecified  	O	null
6 מעריב מעריב מעריב properName unspecified unspecified unspecified unspecified unspecified  	I_ORG	null
7 ספרות ספרות ספרות noun feminine singular absolute unspecified unspecified  	O	null
8 . . . punctuation unspecified unspecified unspecified unspecified unspecified  	O	null

0 . . . punctuation unspecified unspecified unspecified unspecified unspecified  	O	null
1 ###NUMEXP### ###NUMEXP### ###NUMEXP### numberExpression unspecified unspecified unspecified unspecified unspecified  	I_DATE	null

