0 Name Name Name foreign unspecified unspecified unspecified unspecified unspecified  	O	null
1 : : : punctuation unspecified unspecified unspecified unspecified unspecified  	O	null
2 חן חן חן noun masculine singular absolute unspecified unspecified  	O	null
3 , , , punctuation unspecified unspecified unspecified unspecified unspecified  	O	null
4 רועי רועה רועי noun masculine plural construct unspecified unspecified  	O	null
5 Birth Birth Birth foreign unspecified unspecified unspecified unspecified unspecified  	O	null
6 Year Year Year foreign unspecified unspecified unspecified unspecified unspecified  	O	null
7 : : : punctuation unspecified unspecified unspecified unspecified unspecified  	O	null
8 ###NUMBER### ###NUMBER### ###NUMBER### numeral unspecified unspecified unspecified unspecified unspecified  	I_DATE	null
9 Birth Birth Birth foreign unspecified unspecified unspecified unspecified unspecified  	O	null
10 Place Place Place foreign unspecified unspecified unspecified unspecified unspecified  	O	null
11 : : : punctuation unspecified unspecified unspecified unspecified unspecified  	O	null
12 תל תל תל properName unspecified unspecified unspecified unspecified unspecified  	I_LOC	null
13 אביב אביב אביב properName unspecified unspecified unspecified unspecified unspecified  	B_LOC	null
14 Occupation Occupation Occupation foreign unspecified unspecified unspecified unspecified unspecified  	O	null
15 : : : punctuation unspecified unspecified unspecified unspecified unspecified  	O	null
16 סופר סופר סופר noun masculine singular absolute unspecified unspecified  	O	null
17 , , , punctuation unspecified unspecified unspecified unspecified unspecified  	O	null
18 מתרגם מתרגם מתרגם noun masculine singular absolute unspecified unspecified  	O	null
19 ו ו ומחזאי conjunction unspecified unspecified unspecified unspecified unspecified 0 
19 מחזאי מחזאי ומחזאי noun masculine singular absolute unspecified unspecified  	O	null
20 Entry Entry Entry foreign unspecified unspecified unspecified unspecified unspecified  	O	null
21 writer writer writer foreign unspecified unspecified unspecified unspecified unspecified  	O	null
22 : : : punctuation unspecified unspecified unspecified unspecified unspecified  	O	null
23 סבטלנה סבטלנה סבטלנה properName unspecified unspecified unspecified unspecified unspecified  	I_PERS	null
24 נטקוביץ' נטקוביץ' נטקוביץ' properName unspecified unspecified unspecified unspecified unspecified  	I_PERS	null
25 Entry Entry Entry foreign unspecified unspecified unspecified unspecified unspecified  	O	null
26 Value Value Value foreign unspecified unspecified unspecified unspecified unspecified  	O	null
27 : : : punctuation unspecified unspecified unspecified unspecified unspecified  	O	null
28 נולד נולד נולד verb masculine singular unspecified 3 past  	O	null
29 ב ב בתל preposition unspecified unspecified unspecified unspecified unspecified 0 
29 תל תל בתל properName unspecified unspecified unspecified unspecified unspecified  	I_LOC	null
30 אביב אביב אביב properName unspecified unspecified unspecified unspecified unspecified  	I_LOC	null
31 . . . punctuation unspecified unspecified unspecified unspecified unspecified  	O	null

0 הורי הורה הוריו noun masculine plural absolute unspecified unspecified  
0 ו ו הוריו possessive masculine singular unspecified 3 unspecified 0 	O	null
1 ילידי יליד ילידי noun masculine plural construct unspecified unspecified  	O	null
2 ישראל ישראל ישראל properName unspecified unspecified unspecified unspecified unspecified  	I_LOC	null
3 – – – punctuation unspecified unspecified unspecified unspecified unspecified  	O	null
4 אם אם אמו noun feminine singular absolute unspecified unspecified  
4 ו ו אמו possessive masculine singular unspecified 3 unspecified 0 	O	null
5 מ מ ממוצא preposition unspecified unspecified unspecified unspecified unspecified 0 
5 מוצא מוצא ממוצא noun masculine singular absolute unspecified unspecified  	O	null
6 מרוקאי מרוקאי מרוקאי adjective masculine singular absolute unspecified unspecified  	O	null
7 ו ו ואביו conjunction unspecified unspecified unspecified unspecified unspecified 0 
7 אבי אב ואביו noun masculine singular absolute unspecified unspecified  
7 ו ו ואביו possessive masculine singular unspecified 3 unspecified 0 	O	null
8 מ מ ממשפחה preposition unspecified unspecified unspecified unspecified unspecified 0 
8 משפחה משפחה ממשפחה noun feminine singular absolute unspecified unspecified  	O	null
9 ספרדית ספרדי ספרדית adjective feminine singular absolute unspecified unspecified  	O	null
10 ( ( ( punctuation unspecified unspecified unspecified unspecified unspecified  	O	null
11 חסאן חסאן חסאן properName unspecified unspecified unspecified unspecified unspecified  	I_ORG	null
12 ב ב במקור preposition unspecified unspecified unspecified unspecified unspecified 0 
12 מקור מקור במקור noun masculine singular absolute unspecified unspecified  	O	null
13 ) ) ) punctuation unspecified unspecified unspecified unspecified unspecified  	O	null
14 ש ש שמוצאה relativizer/subordinatingConjunction unspecified unspecified unspecified unspecified unspecified 0 
14 מוצא מוצא שמוצאה noun masculine singular absolute unspecified unspecified  
14 ה ה שמוצאה possessive feminine singular unspecified 3 unspecified 0 	O	null
15 מ מ מציפורי preposition unspecified unspecified unspecified unspecified unspecified 0 
15 ציפורי ציפורי מציפורי properName unspecified unspecified unspecified unspecified unspecified  	I_LOC	null
16 , , , punctuation unspecified unspecified unspecified unspecified unspecified  	O	null
17 שפרעם שפרעם שפרעם properName unspecified unspecified unspecified unspecified unspecified  	I_LOC	null
18 ו ו וטבריה conjunction unspecified unspecified unspecified unspecified unspecified 0 
18 טבריה טבריה וטבריה properName unspecified unspecified unspecified unspecified unspecified  	B_LOC	null
19 . . . punctuation unspecified unspecified unspecified unspecified unspecified  	O	null

0 למד למד למד verb masculine singular unspecified 3 past  	O	null
1 ב ב בבית preposition unspecified unspecified unspecified unspecified unspecified 0 
1 בית בית בבית noun masculine singular construct unspecified unspecified  	O	null
2 ה ה הספר definiteArticle unspecified unspecified unspecified unspecified unspecified 0 
2 הספר ספר הספר noun masculine singular absolute unspecified unspecified  	O	null
3 ל ל לאמנויות preposition unspecified unspecified unspecified unspecified unspecified 0 
3 ה ה לאמנויות definiteArticle unspecified unspecified unspecified unspecified unspecified 0 
3 האמנויות אמנות לאמנויות noun feminine plural absolute unspecified unspecified  	O	null
4 ב ב בתל preposition unspecified unspecified unspecified unspecified unspecified 0 
4 תל תל בתל properName unspecified unspecified unspecified unspecified unspecified  	I_LOC	null
5 אביב אביב אביב properName unspecified unspecified unspecified unspecified unspecified  	I_LOC	null
6 , , , punctuation unspecified unspecified unspecified unspecified unspecified  	O	null
7 שם שם שם adverb unspecified unspecified unspecified unspecified unspecified  	O	null
8 נחשף נחשף נחשף verb masculine singular unspecified 3 past  	O	null
9 ל ל לעולם preposition unspecified unspecified unspecified unspecified unspecified 0 
9 עולם עולם לעולם noun masculine singular construct unspecified unspecified  	O	null
10 ה ה הספרות definiteArticle unspecified unspecified unspecified unspecified unspecified 0 
10 הספרות ספרות הספרות noun feminine singular absolute unspecified unspecified  	O	null
11 ו ו ועשה conjunction unspecified unspecified unspecified unspecified unspecified 0 
11 עשה עשה ועשה verb masculine singular unspecified 3 past  	O	null
12 ניסיונות ניסיון ניסיונות noun masculine plural construct unspecified unspecified  	O	null
13 ראשונים ראשונים ראשונים noun masculine plural absolute unspecified unspecified  	O	null
14 ב ב בכתיבת preposition unspecified unspecified unspecified unspecified unspecified 0 
14 כתיבת כתיבה בכתיבת noun feminine singular construct unspecified unspecified  	O	null
15 פרוזה פרוזה פרוזה noun feminine singular absolute unspecified unspecified  	O	null
16 . . . punctuation unspecified unspecified unspecified unspecified unspecified  	O	null

0 ב ב בגיל preposition unspecified unspecified unspecified unspecified unspecified 0 
0 גיל גיל בגיל noun masculine singular construct unspecified unspecified  	O	null
1 חמש CARD5 חמש numeral feminine singular absolute unspecified unspecified  	O	null
2 - - - punctuation unspecified unspecified unspecified unspecified unspecified  	O	null
3 עשרה CARD10 עשרה numeral masculine plural absolute unspecified unspecified  	O	null
4 נשר נשר נשר properName unspecified unspecified unspecified unspecified unspecified  	I_LOC	null
5 מ מ מבית preposition unspecified unspecified unspecified unspecified unspecified 0 
5 בית בית מבית noun masculine singular construct unspecified unspecified  	O	null
6 ה ה הספר definiteArticle unspecified unspecified unspecified unspecified unspecified 0 
6 הספר ספר הספר noun masculine singular absolute unspecified unspecified  	O	null
7 ה ה התיכון definiteArticle unspecified unspecified unspecified unspecified unspecified 0 
7 התיכון תיכון התיכון adjective masculine singular absolute unspecified unspecified  	O	null
8 , , , punctuation unspecified unspecified unspecified unspecified unspecified  	O	null
9 ו ו ואת conjunction unspecified unspecified unspecified unspecified unspecified 0 
9 את את ואת at-preposition unspecified unspecified unspecified unspecified unspecified  	O	null
10 שנות שנה שנות noun feminine plural construct unspecified unspecified  	O	null
11 ה ה ההתבגרות definiteArticle unspecified unspecified unspecified unspecified unspecified 0 
11 ההתבגרות התבגרות ההתבגרות noun feminine singular absolute unspecified unspecified  	O	null
12 של של שלו shel-preposition unspecified unspecified unspecified unspecified unspecified  
12 ו ו שלו pronomial masculine singular unspecified 3 unspecified 0 	O	null
13 העביר העביר העביר verb masculine singular unspecified 3 past  	O	null
14 ב ב בשיטוט preposition unspecified unspecified unspecified unspecified unspecified 0 
14 שיטוט שיטוט בשיטוט noun masculine singular absolute unspecified unspecified  	O	null
15 עם עם עם preposition unspecified unspecified unspecified unspecified unspecified  	O	null
16 חבורות חבורה חבורות noun feminine plural construct unspecified unspecified  	O	null
17 רחוב רחוב רחוב noun masculine singular absolute unspecified unspecified  	O	null
18 , , , punctuation unspecified unspecified unspecified unspecified unspecified  	O	null
19 ב ב בהן preposition unspecified unspecified unspecified unspecified unspecified 0 
19 הן הוא בהן pronoun feminine plural unspecified 3 unspecified  	O	null
20 חבורות חבורה חבורות noun feminine plural absolute unspecified unspecified  	O	null
21 של של של shel-preposition unspecified unspecified unspecified unspecified unspecified  	O	null
22 אמנים אמן אמנים noun masculine plural absolute unspecified unspecified  	O	null
23 רוסים רוסי רוסים adjective masculine plural absolute unspecified unspecified  	O	null
24 , , , punctuation unspecified unspecified unspecified unspecified unspecified  	O	null
25 ש ש שמהם relativizer/subordinatingConjunction unspecified unspecified unspecified unspecified unspecified 0 
25 מן מן שמהם preposition unspecified unspecified unspecified unspecified unspecified  
25 הם הם שמהם pronomial masculine plural unspecified 3 unspecified 0 	O	null
26 למד למד למד verb masculine singular unspecified 3 past  	O	null
27 את את את at-preposition unspecified unspecified unspecified unspecified unspecified  	O	null
28 לשון לשון לשונם noun feminine singular absolute unspecified unspecified  
28 ם ם לשונם possessive masculine plural unspecified 3 unspecified 0 	O	null
29 ו ו ונחשף conjunction unspecified unspecified unspecified unspecified unspecified 0 
29 נחשף נחשף ונחשף verb masculine singular unspecified 3 past  	O	null
30 ל ל לתרבותם preposition unspecified unspecified unspecified unspecified unspecified 0 
30 תרבות תרבות לתרבותם noun feminine singular absolute unspecified unspecified  
30 ם ם לתרבותם possessive masculine plural unspecified 3 unspecified 0 	O	null
31 . . . punctuation unspecified unspecified unspecified unspecified unspecified  	O	null

0 ב ב בהמשך preposition unspecified unspecified unspecified unspecified unspecified 0 
0 המשך המשך בהמשך noun masculine singular absolute unspecified unspecified  	O	null
1 ל ל למד preposition unspecified unspecified unspecified unspecified unspecified 0 
1 מד מד למד noun masculine singular construct unspecified unspecified  	O	null
2 צרפתית צרפתי צרפתית adjective feminine singular absolute unspecified unspecified  	O	null
3 ו ו והשתלם conjunction unspecified unspecified unspecified unspecified unspecified 0 
3 השתלם השתלם והשתלם verb masculine singular unspecified 3 past  	O	null
4 ב ב בלימודי preposition unspecified unspecified unspecified unspecified unspecified 0 
4 לימודי לימוד בלימודי noun masculine plural construct unspecified unspecified  	O	null
5 יידיש יידיש יידיש properName feminine singular unspecified unspecified unspecified  	O	null
6 ו ו ומרוקאית conjunction unspecified unspecified unspecified unspecified unspecified 0 
6 מרוקאית מרוקאי ומרוקאית adjective feminine singular absolute unspecified unspecified  	O	null
7 . . . punctuation unspecified unspecified unspecified unspecified unspecified  	O	null

0 ב ב ב preposition unspecified unspecified unspecified unspecified unspecified 0 	I_ORG	null
1 - - - punctuation unspecified unspecified unspecified unspecified unspecified  	I_ORG	null
2 ###NUMBER### ###NUMBER### ###NUMBER### numeral unspecified unspecified unspecified unspecified unspecified  	I_DATE	null
3 למד למד למד verb masculine singular unspecified 3 past  	O	null
4 בלשנות בלשנות בלשנות noun feminine singular absolute unspecified unspecified  	O	null
5 ו ו וספרות conjunction unspecified unspecified unspecified unspecified unspecified 0 
5 ספרות ספרות וספרות noun feminine singular absolute unspecified unspecified  	O	null
6 צרפתית צרפתי צרפתית adjective feminine singular absolute unspecified unspecified  	O	null
7 ב ב באוניברסיטת preposition unspecified unspecified unspecified unspecified unspecified 0 
7 אוניברסיטת אוניברסיטה באוניברסיטת noun feminine singular construct unspecified unspecified  	I_ORG	null
8 תל תל תל properName unspecified unspecified unspecified unspecified unspecified  	I_ORG	null
9 אביב אביב אביב properName unspecified unspecified unspecified unspecified unspecified  	I_ORG	null
10 . . . punctuation unspecified unspecified unspecified unspecified unspecified  	O	null

0 ב ב בשנים preposition unspecified unspecified unspecified unspecified unspecified 0 
0 שנים שנה בשנים noun feminine plural absolute unspecified unspecified  	O	null
1 ###NUMBER### ###NUMBER### ###NUMBER### numeral unspecified unspecified unspecified unspecified unspecified  	I_DATE	null
2 - - - punctuation unspecified unspecified unspecified unspecified unspecified  	O	null
3 ###NUMBER### ###NUMBER### ###NUMBER### numeral unspecified unspecified unspecified unspecified unspecified  	I_DATE	null
4 הרצה הרצה הרצה verb masculine singular unspecified 3 past  	O	null
5 ב ב בארץ preposition unspecified unspecified unspecified unspecified unspecified 0 
5 ה ה בארץ definiteArticle unspecified unspecified unspecified unspecified unspecified 0 
5 הארץ ארץ בארץ noun feminine singular absolute unspecified unspecified  	O	null
6 ו ו וברחבי conjunction unspecified unspecified unspecified unspecified unspecified 0 
6 ב ב וברחבי preposition unspecified unspecified unspecified unspecified unspecified 0 
6 רחבי רוחב וברחבי noun masculine plural construct unspecified unspecified  	O	null
7 ברית ברייה ברית properName unspecified unspecified unspecified unspecified unspecified  	I_LOC	null
8 המועצות מועצה המועצות properName unspecified unspecified unspecified unspecified unspecified  	I_LOC	null
9 לשעבר לשעבר לשעבר adverb unspecified unspecified unspecified unspecified unspecified  	O	null
10 ב ב בנושאי preposition unspecified unspecified unspecified unspecified unspecified 0 
10 נושאי נושא בנושאי noun masculine plural construct unspecified unspecified  	O	null
11 ספרות ספרות ספרות noun feminine singular absolute unspecified unspecified  	O	null
12 ו ו ותרבות conjunction unspecified unspecified unspecified unspecified unspecified 0 
12 תרבות תרבות ותרבות noun feminine singular absolute unspecified unspecified  	O	null
13 ישראלית ישראלי ישראלית adjective feminine singular absolute unspecified unspecified  	O	null
14 . . . punctuation unspecified unspecified unspecified unspecified unspecified  	O	null

0 ב ב בתקופה preposition unspecified unspecified unspecified unspecified unspecified 0 
0 תקופה תקופה בתקופה noun feminine singular absolute unspecified unspecified  	O	null
1 זאת זאת זאת pronoun feminine singular unspecified 3 unspecified  	O	null
2 גם גם גם conjunction unspecified unspecified unspecified unspecified unspecified  	O	null
3 עיבד עיבד עיבד verb masculine singular unspecified 3 past  	O	null
4 ו ו ותירגם conjunction unspecified unspecified unspecified unspecified unspecified 0 
4 תירגם תרגם ותירגם verb masculine singular unspecified 3 past  	O	null
5 מחזות מחזה מחזות noun masculine plural absolute unspecified unspecified  	O	null
6 מ מ מרוסית preposition unspecified unspecified unspecified unspecified unspecified 0 
6 רוסית רוסית מרוסית properName feminine singular unspecified unspecified unspecified  	I_LOC	null
7 , , , punctuation unspecified unspecified unspecified unspecified unspecified  	O	null
8 מ מ מצרפתית preposition unspecified unspecified unspecified unspecified unspecified 0 
8 צרפתית צרפתית מצרפתית properName unspecified unspecified unspecified unspecified unspecified  	I_LOC	null
9 ו ו ומאנגלית conjunction unspecified unspecified unspecified unspecified unspecified 0 
9 מ מ ומאנגלית preposition unspecified unspecified unspecified unspecified unspecified 0 
9 אנגלית אנגלית ומאנגלית properName feminine singular unspecified unspecified unspecified  	B_LOC	null
10 עבור עבור עבור preposition unspecified unspecified unspecified unspecified unspecified  	O	null
11 בית בית בית noun masculine singular construct unspecified unspecified  	O	null
12 ה ה הספר definiteArticle unspecified unspecified unspecified unspecified unspecified 0 
12 הספר ספר הספר noun masculine singular absolute unspecified unspecified  	O	null
13 ל ל למשחק preposition unspecified unspecified unspecified unspecified unspecified 0 
13 ה ה למשחק definiteArticle unspecified unspecified unspecified unspecified unspecified 0 
13 המשחק משחק למשחק noun masculine singular absolute unspecified unspecified  	O	null
14 " " " punctuation unspecified unspecified unspecified unspecified unspecified  	O	null
15 בית בית בית properName unspecified unspecified unspecified unspecified unspecified  	I_ORG	null
16 צבי צבי צבי properName unspecified unspecified unspecified unspecified unspecified  	I_ORG	null
17 " " " punctuation unspecified unspecified unspecified unspecified unspecified  	O	null
18 ו ו ועבור conjunction unspecified unspecified unspecified unspecified unspecified 0 
18 עבור עבור ועבור preposition unspecified unspecified unspecified unspecified unspecified  	O	null
19 ה ה התיאטראות definiteArticle unspecified unspecified unspecified unspecified unspecified 0 
19 התיאטראות תיאטרון התיאטראות noun masculine plural absolute unspecified unspecified  	O	null
20 " " " punctuation unspecified unspecified unspecified unspecified unspecified  	O	null
21 מאלנקי מאלנקי מאלנקי properName unspecified unspecified unspecified unspecified unspecified  	I_ORG	null
22 " " " punctuation unspecified unspecified unspecified unspecified unspecified  	O	null
23 ו ו ו conjunction unspecified unspecified unspecified unspecified unspecified 0 	I_ORG	null
24 " " " punctuation unspecified unspecified unspecified unspecified unspecified  	I_ORG	null
25 גשר גשר גשר properName unspecified unspecified unspecified unspecified unspecified  	I_ORG	null
26 " " " punctuation unspecified unspecified unspecified unspecified unspecified  	O	null
27 . . . punctuation unspecified unspecified unspecified unspecified unspecified  	O	null

0 החל החל החל verb masculine singular unspecified 3 past  	O	null
1 מ מ מ preposition unspecified unspecified unspecified unspecified unspecified 0 	O	null
2 - - - punctuation unspecified unspecified unspecified unspecified unspecified  	O	null
3 ###NUMBER### ###NUMBER### ###NUMBER### numeral unspecified unspecified unspecified unspecified unspecified  	I_DATE	null
4 משמש משמש משמש verb masculine singular unspecified 3 past  	O	null
5 כדרמטורג כדרמטורג כדרמטורג noun masculine singular construct unspecified unspecified  	O	null
6 ראשי ראשי ראשי adjective masculine singular absolute unspecified unspecified  	O	null
7 של של של shel-preposition unspecified unspecified unspecified unspecified unspecified  	O	null
8 תיאטרון תיאטרון תיאטרון properName unspecified unspecified unspecified unspecified unspecified  	I_ORG	null
9 " " " punctuation unspecified unspecified unspecified unspecified unspecified  	O	null
10 גשר גשר גשר properName unspecified unspecified unspecified unspecified unspecified  	I_ORG	null
11 " " " punctuation unspecified unspecified unspecified unspecified unspecified  	O	null
12 , , , punctuation unspecified unspecified unspecified unspecified unspecified  	O	null
13 ו ו ועיבודים conjunction unspecified unspecified unspecified unspecified unspecified 0 
13 עיבודים עיבוד ועיבודים noun masculine plural absolute unspecified unspecified  	O	null
14 פרי פרי פרי properName unspecified unspecified unspecified unspecified unspecified  	I_PERS	null
15 עטו עט עטו verb masculine-and-feminine plural unspecified 3 past  	O	null
16 מוצגים מוצג מוצגים noun masculine plural absolute unspecified unspecified  	O	null
17 גם גם גם conjunction unspecified unspecified unspecified unspecified unspecified  	O	null
18 ב ב בתיאטראות preposition unspecified unspecified unspecified unspecified unspecified 0 
18 תיאטראות תיאטרון בתיאטראות noun masculine plural absolute unspecified unspecified  	O	null
19 מרכזיים מרכזי מרכזיים adjective masculine plural absolute unspecified unspecified  	O	null
20 ב ב ברוסיה preposition unspecified unspecified unspecified unspecified unspecified 0 
20 רוסיה רוסי ברוסיה properName unspecified unspecified unspecified unspecified unspecified  	I_LOC	null
21 . . . punctuation unspecified unspecified unspecified unspecified unspecified  	O	null

0 ב ב ב preposition unspecified unspecified unspecified unspecified unspecified 0 	O	null
1 - - - punctuation unspecified unspecified unspecified unspecified unspecified  	O	null
2 ###NUMBER### ###NUMBER### ###NUMBER### numeral unspecified unspecified unspecified unspecified unspecified  	I_DATE	null
3 פירסם פרסם פירסם verb masculine singular unspecified 3 past  	O	null
4 מחזור מחזור מחזור noun masculine singular construct unspecified unspecified  	O	null
5 שירים שיר שירים noun masculine plural absolute unspecified unspecified  	O	null
6 ב ב בכתב preposition unspecified unspecified unspecified unspecified unspecified 0 
6 כתב כתב בכתב noun masculine singular construct unspecified unspecified  	O	null
7 ה ה העת definiteArticle unspecified unspecified unspecified unspecified unspecified 0 
7 העת עת העת noun feminine singular absolute unspecified unspecified  	O	null
8 מטען מטען מטען noun masculine singular absolute unspecified unspecified  	O	null
9 . . . punctuation unspecified unspecified unspecified unspecified unspecified  	O	null

0 ב ב ב preposition unspecified unspecified unspecified unspecified unspecified 0 	O	null
1 - - - punctuation unspecified unspecified unspecified unspecified unspecified  	O	null
2 ###NUMBER### ###NUMBER### ###NUMBER### numeral unspecified unspecified unspecified unspecified unspecified  	I_DATE	null
3 החלו החל החלו verb masculine-and-feminine plural unspecified 3 past  	O	null
4 להופיע הופיע להופיע verb unspecified unspecified unspecified unspecified infinitive  	O	null
5 סיפורים סיפור סיפורים noun masculine plural absolute unspecified unspecified  	O	null
6 ו ו ותרגומים conjunction unspecified unspecified unspecified unspecified unspecified 0 
6 תרגומים תרגום ותרגומים noun masculine plural absolute unspecified unspecified  	O	null
7 פרי פרי פרי properName unspecified unspecified unspecified unspecified unspecified  	I_PERS	null
8 עטו עט עטו verb masculine-and-feminine plural unspecified 3 past  	O	null
9 ב ב בכתב preposition unspecified unspecified unspecified unspecified unspecified 0 
9 כתב כתב בכתב noun masculine singular construct unspecified unspecified  	O	null
10 ה ה העת definiteArticle unspecified unspecified unspecified unspecified unspecified 0 
10 העת עת העת noun feminine singular absolute unspecified unspecified  	O	null
11 הו הו הו interjection unspecified unspecified unspecified unspecified unspecified  	O	null
12 ! ! ! punctuation unspecified unspecified unspecified unspecified unspecified  	O	null

0 ו ו ובהארץ conjunction unspecified unspecified unspecified unspecified unspecified 0 
0 ב ב ובהארץ preposition unspecified unspecified unspecified unspecified unspecified 0 
0 ה ה ובהארץ definiteArticle unspecified unspecified unspecified unspecified unspecified 0 
0 ההארץ ארץ ובהארץ noun feminine singular absolute unspecified unspecified  	O	null
1 . . . punctuation unspecified unspecified unspecified unspecified unspecified  	O	null

0 תירגם תרגם תירגם verb masculine singular unspecified 3 past  	O	null
1 מ מ מרוסית preposition unspecified unspecified unspecified unspecified unspecified 0 
1 רוסית רוסית מרוסית properName feminine singular unspecified unspecified unspecified  	I_PERS	null
2 את את את at-preposition unspecified unspecified unspecified unspecified unspecified  	O	null
3 יצירות יצירה יצירותיהם noun feminine plural absolute unspecified unspecified  
3 הם הם יצירותיהם possessive masculine plural unspecified 3 unspecified 0 	O	null
4 של של של shel-preposition unspecified unspecified unspecified unspecified unspecified  	O	null
5 חארמס חארמס חארמס properName unspecified unspecified unspecified unspecified unspecified  	I_PERS	null
6 , , , punctuation unspecified unspecified unspecified unspecified unspecified  	O	null
7 ש ש שאלמוב relativizer/subordinatingConjunction unspecified unspecified unspecified unspecified unspecified 0 
7 אלמו אלמו שאלמוב noun masculine singular absolute unspecified unspecified  
7 י י שאלמוב possessive masculine-and-feminine singular unspecified 1 unspecified 0 	O	null
8 , , , punctuation unspecified unspecified unspecified unspecified unspecified  	O	null
9 ב ב בונין preposition unspecified unspecified unspecified unspecified unspecified 0 
9 ונין ונין בונין noun masculine singular absolute unspecified unspecified  	O	null
10 ודוסטוייבסקי ודוסטוייבסקי ודוסטוייבסקי properName unspecified unspecified unspecified unspecified unspecified  	I_PERS	null
11 . . . punctuation unspecified unspecified unspecified unspecified unspecified  	O	null

0 מחזותי מחזה מחזותיו noun masculine plural absolute unspecified unspecified  
0 ו ו מחזותיו possessive masculine singular unspecified 3 unspecified 0 	O	null
1 ריקוד ריקוד ריקוד noun masculine singular absolute unspecified unspecified  	O	null
2 לבן לבן לבן adjective masculine singular absolute unspecified unspecified  	O	null
3 ( ( ( punctuation unspecified unspecified unspecified unspecified unspecified  	O	null
4 ###NUMBER### ###NUMBER### ###NUMBER### numeral unspecified unspecified unspecified unspecified unspecified  	I_DATE	null
5 ) ) ) punctuation unspecified unspecified unspecified unspecified unspecified  	O	null
6 ו ו ושושנת conjunction unspecified unspecified unspecified unspecified unspecified 0 
6 שושנת שושנה ושושנת noun feminine singular construct unspecified unspecified  	O	null
7 יריחו יריחו יריחו properName unspecified unspecified unspecified unspecified unspecified  	I_LOC	null
8 ( ( ( punctuation unspecified unspecified unspecified unspecified unspecified  	O	null
9 ###NUMBER### ###NUMBER### ###NUMBER### numeral unspecified unspecified unspecified unspecified unspecified  	I_DATE	null
10 ) ) ) punctuation unspecified unspecified unspecified unspecified unspecified  	O	null
11 הוצגו הוצג הוצגו verb masculine-and-feminine plural unspecified 3 past  	O	null
12 ב ב בפסטיבל preposition unspecified unspecified unspecified unspecified unspecified 0 
12 פסטיבל פסטיבל בפסטיבל noun masculine singular construct unspecified unspecified  	O	null
13 עכו עכו עכו properName unspecified unspecified unspecified unspecified unspecified  	I_LOC	null
14 ו ו ובתיאטרון conjunction unspecified unspecified unspecified unspecified unspecified 0 
14 ב ב ובתיאטרון preposition unspecified unspecified unspecified unspecified unspecified 0 
14 ה ה ובתיאטרון definiteArticle unspecified unspecified unspecified unspecified unspecified 0 
14 התיאטרון תיאטרון ובתיאטרון noun masculine singular absolute unspecified unspecified  	O	null
15 ה ה הפרינג' definiteArticle unspecified unspecified unspecified unspecified unspecified 0 
15 הפרינג' הפרינג' הפרינג' adjective masculine singular absolute unspecified unspecified  	O	null
16 . . . punctuation unspecified unspecified unspecified unspecified unspecified  	O	null

0 סיפורי סיפור סיפוריו noun masculine plural absolute unspecified unspecified  
0 ו ו סיפוריו possessive masculine singular unspecified 3 unspecified 0 	O	null
1 תורגמו תורגם תורגמו verb masculine-and-feminine plural unspecified 3 past  	O	null
2 ל ל לרוסית preposition unspecified unspecified unspecified unspecified unspecified 0 
2 רוסית רוסית לרוסית properName feminine singular unspecified unspecified unspecified  	I_LOC	null
3 , , , punctuation unspecified unspecified unspecified unspecified unspecified  	O	null
4 ל ל לאנגלית preposition unspecified unspecified unspecified unspecified unspecified 0 
4 אנגלית אנגלית לאנגלית properName feminine singular unspecified unspecified unspecified  	I_LOC	null
5 ו ו וליידיש conjunction unspecified unspecified unspecified unspecified unspecified 0 
5 ל ל וליידיש preposition unspecified unspecified unspecified unspecified unspecified 0 
5 יידיש יידיש וליידיש properName unspecified unspecified unspecified unspecified unspecified  	B_LOC	null
6 . . . punctuation unspecified unspecified unspecified unspecified unspecified  	O	null

0 רומן רומן רומן noun masculine singular construct unspecified unspecified  	O	null
1 ה ה החניכה definiteArticle unspecified unspecified unspecified unspecified unspecified 0 
1 החניכה חניכה החניכה noun feminine singular absolute unspecified unspecified  	O	null
2 הפנטסמגורי הפנטסמגורי הפנטסמגורי adjective masculine plural construct unspecified unspecified  	O	null
3 סוסי סוס סוסי noun masculine plural construct unspecified unspecified  	O	null
4 הדי הד הדיו noun masculine plural absolute unspecified unspecified  
4 ו ו הדיו possessive masculine singular unspecified 3 unspecified 0 	O	null
5 ( ( ( punctuation unspecified unspecified unspecified unspecified unspecified  	O	null
6 ###NUMBER### ###NUMBER### ###NUMBER### numeral unspecified unspecified unspecified unspecified unspecified  	I_DATE	null
7 ) ) ) punctuation unspecified unspecified unspecified unspecified unspecified  	O	null
8 ו ו וקובץ conjunction unspecified unspecified unspecified unspecified unspecified 0 
8 קובץ קובץ וקובץ noun masculine singular construct unspecified unspecified  	O	null
9 ה ה הסיפורים definiteArticle unspecified unspecified unspecified unspecified unspecified 0 
9 הסיפורים סיפור הסיפורים noun masculine plural absolute unspecified unspecified  	O	null
10 תל תל תל properName unspecified unspecified unspecified unspecified unspecified  	I_LOC	null
11 של של של shel-preposition unspecified unspecified unspecified unspecified unspecified  	O	null
12 אביב אביב אביב properName unspecified unspecified unspecified unspecified unspecified  	I_PERS	null
13 ( ( ( punctuation unspecified unspecified unspecified unspecified unspecified  	O	null
14 ###NUMBER### ###NUMBER### ###NUMBER### numeral unspecified unspecified unspecified unspecified unspecified  	I_DATE	null
15 ) ) ) punctuation unspecified unspecified unspecified unspecified unspecified  	O	null
16 ראו ראה ראו verb masculine-and-feminine plural unspecified 3 past  	O	null
17 אור אור אור noun masculine singular absolute unspecified unspecified  	O	null
18 ב ב בהוצאת preposition unspecified unspecified unspecified unspecified unspecified 0 
18 הוצאת הוצאה בהוצאת noun feminine singular construct unspecified unspecified  	O	null
19 ה ה הקיבוץ definiteArticle unspecified unspecified unspecified unspecified unspecified 0 
19 הקיבוץ קיבוץ הקיבוץ noun masculine singular absolute unspecified unspecified  	O	null
20 ה ה המאוחד definiteArticle unspecified unspecified unspecified unspecified unspecified 0 
20 המאוחד מאוחד המאוחד adjective masculine singular absolute unspecified unspecified  	O	null
21 . . . punctuation unspecified unspecified unspecified unspecified unspecified  	O	null

0 כתיבת כתיבה כתיבתו noun feminine singular absolute unspecified unspecified  
0 ו ו כתיבתו possessive masculine singular unspecified 3 unspecified 0 	O	null
1 , , , punctuation unspecified unspecified unspecified unspecified unspecified  	O	null
2 ה ה המושפעת definiteArticle unspecified unspecified unspecified unspecified unspecified 0 
2 המושפעת הושפע המושפעת participle feminine singular absolute any unspecified  	O	null
3 מ מ ממסורת preposition unspecified unspecified unspecified unspecified unspecified 0 
3 מסורת מסורת ממסורת noun feminine singular construct unspecified unspecified  	O	null
4 ה ה הריאליזם definiteArticle unspecified unspecified unspecified unspecified unspecified 0 
4 הריאליזם ריאליזם הריאליזם noun masculine singular absolute unspecified unspecified  	O	null
5 ה ה הפנטסטי definiteArticle unspecified unspecified unspecified unspecified unspecified 0 
5 הפנטסטי הפנטסטי הפנטסטי adjective masculine singular absolute unspecified unspecified  	O	null
6 ה ה הרוסי definiteArticle unspecified unspecified unspecified unspecified unspecified 0 
6 הרוסי רוסי הרוסי adjective masculine singular absolute unspecified unspecified  	O	null
7 , , , punctuation unspecified unspecified unspecified unspecified unspecified  	O	null
8 משלבת שילב משלבת verb feminine singular unspecified any beinoni  	O	null
9 בין בין בין preposition unspecified unspecified unspecified unspecified unspecified  	O	null
10 יסודות יסוד יסודות noun masculine plural absolute unspecified unspecified  	O	null
11 ריאליסטיים ריאליסטי ריאליסטיים adjective masculine plural absolute unspecified unspecified  	O	null
12 ל ל לאגדה preposition unspecified unspecified unspecified unspecified unspecified 0 
12 ה ה לאגדה definiteArticle unspecified unspecified unspecified unspecified unspecified 0 
12 האגדה אגדה לאגדה noun feminine singular absolute unspecified unspecified  	O	null
13 , , , punctuation unspecified unspecified unspecified unspecified unspecified  	O	null
14 פנטזיה פנטזיה פנטזיה noun feminine singular absolute unspecified unspecified  	O	null
15 , , , punctuation unspecified unspecified unspecified unspecified unspecified  	O	null
16 אלגוריה אלגוריה אלגוריה properName unspecified unspecified unspecified unspecified unspecified  	O	null
17 ו ו ואי conjunction unspecified unspecified unspecified unspecified unspecified 0 
17 אי אי ואי wPrefix unspecified unspecified unspecified unspecified unspecified  	I_ORG	null
18 - - - punctuation unspecified unspecified unspecified unspecified unspecified  	I_ORG	null
19 גיון גיון גיון properName unspecified unspecified unspecified unspecified unspecified  	I_ORG	null
20 . . . punctuation unspecified unspecified unspecified unspecified unspecified  	O	null

0 גיבורי גיבור גיבוריו noun masculine plural absolute unspecified unspecified  
0 ו ו גיבוריו possessive masculine singular unspecified 3 unspecified 0 	O	null
1 ה ה התלושים definiteArticle unspecified unspecified unspecified unspecified unspecified 0 
1 התלושים תלוש התלושים adjective masculine plural absolute unspecified unspecified  	O	null
2 – – – punctuation unspecified unspecified unspecified unspecified unspecified  	O	null
3 מהגרים מהגר מהגרים noun masculine plural absolute unspecified unspecified  	O	null
4 , , , punctuation unspecified unspecified unspecified unspecified unspecified  	O	null
5 דמויות דמות דמויות noun feminine plural absolute unspecified unspecified  	O	null
6 שוליים שולי שוליים adjective masculine plural absolute unspecified unspecified  	O	null
7 , , , punctuation unspecified unspecified unspecified unspecified unspecified  	O	null
8 מחוסרי חוסר מחוסרי participle masculine plural construct any unspecified  	I_ORG	null
9 בית בית בית properName unspecified unspecified unspecified unspecified unspecified  	I_PERS	null
10 , , , punctuation unspecified unspecified unspecified unspecified unspecified  	O	null
11 נעים נע נעים verb masculine plural unspecified any beinoni  	O	null
12 בין בין בין preposition unspecified unspecified unspecified unspecified unspecified  	O	null
13 מרחבי מרחב מרחבי noun masculine plural construct unspecified unspecified  	O	null
14 ה ה המציאות definiteArticle unspecified unspecified unspecified unspecified unspecified 0 
14 המציאות מציאות המציאות noun feminine singular absolute unspecified unspecified  	O	null
15 ל ל להזיה preposition unspecified unspecified unspecified unspecified unspecified 0 
15 הזיה הזיה להזיה noun feminine singular absolute unspecified unspecified  	O	null
16 ב ב בחיפוש preposition unspecified unspecified unspecified unspecified unspecified 0 
16 חיפוש חיפוש בחיפוש noun masculine singular absolute unspecified unspecified  	O	null
17 אחר אחר אחר preposition unspecified unspecified unspecified unspecified unspecified  	O	null
18 תשובות תשובה תשובות noun feminine plural absolute unspecified unspecified  	O	null
19 ל ל לשאלות preposition unspecified unspecified unspecified unspecified unspecified 0 
19 שאלות שאלה לשאלות noun feminine plural absolute unspecified unspecified  	O	null
20 קיומיות קיומי קיומיות adjective feminine plural absolute unspecified unspecified  	O	null
21 גדולות גדול גדולות adjective feminine plural absolute unspecified unspecified  	O	null
22 , , , punctuation unspecified unspecified unspecified unspecified unspecified  	O	null
23 אבל אבל אבל conjunction unspecified unspecified unspecified unspecified unspecified  	O	null
24 גם גם גם conjunction unspecified unspecified unspecified unspecified unspecified  	O	null
25 אחר אחר אחר preposition unspecified unspecified unspecified unspecified unspecified  	O	null
26 עוגני עוגן עוגני noun masculine plural construct unspecified unspecified  	O	null
27 זהות זהות זהות noun feminine singular absolute unspecified unspecified  	O	null
28 בסיסיים בסיסי בסיסיים adjective masculine plural absolute unspecified unspecified  	O	null
29 כמו כמו כמו preposition unspecified unspecified unspecified unspecified unspecified  	O	null
30 בית בית בית noun masculine singular absolute unspecified unspecified  	O	null
31 , , , punctuation unspecified unspecified unspecified unspecified unspecified  	O	null
32 משפחה משפחה משפחה noun feminine singular absolute unspecified unspecified  	O	null
33 ו ו ושפת conjunction unspecified unspecified unspecified unspecified unspecified 0 
33 שפת שפה ושפת noun feminine singular construct unspecified unspecified  	O	null
34 אם אם אם noun feminine singular absolute unspecified unspecified  	O	null
35 . . . punctuation unspecified unspecified unspecified unspecified unspecified  	O	null

0 References References References foreign unspecified unspecified unspecified unspecified unspecified  	O	null
1 : : : punctuation unspecified unspecified unspecified unspecified unspecified  	O	null
2 לב לב לב noun masculine singular construct unspecified unspecified  	O	null
3 - - - properName unspecified unspecified unspecified unspecified unspecified  	O	null
4 ארי ארי ארי properName unspecified unspecified unspecified unspecified unspecified  	I_PERS	null
5 , , , punctuation unspecified unspecified unspecified unspecified unspecified  	O	null
6 ש ש שירי relativizer/subordinatingConjunction unspecified unspecified unspecified unspecified unspecified 0 
6 ירי ירי שירי noun masculine singular absolute unspecified unspecified  	O	null
7 . . . punctuation unspecified unspecified unspecified unspecified unspecified  	O	null

0       punctuation unspecified unspecified unspecified unspecified unspecified  	O	null
1 " " " punctuation unspecified unspecified unspecified unspecified unspecified  	O	null
2 ה ה הבן definiteArticle unspecified unspecified unspecified unspecified unspecified 0 
2 הבן בן הבן noun masculine singular absolute unspecified unspecified  	O	null
3 ה ה המאמץ definiteArticle unspecified unspecified unspecified unspecified unspecified 0 
3 המאמץ מאמץ המאמץ noun masculine singular absolute unspecified unspecified  	O	null
4 " " " punctuation unspecified unspecified unspecified unspecified unspecified  	O	null
5 . . . punctuation unspecified unspecified unspecified unspecified unspecified  	O	null
6 ה ה הארץ definiteArticle unspecified unspecified unspecified unspecified unspecified 0 
6 הארץ ארץ הארץ noun feminine singular absolute unspecified unspecified  	O	null
7 גלריה גלריה גלריה noun feminine singular absolute unspecified unspecified  	O	null
8 . . . punctuation unspecified unspecified unspecified unspecified unspecified  	O	null

0 ###NUMEXP### ###NUMEXP### ###NUMEXP### numberExpression unspecified unspecified unspecified unspecified unspecified  	I_DATE	null
1 . . . punctuation unspecified unspecified unspecified unspecified unspecified  	O	null

0 ###NUMBER### ###NUMBER### ###NUMBER### numeral unspecified unspecified unspecified unspecified unspecified  	O	null
1 . . . punctuation unspecified unspecified unspecified unspecified unspecified  	O	null

