0 Name Name Name foreign unspecified unspecified unspecified unspecified unspecified  	O	null
1 : : : punctuation unspecified unspecified unspecified unspecified unspecified  	O	null
2 ידעיה ידעיה ידעיה properName unspecified unspecified unspecified unspecified unspecified  	I_ORG	null
3 , , , punctuation unspecified unspecified unspecified unspecified unspecified  	O	null
4 רונית רונית רונית properName unspecified unspecified unspecified unspecified unspecified  	I_PERS	null
5 Birth Birth Birth foreign unspecified unspecified unspecified unspecified unspecified  	O	null
6 Year Year Year foreign unspecified unspecified unspecified unspecified unspecified  	O	null
7 : : : punctuation unspecified unspecified unspecified unspecified unspecified  	O	null
8 ###NUMBER### ###NUMBER### ###NUMBER### numeral unspecified unspecified unspecified unspecified unspecified  	I_DATE	null
9 Birth Birth Birth foreign unspecified unspecified unspecified unspecified unspecified  	I_ORG	null
10 Place Place Place foreign unspecified unspecified unspecified unspecified unspecified  	I_ORG	null
11 : : : punctuation unspecified unspecified unspecified unspecified unspecified  	I_LOC	null
12 רמת רמה רמת noun feminine singular construct unspecified unspecified  	I_LOC	null
13 גן גן גן properName unspecified unspecified unspecified unspecified unspecified  	I_LOC	null
14 Occupation Occupation Occupation foreign unspecified unspecified unspecified unspecified unspecified  	O	null
15 : : : punctuation unspecified unspecified unspecified unspecified unspecified  	O	null
16 סופרת סופר סופרת noun feminine singular absolute unspecified unspecified  	O	null
17 ו ו ואמנית conjunction unspecified unspecified unspecified unspecified unspecified 0 
17 אמנית אמן ואמנית noun feminine singular construct unspecified unspecified  	O	null
18 Entry Entry Entry foreign unspecified unspecified unspecified unspecified unspecified  	O	null
19 writer writer writer foreign unspecified unspecified unspecified unspecified unspecified  	O	null
20 : : : punctuation unspecified unspecified unspecified unspecified unspecified  	O	null
21 אוראל אוראל אוראל properName unspecified unspecified unspecified unspecified unspecified  	I_PERS	null
22 שר שר שרפ noun masculine singular absolute unspecified unspecified  
22 ו ו שרפ possessive masculine singular unspecified 3 unspecified 0 	O	null
23 ו ו ויגאל conjunction unspecified unspecified unspecified unspecified unspecified 0 
23 יגאל יגאל ויגאל properName unspecified unspecified unspecified unspecified unspecified  	I_PERS	null
24 שוורץ שוורץ שוורץ properName unspecified unspecified unspecified unspecified unspecified  	I_PERS	null
25 Entry Entry Entry foreign unspecified unspecified unspecified unspecified unspecified  	O	null
26 Value Value Value foreign unspecified unspecified unspecified unspecified unspecified  	O	null
27 : : : punctuation unspecified unspecified unspecified unspecified unspecified  	O	null
28 נולדה נולד נולדה verb feminine singular unspecified 3 past  	I_LOC	null
29 ב ב ברמת preposition unspecified unspecified unspecified unspecified unspecified 0 
29 רמת רמה ברמת noun feminine singular construct unspecified unspecified  	I_LOC	null
30 גן גן גן properName unspecified unspecified unspecified unspecified unspecified  	I_LOC	null
31 . . . punctuation unspecified unspecified unspecified unspecified unspecified  	O	null

0 לאחר לאחר לאחר preposition unspecified unspecified unspecified unspecified unspecified  	O	null
1 שירות שירות שירותה noun masculine singular absolute unspecified unspecified  
1 ה ה שירותה possessive feminine singular unspecified 3 unspecified 0 	O	null
2 ה ה הצבאי definiteArticle unspecified unspecified unspecified unspecified unspecified 0 
2 הצבאי צבאי הצבאי adjective masculine singular absolute unspecified unspecified  	O	null
3 נסעה נסע נסעה verb feminine singular unspecified 3 past  	O	null
4 עם עם עם preposition unspecified unspecified unspecified unspecified unspecified  	O	null
5 בעלה בעל בעלה noun feminine singular absolute unspecified unspecified  	O	null
6 , , , punctuation unspecified unspecified unspecified unspecified unspecified  	O	null
7 ה ה הצלם definiteArticle unspecified unspecified unspecified unspecified unspecified 0 
7 הצלם צלם הצלם noun masculine singular absolute unspecified unspecified  	O	null
8 עודד עודד עודד properName unspecified unspecified unspecified unspecified unspecified  	I_PERS	null
9 ידעיה ידעיה ידעיה properName unspecified unspecified unspecified unspecified unspecified  	I_PERS	null
10 , , , punctuation unspecified unspecified unspecified unspecified unspecified  	O	null
11 ללמוד למד ללמוד verb unspecified unspecified unspecified unspecified infinitive  	O	null
12 אמנות אמנות אמנות noun feminine singular construct unspecified unspecified  	O	null
13 בניו בן בניו properName unspecified unspecified unspecified unspecified unspecified  	I_LOC	null
14 יורק הורק יורק properName unspecified unspecified unspecified unspecified unspecified  	I_LOC	null
15 , , , punctuation unspecified unspecified unspecified unspecified unspecified  	O	null
16 ב ב ב preposition unspecified unspecified unspecified unspecified unspecified 0 	O	null
17 - - - punctuation unspecified unspecified unspecified unspecified unspecified  	O	null
18 School School School foreign unspecified unspecified unspecified unspecified unspecified  	O	null
19 Of Of Of foreign unspecified unspecified unspecified unspecified unspecified  	O	null
20 Visual Visual Visual foreign unspecified unspecified unspecified unspecified unspecified  	O	null
21 Arts Arts Arts foreign unspecified unspecified unspecified unspecified unspecified  	O	null
22 ( ( ( punctuation unspecified unspecified unspecified unspecified unspecified  	O	null
23 SVA SVA SVA foreign unspecified unspecified unspecified unspecified unspecified  	O	null
24 ) ) ) punctuation unspecified unspecified unspecified unspecified unspecified  	O	null
25 . . . punctuation unspecified unspecified unspecified unspecified unspecified  	O	null

0 ב ב בשובה preposition unspecified unspecified unspecified unspecified unspecified 0 
0 שובה שובה בשובה noun masculine singular absolute unspecified unspecified  	O	null
1 ל ל לארץ preposition unspecified unspecified unspecified unspecified unspecified 0 
1 ה ה לארץ definiteArticle unspecified unspecified unspecified unspecified unspecified 0 
1 הארץ ארץ לארץ noun feminine singular absolute unspecified unspecified  	O	null
2 החלה החל החלה verb feminine singular unspecified 3 past  	O	null
3 ללמוד למד ללמוד verb unspecified unspecified unspecified unspecified infinitive  	O	null
4 ל ל לתעודת preposition unspecified unspecified unspecified unspecified unspecified 0 
4 תעודת תעודה לתעודת noun feminine singular construct unspecified unspecified  	O	null
5 הוראה הוראה הוראה noun feminine singular absolute unspecified unspecified  	O	null
6 ב ב באמנות preposition unspecified unspecified unspecified unspecified unspecified 0 
6 ה ה באמנות definiteArticle unspecified unspecified unspecified unspecified unspecified 0 
6 האמנות אמנות באמנות noun feminine singular absolute unspecified unspecified  	O	null
7 . . . punctuation unspecified unspecified unspecified unspecified unspecified  	O	null

0 ב ב בשנים preposition unspecified unspecified unspecified unspecified unspecified 0 
0 שנים שנה בשנים noun feminine plural absolute unspecified unspecified  	O	null
1 ###NUMBER### ###NUMBER### ###NUMBER### numeral unspecified unspecified unspecified unspecified unspecified  	I_DATE	null
2 - - - punctuation unspecified unspecified unspecified unspecified unspecified  	O	null
3 ###NUMBER### ###NUMBER### ###NUMBER### numeral unspecified unspecified unspecified unspecified unspecified  	I_DATE	null
4 חיה חי חיה verb feminine singular unspecified 3 past  	I_LOC	null
5 ב ב בקיבוץ preposition unspecified unspecified unspecified unspecified unspecified 0 
5 קיבוץ קיבוץ בקיבוץ noun masculine singular construct unspecified unspecified  	I_LOC	null
6 חניתה חניתה חניתה properName unspecified unspecified unspecified unspecified unspecified  	I_LOC	null
7 ו ו ושילבה conjunction unspecified unspecified unspecified unspecified unspecified 0 
7 שילבה שילב ושילבה verb feminine singular unspecified 3 past  	O	null
8 עבודה עבודה עבודה noun feminine singular absolute unspecified unspecified  	O	null
9 ב ב בקיבוץ preposition unspecified unspecified unspecified unspecified unspecified 0 
9 ה ה בקיבוץ definiteArticle unspecified unspecified unspecified unspecified unspecified 0 
9 הקיבוץ קיבוץ בקיבוץ noun masculine singular absolute unspecified unspecified  	O	null
10 עם עם עם preposition unspecified unspecified unspecified unspecified unspecified  	O	null
11 אמנות אמנות אמנות noun feminine singular absolute unspecified unspecified  	O	null
12 ו ו והוראת conjunction unspecified unspecified unspecified unspecified unspecified 0 
12 הוראת הוראה והוראת noun feminine singular construct unspecified unspecified  	O	null
13 אמנות אמנות אמנות noun feminine singular absolute unspecified unspecified  	O	null
14 ב ב במכללת preposition unspecified unspecified unspecified unspecified unspecified 0 
14 מכללת מכללה במכללת noun feminine singular construct unspecified unspecified  	O	null
15 " " " punctuation unspecified unspecified unspecified unspecified unspecified  	O	null
16 אורנים אורן אורנים properName unspecified unspecified unspecified unspecified unspecified  	I_ORG	null
17 " " " punctuation unspecified unspecified unspecified unspecified unspecified  	O	null
18 . . . punctuation unspecified unspecified unspecified unspecified unspecified  	O	null

0 ל ל לאורך preposition unspecified unspecified unspecified unspecified unspecified 0 
0 אורך אורך לאורך noun masculine singular construct unspecified unspecified  	O	null
1 ה ה השנים definiteArticle unspecified unspecified unspecified unspecified unspecified 0 
1 השנים שנה השנים noun feminine plural absolute unspecified unspecified  	O	null
2 עסקה עסק עסקה verb feminine singular unspecified 3 past  	O	null
3 גם גם גם conjunction unspecified unspecified unspecified unspecified unspecified  	O	null
4 ב ב בסחר preposition unspecified unspecified unspecified unspecified unspecified 0 
4 סחר סחר בסחר noun masculine singular absolute unspecified unspecified  	O	null
5 ב ב ביהלומים preposition unspecified unspecified unspecified unspecified unspecified 0 
5 יהלומים יהלום ביהלומים noun masculine plural absolute unspecified unspecified  	O	null
6 . . . punctuation unspecified unspecified unspecified unspecified unspecified  	O	null

0 ב ב בראשית preposition unspecified unspecified unspecified unspecified unspecified 0 
0 ראשית ראשית בראשית noun feminine singular construct unspecified unspecified  	O	null
1 שנות שנה שנות noun feminine plural construct unspecified unspecified  	I_DATE	null
2 ה ה התשעים definiteArticle unspecified unspecified unspecified unspecified unspecified 0 
2 התשעים ORD-CARD90 התשעים numeral masculine-and-feminine plural absolute unspecified unspecified  	I_DATE	null
3 חדלה חדל חדלה verb feminine singular unspecified 3 past  	O	null
4 לעסוק עסק לעסוק verb unspecified unspecified unspecified unspecified infinitive  	O	null
5 ב ב באמנות preposition unspecified unspecified unspecified unspecified unspecified 0 
5 אמנות אמנות באמנות noun feminine singular absolute unspecified unspecified  	O	null
6 פלסטית פלסטי פלסטית adjective feminine singular absolute unspecified unspecified  	O	null
7 ו ו ופנתה conjunction unspecified unspecified unspecified unspecified unspecified 0 
7 פנתה פנה ופנתה verb feminine singular unspecified 3 past  	O	null
8 ל ל לכתיבה preposition unspecified unspecified unspecified unspecified unspecified 0 
8 כתיבה כתיבה לכתיבה noun feminine singular absolute unspecified unspecified  	O	null
9 . . . punctuation unspecified unspecified unspecified unspecified unspecified  	O	null

0 ספר ספר ספרה noun masculine singular absolute unspecified unspecified  
0 ה ה ספרה possessive feminine singular unspecified 3 unspecified 0 	O	null
1 ה ה הראשון definiteArticle unspecified unspecified unspecified unspecified unspecified 0 
1 הראשון ORD1 הראשון numeral masculine singular absolute unspecified unspecified  	O	null
2 , , , punctuation unspecified unspecified unspecified unspecified unspecified  	O	null
3 ואקום ואקום ואקום noun masculine singular absolute unspecified unspecified  	O	null
4 , , , punctuation unspecified unspecified unspecified unspecified unspecified  	O	null
5 יצא יצא יצא verb masculine singular unspecified 3 past  	O	null
6 ב ב ב preposition unspecified unspecified unspecified unspecified unspecified 0 	I_ORG	null
7 - - - punctuation unspecified unspecified unspecified unspecified unspecified  	I_ORG	null
8 ###NUMBER### ###NUMBER### ###NUMBER### numeral unspecified unspecified unspecified unspecified unspecified  	I_DATE	null
9 ( ( ( punctuation unspecified unspecified unspecified unspecified unspecified  	I_ORG	null
10 זמורה-ביתן זמורה-ביתן זמורה-ביתן properName unspecified unspecified unspecified unspecified unspecified  	I_ORG	null
11 ) ) ) punctuation unspecified unspecified unspecified unspecified unspecified  	O	null
12 . . . punctuation unspecified unspecified unspecified unspecified unspecified  	O	null

0 אחרי אחרי אחריו preposition unspecified unspecified unspecified unspecified unspecified  
0 ו ו אחריו pronomial masculine singular unspecified 3 unspecified 0 	O	null
1 יצאו יצא יצאו verb masculine-and-feminine plural unspecified 3 past  	O	null
2 : : : punctuation unspecified unspecified unspecified unspecified unspecified  	O	null
3 קטלוג קטלוג קטלוג noun masculine singular absolute unspecified unspecified  	O	null
4 ( ( ( punctuation unspecified unspecified unspecified unspecified unspecified  	O	null
5 ) ) ) punctuation unspecified unspecified unspecified unspecified unspecified  	O	null
6 ; ; ; punctuation unspecified unspecified unspecified unspecified unspecified  	I_MONEY	null
7 ###NUMBER### ###NUMBER### ###NUMBER### numeral unspecified unspecified unspecified unspecified unspecified  	I_DATE	null
8 עור עור עור noun masculine singular absolute unspecified unspecified  	I_MONEY	null
9 ( ( ( punctuation unspecified unspecified unspecified unspecified unspecified  	O	null
10 ) ) ) punctuation unspecified unspecified unspecified unspecified unspecified  	O	null
11 ; ; ; punctuation unspecified unspecified unspecified unspecified unspecified  	O	null
12 שוש שוש שוש properName unspecified unspecified unspecified unspecified unspecified  	O	null
13 ###NUMBER### ###NUMBER### ###NUMBER### numeral unspecified unspecified unspecified unspecified unspecified  	I_DATE	null
14 ) ) ) punctuation unspecified unspecified unspecified unspecified unspecified  	O	null
15 ; ; ; punctuation unspecified unspecified unspecified unspecified unspecified  	O	null
16 ###NUMBER### ###NUMBER### ###NUMBER### numeral unspecified unspecified unspecified unspecified unspecified  	I_DATE	null
17 שכן שכן שכן noun masculine singular absolute unspecified unspecified  	O	null
18 טוב טוב טוב adjective masculine singular absolute unspecified unspecified  	O	null
19 ) ) ) punctuation unspecified unspecified unspecified unspecified unspecified  	O	null
20 . . . punctuation unspecified unspecified unspecified unspecified unspecified  	O	null
21 ###NUMBER### ###NUMBER### ###NUMBER### numeral unspecified unspecified unspecified unspecified unspecified  	I_DATE	null
22 עוסקת עסק עוסקת verb feminine singular unspecified any beinoni  	O	null
23 ב ב בהוראת preposition unspecified unspecified unspecified unspecified unspecified 0 
23 הוראת הוראה בהוראת noun feminine singular construct unspecified unspecified  	O	null
24 כתיבה כתיבה כתיבה noun feminine singular absolute unspecified unspecified  	O	null
25 ו ו ועומדת conjunction unspecified unspecified unspecified unspecified unspecified 0 
25 עומדת עמד ועומדת verb feminine singular unspecified any beinoni  	O	null
26 ב ב בראש preposition unspecified unspecified unspecified unspecified unspecified 0 
26 ראש ראש בראש noun masculine singular construct unspecified unspecified  	O	null
27 ה ה המחלקה definiteArticle unspecified unspecified unspecified unspecified unspecified 0 
27 המחלקה מחלקה המחלקה noun feminine singular absolute unspecified unspecified  	O	null
28 ל ל ללימודי preposition unspecified unspecified unspecified unspecified unspecified 0 
28 לימודי לימוד ללימודי noun masculine plural construct unspecified unspecified  	O	null
29 כתיבה כתיבה כתיבה noun feminine singular absolute unspecified unspecified  	O	null
30 של של של shel-preposition unspecified unspecified unspecified unspecified unspecified  	O	null
31 בית בית בית noun masculine singular construct unspecified unspecified  	O	null
32 ה ה הספר definiteArticle unspecified unspecified unspecified unspecified unspecified 0 
32 הספר ספר הספר noun masculine singular absolute unspecified unspecified  	O	null
33 " " " punctuation unspecified unspecified unspecified unspecified unspecified  	O	null
34 מנשר מנשר מנשר noun masculine singular absolute unspecified unspecified  	O	null
35 " " " punctuation unspecified unspecified unspecified unspecified unspecified  	O	null
36 ל ל לאמנות preposition unspecified unspecified unspecified unspecified unspecified 0 
36 ה ה לאמנות definiteArticle unspecified unspecified unspecified unspecified unspecified 0 
36 האמנות אמנות לאמנות noun feminine singular absolute unspecified unspecified  	O	null
37 , , , punctuation unspecified unspecified unspecified unspecified unspecified  	O	null
38 ש ש שהקימה relativizer/subordinatingConjunction unspecified unspecified unspecified unspecified unspecified 0 
38 הקימה הקים שהקימה verb feminine singular unspecified 3 past  	O	null
39 עם עם עם preposition unspecified unspecified unspecified unspecified unspecified  	O	null
40 בעלה בעל בעלה noun feminine singular absolute unspecified unspecified  	O	null
41 עודד עודד עודד properName unspecified unspecified unspecified unspecified unspecified  	I_PERS	null
42 , , , punctuation unspecified unspecified unspecified unspecified unspecified  	O	null
43 ה ה העומד definiteArticle unspecified unspecified unspecified unspecified unspecified 0 
43 העומד עמד העומד participle masculine singular absolute any unspecified  	O	null
44 ב ב בראשו preposition unspecified unspecified unspecified unspecified unspecified 0 
44 ראש ראש בראשו noun masculine singular absolute unspecified unspecified  
44 ו ו בראשו possessive masculine singular unspecified 3 unspecified 0 	O	null
45 . . . punctuation unspecified unspecified unspecified unspecified unspecified  	O	null

0 ב ב ב preposition unspecified unspecified unspecified unspecified unspecified 0 	I_ORG	null
1 - - - punctuation unspecified unspecified unspecified unspecified unspecified  	I_ORG	null
2 ###NUMBER### ###NUMBER### ###NUMBER### numeral unspecified unspecified unspecified unspecified unspecified  	I_DATE	null
3 יצאה יצא יצאה verb feminine singular unspecified 3 past  	O	null
4 ה ה האסופה definiteArticle unspecified unspecified unspecified unspecified unspecified 0 
4 האסופה אסופה האסופה noun feminine singular absolute unspecified unspecified  	O	null
5 של של של shel-preposition unspecified unspecified unspecified unspecified unspecified  	O	null
6 בוגרי בוגר בוגרי noun masculine plural construct unspecified unspecified  	O	null
7 ה ה המחלקה definiteArticle unspecified unspecified unspecified unspecified unspecified 0 
7 המחלקה מחלקה המחלקה noun feminine singular absolute unspecified unspecified  	O	null
8 ל ל לכתיבה preposition unspecified unspecified unspecified unspecified unspecified 0 
8 כתיבה כתיבה לכתיבה noun feminine singular absolute unspecified unspecified  	O	null
9 של של של shel-preposition unspecified unspecified unspecified unspecified unspecified  	O	null
10 בית בית בית noun masculine singular construct unspecified unspecified  	O	null
11 ה ה הספר definiteArticle unspecified unspecified unspecified unspecified unspecified 0 
11 הספר ספר הספר noun masculine singular absolute unspecified unspecified  	O	null
12 " " " punctuation unspecified unspecified unspecified unspecified unspecified  	O	null
13 מנשר מנשר מנשר noun masculine singular absolute unspecified unspecified  	O	null
14 " " " punctuation unspecified unspecified unspecified unspecified unspecified  	O	null
15 ל ל לאמנות preposition unspecified unspecified unspecified unspecified unspecified 0 
15 ה ה לאמנות definiteArticle unspecified unspecified unspecified unspecified unspecified 0 
15 האמנות אמנות לאמנות noun feminine singular absolute unspecified unspecified  	O	null
16 , , , punctuation unspecified unspecified unspecified unspecified unspecified  	O	null
17 דיבור דיבור דיבור noun masculine singular absolute unspecified unspecified  	O	null
18 , , , punctuation unspecified unspecified unspecified unspecified unspecified  	O	null
19 ש ש שאותה relativizer/subordinatingConjunction unspecified unspecified unspecified unspecified unspecified 0 
19 את את שאותה at-preposition unspecified unspecified unspecified unspecified unspecified  
19 ה ה שאותה pronomial feminine singular unspecified 3 unspecified 0 	O	null
20 ליקטה ליקט ליקטה verb feminine singular unspecified 3 past  	I_LOC	null
21 ידעיה ידעיה ידעיה properName unspecified unspecified unspecified unspecified unspecified  	I_PERS	null
22 , , , punctuation unspecified unspecified unspecified unspecified unspecified  	O	null
23 ו ו והיא conjunction unspecified unspecified unspecified unspecified unspecified 0 
23 היא הוא והיא pronoun feminine singular unspecified 3 unspecified  	O	null
24 כוללת כלל כוללת verb feminine singular unspecified any beinoni  	O	null
25 מבחר מבחר מבחר quantifier unspecified unspecified construct unspecified unspecified  	O	null
26 יצירות יצירה יצירות noun feminine plural absolute unspecified unspecified  	O	null
27 ב ב בפרוזה preposition unspecified unspecified unspecified unspecified unspecified 0 
27 פרוזה פרוזה בפרוזה noun feminine singular absolute unspecified unspecified  	O	null
28 ו ו ובשירה conjunction unspecified unspecified unspecified unspecified unspecified 0 
28 ב ב ובשירה preposition unspecified unspecified unspecified unspecified unspecified 0 
28 שירה שירה ובשירה properName unspecified unspecified unspecified unspecified unspecified  	I_PERS	null
29 . . . punctuation unspecified unspecified unspecified unspecified unspecified  	O	null

0 שם שם שם noun masculine singular construct unspecified unspecified  	O	null
1 ה ה האסופה definiteArticle unspecified unspecified unspecified unspecified unspecified 0 
1 האסופה אסופה האסופה noun feminine singular absolute unspecified unspecified  	O	null
2 ש ש שהוציאה relativizer/subordinatingConjunction unspecified unspecified unspecified unspecified unspecified 0 
2 הוציאה הוציא שהוציאה verb feminine singular unspecified 3 past  	O	null
3 ידעיה ידעיה ידעיה properName unspecified unspecified unspecified unspecified unspecified  	I_PERS	null
4 יכול יכול יכול modal masculine singular unspecified any beinoni  	O	null
5 גם גם גם conjunction unspecified unspecified unspecified unspecified unspecified  	O	null
6 לייצג ייצג לייצג verb unspecified unspecified unspecified unspecified infinitive  	O	null
7 כיוון כיוון כיוון noun masculine singular absolute unspecified unspecified  	I_LOC	null
8 מרכזי מרכזי מרכזי adjective masculine singular absolute unspecified unspecified  	O	null
9 מאוד מאוד מאוד adverb unspecified unspecified unspecified unspecified unspecified  	O	null
10 ה ה המאפיין definiteArticle unspecified unspecified unspecified unspecified unspecified 0 
10 המאפיין אפיין המאפיין participle masculine singular absolute any unspecified  	O	null
11 את את את at-preposition unspecified unspecified unspecified unspecified unspecified  	O	null
12 כתיבת כתיבה כתיבתה noun feminine singular absolute unspecified unspecified  
12 ה ה כתיבתה possessive feminine singular unspecified 3 unspecified 0 	O	null
13 , , , punctuation unspecified unspecified unspecified unspecified unspecified  	O	null
14 ה ה הנושאת definiteArticle unspecified unspecified unspecified unspecified unspecified 0 
14 הנושאת נשא הנושאת participle feminine singular absolute any unspecified  	O	null
15 אופי אופי אופי noun masculine singular absolute unspecified unspecified  	O	null
16 דיבורי דיבורי דיבורי adjective masculine singular absolute unspecified unspecified  	O	null
17 . . . punctuation unspecified unspecified unspecified unspecified unspecified  	O	null

0 כך כך כך adverb unspecified unspecified unspecified unspecified unspecified  	O	null
1 למשל למשל למשל conjunction unspecified unspecified unspecified unspecified unspecified  	O	null
2 ספר ספר ספרה punctuation masculine singular absolute unspecified unspecified  	O	null
3 שוש שוש שוש properName unspecified unspecified unspecified unspecified unspecified  	I_PERS	null
4 , , , punctuation unspecified unspecified unspecified unspecified unspecified  	O	null
5 ש ש שלכל relativizer/subordinatingConjunction unspecified unspecified unspecified unspecified unspecified 0 
5 ל ל שלכל preposition unspecified unspecified unspecified unspecified unspecified 0 
5 כל כול שלכל quantifier unspecified unspecified construct unspecified unspecified  	O	null
6 אורך אורך אורכו noun masculine singular absolute unspecified unspecified  
6 ו ו אורכו possessive masculine singular unspecified 3 unspecified 0 	O	null
7 מהווה היווה מהווה verb masculine singular unspecified any beinoni  	O	null
8 שיחה שיחה שיחה noun feminine singular absolute unspecified unspecified  	O	null
9 חד חד חד wPrefix unspecified unspecified unspecified unspecified unspecified  	I_ORG	null
10 - - - punctuation unspecified unspecified unspecified unspecified unspecified  	I_ORG	null
11 צדדית צדדי צדדית adjective feminine singular absolute unspecified unspecified  	I_ORG	null
12 ש ש שמנהלת relativizer/subordinatingConjunction unspecified unspecified unspecified unspecified unspecified 0 
12 מנהלת ניהל שמנהלת verb feminine singular unspecified any beinoni  	O	null
13 אישה איש אישה noun feminine singular absolute unspecified unspecified  	O	null
14 עם עם עם preposition unspecified unspecified unspecified unspecified unspecified  	O	null
15 אמה אמה אמה properName unspecified unspecified unspecified unspecified unspecified  	I_PERS	null
16 ש ש שנפטרה relativizer/subordinatingConjunction unspecified unspecified unspecified unspecified unspecified 0 
16 נפטרה נפטר שנפטרה verb feminine singular unspecified 3 past  	O	null
17 . . . punctuation unspecified unspecified unspecified unspecified unspecified  	O	null

0 כוח כוח כוחה noun masculine singular absolute unspecified unspecified  
0 ה ה כוחה possessive feminine singular unspecified 3 unspecified 0 	O	null
1 ה ה הדיבורי definiteArticle unspecified unspecified unspecified unspecified unspecified 0 
1 הדיבורי דיבורי הדיבורי adjective masculine singular absolute unspecified unspecified  	O	null
2 של של של shel-preposition unspecified unspecified unspecified unspecified unspecified  	O	null
3 ה ה הכתיבה definiteArticle unspecified unspecified unspecified unspecified unspecified 0 
3 הכתיבה כתיבה הכתיבה noun feminine singular absolute unspecified unspecified  	O	null
4 יוצר יוצר יוצר verb masculine singular unspecified 3 past  	O	null
5 ייצוג ייצוג ייצוג noun masculine singular absolute unspecified unspecified  	O	null
6 פרטי פרטי פרטי adjective masculine singular absolute unspecified unspecified  	O	null
7 ו ו וייחודי conjunction unspecified unspecified unspecified unspecified unspecified 0 
7 ייחודי ייחודי וייחודי adjective masculine singular absolute unspecified unspecified  	O	null
8 ש ש שנתפש relativizer/subordinatingConjunction unspecified unspecified unspecified unspecified unspecified 0 
8 נתפש נתפש שנתפש verb masculine singular unspecified 3 past  	O	null
9 כ כ כמשקף preposition unspecified unspecified unspecified unspecified unspecified 0 
9 ה ה כמשקף definiteArticle unspecified unspecified unspecified unspecified unspecified 0 
9 המשקף משקף כמשקף noun masculine singular absolute unspecified unspecified  	O	null
10 ב ב בצורה preposition unspecified unspecified unspecified unspecified unspecified 0 
10 צורה צורה בצורה noun feminine singular absolute unspecified unspecified  	O	null
11 כנה כן כנה adjective feminine singular absolute unspecified unspecified  	O	null
12 דמויות דמות דמויות noun feminine plural absolute unspecified unspecified  	O	null
13 מגוונות מגוון מגוונות adjective feminine plural absolute unspecified unspecified  	O	null
14 מ מ מחתכים preposition unspecified unspecified unspecified unspecified unspecified 0 
14 חתכים חתך מחתכים noun masculine plural absolute unspecified unspecified  	O	null
15 סוציו סוציו סוציו noun masculine singular construct unspecified unspecified  	O	null
16 - - - punctuation unspecified unspecified unspecified unspecified unspecified  	O	null
17 אקונומיים אקונומי אקונומיים adjective masculine plural absolute unspecified unspecified  	O	null
18 שונים שונה שונים adjective masculine plural absolute unspecified unspecified  	O	null
19 מתוך מתוך מתוך preposition unspecified unspecified unspecified unspecified unspecified  	O	null
20 ה ה החברה definiteArticle unspecified unspecified unspecified unspecified unspecified 0 
20 החברה חבר החברה noun feminine singular absolute unspecified unspecified  	O	null
21 ה ה הישראלית definiteArticle unspecified unspecified unspecified unspecified unspecified 0 
21 הישראלית ישראלי הישראלית adjective feminine singular absolute unspecified unspecified  	O	null
22 . . . punctuation unspecified unspecified unspecified unspecified unspecified  	O	null

0 ספרי ספר ספריה noun masculine plural absolute unspecified unspecified  
0 ה ה ספריה possessive feminine singular unspecified 3 unspecified 0 	O	null
1 מאופיינים אופיין מאופיינים verb masculine plural unspecified any beinoni  	O	null
2 ב ב בתודעה preposition unspecified unspecified unspecified unspecified unspecified 0 
2 תודעה תודעה בתודעה noun feminine singular absolute unspecified unspecified  	O	null
3 חברתית חברתי חברתית adjective feminine singular absolute unspecified unspecified  	O	null
4 - - - punctuation unspecified unspecified unspecified unspecified unspecified  	O	null
5 פוליטית פוליטי פוליטית adjective feminine singular absolute unspecified unspecified  	O	null
6 חריפה חריף חריפה adjective feminine singular absolute unspecified unspecified  	O	null
7 , , , punctuation unspecified unspecified unspecified unspecified unspecified  	O	null
8 ה ה המעוגנת definiteArticle unspecified unspecified unspecified unspecified unspecified 0 
8 המעוגנת עוגן המעוגנת participle feminine singular absolute any unspecified  	O	null
9 ב ב בידע preposition unspecified unspecified unspecified unspecified unspecified 0 
9 ידע ידע בידע noun masculine singular absolute unspecified unspecified  	O	null
10 אינטימי אינטימי אינטימי adjective masculine singular absolute unspecified unspecified  	O	null
11 ב ב בזרמים preposition unspecified unspecified unspecified unspecified unspecified 0 
11 זרמים זרם בזרמים noun masculine plural absolute unspecified unspecified  	O	null
12 חברתיים חברתי חברתיים adjective masculine plural absolute unspecified unspecified  	O	null
13 ביקורתיים ביקורתי ביקורתיים adjective masculine plural absolute unspecified unspecified  	O	null
14 בני בן בני noun masculine plural construct unspecified unspecified  	O	null
15 זמן זמן זמננו noun masculine singular absolute unspecified unspecified  
15 נו נו זמננו possessive masculine-and-feminine plural unspecified 1 unspecified 0 	O	null
16 , , , punctuation unspecified unspecified unspecified unspecified unspecified  	O	null
17 ו ו והיא conjunction unspecified unspecified unspecified unspecified unspecified 0 
17 היא הוא והיא pronoun feminine singular unspecified 3 unspecified  	O	null
18 משתקפת השתקף משתקפת verb feminine singular unspecified any beinoni  	O	null
19 הן הן הן conjunction unspecified unspecified unspecified unspecified unspecified  	O	null
20 ב ב במגוון preposition unspecified unspecified unspecified unspecified unspecified 0 
20 מגוון מגוון במגוון noun masculine singular construct unspecified unspecified  	O	null
21 ה ה הדמויות definiteArticle unspecified unspecified unspecified unspecified unspecified 0 
21 הדמויות דמות הדמויות noun feminine plural absolute unspecified unspecified  	O	null
22 של של שלה shel-preposition unspecified unspecified unspecified unspecified unspecified  
22 ה ה שלה pronomial feminine singular unspecified 3 unspecified 0 	O	null
23 , , , punctuation unspecified unspecified unspecified unspecified unspecified  	O	null
24 ה ה הכוללות definiteArticle unspecified unspecified unspecified unspecified unspecified 0 
24 הכוללות כלל הכוללות participle feminine plural absolute any unspecified  	O	null
25 " " " punctuation unspecified unspecified unspecified unspecified unspecified  	O	null
26 אחרים אחר אחרים adjective masculine plural absolute unspecified unspecified  	O	null
27 " " " punctuation unspecified unspecified unspecified unspecified unspecified  	O	null
28 ו ו ואנשי conjunction unspecified unspecified unspecified unspecified unspecified 0 
28 אנשי איש ואנשי noun masculine plural construct unspecified unspecified  	O	null
29 שוליים שולי שוליים adjective masculine plural absolute unspecified unspecified  	O	null
30 , , , punctuation unspecified unspecified unspecified unspecified unspecified  	O	null
31 הן הן הן conjunction unspecified unspecified unspecified unspecified unspecified  	O	null
32 ב ב בזירות preposition unspecified unspecified unspecified unspecified unspecified 0 
32 זירות זירה בזירות noun feminine plural construct unspecified unspecified  	O	null
33 ה ה האירוע definiteArticle unspecified unspecified unspecified unspecified unspecified 0 
33 האירוע אירוע האירוע noun masculine singular absolute unspecified unspecified  	O	null
34 ו ו והן conjunction unspecified unspecified unspecified unspecified unspecified 0 
34 הן הן והן conjunction unspecified unspecified unspecified unspecified unspecified  	O	null
35 ב ב באופיים preposition unspecified unspecified unspecified unspecified unspecified 0 
35 אופיי אופי באופיים noun masculine singular absolute unspecified unspecified  
35 ם ם באופיים possessive masculine plural unspecified 3 unspecified 0 	O	null
36 של של של shel-preposition unspecified unspecified unspecified unspecified unspecified  	O	null
37 ה ה המצבים definiteArticle unspecified unspecified unspecified unspecified unspecified 0 
37 המצבים מצב המצבים noun masculine plural absolute unspecified unspecified  	O	null
38 ה ה הדרמטיים definiteArticle unspecified unspecified unspecified unspecified unspecified 0 
38 הדרמטיים דרמטי הדרמטיים adjective masculine plural absolute unspecified unspecified  	O	null
39 . . . punctuation unspecified unspecified unspecified unspecified unspecified  	O	null

0 כך כך כך adverb unspecified unspecified unspecified unspecified unspecified  	I_ORG	null
1 , , , punctuation unspecified unspecified unspecified unspecified unspecified  	O	null
2 למשל למשל למשל conjunction unspecified unspecified unspecified unspecified unspecified  	O	null
3 , , , punctuation unspecified unspecified unspecified unspecified unspecified  	O	null
4 גיבורת גיבור גיבורת noun feminine singular construct unspecified unspecified  	O	null
5 ה ה הרומן definiteArticle unspecified unspecified unspecified unspecified unspecified 0 
5 הרומן רומן הרומן noun masculine singular absolute unspecified unspecified  	O	null
6 עור עור עור noun masculine singular absolute unspecified unspecified  	O	null
7 היא הוא היא copula feminine singular unspecified 3 beinoni  	O	null
8 אנה אנה אנה properName unspecified unspecified unspecified unspecified unspecified  	I_PERS	null
9 , , , punctuation unspecified unspecified unspecified unspecified unspecified  	O	null
10 עולה עלה עולה verb masculine singular unspecified any beinoni  	O	null
11 מ מ מרוסיה preposition unspecified unspecified unspecified unspecified unspecified 0 
11 רוסיה רוסי מרוסיה properName unspecified unspecified unspecified unspecified unspecified  	I_LOC	null
12 , , , punctuation unspecified unspecified unspecified unspecified unspecified  	O	null
13 ש ש שאביה relativizer/subordinatingConjunction unspecified unspecified unspecified unspecified unspecified 0 
13 אבי אב שאביה noun masculine singular absolute unspecified unspecified  
13 ה ה שאביה possessive feminine singular unspecified 3 unspecified 0 	O	null
14 הסתלק הסתלק הסתלק verb masculine singular unspecified 3 past  	O	null
15 עם עם עם preposition unspecified unspecified unspecified unspecified unspecified  	O	null
16 סל סל סל noun masculine singular construct unspecified unspecified  	O	null
17 ה ה הקליטה definiteArticle unspecified unspecified unspecified unspecified unspecified 0 
17 הקליטה קליטה הקליטה noun feminine singular absolute unspecified unspecified  	O	null
18 ו ו ועם conjunction unspecified unspecified unspecified unspecified unspecified 0 
18 עם עם ועם preposition unspecified unspecified unspecified unspecified unspecified  	O	null
19 ה ה השכנה definiteArticle unspecified unspecified unspecified unspecified unspecified 0 
19 השכנה שכן השכנה noun feminine singular absolute unspecified unspecified  	O	null
20 . . . punctuation unspecified unspecified unspecified unspecified unspecified  	O	null

0 אנה אנה אנה properName unspecified unspecified unspecified unspecified unspecified  	I_PERS	null
1 ו ו ואמה conjunction unspecified unspecified unspecified unspecified unspecified 0 
1 אמה אמה ואמה properName unspecified unspecified unspecified unspecified unspecified  	I_PERS	null
2 , , , punctuation unspecified unspecified unspecified unspecified unspecified  	O	null
3 " " " punctuation unspecified unspecified unspecified unspecified unspecified  	O	null
4 הפרה הפרה הפרה noun feminine singular absolute unspecified unspecified  	O	null
5 " " " punctuation unspecified unspecified unspecified unspecified unspecified  	O	null
6 – – – punctuation unspecified unspecified unspecified unspecified unspecified  	O	null
7 כפי כפי כפי conjunction unspecified unspecified unspecified unspecified unspecified  	O	null
8 ש ש שאנה relativizer/subordinatingConjunction unspecified unspecified unspecified unspecified unspecified 0 
8 אנה אנה שאנה properName unspecified unspecified unspecified unspecified unspecified  	I_PERS	null
9 קוראת קרא קוראת verb feminine singular unspecified any beinoni  	O	null
10 ל ל לה preposition unspecified unspecified unspecified unspecified unspecified  
10 ה ה לה pronomial feminine singular unspecified 3 unspecified 0 	O	null
11 , , , punctuation unspecified unspecified unspecified unspecified unspecified  	O	null
12 נשארו נשאר נשארו verb masculine-and-feminine plural unspecified 3 past  	O	null
13 ב ב בישראל preposition unspecified unspecified unspecified unspecified unspecified 0 
13 ישראל ישראל בישראל properName unspecified unspecified unspecified unspecified unspecified  	I_LOC	null
14 . . . punctuation unspecified unspecified unspecified unspecified unspecified  	O	null

0 אנה אנה אנה properName unspecified unspecified unspecified unspecified unspecified  	I_PERS	null
1 עבדה עבד עבדה verb feminine singular unspecified 3 past  	O	null
2 ב ב בבורסת preposition unspecified unspecified unspecified unspecified unspecified 0 
2 בורסת בורסה בבורסת noun feminine singular construct unspecified unspecified  	O	null
3 ה ה היהלומים definiteArticle unspecified unspecified unspecified unspecified unspecified 0 
3 היהלומים יהלום היהלומים noun masculine plural absolute unspecified unspecified  	O	null
4 ו ו ומאז conjunction unspecified unspecified unspecified unspecified unspecified 0 
4 מאז מאז ומאז adverb unspecified unspecified unspecified unspecified unspecified  	O	null
5 ש ש שפוטרה relativizer/subordinatingConjunction unspecified unspecified unspecified unspecified unspecified 0 
5 פוטרה פוטר שפוטרה verb feminine singular unspecified 3 past  	O	null
6 היא הוא היא pronoun feminine singular unspecified 3 unspecified  	O	null
7 עובדת עבד עובדת verb feminine singular unspecified any beinoni  	O	null
8 ל ל ליד preposition unspecified unspecified unspecified unspecified unspecified 0 
8 יד יד ליד noun feminine singular absolute unspecified unspecified  	O	null
9 , , , punctuation unspecified unspecified unspecified unspecified unspecified  	O	null
10 ב ב ב preposition unspecified unspecified unspecified unspecified unspecified 0 	O	null
11 " " " punctuation unspecified unspecified unspecified unspecified unspecified  	O	null
12 מועדון מועדון מועדון noun masculine singular construct unspecified unspecified  	O	null
13 ה ה הבורסה definiteArticle unspecified unspecified unspecified unspecified unspecified 0 
13 הבורסה בורסה הבורסה noun feminine singular absolute unspecified unspecified  	O	null
14 " " " punctuation unspecified unspecified unspecified unspecified unspecified  	O	null
15 , , , punctuation unspecified unspecified unspecified unspecified unspecified  	O	null
16 מוכרת מכר מוכרת verb feminine singular unspecified any beinoni  	O	null
17 פנטזיות פנטזיה פנטזיות noun feminine plural absolute unspecified unspecified  	O	null
18 סקס סקס סקס noun masculine singular absolute unspecified unspecified  	O	null
19 . . . punctuation unspecified unspecified unspecified unspecified unspecified  	O	null

0 ה ה המקומות definiteArticle unspecified unspecified unspecified unspecified unspecified 0 
0 המקומות מקום המקומות noun masculine plural absolute unspecified unspecified  	O	null
1 שונים שונה שונים adjective masculine plural absolute unspecified unspecified  	O	null
2 אבל אבל אבל conjunction unspecified unspecified unspecified unspecified unspecified  	O	null
3 ה ה השפה definiteArticle unspecified unspecified unspecified unspecified unspecified 0 
3 השפה שפה השפה noun feminine singular absolute unspecified unspecified  	O	null
4 היא הוא היא copula feminine singular unspecified 3 beinoni  	O	null
5 את את אותה at-preposition unspecified unspecified unspecified unspecified unspecified  
5 ה ה אותה pronomial feminine singular unspecified 3 unspecified 0 	O	null
6 ה ה השפה definiteArticle unspecified unspecified unspecified unspecified unspecified 0 
6 השפה שפה השפה noun feminine singular absolute unspecified unspecified  	O	null
7 : : : punctuation unspecified unspecified unspecified unspecified unspecified  	O	null
8 שפת שפה שפת noun feminine singular construct unspecified unspecified  	O	null
9 ה ה המסחר definiteArticle unspecified unspecified unspecified unspecified unspecified 0 
9 המסחר מסחר המסחר noun masculine singular absolute unspecified unspecified  	O	null
10 היא הוא היא copula feminine singular unspecified 3 beinoni  	O	null
11 גם גם גם conjunction unspecified unspecified unspecified unspecified unspecified  	O	null
12 שפת שפה שפת noun feminine singular construct unspecified unspecified  	O	null
13 ה ה הסקס definiteArticle unspecified unspecified unspecified unspecified unspecified 0 
13 הסקס סקס הסקס noun masculine singular absolute unspecified unspecified  	O	null
14 . . . punctuation unspecified unspecified unspecified unspecified unspecified  	O	null

0 ב ב בשני preposition unspecified unspecified unspecified unspecified unspecified 0 
0 שני שני בשני noun masculine singular construct unspecified unspecified  	O	null
1 ה ה המקומות definiteArticle unspecified unspecified unspecified unspecified unspecified 0 
1 המקומות מקום המקומות noun masculine plural absolute unspecified unspecified  	O	null
2 מוכרים מכר מוכרים verb masculine plural unspecified any beinoni  	O	null
3 ו ו וקונים conjunction unspecified unspecified unspecified unspecified unspecified 0 
3 קונים קנה וקונים verb masculine plural unspecified any beinoni  	O	null
4 אשליות אשליה אשליות noun feminine plural absolute unspecified unspecified  	O	null
5 ו ו ותדמיות conjunction unspecified unspecified unspecified unspecified unspecified 0 
5 תדמיות תדמית ותדמיות noun feminine plural absolute unspecified unspecified  	O	null
6 , , , punctuation unspecified unspecified unspecified unspecified unspecified  	O	null
7 ה ה החמדנות definiteArticle unspecified unspecified unspecified unspecified unspecified 0 
7 החמדנות חמדנות החמדנות noun feminine singular absolute unspecified unspecified  	O	null
8 היא הוא היא copula feminine singular unspecified 3 beinoni  	O	null
9 ה ה הבסיס definiteArticle unspecified unspecified unspecified unspecified unspecified 0 
9 הבסיס בסיס הבסיס noun masculine singular absolute unspecified unspecified  	O	null
10 ה ה המוצק definiteArticle unspecified unspecified unspecified unspecified unspecified 0 
10 המוצק מוצק המוצק adjective masculine singular absolute unspecified unspecified  	O	null
11 ה ה היחיד definiteArticle unspecified unspecified unspecified unspecified unspecified 0 
11 היחיד יחיד היחיד adjective masculine singular absolute unspecified unspecified  	O	null
12 , , , punctuation unspecified unspecified unspecified unspecified unspecified  	O	null
13 ו ו ובשניהם conjunction unspecified unspecified unspecified unspecified unspecified 0 
13 ב ב ובשניהם preposition unspecified unspecified unspecified unspecified unspecified 0 
13 שניים שניים ובשניהם pronoun unspecified unspecified unspecified unspecified unspecified  
13 הם הם ובשניהם pronomial masculine plural unspecified 3 unspecified 0 	O	null
14 נתפשות נתפש נתפשות verb feminine plural unspecified any beinoni  	O	null
15 ה ה האהדה definiteArticle unspecified unspecified unspecified unspecified unspecified 0 
15 האהדה אהדה האהדה noun feminine singular absolute unspecified unspecified  	O	null
16 , , , punctuation unspecified unspecified unspecified unspecified unspecified  	O	null
17 ה ה החמלה definiteArticle unspecified unspecified unspecified unspecified unspecified 0 
17 החמלה חמלה החמלה noun feminine singular absolute unspecified unspecified  	O	null
18 ו ו וההכרה conjunction unspecified unspecified unspecified unspecified unspecified 0 
18 ה ה וההכרה definiteArticle unspecified unspecified unspecified unspecified unspecified 0 
18 ההכרה הכרה וההכרה noun feminine singular absolute unspecified unspecified  	O	null
19 ב ב בזכות preposition unspecified unspecified unspecified unspecified unspecified 0 
19 זכות זכות בזכות noun feminine singular construct unspecified unspecified  	O	null
20 קיום קיום קיומו noun masculine singular absolute unspecified unspecified  
20 ו ו קיומו possessive masculine singular unspecified 3 unspecified 0 	O	null
21 של של של shel-preposition unspecified unspecified unspecified unspecified unspecified  	O	null
22 ה ה הזולת definiteArticle unspecified unspecified unspecified unspecified unspecified 0 
22 הזולת זולת הזולת noun masculine singular absolute unspecified unspecified  	O	null
23 כ כ כיצור preposition unspecified unspecified unspecified unspecified unspecified 0 
23 יצור יצור כיצור noun masculine singular absolute unspecified unspecified  	O	null
24 נבדל נבדל נבדל verb masculine singular unspecified any beinoni  	O	null
25 ו ו ועצמאי conjunction unspecified unspecified unspecified unspecified unspecified 0 
25 עצמאי עצמאי ועצמאי adjective masculine singular absolute unspecified unspecified  	O	null
26 – – – punctuation unspecified unspecified unspecified unspecified unspecified  	O	null
27 כ כ כסוג preposition unspecified unspecified unspecified unspecified unspecified 0 
27 סוג סוג כסוג noun masculine singular absolute unspecified unspecified  	O	null
28 של של של shel-preposition unspecified unspecified unspecified unspecified unspecified  	O	null
29 מותרות מותרות מותרות noun masculine plural absolute unspecified unspecified  	O	null
30 . . . punctuation unspecified unspecified unspecified unspecified unspecified  	O	null

0 בת בת בתה noun feminine singular absolute unspecified unspecified  
0 ה ה בתה possessive feminine singular unspecified 3 unspecified 0 	O	null
1 היא הוא היא pronoun feminine singular unspecified 3 unspecified  	O	null
2 הקולנוענית הקולנוענית הקולנוענית verb feminine singular unspecified 2 past  	O	null
3 קרן קרן קרן noun feminine singular absolute unspecified unspecified  	O	null
4 ידעיה ידעיה ידעיה properName unspecified unspecified unspecified unspecified unspecified  	I_ORG	null
5 . . . punctuation unspecified unspecified unspecified unspecified unspecified  	O	null

0 ידעיה ידעיה ידעיה properName unspecified unspecified unspecified unspecified unspecified  	I_LOC	null
1 היא הוא היא pronoun feminine singular unspecified 3 unspecified  	O	null
2 סופרת ספר סופרת verb feminine singular unspecified any beinoni  	O	null
3 ש ש שמקדישה relativizer/subordinatingConjunction unspecified unspecified unspecified unspecified unspecified 0 
3 מקדישה הקדיש שמקדישה verb feminine singular unspecified any beinoni  	O	null
4 מקום מקום מקום noun masculine singular absolute unspecified unspecified  	O	null
5 מרכזי מרכזי מרכזי adjective masculine singular absolute unspecified unspecified  	O	null
6 ב ב ביצירתה preposition unspecified unspecified unspecified unspecified unspecified 0 
6 יצירת יצירה ביצירתה noun feminine singular absolute unspecified unspecified  
6 ה ה ביצירתה possessive feminine singular unspecified 3 unspecified 0 	O	null
7 ל ל להגות preposition unspecified unspecified unspecified unspecified unspecified 0 
7 הגות הגות להגות noun feminine singular absolute unspecified unspecified  	O	null
8 חברתית חברתי חברתית adjective feminine singular absolute unspecified unspecified  	O	null
9 ו ו וקיומית conjunction unspecified unspecified unspecified unspecified unspecified 0 
9 קיומית קיומי וקיומית adjective feminine singular absolute unspecified unspecified  	O	null
10 ו ו ולעיונים conjunction unspecified unspecified unspecified unspecified unspecified 0 
10 ל ל ולעיונים preposition unspecified unspecified unspecified unspecified unspecified 0 
10 עיונים עיון ולעיונים noun masculine plural absolute unspecified unspecified  	O	null
11 ארס ארס ארס noun masculine singular construct unspecified unspecified  	O	null
12 - - - punctuation unspecified unspecified unspecified unspecified unspecified  	O	null
13 פואטיים פואטיים פואטיים adjective masculine plural absolute unspecified unspecified  	O	null
14 . . . punctuation unspecified unspecified unspecified unspecified unspecified  	O	null

0 ו ו ואולם conjunction unspecified unspecified unspecified unspecified unspecified 0 
0 אולם אולם ואולם conjunction unspecified unspecified unspecified unspecified unspecified  	O	null
1 , , , punctuation unspecified unspecified unspecified unspecified unspecified  	O	null
2 ו ו וזה conjunction unspecified unspecified unspecified unspecified unspecified 0 
2 זה זה וזה pronoun masculine singular unspecified 3 unspecified  	O	null
3 מרכיב מרכיב מרכיב noun masculine singular absolute unspecified unspecified  	O	null
4 מהותי מהותי מהותי adjective masculine singular absolute unspecified unspecified  	O	null
5 ב ב בסוד preposition unspecified unspecified unspecified unspecified unspecified 0 
5 סוד סוד בסוד noun masculine singular construct unspecified unspecified  	O	null
6 עוצמת עוצמה עוצמתם noun feminine singular absolute unspecified unspecified  
6 ם ם עוצמתם possessive masculine plural unspecified 3 unspecified 0 	O	null
7 של של של shel-preposition unspecified unspecified unspecified unspecified unspecified  	O	null
8 סיפורי סיפור סיפוריה noun masculine plural absolute unspecified unspecified  
8 ה ה סיפוריה possessive feminine singular unspecified 3 unspecified 0 	O	null
9 , , , punctuation unspecified unspecified unspecified unspecified unspecified  	O	null
10 היא הוא היא pronoun feminine singular unspecified 3 unspecified  	O	null
11 אינה הוא אינה copula feminine singular unspecified 3 beinoni  	O	null
12 מוותרת ויתר מוותרת verb feminine singular unspecified any beinoni  	O	null
13 על על על preposition unspecified unspecified unspecified unspecified unspecified  	O	null
14 יצירת יצירה יצירת noun feminine singular construct unspecified unspecified  	O	null
15 מערכים מערך מערכים noun masculine plural absolute unspecified unspecified  	O	null
16 מורכבים מורכב מורכבים adjective masculine plural absolute unspecified unspecified  	O	null
17 של של של shel-preposition unspecified unspecified unspecified unspecified unspecified  	O	null
18 מתח מתח מתח noun masculine singular absolute unspecified unspecified  	O	null
19 ו ו וסקרנות conjunction unspecified unspecified unspecified unspecified unspecified 0 
19 סקרנות סקרנות וסקרנות noun feminine singular absolute unspecified unspecified  	O	null
20 . . . punctuation unspecified unspecified unspecified unspecified unspecified  	O	null

0 רוב רוב רוב noun masculine singular construct unspecified unspecified  	O	null
1 סיפורי סיפור סיפוריה noun masculine plural absolute unspecified unspecified  
1 ה ה סיפוריה possessive feminine singular unspecified 3 unspecified 0 	O	null
2 סובבים סבב סובבים verb masculine plural unspecified any beinoni  	O	null
3 סביב סביב סביב preposition unspecified unspecified unspecified unspecified unspecified  	O	null
4 ה ה הניסיון definiteArticle unspecified unspecified unspecified unspecified unspecified 0 
4 הניסיון ניסיון הניסיון noun masculine singular absolute unspecified unspecified  	O	null
5 לפענח פענח לפענח verb unspecified unspecified unspecified unspecified infinitive  	O	null
6 איזה איזה איזו interrogative unspecified unspecified unspecified unspecified unspecified  
6 ה ה איזו pronomial feminine singular unspecified 3 unspecified 0 	O	null
7 תעלומה תעלומה תעלומה noun feminine singular absolute unspecified unspecified  	O	null
8 , , , punctuation unspecified unspecified unspecified unspecified unspecified  	O	null
9 ש ש שפתרונה relativizer/subordinatingConjunction unspecified unspecified unspecified unspecified unspecified 0 
9 פתרון פתרון שפתרונה noun masculine singular absolute unspecified unspecified  
9 ה ה שפתרונה possessive feminine singular unspecified 3 unspecified 0 	O	null
10 קשור קשור קשור adjective masculine singular absolute unspecified unspecified  	O	null
11 תמיד תמיד תמיד adverb unspecified unspecified unspecified unspecified unspecified  	O	null
12 ב ב בסוגיות preposition unspecified unspecified unspecified unspecified unspecified 0 
12 סוגיות סוגיה בסוגיות noun feminine plural absolute unspecified unspecified  	O	null
13 מוסריות מוסרי מוסריות adjective feminine plural absolute unspecified unspecified  	O	null
14 מהותיות מהותי מהותיות adjective feminine plural absolute unspecified unspecified  	O	null
15 ו ו ובסוגיות conjunction unspecified unspecified unspecified unspecified unspecified 0 
15 ב ב ובסוגיות preposition unspecified unspecified unspecified unspecified unspecified 0 
15 סוגיות סוגיה ובסוגיות noun feminine plural absolute unspecified unspecified  	O	null
16 אידיאולוגיות אידיאולוגי אידיאולוגיות adjective feminine plural absolute unspecified unspecified  	O	null
17 ו ו ופוליטיות conjunction unspecified unspecified unspecified unspecified unspecified 0 
17 פוליטיות פוליטי ופוליטיות adjective feminine plural absolute unspecified unspecified  	O	null
18 . . . punctuation unspecified unspecified unspecified unspecified unspecified  	O	null

0 מרכיב מרכיב מרכיב noun masculine singular absolute unspecified unspecified  	O	null
1 חשוב חשוב חשוב adjective masculine singular absolute unspecified unspecified  	O	null
2 נוסף נוסף נוסף adjective masculine singular absolute unspecified unspecified  	O	null
3 , , , punctuation unspecified unspecified unspecified unspecified unspecified  	O	null
4 ה ה המעבה definiteArticle unspecified unspecified unspecified unspecified unspecified 0 
4 המעבה עיבה המעבה participle masculine singular absolute any unspecified  	O	null
5 את את את at-preposition unspecified unspecified unspecified unspecified unspecified  	O	null
6 כוח כוח כוח noun masculine singular construct unspecified unspecified  	O	null
7 ה ה המשיכה definiteArticle unspecified unspecified unspecified unspecified unspecified 0 
7 המשיכה משיכה המשיכה noun feminine singular absolute unspecified unspecified  	O	null
8 של של של shel-preposition unspecified unspecified unspecified unspecified unspecified  	O	null
9 ה ה הסיפורים definiteArticle unspecified unspecified unspecified unspecified unspecified 0 
9 הסיפורים סיפור הסיפורים noun masculine plural absolute unspecified unspecified  	O	null
10 , , , punctuation unspecified unspecified unspecified unspecified unspecified  	O	null
11 הוא הוא הוא pronoun masculine singular unspecified 3 unspecified  	O	null
12 קול קול קולה noun masculine singular absolute unspecified unspecified  
12 ה ה קולה possessive feminine singular unspecified 3 unspecified 0 	O	null
13 של של של shel-preposition unspecified unspecified unspecified unspecified unspecified  	O	null
14 ה ה הסופרת definiteArticle unspecified unspecified unspecified unspecified unspecified 0 
14 הסופרת סופר הסופרת noun feminine singular absolute unspecified unspecified  	O	null
15 , , , punctuation unspecified unspecified unspecified unspecified unspecified  	O	null
16 ה ה השומר definiteArticle unspecified unspecified unspecified unspecified unspecified 0 
16 השומר שומר השומר properName unspecified unspecified unspecified unspecified unspecified  	O	null
17 ב ב ברוב preposition unspecified unspecified unspecified unspecified unspecified 0 
17 רוב רוב ברוב noun masculine singular construct unspecified unspecified  	O	null
18 ה ה הגילומים definiteArticle unspecified unspecified unspecified unspecified unspecified 0 
18 הגילומים גילום הגילומים noun masculine plural absolute unspecified unspecified  	O	null
19 של של שלו shel-preposition unspecified unspecified unspecified unspecified unspecified  
19 ו ו שלו pronomial masculine singular unspecified 3 unspecified 0 	O	null
20 על על על preposition unspecified unspecified unspecified unspecified unspecified  	O	null
21 גוון גוון גוון noun masculine singular absolute unspecified unspecified  	O	null
22 צרוד צרוד צרוד adjective masculine singular absolute unspecified unspecified  	O	null
23 , , , punctuation unspecified unspecified unspecified unspecified unspecified  	O	null
24 אפלולי אפלולי אפלולי adjective masculine singular absolute unspecified unspecified  	O	null
25 ו ו וסקסי conjunction unspecified unspecified unspecified unspecified unspecified 0 
25 סקסי סקסי וסקסי adjective masculine singular absolute unspecified unspecified  	O	null
26 , , , punctuation unspecified unspecified unspecified unspecified unspecified  	O	null
27 ה ה העולה definiteArticle unspecified unspecified unspecified unspecified unspecified 0 
27 העולה עלה העולה participle masculine singular absolute any unspecified  	O	null
28 ב ב בקנה preposition unspecified unspecified unspecified unspecified unspecified 0 
28 קנה קנה בקנה noun masculine singular absolute unspecified unspecified  	O	null
29 אחד CARD1 אחד numeral masculine singular absolute unspecified unspecified  	O	null
30 עם עם עם preposition unspecified unspecified unspecified unspecified unspecified  	O	null
31 תיאורי תיאור תיאורי noun masculine plural construct unspecified unspecified  	O	null
32 מין מין מין noun masculine singular absolute unspecified unspecified  	O	null
33 " " " punctuation unspecified unspecified unspecified unspecified unspecified  	O	null
34 קשים קשה קשים adjective masculine plural absolute unspecified unspecified  	O	null
35 " " " punctuation unspecified unspecified unspecified unspecified unspecified  	O	null
36 ו ו ומשכנעים conjunction unspecified unspecified unspecified unspecified unspecified 0 
36 משכנעים שכנע ומשכנעים verb masculine plural unspecified any beinoni  	O	null
37 . . . punctuation unspecified unspecified unspecified unspecified unspecified  	O	null

0 References References References foreign unspecified unspecified unspecified unspecified unspecified  	O	null
1 : : : punctuation unspecified unspecified unspecified unspecified unspecified  	O	null
2 אדיבי אדיב אדיבי adjective masculine plural construct unspecified unspecified  	O	null
3 - - - punctuation unspecified unspecified unspecified unspecified unspecified  	O	null
4 שושן שושן שושן properName unspecified unspecified unspecified unspecified unspecified  	I_PERS	null
5 , , , punctuation unspecified unspecified unspecified unspecified unspecified  	O	null
6 אסתי אסתי אסתי properName unspecified unspecified unspecified unspecified unspecified  	I_PERS	null
7 . . . punctuation unspecified unspecified unspecified unspecified unspecified  	O	null

0 " " " punctuation unspecified unspecified unspecified unspecified unspecified  	O	null
1 שלג שלג שלג noun masculine singular absolute unspecified unspecified  	O	null
2 על על על preposition unspecified unspecified unspecified unspecified unspecified  	O	null
3 אבן אבן אבן properName unspecified unspecified unspecified unspecified unspecified  	I_LOC	null
4 יהודה יהודה יהודה properName unspecified unspecified unspecified unspecified unspecified  	I_LOC	null
5 " " " punctuation unspecified unspecified unspecified unspecified unspecified  	O	null
6 . . . punctuation unspecified unspecified unspecified unspecified unspecified  	O	null

0 עתון עיתון עתון noun masculine singular construct unspecified unspecified  	O	null
1 ###NUMBER### ###NUMBER### ###NUMBER### numeral unspecified unspecified unspecified unspecified unspecified  	O	null
2 ־ ־ ־ punctuation unspecified unspecified unspecified unspecified unspecified  	O	null
3 ###NUMBER### ###NUMBER### ###NUMBER### numeral unspecified unspecified unspecified unspecified unspecified  	O	null
4 . . . punctuation unspecified unspecified unspecified unspecified unspecified  	O	null

0 ###NUMBER### ###NUMBER### ###NUMBER### numeral unspecified unspecified unspecified unspecified unspecified  	I_DATE	null
1 . . . punctuation unspecified unspecified unspecified unspecified unspecified  	O	null

0 ־ ־ ־ punctuation unspecified unspecified unspecified unspecified unspecified  	O	null
1 ###NUMBER### ###NUMBER### ###NUMBER### numeral unspecified unspecified unspecified unspecified unspecified  	O	null
2 ; ; ; punctuation unspecified unspecified unspecified unspecified unspecified  	O	null
3 ###NUMBER### ###NUMBER### ###NUMBER### numeral unspecified unspecified unspecified unspecified unspecified  	O	null
4 מנדה נידה מנדה verb masculine singular unspecified any beinoni  	O	null
5 - - - punctuation unspecified unspecified unspecified unspecified unspecified  	O	null
6 לוי לוי לוי properName unspecified unspecified unspecified unspecified unspecified  	I_PERS	null
7 , , , punctuation unspecified unspecified unspecified unspecified unspecified  	O	null
8 עודד עודד עודד properName unspecified unspecified unspecified unspecified unspecified  	I_PERS	null
9 . . . punctuation unspecified unspecified unspecified unspecified unspecified  	O	null

0 " " " punctuation unspecified unspecified unspecified unspecified unspecified  	I_LOC	null
1 מעתקידמויותכתופעהבין-טקסטואלית–מקרהיונתן".צפון מעתקידמויותכתופעהבין-טקסטואלית–מקרהיונתן".צפון מעתקידמויותכתופעהבין-טקסטואלית–מקרהיונתן".צפון properName unspecified unspecified unspecified unspecified unspecified  	I_ORG	null
2 . . . punctuation unspecified unspecified unspecified unspecified unspecified  	O	null
3 ###NUMBER### ###NUMBER### ###NUMBER### numeral unspecified unspecified unspecified unspecified unspecified  	O	null
4 ###NUMBER### ###NUMBER### ###NUMBER### numeral unspecified unspecified unspecified unspecified unspecified  	I_DATE	null
5 . . . punctuation unspecified unspecified unspecified unspecified unspecified  	O	null

0 ־ ־ ־ punctuation unspecified unspecified unspecified unspecified unspecified  	I_LOC	null
1 261;סמיט 261;סמיט 261;סמיט properName unspecified unspecified unspecified unspecified unspecified  	I_PERS	null
2 , , , punctuation unspecified unspecified unspecified unspecified unspecified  	O	null
3 ###NUMBER### ###NUMBER### ###NUMBER### numeral unspecified unspecified unspecified unspecified unspecified  	O	null
4 ש ש שהם relativizer/subordinatingConjunction unspecified unspecified unspecified unspecified unspecified 0 
4 הם הוא שהם pronoun masculine plural unspecified 3 unspecified  	O	null
5 . . . punctuation unspecified unspecified unspecified unspecified unspecified  	O	null

0 " " " punctuation unspecified unspecified unspecified unspecified unspecified  	I_ORG	null
1 אנה אנה אנה properName unspecified unspecified unspecified unspecified unspecified  	I_PERS	null
2 איננינה איננינה איננינה properName unspecified unspecified unspecified unspecified unspecified  	I_PERS	null
3 " " " punctuation unspecified unspecified unspecified unspecified unspecified  	O	null
4 . . . punctuation unspecified unspecified unspecified unspecified unspecified  	O	null

0 ה ה הארץ definiteArticle unspecified unspecified unspecified unspecified unspecified 0 
0 הארץ ארץ הארץ noun feminine singular absolute unspecified unspecified  	O	null
1 ספרים ספר ספרים noun masculine plural absolute unspecified unspecified  	O	null
2 . . . punctuation unspecified unspecified unspecified unspecified unspecified  	O	null

0 . . . punctuation unspecified unspecified unspecified unspecified unspecified  	O	null
1 ###NUMEXP### ###NUMEXP### ###NUMEXP### numberExpression unspecified unspecified unspecified unspecified unspecified  	I_DATE	null
2 ###NUMBER### ###NUMBER### ###NUMBER### numeral unspecified unspecified unspecified unspecified unspecified  	I_LOC	null
3 . . . punctuation unspecified unspecified unspecified unspecified unspecified  	O	null

