0 Name Name Name foreign unspecified unspecified unspecified unspecified unspecified  	O	null
1 : : : punctuation unspecified unspecified unspecified unspecified unspecified  	O	null
2 יוכל יכול יוכל modal masculine singular unspecified 2 future  	O	null
3 - - - punctuation unspecified unspecified unspecified unspecified unspecified  	I_ORG	null
4 חיטין חיטין חיטין properName unspecified unspecified unspecified unspecified unspecified  	I_ORG	null
5 , , , punctuation unspecified unspecified unspecified unspecified unspecified  	O	null
6 רונית רונית רונית properName unspecified unspecified unspecified unspecified unspecified  	I_PERS	null
7 Birth Birth Birth foreign unspecified unspecified unspecified unspecified unspecified  	O	null
8 Year Year Year foreign unspecified unspecified unspecified unspecified unspecified  	O	null
9 : : : punctuation unspecified unspecified unspecified unspecified unspecified  	O	null
10 ###NUMBER### ###NUMBER### ###NUMBER### numeral unspecified unspecified unspecified unspecified unspecified  	I_DATE	null
11 Birth Birth Birth foreign unspecified unspecified unspecified unspecified unspecified  	O	null
12 Place Place Place foreign unspecified unspecified unspecified unspecified unspecified  	O	null
13 : : : punctuation unspecified unspecified unspecified unspecified unspecified  	O	null
14 גדלה גדל גדלה verb feminine singular unspecified 3 past  	I_LOC	null
15 ב ב בקיבוץ preposition unspecified unspecified unspecified unspecified unspecified 0 
15 קיבוץ קיבוץ בקיבוץ noun masculine singular construct unspecified unspecified  	I_LOC	null
16 עמיר עמיר עמיר properName unspecified unspecified unspecified unspecified unspecified  	I_LOC	null
17 Occupation Occupation Occupation foreign unspecified unspecified unspecified unspecified unspecified  	O	null
18 : : : punctuation unspecified unspecified unspecified unspecified unspecified  	O	null
19 משוררת משורר משוררת noun feminine singular absolute unspecified unspecified  	O	null
20 ו ו וסופרת conjunction unspecified unspecified unspecified unspecified unspecified 0 
20 סופרת סופר וסופרת noun feminine singular absolute unspecified unspecified  	O	null
21 Entry Entry Entry foreign unspecified unspecified unspecified unspecified unspecified  	O	null
22 writer writer writer foreign unspecified unspecified unspecified unspecified unspecified  	O	null
23 : : : punctuation unspecified unspecified unspecified unspecified unspecified  	O	null
24 רותם רותם רותם properName unspecified unspecified unspecified unspecified unspecified  	I_PERS	null
25 רז רז רז properName unspecified unspecified unspecified unspecified unspecified  	I_PERS	null
26 Entry Entry Entry foreign unspecified unspecified unspecified unspecified unspecified  	O	null
27 Value Value Value foreign unspecified unspecified unspecified unspecified unspecified  	O	null
28 : : : punctuation unspecified unspecified unspecified unspecified unspecified  	O	null
29 נולדה נולד נולדה verb feminine singular unspecified 3 past  	O	null
30 ו ו וגדלה conjunction unspecified unspecified unspecified unspecified unspecified 0 
30 גדלה גדל וגדלה verb feminine singular unspecified 3 past  	I_LOC	null
31 ב ב בקיבוץ preposition unspecified unspecified unspecified unspecified unspecified 0 
31 קיבוץ קיבוץ בקיבוץ noun masculine singular construct unspecified unspecified  	I_LOC	null
32 עמיר עמיר עמיר properName unspecified unspecified unspecified unspecified unspecified  	I_LOC	null
33 ש ש שבגליל relativizer/subordinatingConjunction unspecified unspecified unspecified unspecified unspecified 0 
33 ב ב שבגליל preposition unspecified unspecified unspecified unspecified unspecified 0 
33 ה ה שבגליל definiteArticle unspecified unspecified unspecified unspecified unspecified 0 
33 הגליל גליל שבגליל noun masculine singular absolute unspecified unspecified  	O	null
34 ה ה העליון definiteArticle unspecified unspecified unspecified unspecified unspecified 0 
34 העליון עליון העליון adjective masculine singular absolute unspecified unspecified  	O	null
35 . . . punctuation unspecified unspecified unspecified unspecified unspecified  	O	null

0 למדה למד למדה verb feminine singular unspecified 3 past  	O	null
1 ספרות ספרות ספרות noun feminine singular absolute unspecified unspecified  	O	null
2 עברית עברי עברית adjective feminine singular absolute unspecified unspecified  	O	null
3 ו ו ומקרא conjunction unspecified unspecified unspecified unspecified unspecified 0 
3 מקרא מקרא ומקרא noun masculine singular absolute unspecified unspecified  	O	null
4 ב ב באוניברסיטה preposition unspecified unspecified unspecified unspecified unspecified 0 
4 ה ה באוניברסיטה definiteArticle unspecified unspecified unspecified unspecified unspecified 0 
4 האוניברסיטה אוניברסיטה באוניברסיטה noun feminine singular absolute unspecified unspecified  	O	null
5 ה ה העברית definiteArticle unspecified unspecified unspecified unspecified unspecified 0 
5 העברית עברי העברית adjective feminine singular absolute unspecified unspecified  	O	null
6 ב ב בירושלים preposition unspecified unspecified unspecified unspecified unspecified 0 
6 ירושלים ירושלים בירושלים properName unspecified unspecified unspecified unspecified unspecified  	I_LOC	null
7 . . . punctuation unspecified unspecified unspecified unspecified unspecified  	O	null

0 במשך במשך במשך preposition unspecified unspecified unspecified unspecified unspecified  	O	null
1 שנים שנה שנים noun feminine plural absolute unspecified unspecified  	O	null
2 רבות רב רבות adjective feminine plural absolute unspecified unspecified  	O	null
3 שימשה שימש שימשה verb feminine singular unspecified 3 past  	O	null
4 כמורה כמורה כמורה noun feminine singular absolute unspecified unspecified  	O	null
5 ו ו והתמחתה conjunction unspecified unspecified unspecified unspecified unspecified 0 
5 התמחתה התמחה והתמחתה verb feminine singular unspecified 3 past  	O	null
6 ב ב באסטרטגיות preposition unspecified unspecified unspecified unspecified unspecified 0 
6 אסטרטגיות אסטרטגיה באסטרטגיות noun feminine plural absolute unspecified unspecified  	O	null
7 ל ל למידה preposition unspecified unspecified unspecified unspecified unspecified 0 
7 מידה מידה למידה noun feminine singular absolute unspecified unspecified  	O	null
8 ל ל לילדים preposition unspecified unspecified unspecified unspecified unspecified 0 
8 ילדים ילד לילדים noun masculine plural absolute unspecified unspecified  	O	null
9 עם עם עם preposition unspecified unspecified unspecified unspecified unspecified  	O	null
10 בעיות בעיה בעיות noun feminine plural absolute unspecified unspecified  	O	null
11 ל ל למידה preposition unspecified unspecified unspecified unspecified unspecified 0 
11 מידה מידה למידה noun feminine singular absolute unspecified unspecified  	O	null
12 . . . punctuation unspecified unspecified unspecified unspecified unspecified  	O	null

0 ב ב בעשר preposition unspecified unspecified unspecified unspecified unspecified 0 
0 עשר CARD10 בעשר numeral feminine singular absolute unspecified unspecified  	O	null
1 ה ה השנים definiteArticle unspecified unspecified unspecified unspecified unspecified 0 
1 השנים שנה השנים noun feminine plural absolute unspecified unspecified  	O	null
2 ה ה האחרונות definiteArticle unspecified unspecified unspecified unspecified unspecified 0 
2 האחרונות אחרון האחרונות adjective feminine plural absolute unspecified unspecified  	O	null
3 מלמדת לימד מלמדת verb feminine singular unspecified any beinoni  	O	null
4 כתיבה כתיבה כתיבה noun feminine singular absolute unspecified unspecified  	O	null
5 יוצרת יצר יוצרת verb feminine singular unspecified any beinoni  	O	null
6 ב ב בבית preposition unspecified unspecified unspecified unspecified unspecified 0 
6 בית בית בבית noun masculine singular construct unspecified unspecified  	O	null
7 ה ה הספר definiteArticle unspecified unspecified unspecified unspecified unspecified 0 
7 הספר ספר הספר noun masculine singular absolute unspecified unspecified  	O	null
8 ל ל ללימודי preposition unspecified unspecified unspecified unspecified unspecified 0 
8 לימודי לימוד ללימודי noun masculine plural construct unspecified unspecified  	O	null
9 חוץ חוץ חוץ noun masculine singular absolute unspecified unspecified  	O	null
10 ב ב באוניברסיטת preposition unspecified unspecified unspecified unspecified unspecified 0 
10 אוניברסיטת אוניברסיטה באוניברסיטת noun feminine singular construct unspecified unspecified  	I_ORG	null
11 בן בן בן properName unspecified unspecified unspecified unspecified unspecified  	I_ORG	null
12 - - - properName unspecified unspecified unspecified unspecified unspecified  	I_ORG	null
13 גוריון גוריון גוריון properName unspecified unspecified unspecified unspecified unspecified  	I_ORG	null
14 ב ב בנגב preposition unspecified unspecified unspecified unspecified unspecified 0 
14 ה ה בנגב definiteArticle unspecified unspecified unspecified unspecified unspecified 0 
14 הנגב נגב בנגב properName unspecified unspecified unspecified unspecified unspecified  	I_ORG	null
15 ו ו וכן conjunction unspecified unspecified unspecified unspecified unspecified 0 
15 כן כן וכן conjunction unspecified unspecified unspecified unspecified unspecified  	O	null
16 מנחה הנחה מנחה verb masculine singular unspecified any beinoni  	O	null
17 סדנאות סדנה סדנאות noun feminine plural absolute unspecified unspecified  	O	null
18 כתיבה כתיבה כתיבה noun feminine singular absolute unspecified unspecified  	O	null
19 ב ב בטכניקה preposition unspecified unspecified unspecified unspecified unspecified 0 
19 טכניקה טכניקה בטכניקה noun feminine singular absolute unspecified unspecified  	O	null
20 ייחודית ייחודי ייחודית adjective feminine singular absolute unspecified unspecified  	O	null
21 ש ש שפיתחה relativizer/subordinatingConjunction unspecified unspecified unspecified unspecified unspecified 0 
21 פיתחה פיתח שפיתחה verb feminine singular unspecified 3 past  	O	null
22 . . . punctuation unspecified unspecified unspecified unspecified unspecified  	O	null

0 שירי שיר שיריה noun masculine plural absolute unspecified unspecified  
0 ה ה שיריה possessive feminine singular unspecified 3 unspecified 0 	O	null
1 ה ה הראשונים definiteArticle unspecified unspecified unspecified unspecified unspecified 0 
1 הראשונים ORD1 הראשונים numeral masculine plural absolute unspecified unspecified  	I_DATE	null
2 ראו ראה ראו verb masculine-and-feminine plural unspecified 3 past  	O	null
3 אור אור אור noun masculine singular absolute unspecified unspecified  	O	null
4 ב ב ב preposition unspecified unspecified unspecified unspecified unspecified 0 	O	null
5 - - - punctuation unspecified unspecified unspecified unspecified unspecified  	O	null
6 ###NUMBER### ###NUMBER### ###NUMBER### numeral unspecified unspecified unspecified unspecified unspecified  	I_DATE	null
7 ב ב בהדים preposition unspecified unspecified unspecified unspecified unspecified 0 
7 הדים הד בהדים noun masculine plural absolute unspecified unspecified  	O	null
8 , , , punctuation unspecified unspecified unspecified unspecified unspecified  	O	null
9 ביטאון ביטאון ביטאון noun masculine singular construct unspecified unspecified  	O	null
10 ה ה הקיבוץ definiteArticle unspecified unspecified unspecified unspecified unspecified 0 
10 הקיבוץ קיבוץ הקיבוץ noun masculine singular absolute unspecified unspecified  	O	null
11 ה ה הארצי definiteArticle unspecified unspecified unspecified unspecified unspecified 0 
11 הארצי ארצי הארצי adjective masculine singular absolute unspecified unspecified  	O	null
12 . . . punctuation unspecified unspecified unspecified unspecified unspecified  	O	null

0 פירסמה פרסם פירסמה verb feminine singular unspecified 3 past  	O	null
1 שירים שיר שירים noun masculine plural absolute unspecified unspecified  	O	null
2 ב ב בעיתונים preposition unspecified unspecified unspecified unspecified unspecified 0 
2 ה ה בעיתונים definiteArticle unspecified unspecified unspecified unspecified unspecified 0 
2 העיתונים עיתון בעיתונים noun masculine plural absolute unspecified unspecified  	O	null
3 מעריב מעריב מעריב properName unspecified unspecified unspecified unspecified unspecified  	I_ORG	null
4 , , , punctuation unspecified unspecified unspecified unspecified unspecified  	O	null
5 דבר דבר דבר noun masculine singular absolute unspecified unspecified  	O	null
6 ו ו ועל conjunction unspecified unspecified unspecified unspecified unspecified 0 
6 על על ועל preposition unspecified unspecified unspecified unspecified unspecified  	O	null
7 ה ה המשמר definiteArticle unspecified unspecified unspecified unspecified unspecified 0 
7 המשמר משמר המשמר noun masculine singular absolute unspecified unspecified  	O	null
8 , , , punctuation unspecified unspecified unspecified unspecified unspecified  	O	null
9 ב ב בכתבי preposition unspecified unspecified unspecified unspecified unspecified 0 
9 כתבי כתב בכתבי noun masculine plural construct unspecified unspecified  	O	null
10 ה ה העת definiteArticle unspecified unspecified unspecified unspecified unspecified 0 
10 העת עת העת noun feminine singular absolute unspecified unspecified  	O	null
11 ל ל לספרות preposition unspecified unspecified unspecified unspecified unspecified 0 
11 ספרות ספרות לספרות noun feminine singular construct unspecified unspecified  	O	null
12 סימן סימן סימן noun masculine singular absolute unspecified unspecified  	O	null
13 קריאה קריאה קריאה noun feminine singular absolute unspecified unspecified  	O	null
14 ו ו ועלי conjunction unspecified unspecified unspecified unspecified unspecified 0 
14 על על ועלי preposition unspecified unspecified unspecified unspecified unspecified  
14 י י ועלי pronomial masculine-and-feminine singular unspecified 1 unspecified 0 	O	null
15 שיח שיח שיח noun masculine singular absolute unspecified unspecified  	O	null
16 ו ו ועוד conjunction unspecified unspecified unspecified unspecified unspecified 0 
16 עוד עוד ועוד adverb unspecified unspecified unspecified unspecified unspecified  	I_LOC	null
17 . . . punctuation unspecified unspecified unspecified unspecified unspecified  	O	null

0 פירסמה פרסם פירסמה verb feminine singular unspecified 3 past  	O	null
1 שלושה CARD3 שלושה numeral masculine plural absolute unspecified unspecified  	O	null
2 ספרי ספר ספרי noun masculine plural construct unspecified unspecified  	O	null
3 שירה שירה שירה noun feminine singular absolute unspecified unspecified  	O	null
4 . . . punctuation unspecified unspecified unspecified unspecified unspecified  	O	null

0 ה ה הראשון definiteArticle unspecified unspecified unspecified unspecified unspecified 0 
0 הראשון ORD1 הראשון numeral masculine singular absolute unspecified unspecified  	O	null
1 ב ב בהם preposition unspecified unspecified unspecified unspecified unspecified  
1 הם הם בהם pronomial masculine plural unspecified 3 unspecified 0 	O	null
2 , , , punctuation unspecified unspecified unspecified unspecified unspecified  	O	null
3 ה ה העשירית definiteArticle unspecified unspecified unspecified unspecified unspecified 0 
3 העשירית ORD10 העשירית numeral feminine singular absolute unspecified unspecified  	O	null
4 ב ב בצבע preposition unspecified unspecified unspecified unspecified unspecified 0 
4 צבע צבע בצבע noun masculine singular construct unspecified unspecified  	O	null
5 ה ה החרק definiteArticle unspecified unspecified unspecified unspecified unspecified 0 
5 החרק חרק החרק noun masculine singular absolute unspecified unspecified  	O	null
6 , , , punctuation unspecified unspecified unspecified unspecified unspecified  	O	null
7 ראה ראה ראה verb masculine singular unspecified 3 past  	O	null
8 אור אור אור noun masculine singular absolute unspecified unspecified  	O	null
9 ב ב ב preposition unspecified unspecified unspecified unspecified unspecified 0 	O	null
10 - - - punctuation unspecified unspecified unspecified unspecified unspecified  	O	null
11 ###NUMBER### ###NUMBER### ###NUMBER### numeral unspecified unspecified unspecified unspecified unspecified  	I_DATE	null
12 ב ב בקיבוץ preposition unspecified unspecified unspecified unspecified unspecified 0 
12 ה ה בקיבוץ definiteArticle unspecified unspecified unspecified unspecified unspecified 0 
12 הקיבוץ קיבוץ בקיבוץ noun masculine singular absolute unspecified unspecified  	O	null
13 ה ה המאוחד definiteArticle unspecified unspecified unspecified unspecified unspecified 0 
13 המאוחד מאוחד המאוחד adjective masculine singular absolute unspecified unspecified  	O	null
14 . . . punctuation unspecified unspecified unspecified unspecified unspecified  	O	null

0 ספרי ספר ספרי noun masculine plural construct unspecified unspecified  	O	null
1 שירה שירה שירה noun feminine singular absolute unspecified unspecified  	O	null
2 נוספים נוסף נוספים adjective masculine plural absolute unspecified unspecified  	O	null
3 פרי פרי פרי properName unspecified unspecified unspecified unspecified unspecified  	I_PERS	null
4 עטה עטה עטה verb masculine singular unspecified 3 past  	O	null
5 : : : punctuation unspecified unspecified unspecified unspecified unspecified  	O	null
6 מ מ משירי preposition unspecified unspecified unspecified unspecified unspecified 0 
6 שירי שיר משירי noun masculine plural construct unspecified unspecified  	O	null
7 ה ה האיש definiteArticle unspecified unspecified unspecified unspecified unspecified 0 
7 האיש איש האיש noun masculine singular absolute unspecified unspecified  	O	null
8 ה ה החי definiteArticle unspecified unspecified unspecified unspecified unspecified 0 
8 החי חי החי adjective masculine singular absolute unspecified unspecified  	O	null
9 ( ( ( punctuation unspecified unspecified unspecified unspecified unspecified  	O	null
10 ###NUMBER### ###NUMBER### ###NUMBER### numeral unspecified unspecified unspecified unspecified unspecified  	I_DATE	null
11 ) ) ) punctuation unspecified unspecified unspecified unspecified unspecified  	O	null
12 ו ו ובדרך conjunction unspecified unspecified unspecified unspecified unspecified 0 
12 ב ב ובדרך preposition unspecified unspecified unspecified unspecified unspecified 0 
12 דרך דרך ובדרך noun feminine singular absolute unspecified unspecified  	O	null
13 אל אל אליך preposition unspecified unspecified unspecified unspecified unspecified  
13 ך ך אליך pronomial masculine singular unspecified 2 unspecified 0 	O	null
14 רוברט רוברט רוברט properName unspecified unspecified unspecified unspecified unspecified  	I_PERS	null
15 : : : punctuation unspecified unspecified unspecified unspecified unspecified  	O	null
16 שירים שיר שירים noun masculine plural absolute unspecified unspecified  	O	null
17 ) ) ) punctuation unspecified unspecified unspecified unspecified unspecified  	O	null
18 . . . punctuation unspecified unspecified unspecified unspecified unspecified  	O	null
19 ###NUMBER### ###NUMBER### ###NUMBER### numeral unspecified unspecified unspecified unspecified unspecified  	I_DATE	null
20 ספרי ספר ספרי noun masculine plural construct unspecified unspecified  	O	null
21 ה ה הפרוזה definiteArticle unspecified unspecified unspecified unspecified unspecified 0 
21 הפרוזה פרוזה הפרוזה noun feminine singular absolute unspecified unspecified  	O	null
22 של של שלה shel-preposition unspecified unspecified unspecified unspecified unspecified  
22 ה ה שלה pronomial feminine singular unspecified 3 unspecified 0 	O	null
23 הם הוא הם pronoun masculine plural unspecified 3 unspecified  	O	null
24 בעלי בעל בעלי noun masculine plural construct unspecified unspecified  	O	null
25 גוון גוון גוון noun masculine singular absolute unspecified unspecified  	O	null
26 שירי שירי שירי adjective masculine singular absolute unspecified unspecified  	O	null
27 מובהק מובהק מובהק adjective masculine singular absolute unspecified unspecified  	O	null
28 . . . punctuation unspecified unspecified unspecified unspecified unspecified  	O	null

0 ספר ספר ספר noun masculine singular construct unspecified unspecified  	O	null
1 מבחר מבחר מבחר quantifier unspecified unspecified construct unspecified unspecified  	O	null
2 ה ה המראות definiteArticle unspecified unspecified unspecified unspecified unspecified 0 
2 המראות מראה המראות noun masculine plural absolute unspecified unspecified  	O	null
3 ( ( ( punctuation unspecified unspecified unspecified unspecified unspecified  	O	null
4 ###NUMBER### ###NUMBER### ###NUMBER### numeral unspecified unspecified unspecified unspecified unspecified  	I_DATE	null
5 ) ) ) punctuation unspecified unspecified unspecified unspecified unspecified  	O	null
6 הוא הוא הוא pronoun masculine singular unspecified 3 unspecified  	O	null
7 ספר ספר ספר noun masculine singular construct unspecified unspecified  	O	null
8 מסע מסע מסע noun masculine singular absolute unspecified unspecified  	O	null
9 פיוטי פיוטי פיוטי adjective masculine singular absolute unspecified unspecified  	O	null
10 ש ש ששורה relativizer/subordinatingConjunction unspecified unspecified unspecified unspecified unspecified 0 
10 שורה שורה ששורה noun feminine singular absolute unspecified unspecified  	O	null
11 על על עליו preposition unspecified unspecified unspecified unspecified unspecified  
11 ו ו עליו pronomial masculine singular unspecified 3 unspecified 0 	O	null
12 אווירת אווירה אווירת noun feminine singular construct unspecified unspecified  	O	null
13 הזיה הזיה הזיה noun feminine singular absolute unspecified unspecified  	O	null
14 קסומה קסום קסומה adjective feminine singular absolute unspecified unspecified  	O	null
15 . . . punctuation unspecified unspecified unspecified unspecified unspecified  	O	null

0 זהו זהו זהו pronoun masculine singular unspecified 3 unspecified  	O	null
1 ספר ספר ספר noun masculine singular absolute unspecified unspecified  	O	null
2 מסע מסע מסע noun masculine singular absolute unspecified unspecified  	O	null
3 חיצוני חיצוני חיצוני adjective masculine singular absolute unspecified unspecified  	O	null
4 ו ו ופנימי conjunction unspecified unspecified unspecified unspecified unspecified 0 
4 פנימי פנימי ופנימי adjective masculine singular absolute unspecified unspecified  	O	null
5 : : : punctuation unspecified unspecified unspecified unspecified unspecified  	O	null
6 מסע מסע מסען noun masculine singular absolute unspecified unspecified  
6 ן ן מסען possessive feminine plural unspecified 3 unspecified 0 	O	null
7 של של של shel-preposition unspecified unspecified unspecified unspecified unspecified  	O	null
8 שתי CARD2 שתי numeral feminine dual construct unspecified unspecified  	O	null
9 דמויות דמות דמויות noun feminine plural absolute unspecified unspecified  	O	null
10 יוצרים יוצר יוצרים noun masculine plural absolute unspecified unspecified  	O	null
11 ה ה העוברות definiteArticle unspecified unspecified unspecified unspecified unspecified 0 
11 העוברות עבר העוברות participle feminine plural absolute any unspecified  	O	null
12 דרך דרך דרך noun feminine singular construct unspecified unspecified  	O	null
13 תחנות תחנה תחנות noun feminine plural absolute unspecified unspecified  	O	null
14 שונות שונה שונות adjective feminine plural absolute unspecified unspecified  	O	null
15 , , , punctuation unspecified unspecified unspecified unspecified unspecified  	O	null
16 ב ב בניסיון preposition unspecified unspecified unspecified unspecified unspecified 0 
16 ניסיון ניסיון בניסיון noun masculine singular absolute unspecified unspecified  	O	null
17 להגיע הגיע להגיע verb unspecified unspecified unspecified unspecified infinitive  	O	null
18 אל אל אל preposition unspecified unspecified unspecified unspecified unspecified  	O	null
19 מהות מהות מהות noun feminine singular construct unspecified unspecified  	O	null
20 ה ה האמת definiteArticle unspecified unspecified unspecified unspecified unspecified 0 
20 האמת אמת האמת noun feminine singular absolute unspecified unspecified  	O	null
21 ו ו ולהגדיר conjunction unspecified unspecified unspecified unspecified unspecified 0 
21 להגדיר הגדיר ולהגדיר verb unspecified unspecified unspecified unspecified infinitive  	O	null
22 את את אותה at-preposition unspecified unspecified unspecified unspecified unspecified  
22 ה ה אותה pronomial feminine singular unspecified 3 unspecified 0 	O	null
23 ב ב במילים preposition unspecified unspecified unspecified unspecified unspecified 0 
23 מילים מילה במילים noun feminine plural absolute unspecified unspecified  	O	null
24 . . . punctuation unspecified unspecified unspecified unspecified unspecified  	O	null

0 ספר ספר ספר noun masculine singular construct unspecified unspecified  	O	null
1 ה ה הפרוזה definiteArticle unspecified unspecified unspecified unspecified unspecified 0 
1 הפרוזה פרוזה הפרוזה noun feminine singular absolute unspecified unspecified  	O	null
2 ה ה השני definiteArticle unspecified unspecified unspecified unspecified unspecified 0 
2 השני ORD2 השני numeral masculine singular absolute unspecified unspecified  	O	null
3 של של שלה shel-preposition unspecified unspecified unspecified unspecified unspecified  
3 ה ה שלה pronomial feminine singular unspecified 3 unspecified 0 	O	null
4 , , , punctuation unspecified unspecified unspecified unspecified unspecified  	O	null
5 מכתבי מכתב מכתבי noun masculine plural construct unspecified unspecified  	O	null
6 אהבה אהבה אהבה noun feminine singular absolute unspecified unspecified  	O	null
7 ל ל לפסיכיאטר preposition unspecified unspecified unspecified unspecified unspecified 0 
7 ה ה לפסיכיאטר definiteArticle unspecified unspecified unspecified unspecified unspecified 0 
7 הפסיכיאטר פסיכיאטר לפסיכיאטר noun masculine singular absolute unspecified unspecified  	O	null
8 : : : punctuation unspecified unspecified unspecified unspecified unspecified  	O	null
9 רוצה רצה רוצה verb masculine singular unspecified any beinoni  	O	null
10 ל ל לגעת preposition unspecified unspecified unspecified unspecified unspecified 0 
10 געת געת לגעת noun feminine singular construct unspecified unspecified  	O	null
11 ב ב בך preposition unspecified unspecified unspecified unspecified unspecified  
11 ך ך בך pronomial masculine singular unspecified 2 unspecified 0 	O	null
12 ) ) ) punctuation unspecified unspecified unspecified unspecified unspecified  	O	null
13 , , , punctuation unspecified unspecified unspecified unspecified unspecified  	O	null
14 ב ב בנוי preposition unspecified unspecified unspecified unspecified unspecified 0 
14 נוי נוי בנוי noun masculine singular absolute unspecified unspecified  	O	null
15 ###NUMBER### ###NUMBER### ###NUMBER### numeral unspecified unspecified unspecified unspecified unspecified  	I_DATE	null
16 מ מ מאוסף preposition unspecified unspecified unspecified unspecified unspecified 0 
16 אוסף אוסף מאוסף noun masculine singular construct unspecified unspecified  	O	null
17 מכתבים מכתב מכתבים noun masculine plural absolute unspecified unspecified  	O	null
18 ש ש שכותבת relativizer/subordinatingConjunction unspecified unspecified unspecified unspecified unspecified 0 
18 כותבת כתב שכותבת verb feminine singular unspecified any beinoni  	O	null
19 אישה איש אישה noun feminine singular absolute unspecified unspecified  	O	null
20 ל ל לשלושת preposition unspecified unspecified unspecified unspecified unspecified 0 
20 שלושת CARD3 לשלושת numeral masculine plural construct unspecified unspecified  	O	null
21 ה ה הגברים definiteArticle unspecified unspecified unspecified unspecified unspecified 0 
21 הגברים גבר הגברים noun masculine plural absolute unspecified unspecified  	O	null
22 ה ה המשמעותיים definiteArticle unspecified unspecified unspecified unspecified unspecified 0 
22 המשמעותיים משמעותי המשמעותיים adjective masculine plural absolute unspecified unspecified  	O	null
23 ב ב בחייה preposition unspecified unspecified unspecified unspecified unspecified 0 
23 חיי חיים בחייה noun masculine plural absolute unspecified unspecified  
23 ה ה בחייה possessive feminine singular unspecified 3 unspecified 0 	O	null
24 , , , punctuation unspecified unspecified unspecified unspecified unspecified  	O	null
25 ש ש שאחד relativizer/subordinatingConjunction unspecified unspecified unspecified unspecified unspecified 0 
25 אחד CARD1 שאחד numeral masculine singular absolute unspecified unspecified  	O	null
26 מה מה מהם interrogative unspecified unspecified unspecified unspecified unspecified  
26 הם הם מהם pronomial masculine plural unspecified 3 unspecified 0 	O	null
27 היה הוא היה copula masculine singular unspecified 3 past  	O	null
28 ה ה הפסיכיאטר definiteArticle unspecified unspecified unspecified unspecified unspecified 0 
28 הפסיכיאטר פסיכיאטר הפסיכיאטר noun masculine singular absolute unspecified unspecified  	O	null
29 של של שלה shel-preposition unspecified unspecified unspecified unspecified unspecified  
29 ה ה שלה pronomial feminine singular unspecified 3 unspecified 0 	O	null
30 . . . punctuation unspecified unspecified unspecified unspecified unspecified  	O	null

0 ה ה המכתבים definiteArticle unspecified unspecified unspecified unspecified unspecified 0 
0 המכתבים מכתב המכתבים noun masculine plural absolute unspecified unspecified  	O	null
1 הללו הללו הללו pronoun masculine plural unspecified 3 unspecified  	O	null
2 , , , punctuation unspecified unspecified unspecified unspecified unspecified  	O	null
3 ה ה הכתובים definiteArticle unspecified unspecified unspecified unspecified unspecified 0 
3 הכתובים כתב הכתובים participle masculine plural absolute any unspecified  	O	null
4 ב ב בשפה preposition unspecified unspecified unspecified unspecified unspecified 0 
4 שפה שפה בשפה noun feminine singular absolute unspecified unspecified  	O	null
5 פיגורטיבית פיגורטיבית פיגורטיבית adjective feminine singular absolute unspecified unspecified  	O	null
6 , , , punctuation unspecified unspecified unspecified unspecified unspecified  	O	null
7 עשירה עשיר עשירה adjective feminine singular absolute unspecified unspecified  	O	null
8 ו ו ודחוסה conjunction unspecified unspecified unspecified unspecified unspecified 0 
8 דחוסה דחוס ודחוסה adjective feminine singular absolute unspecified unspecified  	O	null
9 , , , punctuation unspecified unspecified unspecified unspecified unspecified  	O	null
10 מגלמים גילם מגלמים verb masculine plural unspecified any beinoni  	O	null
11 מסע מסע מסע noun masculine singular construct unspecified unspecified  	O	null
12 חיפוש חיפוש חיפוש noun masculine singular absolute unspecified unspecified  	O	null
13 כואב כואב כואב adjective masculine singular absolute unspecified unspecified  	O	null
14 של של של shel-preposition unspecified unspecified unspecified unspecified unspecified  	O	null
15 ה ה הגיבורה definiteArticle unspecified unspecified unspecified unspecified unspecified 0 
15 הגיבורה גיבור הגיבורה noun feminine singular absolute unspecified unspecified  	O	null
16 אחר אחר אחר preposition unspecified unspecified unspecified unspecified unspecified  	O	null
17 מילים מילה מילים noun feminine plural absolute unspecified unspecified  	O	null
18 ש ש שיעניקו relativizer/subordinatingConjunction unspecified unspecified unspecified unspecified unspecified 0 
18 יעניקו העניק שיעניקו verb masculine-and-feminine plural unspecified 3 future  	O	null
19 מסגרת מסגרת מסגרת noun feminine singular absolute unspecified unspecified  	O	null
20 ו ו ומשמעות conjunction unspecified unspecified unspecified unspecified unspecified 0 
20 משמעות משמעות ומשמעות noun feminine singular absolute unspecified unspecified  	O	null
21 ל ל לחוויית preposition unspecified unspecified unspecified unspecified unspecified 0 
21 חוויית חוויה לחוויית noun feminine singular construct unspecified unspecified  	O	null
22 ה ה הקיום definiteArticle unspecified unspecified unspecified unspecified unspecified 0 
22 הקיום קיום הקיום noun masculine singular absolute unspecified unspecified  	O	null
23 ה ה הכאוטית definiteArticle unspecified unspecified unspecified unspecified unspecified 0 
23 הכאוטית הכאוטית הכאוטית adjective feminine singular absolute unspecified unspecified  	O	null
24 שבה שב שבה verb feminine singular unspecified 3 past  	O	null
25 היא הוא היא pronoun feminine singular unspecified 3 unspecified  	O	null
26 שרויה שרוי שרויה adjective feminine singular absolute unspecified unspecified  	O	null
27 . . . punctuation unspecified unspecified unspecified unspecified unspecified  	O	null

0 ב ב ברשימתהשהתפרסמה preposition unspecified unspecified unspecified unspecified unspecified 0 
0 רשימתהשהתפרסמה רשימתהשהתפרסמה ברשימתהשהתפרסמה adjective feminine singular construct unspecified unspecified  	O	null
1 ב ב בהארץ preposition unspecified unspecified unspecified unspecified unspecified 0 
1 ה ה בהארץ definiteArticle unspecified unspecified unspecified unspecified unspecified 0 
1 ההארץ ארץ בהארץ noun feminine singular absolute unspecified unspecified  	O	null
2 כתבה כתב כתבה verb feminine singular unspecified 3 past  	O	null
3 קרן קרן קרן noun feminine singular construct unspecified unspecified  	O	null
4 פייט פייט פייט verb masculine singular unspecified 2 imperative  	O	null
5 ) ) ) punctuation unspecified unspecified unspecified unspecified unspecified  	O	null
6 : : : punctuation unspecified unspecified unspecified unspecified unspecified  	O	null
7 ###NUMBER### ###NUMBER### ###NUMBER### numeral unspecified unspecified unspecified unspecified unspecified  	I_DATE	null
8 " " " punctuation unspecified unspecified unspecified unspecified unspecified  	O	null
9 אל אל אל preposition unspecified unspecified unspecified unspecified unspecified  	O	null
10 תיקחו לקח תיקחו verb masculine-and-feminine plural unspecified 2 future  	O	null
11 את את את at-preposition unspecified unspecified unspecified unspecified unspecified  	O	null
12 ה ה הספר definiteArticle unspecified unspecified unspecified unspecified unspecified 0 
12 הספר ספר הספר noun masculine singular absolute unspecified unspecified  	O	null
13 ה ה הזה definiteArticle unspecified unspecified unspecified unspecified unspecified 0 
13 הזה זה הזה pronoun masculine singular unspecified 3 unspecified  	O	null
14 ל ל לטיסה preposition unspecified unspecified unspecified unspecified unspecified 0 
14 ה ה לטיסה definiteArticle unspecified unspecified unspecified unspecified unspecified 0 
14 הטיסה טיסה לטיסה noun feminine singular absolute unspecified unspecified  	O	null
15 . . . punctuation unspecified unspecified unspecified unspecified unspecified  	O	null

0 קחו לקח קחו verb masculine-and-feminine plural unspecified 2 imperative  	O	null
1 את את אותו at-preposition unspecified unspecified unspecified unspecified unspecified  
1 ו ו אותו pronomial masculine singular unspecified 3 unspecified 0 	O	null
2 ל ל למקום preposition unspecified unspecified unspecified unspecified unspecified 0 
2 מקום מקום למקום noun masculine singular absolute unspecified unspecified  	O	null
3 שבו ישב שבו verb masculine-and-feminine plural unspecified 2 imperative  	O	null
4 יש יש יש existential unspecified unspecified unspecified unspecified unspecified  	O	null
5 ל ל לכם preposition unspecified unspecified unspecified unspecified unspecified  
5 כם כם לכם pronomial masculine plural unspecified 2 unspecified 0 	O	null
6 מרחב מרחב מרחב noun masculine singular absolute unspecified unspecified  	O	null
7 ו ו וזמן conjunction unspecified unspecified unspecified unspecified unspecified 0 
7 זמן זמן וזמן noun masculine singular absolute unspecified unspecified  	O	null
8 להתמסר התמסר להתמסר verb unspecified unspecified unspecified unspecified infinitive  	O	null
9 ל ל לעושר preposition unspecified unspecified unspecified unspecified unspecified 0 
9 ה ה לעושר definiteArticle unspecified unspecified unspecified unspecified unspecified 0 
9 העושר עושר לעושר noun masculine singular absolute unspecified unspecified  	O	null
10 ה ה הלשוני definiteArticle unspecified unspecified unspecified unspecified unspecified 0 
10 הלשוני לשוני הלשוני adjective masculine singular absolute unspecified unspecified  	O	null
11 , , , punctuation unspecified unspecified unspecified unspecified unspecified  	O	null
12 ל ל לריבוי preposition unspecified unspecified unspecified unspecified unspecified 0 
12 ריבוי ריבוי לריבוי noun masculine singular construct unspecified unspecified  	O	null
13 ה ה האלוזיות definiteArticle unspecified unspecified unspecified unspecified unspecified 0 
13 האלוזיות אלוזיה האלוזיות noun feminine plural absolute unspecified unspecified  	O	null
14 ה ה הספרותיות definiteArticle unspecified unspecified unspecified unspecified unspecified 0 
14 הספרותיות ספרותי הספרותיות adjective feminine plural absolute unspecified unspecified  	O	null
15 ו ו והמקראיות conjunction unspecified unspecified unspecified unspecified unspecified 0 
15 ה ה והמקראיות definiteArticle unspecified unspecified unspecified unspecified unspecified 0 
15 המקראיות מקראי והמקראיות adjective feminine plural absolute unspecified unspecified  	O	null
16 , , , punctuation unspecified unspecified unspecified unspecified unspecified  	O	null
17 ו ו ולמורכבות conjunction unspecified unspecified unspecified unspecified unspecified 0 
17 ל ל ולמורכבות preposition unspecified unspecified unspecified unspecified unspecified 0 
17 ה ה ולמורכבות definiteArticle unspecified unspecified unspecified unspecified unspecified 0 
17 המורכבות מורכבות ולמורכבות noun feminine singular absolute unspecified unspecified  	O	null
18 ה ה הרגשית definiteArticle unspecified unspecified unspecified unspecified unspecified 0 
18 הרגשית רגשי הרגשית adjective feminine singular absolute unspecified unspecified  	O	null
19 ש ש שהוא relativizer/subordinatingConjunction unspecified unspecified unspecified unspecified unspecified 0 
19 הוא הוא שהוא pronoun masculine singular unspecified 3 unspecified  	O	null
20 מביא הביא מביא verb masculine singular unspecified any beinoni  	O	null
21 . . . punctuation unspecified unspecified unspecified unspecified unspecified  	O	null

0 שחררו שחרר שחררו verb masculine-and-feminine plural unspecified 3 past  	O	null
1 עצמו עצמו עצמכם pronoun unspecified unspecified unspecified unspecified unspecified  
1 כם כם עצמכם pronomial masculine plural unspecified 2 unspecified 0 	O	null
2 מ מ מהצורך preposition unspecified unspecified unspecified unspecified unspecified 0 
2 ה ה מהצורך definiteArticle unspecified unspecified unspecified unspecified unspecified 0 
2 הצורך צורך מהצורך noun masculine singular absolute unspecified unspecified  	O	null
3 לקרוא קרא לקרוא verb unspecified unspecified unspecified unspecified infinitive  	O	null
4 את את אותו at-preposition unspecified unspecified unspecified unspecified unspecified  
4 ו ו אותו pronomial masculine singular unspecified 3 unspecified 0 	O	null
5 ב ב בשמרנות preposition unspecified unspecified unspecified unspecified unspecified 0 
5 שמרנות שמרנות בשמרנות noun feminine singular absolute unspecified unspecified  	O	null
6 מ מ מתחילתו preposition unspecified unspecified unspecified unspecified unspecified 0 
6 תחילת תחילה מתחילתו noun feminine singular absolute unspecified unspecified  
6 ו ו מתחילתו possessive masculine singular unspecified 3 unspecified 0 	O	null
7 ו ו ועד conjunction unspecified unspecified unspecified unspecified unspecified 0 
7 עד עד ועד preposition unspecified unspecified unspecified unspecified unspecified  	O	null
8 סוף סוף סופו noun masculine singular absolute unspecified unspecified  
8 ו ו סופו possessive masculine singular unspecified 3 unspecified 0 	O	null
9 , , , punctuation unspecified unspecified unspecified unspecified unspecified  	O	null
10 ו ו והרשו conjunction unspecified unspecified unspecified unspecified unspecified 0 
10 הרשו הרשה והרשו verb masculine-and-feminine plural unspecified 3 past  	O	null
11 ל ל לעצמכם preposition unspecified unspecified unspecified unspecified unspecified 0 
11 עצמו עצמו לעצמכם pronoun unspecified unspecified unspecified unspecified unspecified  
11 כם כם לעצמכם pronomial masculine plural unspecified 2 unspecified 0 	O	null
12 לגלות גלה לגלות verb unspecified unspecified unspecified unspecified infinitive  	O	null
13 לאט לאט לאט adverb unspecified unspecified unspecified unspecified unspecified  	O	null
14 את את את at-preposition unspecified unspecified unspecified unspecified unspecified  	O	null
15 ה ה השירה definiteArticle unspecified unspecified unspecified unspecified unspecified 0 
15 השירה שירה השירה noun feminine singular absolute unspecified unspecified  	O	null
16 ה ה הטמונה definiteArticle unspecified unspecified unspecified unspecified unspecified 0 
16 הטמונה טמון הטמונה adjective feminine singular absolute unspecified unspecified  	O	null
17 בתוך בתוך בתוך preposition unspecified unspecified unspecified unspecified unspecified  	O	null
18 ה ה הפרוזה definiteArticle unspecified unspecified unspecified unspecified unspecified 0 
18 הפרוזה פרוזה הפרוזה noun feminine singular absolute unspecified unspecified  	O	null
19 של של של shel-preposition unspecified unspecified unspecified unspecified unspecified  	O	null
20 ה ה המכתבים definiteArticle unspecified unspecified unspecified unspecified unspecified 0 
20 המכתבים מכתב המכתבים noun masculine plural absolute unspecified unspecified  	O	null
21 . . . punctuation unspecified unspecified unspecified unspecified unspecified  	O	null

0       punctuation unspecified unspecified unspecified unspecified unspecified  	O	null
1 מי מי מי interrogative unspecified unspecified unspecified unspecified unspecified  	O	null
2 ש ש שיעז relativizer/subordinatingConjunction unspecified unspecified unspecified unspecified unspecified 0 
2 יעז העז שיעז verb masculine singular unspecified 3 future  	O	null
3 ו ו ויצא conjunction unspecified unspecified unspecified unspecified unspecified 0 
3 יצא יצא ויצא verb masculine singular unspecified 3 past  	O	null
4 אל אל אל preposition unspecified unspecified unspecified unspecified unspecified  	O	null
5 ה ה המסע definiteArticle unspecified unspecified unspecified unspecified unspecified 0 
5 המסע מסע המסע noun masculine singular absolute unspecified unspecified  	O	null
6 ייכנס נכנס ייכנס verb masculine singular unspecified 3 future  	O	null
7 אל אל אל preposition unspecified unspecified unspecified unspecified unspecified  	O	null
8 תוך תוך תוך noun masculine singular construct unspecified unspecified  	O	null
9 ארץ ארץ ארץ noun feminine singular construct unspecified unspecified  	O	null
10 פלאות פלא פלאות noun masculine plural absolute unspecified unspecified  	O	null
11 של של של shel-preposition unspecified unspecified unspecified unspecified unspecified  	O	null
12 מכאובים מכאוב מכאובים noun masculine plural absolute unspecified unspecified  	O	null
13 ו ו ועינוגים conjunction unspecified unspecified unspecified unspecified unspecified 0 
13 עינוגים עינוג ועינוגים noun masculine plural absolute unspecified unspecified  	O	null
14 , , , punctuation unspecified unspecified unspecified unspecified unspecified  	O	null
15 אל אל אל preposition unspecified unspecified unspecified unspecified unspecified  	O	null
16 דרכים דרך דרכים noun feminine plural absolute unspecified unspecified  	O	null
17 של של של shel-preposition unspecified unspecified unspecified unspecified unspecified  	O	null
18 הנאה הנאה הנאה noun feminine singular absolute unspecified unspecified  	O	null
19 חושנית חושני חושנית adjective feminine singular absolute unspecified unspecified  	O	null
20 מ מ ממילים preposition unspecified unspecified unspecified unspecified unspecified 0 
20 מילים מילה ממילים noun feminine plural absolute unspecified unspecified  	O	null
21 ה ה החושפות definiteArticle unspecified unspecified unspecified unspecified unspecified 0 
21 החושפות חשף החושפות participle feminine plural absolute any unspecified  	O	null
22 בפני בפני בפני preposition unspecified unspecified unspecified unspecified unspecified  	O	null
23 ה ה ההולך definiteArticle unspecified unspecified unspecified unspecified unspecified 0 
23 ההולך הלך ההולך participle masculine singular absolute any unspecified  	O	null
24 ב ב בהן preposition unspecified unspecified unspecified unspecified unspecified 0 
24 הן הוא בהן pronoun feminine plural unspecified 3 unspecified  	O	null
25 את את את at-preposition unspecified unspecified unspecified unspecified unspecified  	O	null
26 מראות מראה מראות noun masculine plural construct unspecified unspecified  	O	null
27 ה ה היצירה definiteArticle unspecified unspecified unspecified unspecified unspecified 0 
27 היצירה יצירה היצירה noun feminine singular absolute unspecified unspecified  	O	null
28 ו ו ומוראותיה conjunction unspecified unspecified unspecified unspecified unspecified 0 
28 מוראותיה מוראותיה ומוראותיה noun feminine singular absolute unspecified unspecified  	O	null
29 " " " punctuation unspecified unspecified unspecified unspecified unspecified  	O	null
30 . . . punctuation unspecified unspecified unspecified unspecified unspecified  	O	null

0 References References References foreign unspecified unspecified unspecified unspecified unspecified  	O	null
1 : : : punctuation unspecified unspecified unspecified unspecified unspecified  	O	null
2 פייט פייט פייט verb masculine singular unspecified 3 past  	O	null
3 , , , punctuation unspecified unspecified unspecified unspecified unspecified  	O	null
4 קרן קרן קרן verb masculine singular unspecified 3 past  	O	null
5 . . . punctuation unspecified unspecified unspecified unspecified unspecified  	O	null

0 " " " punctuation unspecified unspecified unspecified unspecified unspecified  	O	null
1 אצבעות אצבע אצבעות noun feminine plural absolute unspecified unspecified  	O	null
2 אישה איש אישה noun feminine singular absolute unspecified unspecified  	O	null
3 שורטות שרט שורטות verb feminine plural unspecified any beinoni  	O	null
4 בלחייה בלחייה בלחייה properName unspecified unspecified unspecified unspecified unspecified  	O	null
5 אותיות אות אותיות noun feminine plural absolute unspecified unspecified  	O	null
6 של של של shel-preposition unspecified unspecified unspecified unspecified unspecified  	O	null
7 זמר זמר זמר noun masculine singular absolute unspecified unspecified  	O	null
8 " " " punctuation unspecified unspecified unspecified unspecified unspecified  	O	null
9 . . . punctuation unspecified unspecified unspecified unspecified unspecified  	O	null

0 ה ה הארץ definiteArticle unspecified unspecified unspecified unspecified unspecified 0 
0 הארץ ארץ הארץ noun feminine singular absolute unspecified unspecified  	O	null
1 ספרים ספר ספרים noun masculine plural absolute unspecified unspecified  	O	null
2 . . . punctuation unspecified unspecified unspecified unspecified unspecified  	O	null

0 ###NUMEXP### ###NUMEXP### ###NUMEXP### numberExpression unspecified unspecified unspecified unspecified unspecified  	I_DATE	null
1 . . . punctuation unspecified unspecified unspecified unspecified unspecified  	O	null

0 ###NUMBER### ###NUMBER### ###NUMBER### numeral unspecified unspecified unspecified unspecified unspecified  	O	null
1 . . . punctuation unspecified unspecified unspecified unspecified unspecified  	O	null

