0 Name Name Name foreign unspecified unspecified unspecified unspecified unspecified  	O	null
1 : : : punctuation unspecified unspecified unspecified unspecified unspecified  	O	null
2 כ כ כגן preposition unspecified unspecified unspecified unspecified unspecified 0 
2 גן גן כגן noun masculine singular absolute unspecified unspecified  	O	null
3 , , , punctuation unspecified unspecified unspecified unspecified unspecified  	O	null
4 צפורה צפורה צפורה properName unspecified unspecified unspecified unspecified unspecified  	I_PERS	null
5 Birth Birth Birth foreign unspecified unspecified unspecified unspecified unspecified  	O	null
6 Year Year Year foreign unspecified unspecified unspecified unspecified unspecified  	O	null
7 : : : punctuation unspecified unspecified unspecified unspecified unspecified  	O	null
8 ###NUMBER### ###NUMBER### ###NUMBER### numeral unspecified unspecified unspecified unspecified unspecified  	I_DATE	null
9 Birth Birth Birth foreign unspecified unspecified unspecified unspecified unspecified  	O	null
10 Place Place Place foreign unspecified unspecified unspecified unspecified unspecified  	O	null
11 : : : punctuation unspecified unspecified unspecified unspecified unspecified  	O	null
12 תלאביב תלאביב תלאביב properName unspecified unspecified unspecified unspecified unspecified  	I_ORG	null
13 ל ל למשפחת preposition unspecified unspecified unspecified unspecified unspecified 0 
13 משפחת משפחה למשפחת noun feminine singular construct unspecified unspecified  	O	null
14 רבנים רב רבנים noun masculine plural absolute unspecified unspecified  	O	null
15 Occupation Occupation Occupation foreign unspecified unspecified unspecified unspecified unspecified  	O	null
16 : : : punctuation unspecified unspecified unspecified unspecified unspecified  	O	null
17 חוקרת חקר חוקרת verb feminine singular unspecified any beinoni  	O	null
18 ספרות ספרות ספרות noun feminine singular construct unspecified unspecified  	O	null
19 Entry Entry Entry foreign unspecified unspecified unspecified unspecified unspecified  	O	null
20 writer writer writer foreign unspecified unspecified unspecified unspecified unspecified  	O	null
21 : : : punctuation unspecified unspecified unspecified unspecified unspecified  	O	null
22 עירית עירייה עירית properName unspecified unspecified unspecified unspecified unspecified  	I_PERS	null
23 רונן רונן רונן properName unspecified unspecified unspecified unspecified unspecified  	I_PERS	null
24 Entry Entry Entry foreign unspecified unspecified unspecified unspecified unspecified  	O	null
25 Value Value Value foreign unspecified unspecified unspecified unspecified unspecified  	O	null
26 : : : punctuation unspecified unspecified unspecified unspecified unspecified  	O	null
27 נולדה נולד נולדה verb feminine singular unspecified 3 past  	O	null
28 בתלאביב בתלאביב בתלאביב noun feminine singular absolute unspecified unspecified  	O	null
29 ל ל למשפחת preposition unspecified unspecified unspecified unspecified unspecified 0 
29 משפחת משפחה למשפחת noun feminine singular construct unspecified unspecified  	O	null
30 רבנים רב רבנים noun masculine plural absolute unspecified unspecified  	O	null
31 חרדית חרדי חרדית adjective feminine singular absolute unspecified unspecified  	O	null
32 . . . punctuation unspecified unspecified unspecified unspecified unspecified  	O	null

0 ב ב בנעוריה preposition unspecified unspecified unspecified unspecified unspecified 0 
0 נעורי נעורים בנעוריה noun masculine plural absolute unspecified unspecified  
0 ה ה בנעוריה possessive feminine singular unspecified 3 unspecified 0 	O	null
1 פרשה פרשה פרשה noun feminine singular absolute unspecified unspecified  	O	null
2 מן מן מן preposition unspecified unspecified unspecified unspecified unspecified  	O	null
3 ה ה הסביבה definiteArticle unspecified unspecified unspecified unspecified unspecified 0 
3 הסביבה סביבה הסביבה noun feminine singular absolute unspecified unspecified  	O	null
4 ה ה הדתית definiteArticle unspecified unspecified unspecified unspecified unspecified 0 
4 הדתית דתי הדתית adjective feminine singular absolute unspecified unspecified  	O	null
5 , , , punctuation unspecified unspecified unspecified unspecified unspecified  	O	null
6 למדה למד למדה verb feminine singular unspecified 3 past  	O	null
7 הוראה הוראה הוראה noun feminine singular absolute unspecified unspecified  	O	null
8 , , , punctuation unspecified unspecified unspecified unspecified unspecified  	O	null
9 ו ו ולאחר conjunction unspecified unspecified unspecified unspecified unspecified 0 
9 לאחר לאחר ולאחר conjunction unspecified unspecified unspecified unspecified unspecified  	O	null
10 מכן מיכן מכן verb masculine singular unspecified 2 imperative  	O	null
11 שימשה שימש שימשה verb feminine singular unspecified 3 past  	O	null
12 שנים שנה שנים noun feminine plural absolute unspecified unspecified  	O	null
13 רבות רב רבות adjective feminine plural absolute unspecified unspecified  	O	null
14 כ כ כמורה preposition unspecified unspecified unspecified unspecified unspecified 0 
14 מורה מורה כמורה noun masculine singular absolute unspecified unspecified  	O	null
15 ב ב בבתי preposition unspecified unspecified unspecified unspecified unspecified 0 
15 בתי בית בבתי noun masculine plural construct unspecified unspecified  	O	null
16 ספר ספר ספר noun masculine singular absolute unspecified unspecified  	O	null
17 יסודיים יסודי יסודיים adjective masculine plural absolute unspecified unspecified  	O	null
18 ו ו ותיכוניים conjunction unspecified unspecified unspecified unspecified unspecified 0 
18 תיכוניים תיכוני ותיכוניים adjective masculine plural absolute unspecified unspecified  	O	null
19 ב ב בעפולה preposition unspecified unspecified unspecified unspecified unspecified 0 
19 עפולה עפולה בעפולה properName unspecified unspecified unspecified unspecified unspecified  	I_LOC	null
20 ו ו ובקריית conjunction unspecified unspecified unspecified unspecified unspecified 0 
20 ב ב ובקריית preposition unspecified unspecified unspecified unspecified unspecified 0 
20 קריית קריה ובקריית noun feminine singular construct unspecified unspecified  	O	null
21 חיים חיים חיים noun masculine plural absolute unspecified unspecified  	O	null
22 . . . punctuation unspecified unspecified unspecified unspecified unspecified  	O	null

0 ב ב בשנות preposition unspecified unspecified unspecified unspecified unspecified 0 
0 שנות שנה בשנות noun feminine plural construct unspecified unspecified  	I_DATE	null
1 ה ה השישים definiteArticle unspecified unspecified unspecified unspecified unspecified 0 
1 השישים ORD-CARD60 השישים numeral masculine-and-feminine plural absolute unspecified unspecified  	I_DATE	null
2 פנתה פנה פנתה verb feminine singular unspecified 3 past  	O	null
3 ל ל ללימודים preposition unspecified unspecified unspecified unspecified unspecified 0 
3 לימודים לימוד ללימודים noun masculine plural absolute unspecified unspecified  	O	null
4 אקדמיים אקדמי אקדמיים adjective masculine plural absolute unspecified unspecified  	O	null
5 ל ל לתארים preposition unspecified unspecified unspecified unspecified unspecified 0 
5 תארים תואר לתארים noun masculine plural absolute unspecified unspecified  	O	null
6 מתקדמים מתקדם מתקדמים adjective masculine plural absolute unspecified unspecified  	O	null
7 ב ב באוניברסיטה preposition unspecified unspecified unspecified unspecified unspecified 0 
7 ה ה באוניברסיטה definiteArticle unspecified unspecified unspecified unspecified unspecified 0 
7 האוניברסיטה אוניברסיטה באוניברסיטה noun feminine singular absolute unspecified unspecified  	O	null
8 ה ה העברית definiteArticle unspecified unspecified unspecified unspecified unspecified 0 
8 העברית עברי העברית adjective feminine singular absolute unspecified unspecified  	O	null
9 ב ב בירושלים preposition unspecified unspecified unspecified unspecified unspecified 0 
9 ירושלים ירושלים בירושלים properName unspecified unspecified unspecified unspecified unspecified  	I_LOC	null
10 . . . punctuation unspecified unspecified unspecified unspecified unspecified  	O	null

0 תחילה תחילה תחילה adverb unspecified unspecified unspecified unspecified unspecified  	O	null
1 התמחתה התמחה התמחתה verb feminine singular unspecified 3 past  	O	null
2 ב ב בתחום preposition unspecified unspecified unspecified unspecified unspecified 0 
2 תחום תחום בתחום noun masculine singular construct unspecified unspecified  	O	null
3 ה ה האגדה definiteArticle unspecified unspecified unspecified unspecified unspecified 0 
3 האגדה אגדה האגדה noun feminine singular absolute unspecified unspecified  	O	null
4 , , , punctuation unspecified unspecified unspecified unspecified unspecified  	O	null
5 ה ה המדרש definiteArticle unspecified unspecified unspecified unspecified unspecified 0 
5 המדרש מדרש המדרש noun masculine singular absolute unspecified unspecified  	O	null
6 ו ו והספרות conjunction unspecified unspecified unspecified unspecified unspecified 0 
6 ה ה והספרות definiteArticle unspecified unspecified unspecified unspecified unspecified 0 
6 הספרות ספרות והספרות noun feminine singular absolute unspecified unspecified  	O	null
7 ה ה העממית definiteArticle unspecified unspecified unspecified unspecified unspecified 0 
7 העממית עממי העממית adjective feminine singular absolute unspecified unspecified  	O	null
8 , , , punctuation unspecified unspecified unspecified unspecified unspecified  	O	null
9 ו ו וחיברה conjunction unspecified unspecified unspecified unspecified unspecified 0 
9 חיברה חיבר וחיברה verb feminine singular unspecified 3 past  	O	null
10 עבודת עבודה עבודת noun feminine singular construct unspecified unspecified  	O	null
11 גמר גמר גמר noun masculine singular absolute unspecified unspecified  	O	null
12 ל ל לתואר preposition unspecified unspecified unspecified unspecified unspecified 0 
12 תואר תואר לתואר noun masculine singular construct unspecified unspecified  	O	null
13 ה ה השני definiteArticle unspecified unspecified unspecified unspecified unspecified 0 
13 השני שני השני noun masculine singular absolute unspecified unspecified  	O	null
14 על על על preposition unspecified unspecified unspecified unspecified unspecified  	O	null
15 גלגולי גלגול גלגולי noun masculine plural construct unspecified unspecified  	O	null
16 מוטיבים מוטיב מוטיבים noun masculine plural absolute unspecified unspecified  	O	null
17 ב ב בסיפורים preposition unspecified unspecified unspecified unspecified unspecified 0 
17 סיפורים סיפור בסיפורים noun masculine plural absolute unspecified unspecified  	O	null
18 על על על preposition unspecified unspecified unspecified unspecified unspecified  	O	null
19 נשים איש נשים noun feminine plural absolute unspecified unspecified  	O	null
20 ב ב באגדת preposition unspecified unspecified unspecified unspecified unspecified 0 
20 אגדת אגדה באגדת noun feminine singular construct unspecified unspecified  	O	null
21 חז"ל חז"ל חז"ל noun masculine singular absolute unspecified unspecified  	O	null
22 ו ו ובסיפור conjunction unspecified unspecified unspecified unspecified unspecified 0 
22 ב ב ובסיפור preposition unspecified unspecified unspecified unspecified unspecified 0 
22 ה ה ובסיפור definiteArticle unspecified unspecified unspecified unspecified unspecified 0 
22 הסיפור סיפור ובסיפור noun masculine singular absolute unspecified unspecified  	O	null
23 ה ה העממי definiteArticle unspecified unspecified unspecified unspecified unspecified 0 
23 העממי עממי העממי adjective masculine singular absolute unspecified unspecified  	O	null
24 של של של shel-preposition unspecified unspecified unspecified unspecified unspecified  	O	null
25 עדות עדות עדות noun feminine singular construct unspecified unspecified  	O	null
26 ישראל ישראל ישראל properName unspecified unspecified unspecified unspecified unspecified  	I_LOC	null
27 . . . punctuation unspecified unspecified unspecified unspecified unspecified  	O	null

0 ב ב באותן preposition unspecified unspecified unspecified unspecified unspecified 0 
0 אותו אותו באותן quantifier unspecified unspecified unspecified unspecified unspecified  
0 הן הן באותן pronomial feminine plural unspecified 3 unspecified 0 	O	null
1 שנים שנה שנים noun feminine plural absolute unspecified unspecified  	O	null
2 פעלה פעל פעלה verb feminine singular unspecified 3 past  	O	null
3 גם גם גם conjunction unspecified unspecified unspecified unspecified unspecified  	O	null
4 ב ב במסגרת preposition unspecified unspecified unspecified unspecified unspecified 0 
4 מסגרת מסגרת במסגרת noun feminine singular construct unspecified unspecified  	O	null
5 ארכיון ארכיון ארכיון noun masculine singular construct unspecified unspecified  	O	null
6 ה ה הסיפור definiteArticle unspecified unspecified unspecified unspecified unspecified 0 
6 הסיפור סיפור הסיפור noun masculine singular absolute unspecified unspecified  	O	null
7 ה ה העממי definiteArticle unspecified unspecified unspecified unspecified unspecified 0 
7 העממי עממי העממי adjective masculine singular absolute unspecified unspecified  	O	null
8 ש ש שנוסד relativizer/subordinatingConjunction unspecified unspecified unspecified unspecified unspecified 0 
8 נוסד נוסד שנוסד verb masculine singular unspecified 3 past  	O	null
9 ב ב בחיפה preposition unspecified unspecified unspecified unspecified unspecified 0 
9 חיפה חיפה בחיפה properName unspecified unspecified unspecified unspecified unspecified  	I_LOC	null
10 על על על preposition unspecified unspecified unspecified unspecified unspecified  	O	null
11 ידי יד ידי noun feminine plural construct unspecified unspecified  	O	null
12 מורה מורה מורה noun masculine singular construct unspecified unspecified  	O	null
13 ּ ּ ּ punctuation unspecified unspecified unspecified unspecified unspecified  	O	null
14 דב דב דב properName unspecified unspecified unspecified unspecified unspecified  	I_PERS	null
15 נוי נוי נוי properName unspecified unspecified unspecified unspecified unspecified  	I_PERS	null
16 , , , punctuation unspecified unspecified unspecified unspecified unspecified  	O	null
17 ו ו וערכה conjunction unspecified unspecified unspecified unspecified unspecified 0 
17 ערכה ערכה וערכה noun feminine singular absolute unspecified unspecified  	O	null
18 קבצים קובץ קבצים noun masculine plural absolute unspecified unspecified  	O	null
19 אחדים אחדים אחדים adjective masculine plural absolute unspecified unspecified  	O	null
20 של של של shel-preposition unspecified unspecified unspecified unspecified unspecified  	O	null
21 סיפורי סיפור סיפורי noun masculine plural construct unspecified unspecified  	O	null
22 עם עם עם preposition unspecified unspecified unspecified unspecified unspecified  	O	null
23 : : : punctuation unspecified unspecified unspecified unspecified unspecified  	O	null
24 חודש חודש חודש noun masculine singular construct unspecified unspecified  	I_DATE	null
25 חודש חודש חודש noun masculine singular construct unspecified unspecified  	O	null
26 ו ו וסיפורו conjunction unspecified unspecified unspecified unspecified unspecified 0 
26 סיפור סיפור וסיפורו noun masculine singular absolute unspecified unspecified  
26 ו ו וסיפורו possessive masculine singular unspecified 3 unspecified 0 	O	null
27 ) ) ) punctuation unspecified unspecified unspecified unspecified unspecified  	O	null
28 ; ; ; punctuation unspecified unspecified unspecified unspecified unspecified  	O	null
29 ###NUMBER### ###NUMBER### ###NUMBER### numeral unspecified unspecified unspecified unspecified unspecified  	I_DATE	null
30 סבתא סבא סבתא noun feminine singular construct unspecified unspecified  	O	null
31 אסתר אסתר אסתר properName unspecified unspecified unspecified unspecified unspecified  	I_PERS	null
32 מספרת סיפר מספרת verb feminine singular unspecified any beinoni  	O	null
33 : : : punctuation unspecified unspecified unspecified unspecified unspecified  	O	null
34 שמונה CARD8 שמונה numeral feminine plural absolute unspecified unspecified  	O	null
35 - - - punctuation unspecified unspecified unspecified unspecified unspecified  	O	null
36 עשר עישר עשר verb masculine singular unspecified 3 past  	O	null
37 סיפורי סיפור סיפורי noun masculine plural construct unspecified unspecified  	O	null
38 - - - punctuation unspecified unspecified unspecified unspecified unspecified  	O	null
39 עם עם עם preposition unspecified unspecified unspecified unspecified unspecified  	O	null
40 ) ) ) punctuation unspecified unspecified unspecified unspecified unspecified  	O	null
41 ; ; ; punctuation unspecified unspecified unspecified unspecified unspecified  	O	null
42 ###NUMBER### ###NUMBER### ###NUMBER### numeral unspecified unspecified unspecified unspecified unspecified  	I_DATE	null
43 צוואת צוואה צוואת noun feminine singular construct unspecified unspecified  	O	null
44 אב אב אב noun masculine singular construct unspecified unspecified  	O	null
45 : : : punctuation unspecified unspecified unspecified unspecified unspecified  	O	null
46 י"ג י"ג י"ג noun masculine singular absolute unspecified unspecified  	O	null
47 סיפורי סיפור סיפורי noun masculine plural construct unspecified unspecified  	O	null
48 - - - punctuation unspecified unspecified unspecified unspecified unspecified  	O	null
49 עם עם עם preposition unspecified unspecified unspecified unspecified unspecified  	I_LOC	null
50 מ מ מאפגניסטן preposition unspecified unspecified unspecified unspecified unspecified 0 
50 אפגניסטן אפגניסטן מאפגניסטן properName unspecified unspecified unspecified unspecified unspecified  	I_LOC	null
51 ) ) ) punctuation unspecified unspecified unspecified unspecified unspecified  	O	null
52 . . . punctuation unspecified unspecified unspecified unspecified unspecified  	O	null
53 ###NUMBER### ###NUMBER### ###NUMBER### numeral unspecified unspecified unspecified unspecified unspecified  	I_DATE	null
54 מ מ מתוך preposition unspecified unspecified unspecified unspecified unspecified 0 
54 תוך תוך מתוך wPrefix unspecified unspecified unspecified unspecified unspecified  	O	null
55 עבודת עבודה עבודתה noun feminine singular absolute unspecified unspecified  
55 ה ה עבודתה possessive feminine singular unspecified 3 unspecified 0 	O	null
56 ב ב בחקר preposition unspecified unspecified unspecified unspecified unspecified 0 
56 חקר חקר בחקר noun masculine singular construct unspecified unspecified  	O	null
57 ה ה האגדה definiteArticle unspecified unspecified unspecified unspecified unspecified 0 
57 האגדה אגדה האגדה noun feminine singular absolute unspecified unspecified  	O	null
58 נמשכה נמשך נמשכה verb feminine singular unspecified 3 past  	O	null
59 ב ב בהשפעת preposition unspecified unspecified unspecified unspecified unspecified 0 
59 השפעת השפעה בהשפעת noun feminine singular construct unspecified unspecified  	O	null
60 מורה מורה מורה noun masculine singular construct unspecified unspecified  	O	null
61 ּ ּ ּ punctuation unspecified unspecified unspecified unspecified unspecified  	O	null
62 שמעון שמעון שמעון properName unspecified unspecified unspecified unspecified unspecified  	I_PERS	null
63 הלקין הלקין הלקין properName unspecified unspecified unspecified unspecified unspecified  	I_PERS	null
64 ל ל לעיסוק preposition unspecified unspecified unspecified unspecified unspecified 0 
64 עיסוק עיסוק לעיסוק noun masculine singular construct unspecified unspecified  	O	null
65 ב ב ביצירתו preposition unspecified unspecified unspecified unspecified unspecified 0 
65 יצירת יצירה ביצירתו noun feminine singular absolute unspecified unspecified  
65 ו ו ביצירתו possessive masculine singular unspecified 3 unspecified 0 	O	null
66 של של של shel-preposition unspecified unspecified unspecified unspecified unspecified  	O	null
67 מיכה מיכה מיכה properName unspecified unspecified unspecified unspecified unspecified  	I_PERS	null
68 יוסף יוסף יוסף properName unspecified unspecified unspecified unspecified unspecified  	I_PERS	null
69 ברדיצ'בסקי ברדיצ'בסקי ברדיצ'בסקי properName unspecified unspecified unspecified unspecified unspecified  	I_PERS	null
70 . . . punctuation unspecified unspecified unspecified unspecified unspecified  	O	null

0 היא הוא היא pronoun feminine singular unspecified 3 unspecified  	O	null
1 הקדישה הקדיש הקדישה verb feminine singular unspecified 3 past  	O	null
2 את את את at-preposition unspecified unspecified unspecified unspecified unspecified  	O	null
3 עבודת עבודה עבודת noun feminine singular construct unspecified unspecified  	O	null
4 ה ה הדוקטור definiteArticle unspecified unspecified unspecified unspecified unspecified 0 
4 הדוקטור דוקטור הדוקטור noun masculine singular absolute unspecified unspecified  	O	null
5 של של שלה shel-preposition unspecified unspecified unspecified unspecified unspecified  
5 ה ה שלה pronomial feminine singular unspecified 3 unspecified 0 	O	null
6 ( ( ( punctuation unspecified unspecified unspecified unspecified unspecified  	O	null
7 ###NUMBER### ###NUMBER### ###NUMBER### numeral unspecified unspecified unspecified unspecified unspecified  	I_DATE	null
8 ) ) ) punctuation unspecified unspecified unspecified unspecified unspecified  	O	null
9 ל ל לתיאור preposition unspecified unspecified unspecified unspecified unspecified 0 
9 תיאור תיאור לתיאור noun masculine singular construct unspecified unspecified  	O	null
10 מקום מקום מקומה noun masculine singular absolute unspecified unspecified  
10 ה ה מקומה possessive feminine singular unspecified 3 unspecified 0 	O	null
11 של של של shel-preposition unspecified unspecified unspecified unspecified unspecified  	O	null
12 ה ה האגדה definiteArticle unspecified unspecified unspecified unspecified unspecified 0 
12 האגדה אגדה האגדה noun feminine singular absolute unspecified unspecified  	O	null
13 ב ב בעולמו preposition unspecified unspecified unspecified unspecified unspecified 0 
13 עולם עולם בעולמו noun masculine singular absolute unspecified unspecified  
13 ו ו בעולמו possessive masculine singular unspecified 3 unspecified 0 	O	null
14 כ כ כסופר preposition unspecified unspecified unspecified unspecified unspecified 0 
14 ה ה כסופר definiteArticle unspecified unspecified unspecified unspecified unspecified 0 
14 הסופר ספר כסופר participle masculine singular absolute any unspecified  	O	null
15 וכמכַנֵס וכמכַנֵס וכמכַנֵס properName unspecified unspecified unspecified unspecified unspecified  	I_PERS	null
16 , , , punctuation unspecified unspecified unspecified unspecified unspecified  	O	null
17 כ כ כמעבד preposition unspecified unspecified unspecified unspecified unspecified 0 
17 ה ה כמעבד definiteArticle unspecified unspecified unspecified unspecified unspecified 0 
17 המעבד מעבד כמעבד noun masculine singular absolute unspecified unspecified  	O	null
18 ו ו וכחוקר conjunction unspecified unspecified unspecified unspecified unspecified 0 
18 כ כ וכחוקר preposition unspecified unspecified unspecified unspecified unspecified 0 
18 ה ה וכחוקר definiteArticle unspecified unspecified unspecified unspecified unspecified 0 
18 החוקר חוקר וכחוקר noun masculine singular absolute unspecified unspecified  	O	null
19 . . . punctuation unspecified unspecified unspecified unspecified unspecified  	O	null

0 מאז מאז מאז adverb unspecified unspecified unspecified unspecified unspecified  	O	null
1 ואילך ואילך ואילך adverb unspecified unspecified unspecified unspecified unspecified  	O	null
2 נעשה נעשה נעשה verb masculine singular unspecified 3 past  	O	null
3 חקר חקר חקר noun masculine singular construct unspecified unspecified  	O	null
4 ברדיצ'בסקי ברדיצ'בסקי ברדיצ'בסקי properName unspecified unspecified unspecified unspecified unspecified  	O	null
5 ל ל לתחום preposition unspecified unspecified unspecified unspecified unspecified 0 
5 תחום תחום לתחום noun masculine singular construct unspecified unspecified  	O	null
6 התמחות התמחות התמחותה noun feminine singular absolute unspecified unspecified  
6 ה ה התמחותה possessive feminine singular unspecified 3 unspecified 0 	O	null
7 ה ה העיקרי definiteArticle unspecified unspecified unspecified unspecified unspecified 0 
7 העיקרי עיקרי העיקרי adjective masculine singular absolute unspecified unspecified  	O	null
8 . . . punctuation unspecified unspecified unspecified unspecified unspecified  	O	null

0 צפורה צפורה צפורה properName unspecified unspecified unspecified unspecified unspecified  	I_PERS	null
1 כ כ כגן preposition unspecified unspecified unspecified unspecified unspecified 0 
1 גן גן כגן noun masculine singular absolute unspecified unspecified  	O	null
2 היתה הוא היתה copula feminine singular unspecified 3 past  	O	null
3 מ מ מראשוני preposition unspecified unspecified unspecified unspecified unspecified 0 
3 ראשוני ראשונים מראשוני noun masculine plural construct unspecified unspecified  	O	null
4 ה ה המורים definiteArticle unspecified unspecified unspecified unspecified unspecified 0 
4 המורים מורה המורים noun masculine plural absolute unspecified unspecified  	O	null
5 ב ב באוניברסיטת preposition unspecified unspecified unspecified unspecified unspecified 0 
5 אוניברסיטת אוניברסיטה באוניברסיטת noun feminine singular construct unspecified unspecified  	I_ORG	null
6 חיפה חיפה חיפה properName unspecified unspecified unspecified unspecified unspecified  	I_ORG	null
7 , , , punctuation unspecified unspecified unspecified unspecified unspecified  	O	null
8 עוד עוד עוד adverb unspecified unspecified unspecified unspecified unspecified  	O	null
9 ב ב בגלגולה preposition unspecified unspecified unspecified unspecified unspecified 0 
9 גלגול גלגול בגלגולה noun masculine singular absolute unspecified unspecified  
9 ה ה בגלגולה possessive feminine singular unspecified 3 unspecified 0 	O	null
10 ה ה הקודם definiteArticle unspecified unspecified unspecified unspecified unspecified 0 
10 הקודם קודם הקודם adjective masculine singular absolute unspecified unspecified  	O	null
11 כ כ כ preposition unspecified unspecified unspecified unspecified unspecified 0 	O	null
12 " " " punctuation unspecified unspecified unspecified unspecified unspecified  	O	null
13 מכון מיכון מכון noun masculine singular construct unspecified unspecified  	O	null
14 ה ה האוניברסיטאי definiteArticle unspecified unspecified unspecified unspecified unspecified 0 
14 האוניברסיטאי האוניברסיטאי האוניברסיטאי adjective masculine singular absolute unspecified unspecified  	O	null
15 של של של shel-preposition unspecified unspecified unspecified unspecified unspecified  	O	null
16 חיפה חיפה חיפה properName unspecified unspecified unspecified unspecified unspecified  	I_LOC	null
17 " " " punctuation unspecified unspecified unspecified unspecified unspecified  	O	null
18 , , , punctuation unspecified unspecified unspecified unspecified unspecified  	O	null
19 ש ש שפעל relativizer/subordinatingConjunction unspecified unspecified unspecified unspecified unspecified 0 
19 פעל פעל שפעל verb masculine singular unspecified 3 past  	O	null
20 ב ב בחסותה preposition unspecified unspecified unspecified unspecified unspecified 0 
20 חסות חסות בחסותה noun feminine singular absolute unspecified unspecified  
20 ה ה בחסותה possessive feminine singular unspecified 3 unspecified 0 	O	null
21 ה ה האקדמית definiteArticle unspecified unspecified unspecified unspecified unspecified 0 
21 האקדמית אקדמי האקדמית adjective feminine singular absolute unspecified unspecified  	O	null
22 של של של shel-preposition unspecified unspecified unspecified unspecified unspecified  	O	null
23 ה ה האוניברסיטה definiteArticle unspecified unspecified unspecified unspecified unspecified 0 
23 האוניברסיטה אוניברסיטה האוניברסיטה noun feminine singular absolute unspecified unspecified  	I_ORG	null
24 ה ה העברית definiteArticle unspecified unspecified unspecified unspecified unspecified 0 
24 העברית עברי העברית adjective feminine singular absolute unspecified unspecified  	I_ORG	null
25 . . . punctuation unspecified unspecified unspecified unspecified unspecified  	O	null

0 לימדה לימד לימדה verb feminine singular unspecified 3 past  	O	null
1 ב ב בה preposition unspecified unspecified unspecified unspecified unspecified  
1 ה ה בה pronomial feminine singular unspecified 3 unspecified 0 	O	null
2 מ מ מ preposition unspecified unspecified unspecified unspecified unspecified 0 	O	null
3 - - - punctuation unspecified unspecified unspecified unspecified unspecified  	O	null
4 ###NUMBER### ###NUMBER### ###NUMBER### numeral unspecified unspecified unspecified unspecified unspecified  	I_DATE	null
5 ב ב בחוג preposition unspecified unspecified unspecified unspecified unspecified 0 
5 ה ה בחוג definiteArticle unspecified unspecified unspecified unspecified unspecified 0 
5 החוג חוג בחוג noun masculine singular absolute unspecified unspecified  	O	null
6 ל ל לספרות preposition unspecified unspecified unspecified unspecified unspecified 0 
6 ספרות ספרות לספרות noun feminine singular absolute unspecified unspecified  	O	null
7 עברית עברי עברית adjective feminine singular absolute unspecified unspecified  	O	null
8 ו ו והשוואתית conjunction unspecified unspecified unspecified unspecified unspecified 0 
8 השוואתית השוואתי והשוואתית adjective feminine singular absolute unspecified unspecified  	O	null
9 , , , punctuation unspecified unspecified unspecified unspecified unspecified  	O	null
10 ו ו והתקדמה conjunction unspecified unspecified unspecified unspecified unspecified 0 
10 התקדמה התקדם והתקדמה verb feminine singular unspecified 3 past  	O	null
11 עד עד עד preposition unspecified unspecified unspecified unspecified unspecified  	O	null
12 דרגת דרגה דרגת noun feminine singular construct unspecified unspecified  	O	null
13 פרופסור פרופסור פרופסור noun masculine singular absolute unspecified unspecified  	O	null
14 מן מן מן preposition unspecified unspecified unspecified unspecified unspecified  	O	null
15 ה ה המניין definiteArticle unspecified unspecified unspecified unspecified unspecified 0 
15 המניין מניין המניין noun masculine singular absolute unspecified unspecified  	O	null
16 ) ) ) punctuation unspecified unspecified unspecified unspecified unspecified  	O	null
17 . . . punctuation unspecified unspecified unspecified unspecified unspecified  	O	null
18 ###NUMBER### ###NUMBER### ###NUMBER### numeral unspecified unspecified unspecified unspecified unspecified  	I_DATE	null
19 מ מ מ preposition unspecified unspecified unspecified unspecified unspecified 0 	O	null
20 - - - punctuation unspecified unspecified unspecified unspecified unspecified  	O	null
21 ###NUMBER### ###NUMBER### ###NUMBER### numeral unspecified unspecified unspecified unspecified unspecified  	I_DATE	null
22 עד עד עד preposition unspecified unspecified unspecified unspecified unspecified  	O	null
23 ###NUMBER### ###NUMBER### ###NUMBER### numeral unspecified unspecified unspecified unspecified unspecified  	I_DATE	null
24 נמנתה נמנה נמנתה verb feminine singular unspecified 3 past  	O	null
25 עם עם עם preposition unspecified unspecified unspecified unspecified unspecified  	O	null
26 עורכי עורך עורכי noun masculine plural construct unspecified unspecified  	O	null
27 כתב כתב כתב noun masculine singular construct unspecified unspecified  	O	null
28 ה ה העת definiteArticle unspecified unspecified unspecified unspecified unspecified 0 
28 העת עת העת noun feminine singular absolute unspecified unspecified  	O	null
29 של של של shel-preposition unspecified unspecified unspecified unspecified unspecified  	O	null
30 ה ה החוג definiteArticle unspecified unspecified unspecified unspecified unspecified 0 
30 החוג חוג החוג noun masculine singular absolute unspecified unspecified  	O	null
31 , , , punctuation unspecified unspecified unspecified unspecified unspecified  	O	null
32 דפים דף דפים noun masculine plural absolute unspecified unspecified  	O	null
33 ל ל למחקר preposition unspecified unspecified unspecified unspecified unspecified 0 
33 מחקר מחקר למחקר noun masculine singular absolute unspecified unspecified  	O	null
34 ב ב בספרות preposition unspecified unspecified unspecified unspecified unspecified 0 
34 ה ה בספרות definiteArticle unspecified unspecified unspecified unspecified unspecified 0 
34 הספרות ספרות בספרות noun feminine singular absolute unspecified unspecified  	O	null
35 . . . punctuation unspecified unspecified unspecified unspecified unspecified  	O	null

0 ב ב ב preposition unspecified unspecified unspecified unspecified unspecified 0 	O	null
1 - - - punctuation unspecified unspecified unspecified unspecified unspecified  	O	null
2 ###NUMBER### ###NUMBER### ###NUMBER### numeral unspecified unspecified unspecified unspecified unspecified  	I_DATE	null
3 פרשה פרשה פרשה noun feminine singular absolute unspecified unspecified  	O	null
4 ל ל לגמלאות preposition unspecified unspecified unspecified unspecified unspecified 0 
4 גמלאות גמלה לגמלאות noun feminine plural absolute unspecified unspecified  	O	null
5 . . . punctuation unspecified unspecified unspecified unspecified unspecified  	O	null

0 תרומת תרומה תרומתה noun feminine singular absolute unspecified unspecified  
0 ה ה תרומתה possessive feminine singular unspecified 3 unspecified 0 	O	null
1 ל ל לחקר preposition unspecified unspecified unspecified unspecified unspecified 0 
1 חקר חקר לחקר noun masculine singular construct unspecified unspecified  	O	null
2 ברדיצ'בסקי ברדיצ'בסקי ברדיצ'בסקי properName unspecified unspecified unspecified unspecified unspecified  	I_ORG	null
3 מקיפה מקיף מקיפה adjective feminine singular absolute unspecified unspecified  	O	null
4 תחומים תחום תחומים noun masculine plural absolute unspecified unspecified  	O	null
5 אחדים אחדים אחדים adjective masculine plural absolute unspecified unspecified  	O	null
6 . . . punctuation unspecified unspecified unspecified unspecified unspecified  	O	null

0 ב ב בשורה preposition unspecified unspecified unspecified unspecified unspecified 0 
0 שורה שורה בשורה noun feminine singular absolute unspecified unspecified  	O	null
1 של של של shel-preposition unspecified unspecified unspecified unspecified unspecified  	O	null
2 מאמרים מאמר מאמרים noun masculine plural absolute unspecified unspecified  	O	null
3 תיארה תיאר תיארה verb feminine singular unspecified 3 past  	O	null
4 , , , punctuation unspecified unspecified unspecified unspecified unspecified  	O	null
5 אפיינה אפיין אפיינה verb feminine singular unspecified 3 past  	O	null
6 ו ו ומיינה conjunction unspecified unspecified unspecified unspecified unspecified 0 
6 מיינה מיין ומיינה verb feminine singular unspecified 3 past  	O	null
7 את את את at-preposition unspecified unspecified unspecified unspecified unspecified  	O	null
8 יצירת יצירה יצירתו noun feminine singular absolute unspecified unspecified  
8 ו ו יצירתו possessive masculine singular unspecified 3 unspecified 0 	O	null
9 ה ה האגדית definiteArticle unspecified unspecified unspecified unspecified unspecified 0 
9 האגדית אגדי האגדית adjective feminine singular absolute unspecified unspecified  	O	null
10 ל ל לסוגיה preposition unspecified unspecified unspecified unspecified unspecified 0 
10 ה ה לסוגיה definiteArticle unspecified unspecified unspecified unspecified unspecified 0 
10 הסוגיה סוגיה לסוגיה noun feminine singular absolute unspecified unspecified  	O	null
11 ו ו וללשונותיה conjunction unspecified unspecified unspecified unspecified unspecified 0 
11 ל ל וללשונותיה preposition unspecified unspecified unspecified unspecified unspecified 0 
11 לשונות לשון וללשונותיה noun feminine plural absolute unspecified unspecified  
11 ה ה וללשונותיה possessive feminine singular unspecified 3 unspecified 0 	O	null
12 , , , punctuation unspecified unspecified unspecified unspecified unspecified  	O	null
13 עמדה עמד עמדה verb feminine singular unspecified 3 past  	O	null
14 על על על preposition unspecified unspecified unspecified unspecified unspecified  	O	null
15 דרכי דרך דרכי noun feminine plural construct unspecified unspecified  	O	null
16 עריכת עריכה עריכתם noun feminine singular absolute unspecified unspecified  
16 ם ם עריכתם possessive masculine plural unspecified 3 unspecified 0 	O	null
17 של של של shel-preposition unspecified unspecified unspecified unspecified unspecified  	O	null
18 קובצי קבץ קובצי participle masculine plural construct any unspecified  	O	null
19 ה ה האגדות definiteArticle unspecified unspecified unspecified unspecified unspecified 0 
19 האגדות אגדה האגדות noun feminine plural absolute unspecified unspecified  	O	null
20 של של שלו shel-preposition unspecified unspecified unspecified unspecified unspecified  
20 ו ו שלו pronomial masculine singular unspecified 3 unspecified 0 	O	null
21 , , , punctuation unspecified unspecified unspecified unspecified unspecified  	O	null
22 הראתה הראה הראתה verb feminine singular unspecified 3 past  	O	null
23 את את את at-preposition unspecified unspecified unspecified unspecified unspecified  	O	null
24 סממני סממן סממניו noun masculine plural absolute unspecified unspecified  
24 ו ו סממניו possessive masculine singular unspecified 3 unspecified 0 	O	null
25 של של של shel-preposition unspecified unspecified unspecified unspecified unspecified  	O	null
26 ה ה הכוח definiteArticle unspecified unspecified unspecified unspecified unspecified 0 
26 הכוח כוח הכוח noun masculine singular absolute unspecified unspecified  	O	null
27 ה ה היוצר definiteArticle unspecified unspecified unspecified unspecified unspecified 0 
27 היוצר יצר היוצר participle masculine singular absolute any unspecified  	O	null
28 ש ש ששוקע relativizer/subordinatingConjunction unspecified unspecified unspecified unspecified unspecified 0 
28 שוקע שוקע ששוקע verb masculine singular unspecified 3 past  	O	null
29 ב ב בהם preposition unspecified unspecified unspecified unspecified unspecified  
29 הם הם בהם pronomial masculine plural unspecified 3 unspecified 0 	O	null
30 ו ו וקישרה conjunction unspecified unspecified unspecified unspecified unspecified 0 
30 קישרה קישר וקישרה verb feminine singular unspecified 3 past  	O	null
31 את את אותם at-preposition unspecified unspecified unspecified unspecified unspecified  
31 הם הם אותם pronomial masculine plural unspecified 3 unspecified 0 	O	null
32 ל ל להשקפת preposition unspecified unspecified unspecified unspecified unspecified 0 
32 השקפת השקפה להשקפת noun feminine singular construct unspecified unspecified  	O	null
33 עולם עולם עולמו noun masculine singular absolute unspecified unspecified  
33 ו ו עולמו possessive masculine singular unspecified 3 unspecified 0 	O	null
34 ה ה הנועזת definiteArticle unspecified unspecified unspecified unspecified unspecified 0 
34 הנועזת נועז הנועזת adjective feminine singular absolute unspecified unspecified  	O	null
35 על על על preposition unspecified unspecified unspecified unspecified unspecified  	O	null
36 טיב טיב טיבה noun masculine singular absolute unspecified unspecified  
36 ה ה טיבה possessive feminine singular unspecified 3 unspecified 0 	O	null
37 ה ה הפלורליסטי definiteArticle unspecified unspecified unspecified unspecified unspecified 0 
37 הפלורליסטי הפלורליסטי הפלורליסטי adjective masculine singular absolute unspecified unspecified  	O	null
38 של של של shel-preposition unspecified unspecified unspecified unspecified unspecified  	O	null
39 ה ה התרבות definiteArticle unspecified unspecified unspecified unspecified unspecified 0 
39 התרבות תרבות התרבות noun feminine singular absolute unspecified unspecified  	O	null
40 ה ה היהודית definiteArticle unspecified unspecified unspecified unspecified unspecified 0 
40 היהודית יהודי היהודית adjective feminine singular absolute unspecified unspecified  	O	null
41 . . . punctuation unspecified unspecified unspecified unspecified unspecified  	O	null

0 ב ב בספרה preposition unspecified unspecified unspecified unspecified unspecified 0 
0 ספר ספר בספרה noun masculine singular absolute unspecified unspecified  
0 ה ה בספרה possessive feminine singular unspecified 3 unspecified 0 	O	null
1 מ מ מאגדה preposition unspecified unspecified unspecified unspecified unspecified 0 
1 אגדה אגדה מאגדה noun feminine singular absolute unspecified unspecified  	O	null
2 ל ל לסיפורת preposition unspecified unspecified unspecified unspecified unspecified 0 
2 סיפורת סיפורת לסיפורת noun feminine singular absolute unspecified unspecified  	O	null
3 מודרנית מודרני מודרנית adjective feminine singular absolute unspecified unspecified  	O	null
4 ב ב ביצירת preposition unspecified unspecified unspecified unspecified unspecified 0 
4 יצירת יצירה ביצירת noun feminine singular construct unspecified unspecified  	O	null
5 ברדיצ'בסקי ברדיצ'בסקי ברדיצ'בסקי properName unspecified unspecified unspecified unspecified unspecified  	I_LOC	null
6 ( ( ( punctuation unspecified unspecified unspecified unspecified unspecified  	O	null
7 ###NUMBER### ###NUMBER### ###NUMBER### numeral unspecified unspecified unspecified unspecified unspecified  	I_DATE	null
8 ) ) ) punctuation unspecified unspecified unspecified unspecified unspecified  	O	null
9 זיהתה זיהה זיהתה verb feminine singular unspecified 3 past  	O	null
10 תשתיות תשתית תשתיות noun feminine plural absolute unspecified unspecified  	O	null
11 מקראיות מקראי מקראיות adjective feminine plural absolute unspecified unspecified  	O	null
12 ו ו ואגדיות conjunction unspecified unspecified unspecified unspecified unspecified 0 
12 אגדיות אגדי ואגדיות adjective feminine plural absolute unspecified unspecified  	O	null
13 ב ב ביצירתו preposition unspecified unspecified unspecified unspecified unspecified 0 
13 יצירת יצירה ביצירתו noun feminine singular absolute unspecified unspecified  
13 ו ו ביצירתו possessive masculine singular unspecified 3 unspecified 0 	O	null
14 ה ה הסיפורית definiteArticle unspecified unspecified unspecified unspecified unspecified 0 
14 הסיפורית סיפורי הסיפורית adjective feminine singular absolute unspecified unspecified  	O	null
15 הקנונית הקנונית הקנונית adjective feminine singular absolute unspecified unspecified  	O	null
16 , , , punctuation unspecified unspecified unspecified unspecified unspecified  	O	null
17 ו ו ותיארה conjunction unspecified unspecified unspecified unspecified unspecified 0 
17 תיארה תיאר ותיארה verb feminine singular unspecified 3 past  	O	null
18 את את את at-preposition unspecified unspecified unspecified unspecified unspecified  	O	null
19 ה ה הדיאלוג definiteArticle unspecified unspecified unspecified unspecified unspecified 0 
19 הדיאלוג דיאלוג הדיאלוג noun masculine singular absolute unspecified unspecified  	O	null
20 ש ש שברדיצ'בסקי relativizer/subordinatingConjunction unspecified unspecified unspecified unspecified unspecified 0 
20 ברדיצ'בסקי ברדיצ'בסקי שברדיצ'בסקי properName unspecified unspecified unspecified unspecified unspecified  	O	null
21 מנהל מנהל מנהל noun masculine singular construct unspecified unspecified  	O	null
22 עם עם עם noun masculine singular construct unspecified unspecified  	O	null
23 ה ה המקורות definiteArticle unspecified unspecified unspecified unspecified unspecified 0 
23 המקורות מקור המקורות noun masculine plural absolute unspecified unspecified  	O	null
24 ה ה הקדומים definiteArticle unspecified unspecified unspecified unspecified unspecified 0 
24 הקדומים קדום הקדומים adjective masculine plural absolute unspecified unspecified  	O	null
25 ל ל למיניהם preposition unspecified unspecified unspecified unspecified unspecified 0 
25 מיני מין למיניהם noun masculine plural absolute unspecified unspecified  
25 הם הם למיניהם possessive masculine plural unspecified 3 unspecified 0 	O	null
26 כ כ כחלק preposition unspecified unspecified unspecified unspecified unspecified 0 
26 חלק חלק כחלק noun masculine singular absolute unspecified unspecified  	O	null
27 מ מ מחתירתו preposition unspecified unspecified unspecified unspecified unspecified 0 
27 חתירת חתירה מחתירתו noun feminine singular absolute unspecified unspecified  
27 ו ו מחתירתו possessive masculine singular unspecified 3 unspecified 0 	O	null
28 ל ל לשמירת preposition unspecified unspecified unspecified unspecified unspecified 0 
28 שמירת שמירה לשמירת noun feminine singular construct unspecified unspecified  	O	null
29 ה ה הרציפות definiteArticle unspecified unspecified unspecified unspecified unspecified 0 
29 הרציפות רציפות הרציפות noun feminine singular absolute unspecified unspecified  	O	null
30 ה ה התרבותית definiteArticle unspecified unspecified unspecified unspecified unspecified 0 
30 התרבותית תרבותי התרבותית adjective feminine singular absolute unspecified unspecified  	O	null
31 . . . punctuation unspecified unspecified unspecified unspecified unspecified  	O	null

0 ב ב במחקרה preposition unspecified unspecified unspecified unspecified unspecified 0 
0 מחקר מחקר במחקרה noun masculine singular absolute unspecified unspecified  
0 ה ה במחקרה possessive feminine singular unspecified 3 unspecified 0 	O	null
1 ה ה המקיף definiteArticle unspecified unspecified unspecified unspecified unspecified 0 
1 המקיף מקיף המקיף adjective masculine singular absolute unspecified unspecified  	O	null
2 על על על preposition unspecified unspecified unspecified unspecified unspecified  	O	null
3 ה ה הרומן definiteArticle unspecified unspecified unspecified unspecified unspecified 0 
3 הרומן רומן הרומן noun masculine singular absolute unspecified unspecified  	O	null
4 מרים מרים מרים properName unspecified unspecified unspecified unspecified unspecified  	I_PERS	null
5 ( ( ( punctuation unspecified unspecified unspecified unspecified unspecified  	O	null
6 רומן רומן רומן noun masculine singular absolute unspecified unspecified  	O	null
7 גמור גמור גמור adjective masculine singular absolute unspecified unspecified  	O	null
8 , , , punctuation unspecified unspecified unspecified unspecified unspecified  	O	null
9 ) ) ) punctuation unspecified unspecified unspecified unspecified unspecified  	O	null
10 ###NUMBER### ###NUMBER### ###NUMBER### numeral unspecified unspecified unspecified unspecified unspecified  	I_DATE	null
11 העמידה העמיד העמידה verb feminine singular unspecified 3 past  	O	null
12 מהדורה מהדורה מהדורה noun feminine singular absolute unspecified unspecified  	O	null
13 מדעית מדעי מדעית adjective feminine singular absolute unspecified unspecified  	O	null
14 שלמה שלם שלמה adjective feminine singular absolute unspecified unspecified  	O	null
15 של של של shel-preposition unspecified unspecified unspecified unspecified unspecified  	O	null
16 ה ה היצירה definiteArticle unspecified unspecified unspecified unspecified unspecified 0 
16 היצירה יצירה היצירה noun feminine singular absolute unspecified unspecified  	O	null
17 , , , punctuation unspecified unspecified unspecified unspecified unspecified  	O	null
18 על על על preposition unspecified unspecified unspecified unspecified unspecified  	O	null
19 נוסחאותיה נוסחאותיה נוסחאותיה properName unspecified unspecified unspecified unspecified unspecified  	I_PERS	null
20 ו ו ומקורותיה conjunction unspecified unspecified unspecified unspecified unspecified 0 
20 מקורותי מקור ומקורותיה noun masculine plural absolute unspecified unspecified  
20 ה ה ומקורותיה possessive feminine singular unspecified 3 unspecified 0 	O	null
21 , , , punctuation unspecified unspecified unspecified unspecified unspecified  	O	null
22 ו ו והציעה conjunction unspecified unspecified unspecified unspecified unspecified 0 
22 הציעה הציע והציעה verb feminine singular unspecified 3 past  	O	null
23 תשובות תשובה תשובות noun feminine plural absolute unspecified unspecified  	O	null
24 מורכבות מורכב מורכבות adjective feminine plural absolute unspecified unspecified  	O	null
25 ל ל לשאלת preposition unspecified unspecified unspecified unspecified unspecified 0 
25 שאלת שאלה לשאלת noun feminine singular construct unspecified unspecified  	O	null
26 אחדוּת אחדוּת אחדוּת noun feminine plural construct unspecified unspecified  	O	null
27 ה ה המבנה definiteArticle unspecified unspecified unspecified unspecified unspecified 0 
27 המבנה מבנה המבנה noun masculine singular absolute unspecified unspecified  	O	null
28 של של שלה shel-preposition unspecified unspecified unspecified unspecified unspecified  
28 ה ה שלה pronomial feminine singular unspecified 3 unspecified 0 	O	null
29 , , , punctuation unspecified unspecified unspecified unspecified unspecified  	O	null
30 ש ש שהביקורת relativizer/subordinatingConjunction unspecified unspecified unspecified unspecified unspecified 0 
30 ה ה שהביקורת definiteArticle unspecified unspecified unspecified unspecified unspecified 0 
30 הביקורת ביקורת שהביקורת noun feminine singular absolute unspecified unspecified  	O	null
31 ה ה העברית definiteArticle unspecified unspecified unspecified unspecified unspecified 0 
31 העברית עברי העברית adjective feminine singular absolute unspecified unspecified  	O	null
32 התחבטה התחבט התחבטה verb feminine singular unspecified 3 past  	O	null
33 ב ב בה preposition unspecified unspecified unspecified unspecified unspecified  
33 ה ה בה pronomial feminine singular unspecified 3 unspecified 0 	O	null
34 עשרות CARD10 עשרות numeral feminine plural construct unspecified unspecified  	O	null
35 שנים שנה שנים noun feminine plural absolute unspecified unspecified  	O	null
36 . . . punctuation unspecified unspecified unspecified unspecified unspecified  	O	null

0 בעיקר בעיקר בעיקר adverb unspecified unspecified unspecified unspecified unspecified  	O	null
1 הראתה הראה הראתה verb feminine singular unspecified 3 past  	O	null
2 כיצד כיצד כיצד adverb unspecified unspecified unspecified unspecified unspecified  	O	null
3 מתנודדת התנודד מתנודדת verb feminine singular unspecified any beinoni  	O	null
4 ה ה היצירה definiteArticle unspecified unspecified unspecified unspecified unspecified 0 
4 היצירה יצירה היצירה noun feminine singular absolute unspecified unspecified  	O	null
5 בין בין בין preposition unspecified unspecified unspecified unspecified unspecified  	O	null
6 ה ה הפואטיקה definiteArticle unspecified unspecified unspecified unspecified unspecified 0 
6 הפואטיקה הפואטיקה הפואטיקה noun feminine singular absolute unspecified unspecified  	O	null
7 של של של shel-preposition unspecified unspecified unspecified unspecified unspecified  	O	null
8 ה ה הרומן definiteArticle unspecified unspecified unspecified unspecified unspecified 0 
8 הרומן רומן הרומן noun masculine singular absolute unspecified unspecified  	O	null
9 ה ה האירופי definiteArticle unspecified unspecified unspecified unspecified unspecified 0 
9 האירופי אירופי האירופי adjective masculine singular absolute unspecified unspecified  	O	null
10 ו ו ובין conjunction unspecified unspecified unspecified unspecified unspecified 0 
10 בין בין ובין preposition unspecified unspecified unspecified unspecified unspecified  	O	null
11 פואטיקה פואטיקה פואטיקה properName unspecified unspecified unspecified unspecified unspecified  	I_PERS	null
12 ליקוטית ליקוטית ליקוטית noun masculine-and-feminine singular absolute unspecified unspecified  	O	null
13 - - - punctuation unspecified unspecified unspecified unspecified unspecified  	O	null
14 אנתולוגית אנתולוגית אנתולוגית noun masculine-and-feminine singular absolute unspecified unspecified  	O	null
15 ה ה הנשענת definiteArticle unspecified unspecified unspecified unspecified unspecified 0 
15 הנשענת נשען הנשענת participle feminine singular absolute any unspecified  	O	null
16 על על על preposition unspecified unspecified unspecified unspecified unspecified  	O	null
17 דגמים דגם דגמים noun masculine plural absolute unspecified unspecified  	O	null
18 יהודיים יהודי יהודיים adjective masculine plural absolute unspecified unspecified  	O	null
19 קדומים קדום קדומים adjective masculine plural absolute unspecified unspecified  	I_LOC	null
20 . . . punctuation unspecified unspecified unspecified unspecified unspecified  	O	null

0 בכך בכך בכך adverb unspecified unspecified unspecified unspecified unspecified  	I_ORG	null
1 תרמה תרם תרמה verb feminine singular unspecified 3 past  	O	null
2 ל ל להבנת preposition unspecified unspecified unspecified unspecified unspecified 0 
2 הבנת הבנה להבנת noun feminine singular construct unspecified unspecified  	O	null
3 ייחודיות ייחודיות ייחודיותו noun feminine singular absolute unspecified unspecified  
3 ו ו ייחודיותו possessive masculine singular unspecified 3 unspecified 0 	O	null
4 של של של shel-preposition unspecified unspecified unspecified unspecified unspecified  	O	null
5 ברדיצ'בסקי ברדיצ'בסקי ברדיצ'בסקי properName unspecified unspecified unspecified unspecified unspecified  	I_PERS	null
6 כ כ כיוצר preposition unspecified unspecified unspecified unspecified unspecified 0 
6 יוצר יוצר כיוצר noun masculine singular construct unspecified unspecified  	O	null
7 ה ה הניצב definiteArticle unspecified unspecified unspecified unspecified unspecified 0 
7 הניצב ניצב הניצב noun masculine singular absolute unspecified unspecified  	O	null
8 ב ב ברגל preposition unspecified unspecified unspecified unspecified unspecified 0 
8 רגל רגל ברגל noun feminine singular absolute unspecified unspecified  	O	null
9 אחת CARD1 אחת numeral feminine singular absolute unspecified unspecified  	O	null
10 ב ב בספרות preposition unspecified unspecified unspecified unspecified unspecified 0 
10 ה ה בספרות definiteArticle unspecified unspecified unspecified unspecified unspecified 0 
10 הספרות ספרות בספרות noun feminine singular absolute unspecified unspecified  	O	null
11 ה ה המודרנית definiteArticle unspecified unspecified unspecified unspecified unspecified 0 
11 המודרנית מודרני המודרנית adjective feminine singular absolute unspecified unspecified  	O	null
12 ו ו וברגל conjunction unspecified unspecified unspecified unspecified unspecified 0 
12 ב ב וברגל preposition unspecified unspecified unspecified unspecified unspecified 0 
12 רגל רגל וברגל noun feminine singular absolute unspecified unspecified  	O	null
13 אחת CARD1 אחת numeral feminine singular absolute unspecified unspecified  	O	null
14 ב ב בעולם preposition unspecified unspecified unspecified unspecified unspecified 0 
14 עולם עולם בעולם noun masculine singular construct unspecified unspecified  	O	null
15 ה ה הסיפור definiteArticle unspecified unspecified unspecified unspecified unspecified 0 
15 הסיפור סיפור הסיפור noun masculine singular absolute unspecified unspecified  	O	null
16 ה ה היהודי definiteArticle unspecified unspecified unspecified unspecified unspecified 0 
16 היהודי יהודי היהודי adjective masculine singular absolute unspecified unspecified  	O	null
17 ה ה המסורתי definiteArticle unspecified unspecified unspecified unspecified unspecified 0 
17 המסורתי מסורתי המסורתי adjective masculine singular absolute unspecified unspecified  	O	null
18 . . . punctuation unspecified unspecified unspecified unspecified unspecified  	O	null

0 כמו כמו כמו conjunction unspecified unspecified unspecified unspecified unspecified  	O	null
1 כן כן כן conjunction unspecified unspecified unspecified unspecified unspecified  	O	null
2 ערכה ערך ערכה verb feminine singular unspecified 3 past  	O	null
3 את את את at-preposition unspecified unspecified unspecified unspecified unspecified  	O	null
4 קובץ קובץ קובץ noun masculine singular construct unspecified unspecified  	O	null
5 ה ה המאמרים definiteArticle unspecified unspecified unspecified unspecified unspecified 0 
5 המאמרים מאמר המאמרים noun masculine plural absolute unspecified unspecified  	O	null
6 הגות הגות הגות noun feminine singular absolute unspecified unspecified  	O	null
7 ו ו וסיפורת conjunction unspecified unspecified unspecified unspecified unspecified 0 
7 סיפורת סיפורת וסיפורת noun feminine singular absolute unspecified unspecified  	O	null
8 ב ב ביצירת preposition unspecified unspecified unspecified unspecified unspecified 0 
8 יצירת יצירה ביצירת noun feminine singular construct unspecified unspecified  	O	null
9 ברדיצ'בסקי ברדיצ'בסקי ברדיצ'בסקי properName unspecified unspecified unspecified unspecified unspecified  	I_ORG	null
10 ( ( ( punctuation unspecified unspecified unspecified unspecified unspecified  	O	null
11 ###NUMBER### ###NUMBER### ###NUMBER### numeral unspecified unspecified unspecified unspecified unspecified  	I_DATE	null
12 ) ) ) punctuation unspecified unspecified unspecified unspecified unspecified  	O	null
13 ו ו ואת conjunction unspecified unspecified unspecified unspecified unspecified 0 
13 את את ואת at-preposition unspecified unspecified unspecified unspecified unspecified  	O	null
14 קובץ קובץ קובץ noun masculine singular construct unspecified unspecified  	O	null
15 סיפורי סיפור סיפוריו noun masculine plural absolute unspecified unspecified  
15 ו ו סיפוריו possessive masculine singular unspecified 3 unspecified 0 	O	null
16 מ מ משני preposition unspecified unspecified unspecified unspecified unspecified 0 
16 שני שני משני noun masculine singular construct unspecified unspecified  	O	null
17 עולמות עולם עולמות noun masculine plural absolute unspecified unspecified  	O	null
18 ) ) ) punctuation unspecified unspecified unspecified unspecified unspecified  	O	null
19 . . . punctuation unspecified unspecified unspecified unspecified unspecified  	O	null
20 ###NUMBER### ###NUMBER### ###NUMBER### numeral unspecified unspecified unspecified unspecified unspecified  	I_DATE	null
21 תכונת תכונה תכונת noun feminine singular construct unspecified unspecified  	O	null
22 ה ה היסוד definiteArticle unspecified unspecified unspecified unspecified unspecified 0 
22 היסוד יסוד היסוד noun masculine singular absolute unspecified unspecified  	O	null
23 ה ה המאפיינת definiteArticle unspecified unspecified unspecified unspecified unspecified 0 
23 המאפיינת אפיין המאפיינת participle feminine singular absolute any unspecified  	O	null
24 את את את at-preposition unspecified unspecified unspecified unspecified unspecified  	O	null
25 עבודת עבודה עבודתה noun feminine singular absolute unspecified unspecified  
25 ה ה עבודתה possessive feminine singular unspecified 3 unspecified 0 	O	null
26 – – – punctuation unspecified unspecified unspecified unspecified unspecified  	O	null
27 חיפוש חיפוש חיפוש noun masculine singular absolute unspecified unspecified  	O	null
28 ה ה הרציפות definiteArticle unspecified unspecified unspecified unspecified unspecified 0 
28 הרציפות רציפות הרציפות noun feminine singular absolute unspecified unspecified  	O	null
29 בין בין בין preposition unspecified unspecified unspecified unspecified unspecified  	O	null
30 עולם עולם עולם noun masculine singular construct unspecified unspecified  	O	null
31 ה ה המסורת definiteArticle unspecified unspecified unspecified unspecified unspecified 0 
31 המסורת מסורת המסורת noun feminine singular absolute unspecified unspecified  	O	null
32 ה ה היהודית definiteArticle unspecified unspecified unspecified unspecified unspecified 0 
32 היהודית יהודי היהודית adjective feminine singular absolute unspecified unspecified  	O	null
33 ו ו וספרותו conjunction unspecified unspecified unspecified unspecified unspecified 0 
33 ספרות ספרות וספרותו noun feminine singular absolute unspecified unspecified  
33 ו ו וספרותו possessive masculine singular unspecified 3 unspecified 0 	O	null
34 ו ו ובין conjunction unspecified unspecified unspecified unspecified unspecified 0 
34 בין בין ובין preposition unspecified unspecified unspecified unspecified unspecified  	O	null
35 ה ה התרבות definiteArticle unspecified unspecified unspecified unspecified unspecified 0 
35 התרבות תרבות התרבות noun feminine singular absolute unspecified unspecified  	O	null
36 ה ה היהודית definiteArticle unspecified unspecified unspecified unspecified unspecified 0 
36 היהודית יהודי היהודית adjective feminine singular absolute unspecified unspecified  	O	null
37 ה ה המודרנית definiteArticle unspecified unspecified unspecified unspecified unspecified 0 
37 המודרנית מודרני המודרנית adjective feminine singular absolute unspecified unspecified  	O	null
38 – – – punctuation unspecified unspecified unspecified unspecified unspecified  	O	null
39 ניזונה ניזונה ניזונה adverb unspecified unspecified unspecified unspecified unspecified  	O	null
40 מ מ מחוויית preposition unspecified unspecified unspecified unspecified unspecified 0 
40 חוויית חוויה מחוויית noun feminine singular construct unspecified unspecified  	O	null
41 חיי חיים חייה noun masculine plural absolute unspecified unspecified  
41 ה ה חייה possessive feminine singular unspecified 3 unspecified 0 	O	null
42 כ כ כמי preposition unspecified unspecified unspecified unspecified unspecified 0 
42 מי מי כמי interrogative unspecified unspecified unspecified unspecified unspecified  	O	null
43 ש ש ש relativizer/subordinatingConjunction unspecified unspecified unspecified unspecified unspecified 0 	O	null
44 " " " punctuation unspecified unspecified unspecified unspecified unspecified  	O	null
45 הציצה הציץ הציצה verb feminine singular unspecified 3 past  	O	null
46 ו ו ונפגעה conjunction unspecified unspecified unspecified unspecified unspecified 0 
46 נפגעה נפגע ונפגעה verb feminine singular unspecified 3 past  	O	null
47 " " " punctuation unspecified unspecified unspecified unspecified unspecified  	O	null
48 ו ו ועם conjunction unspecified unspecified unspecified unspecified unspecified 0 
48 עם עם ועם preposition unspecified unspecified unspecified unspecified unspecified  	O	null
49 זאת זאת זאת pronoun feminine singular unspecified 3 unspecified  	O	null
50 הוסיפה הוסיף הוסיפה verb feminine singular unspecified 3 past  	O	null
51 לשמור שמר לשמור verb unspecified unspecified unspecified unspecified infinitive  	O	null
52 על על על preposition unspecified unspecified unspecified unspecified unspecified  	O	null
53 קשר קשר קשר noun masculine singular absolute unspecified unspecified  	O	null
54 אורגני אורגני אורגני adjective masculine singular absolute unspecified unspecified  	O	null
55 חם חם חם adjective masculine singular absolute unspecified unspecified  	O	null
56 עם עם עם preposition unspecified unspecified unspecified unspecified unspecified  	O	null
57 צור צור צור noun masculine singular construct unspecified unspecified  	I_LOC	null
58 מחצבת מחצבה מחצבתה noun feminine singular absolute unspecified unspecified  
58 ה ה מחצבתה possessive feminine singular unspecified 3 unspecified 0 	O	null
59 . . . punctuation unspecified unspecified unspecified unspecified unspecified  	O	null

0 ביטוי ביטוי ביטוי noun masculine singular absolute unspecified unspecified  	O	null
1 נוסף נוסף נוסף adjective masculine singular absolute unspecified unspecified  	O	null
2 ל ל לשילובתחומים preposition unspecified unspecified unspecified unspecified unspecified 0 
2 שילובתחומים שילובתחומים לשילובתחומים noun feminine plural absolute unspecified unspecified  	O	null
3 זה זה זה pronoun masculine singular unspecified 3 unspecified  	O	null
4 הוא הוא הוא pronoun masculine singular unspecified 3 unspecified  	O	null
5 ספר ספר ספרה noun masculine singular absolute unspecified unspecified  
5 ה ה ספרה possessive feminine singular unspecified 3 unspecified 0 	O	null
6 הלכה הלכה הלכה noun feminine singular absolute unspecified unspecified  	O	null
7 ו ו ואגדה conjunction unspecified unspecified unspecified unspecified unspecified 0 
7 אגדה אגדה ואגדה noun feminine singular absolute unspecified unspecified  	O	null
8 כ כ כצופן preposition unspecified unspecified unspecified unspecified unspecified 0 
8 ה ה כצופן definiteArticle unspecified unspecified unspecified unspecified unspecified 0 
8 הצופן צופן כצופן noun masculine singular absolute unspecified unspecified  	O	null
9 של של של shel-preposition unspecified unspecified unspecified unspecified unspecified  	O	null
10 ספרות ספרות ספרות noun feminine singular absolute unspecified unspecified  	O	null
11 ) ) ) punctuation unspecified unspecified unspecified unspecified unspecified  	O	null
12 . . . punctuation unspecified unspecified unspecified unspecified unspecified  	O	null
13 ###NUMBER### ###NUMBER### ###NUMBER### numeral unspecified unspecified unspecified unspecified unspecified  	I_DATE	null
14 מאמר מאמר מאמרו noun masculine singular absolute unspecified unspecified  
14 ו ו מאמרו possessive masculine singular unspecified 3 unspecified 0 	O	null
15 ה ה הנודע definiteArticle unspecified unspecified unspecified unspecified unspecified 0 
15 הנודע נודע הנודע adjective masculine singular absolute unspecified unspecified  	O	null
16 של של של shel-preposition unspecified unspecified unspecified unspecified unspecified  	O	null
17 ביאליק ביאליק ביאליק properName unspecified unspecified unspecified unspecified unspecified  	I_PERS	null
18 " " " punctuation unspecified unspecified unspecified unspecified unspecified  	O	null
19 הלכה הלכה הלכה noun feminine singular absolute unspecified unspecified  	O	null
20 ו ו ואגדה conjunction unspecified unspecified unspecified unspecified unspecified 0 
20 אגדה אגדה ואגדה noun feminine singular absolute unspecified unspecified  	O	null
21 " " " punctuation unspecified unspecified unspecified unspecified unspecified  	O	null
22 שימש שימש שימש verb masculine singular unspecified 3 past  	O	null
23 ל ל לה preposition unspecified unspecified unspecified unspecified unspecified  
23 ה ה לה pronomial feminine singular unspecified 3 unspecified 0 	O	null
24 נקודת נקודה נקודת noun feminine singular construct unspecified unspecified  	O	null
25 מוצא מוצא מוצא noun masculine singular absolute unspecified unspecified  	O	null
26 ל ל לזיהוי preposition unspecified unspecified unspecified unspecified unspecified 0 
26 זיהוי זיהוי לזיהוי noun feminine singular construct unspecified unspecified  	O	null
27 צופן צופן צופן noun masculine singular absolute unspecified unspecified  	O	null
28 עמוק עמוק עמוק adjective masculine singular absolute unspecified unspecified  	O	null
29 ה ה הטבוע definiteArticle unspecified unspecified unspecified unspecified unspecified 0 
29 הטבוע טבוע הטבוע adjective masculine singular absolute unspecified unspecified  	O	null
30 ב ב בספרות preposition unspecified unspecified unspecified unspecified unspecified 0 
30 ה ה בספרות definiteArticle unspecified unspecified unspecified unspecified unspecified 0 
30 הספרות ספרות בספרות noun feminine singular absolute unspecified unspecified  	O	null
31 ה ה העברית definiteArticle unspecified unspecified unspecified unspecified unspecified 0 
31 העברית עברי העברית adjective feminine singular absolute unspecified unspecified  	O	null
32 ו ו ובתרבות conjunction unspecified unspecified unspecified unspecified unspecified 0 
32 ב ב ובתרבות preposition unspecified unspecified unspecified unspecified unspecified 0 
32 ה ה ובתרבות definiteArticle unspecified unspecified unspecified unspecified unspecified 0 
32 התרבות תרבות ובתרבות noun feminine singular absolute unspecified unspecified  	O	null
33 ה ה היהודית definiteArticle unspecified unspecified unspecified unspecified unspecified 0 
33 היהודית יהודי היהודית adjective feminine singular absolute unspecified unspecified  	O	null
34 מ מ מימי preposition unspecified unspecified unspecified unspecified unspecified 0 
34 ימי יום מימי noun masculine plural construct unspecified unspecified  	O	null
35 חז"ל חז"ל חז"ל noun masculine singular absolute unspecified unspecified  	O	null
36 ו ו ועד conjunction unspecified unspecified unspecified unspecified unspecified 0 
36 עד עד ועד preposition unspecified unspecified unspecified unspecified unspecified  	O	null
37 ה ה המאה definiteArticle unspecified unspecified unspecified unspecified unspecified 0 
37 המאה ORD-CARD100 המאה numeral feminine plural absolute unspecified unspecified  	I_DATE	null
38 ה ה העשרים definiteArticle unspecified unspecified unspecified unspecified unspecified 0 
38 העשרים ORD-CARD20 העשרים numeral masculine-and-feminine plural absolute unspecified unspecified  	I_DATE	null
39 , , , punctuation unspecified unspecified unspecified unspecified unspecified  	O	null
40 ו ו ומתגלם conjunction unspecified unspecified unspecified unspecified unspecified 0 
40 מתגלם התגלם ומתגלם verb masculine singular unspecified any beinoni  	O	null
41 ב ב בשרשרת preposition unspecified unspecified unspecified unspecified unspecified 0 
41 שרשרת שרשרת בשרשרת noun feminine singular absolute unspecified unspecified  	O	null
42 של של של shel-preposition unspecified unspecified unspecified unspecified unspecified  	O	null
43 עימותים עימות עימותים noun feminine plural absolute unspecified unspecified  	O	null
44 ו ו ומזיגות conjunction unspecified unspecified unspecified unspecified unspecified 0 
44 מזיגות מזיגה ומזיגות noun feminine plural absolute unspecified unspecified  	O	null
45 בין בין בין preposition unspecified unspecified unspecified unspecified unspecified  	O	null
46 מציאות מציאות מציאות noun feminine singular absolute unspecified unspecified  	O	null
47 ל ל לדמיון preposition unspecified unspecified unspecified unspecified unspecified 0 
47 ה ה לדמיון definiteArticle unspecified unspecified unspecified unspecified unspecified 0 
47 הדמיון דמיון לדמיון noun masculine singular absolute unspecified unspecified  	O	null
48 , , , punctuation unspecified unspecified unspecified unspecified unspecified  	O	null
49 בין בין בין preposition unspecified unspecified unspecified unspecified unspecified  	O	null
50 חופש חופש חופש noun masculine singular absolute unspecified unspecified  	O	null
51 לסדר סידר לסדר verb unspecified unspecified unspecified unspecified infinitive  	O	null
52 ו ו ובין conjunction unspecified unspecified unspecified unspecified unspecified 0 
52 בין בין ובין preposition unspecified unspecified unspecified unspecified unspecified  	O	null
53 מסורת מסורת מסורת noun feminine singular absolute unspecified unspecified  	O	null
54 ל ל לחידוש preposition unspecified unspecified unspecified unspecified unspecified 0 
54 ה ה לחידוש definiteArticle unspecified unspecified unspecified unspecified unspecified 0 
54 החידוש חידוש לחידוש noun masculine singular absolute unspecified unspecified  	O	null
55 . . . punctuation unspecified unspecified unspecified unspecified unspecified  	O	null

0 ספרים ספר ספרים noun masculine plural absolute unspecified unspecified  	O	null
1 נוספים נוסף נוספים adjective masculine plural absolute unspecified unspecified  	O	null
2 ש ש שערכה relativizer/subordinatingConjunction unspecified unspecified unspecified unspecified unspecified 0 
2 ערכה ערך שערכה verb feminine singular unspecified 3 past  	O	null
3 : : : punctuation unspecified unspecified unspecified unspecified unspecified  	O	null
4 מוסכמות מוסכמה מוסכמות noun feminine plural absolute unspecified unspecified  	O	null
5 ו ו ומשברים conjunction unspecified unspecified unspecified unspecified unspecified 0 
5 משברים משבר ומשברים noun masculine plural absolute unspecified unspecified  	O	null
6 ב ב בספרותנו preposition unspecified unspecified unspecified unspecified unspecified 0 
6 ספרות ספרות בספרותנו noun feminine singular absolute unspecified unspecified  
6 נו נו בספרותנו possessive masculine-and-feminine plural unspecified 1 unspecified 0 	O	null
7 ( ( ( punctuation unspecified unspecified unspecified unspecified unspecified  	O	null
8 ###NUMBER### ###NUMBER### ###NUMBER### numeral unspecified unspecified unspecified unspecified unspecified  	I_DATE	null
9 ) ) ) punctuation unspecified unspecified unspecified unspecified unspecified  	O	null
10 ו ו וזרמים conjunction unspecified unspecified unspecified unspecified unspecified 0 
10 זרמים זרם וזרמים noun masculine plural absolute unspecified unspecified  	O	null
11 ו ו וצורות conjunction unspecified unspecified unspecified unspecified unspecified 0 
11 צורות צורה וצורות noun feminine plural absolute unspecified unspecified  	O	null
12 ב ב בספרות preposition unspecified unspecified unspecified unspecified unspecified 0 
12 ה ה בספרות definiteArticle unspecified unspecified unspecified unspecified unspecified 0 
12 הספרות ספרות בספרות noun feminine singular absolute unspecified unspecified  	O	null
13 ה ה העברית definiteArticle unspecified unspecified unspecified unspecified unspecified 0 
13 העברית עברי העברית adjective feminine singular absolute unspecified unspecified  	O	null
14 ה ה החדשה definiteArticle unspecified unspecified unspecified unspecified unspecified 0 
14 החדשה חדש החדשה adjective feminine singular absolute unspecified unspecified  	O	null
15 ( ( ( punctuation unspecified unspecified unspecified unspecified unspecified  	O	null
16 ###NUMBER### ###NUMBER### ###NUMBER### numeral unspecified unspecified unspecified unspecified unspecified  	I_DATE	null
17 ) ) ) punctuation unspecified unspecified unspecified unspecified unspecified  	O	null
18 מאת מאת מאת preposition unspecified unspecified unspecified unspecified unspecified  	O	null
19 שמעון שמעון שמעון properName unspecified unspecified unspecified unspecified unspecified  	I_PERS	null
20 הלקין הלקין הלקין properName unspecified unspecified unspecified unspecified unspecified  	I_PERS	null
21 , , , punctuation unspecified unspecified unspecified unspecified unspecified  	O	null
22 ו ו וסיפורי conjunction unspecified unspecified unspecified unspecified unspecified 0 
22 סיפורי סיפור וסיפורי noun masculine plural construct unspecified unspecified  	O	null
23 ב ב במדבר preposition unspecified unspecified unspecified unspecified unspecified 0 
23 ה ה במדבר definiteArticle unspecified unspecified unspecified unspecified unspecified 0 
23 המדבר מדבר במדבר noun masculine singular absolute unspecified unspecified  	O	null
24 של של של shel-preposition unspecified unspecified unspecified unspecified unspecified  	O	null
25 דוד דוד דוד properName unspecified unspecified unspecified unspecified unspecified  	I_PERS	null
26 פרישמן פרישמן פרישמן properName unspecified unspecified unspecified unspecified unspecified  	I_PERS	null
27 ) ) ) punctuation unspecified unspecified unspecified unspecified unspecified  	O	null
28 . . . punctuation unspecified unspecified unspecified unspecified unspecified  	O	null
29 ###NUMBER### ###NUMBER### ###NUMBER### numeral unspecified unspecified unspecified unspecified unspecified  	I_DATE	null
30 כמו כמו כמו conjunction unspecified unspecified unspecified unspecified unspecified  	O	null
31 כן כן כן conjunction unspecified unspecified unspecified unspecified unspecified  	O	null
32 השתתפה השתתף השתתפה verb feminine singular unspecified 3 past  	O	null
33 , , , punctuation unspecified unspecified unspecified unspecified unspecified  	O	null
34 ל ל לצדם preposition unspecified unspecified unspecified unspecified unspecified 0 
34 צד צד לצדם noun masculine singular absolute unspecified unspecified  
34 ם ם לצדם possessive masculine plural unspecified 3 unspecified 0 	O	null
35 של של של shel-preposition unspecified unspecified unspecified unspecified unspecified  	O	null
36 דן דן דן properName unspecified unspecified unspecified unspecified unspecified  	I_PERS	null
37 מירון מירון מירון properName unspecified unspecified unspecified unspecified unspecified  	I_PERS	null
38 ו ו ונתן conjunction unspecified unspecified unspecified unspecified unspecified 0 
38 נתן נתן ונתן properName unspecified unspecified unspecified unspecified unspecified  	B_PERS	null
39 זך זך זך adjective masculine singular absolute unspecified unspecified  	O	null
40 , , , punctuation unspecified unspecified unspecified unspecified unspecified  	O	null
41 ב ב בעריכת preposition unspecified unspecified unspecified unspecified unspecified 0 
41 עריכת עריכה בעריכת noun feminine singular construct unspecified unspecified  	O	null
42 שני שני שני noun masculine singular construct unspecified unspecified  	O	null
43 ה ה הכרכים definiteArticle unspecified unspecified unspecified unspecified unspecified 0 
43 הכרכים כרך הכרכים noun masculine plural absolute unspecified unspecified  	O	null
44 ה ה הראשונים definiteArticle unspecified unspecified unspecified unspecified unspecified 0 
44 הראשונים ORD1 הראשונים numeral masculine plural absolute unspecified unspecified  	I_DATE	null
45 של של של shel-preposition unspecified unspecified unspecified unspecified unspecified  	I_DATE	null
46 ה ה המאסף definiteArticle unspecified unspecified unspecified unspecified unspecified 0 
46 המאסף מאסף המאסף noun masculine singular absolute unspecified unspecified  	O	null
47 אִגרא אִגרא אִגרא properName unspecified unspecified unspecified unspecified unspecified  	I_PERS	null
48 , , , punctuation unspecified unspecified unspecified unspecified unspecified  	O	null
49 ###NUMBER### ###NUMBER### ###NUMBER### numeral unspecified unspecified unspecified unspecified unspecified  	I_DATE	null
50 ###NUMBER### ###NUMBER### ###NUMBER### numeral unspecified unspecified unspecified unspecified unspecified  	I_DATE	null
51 ) ) ) punctuation unspecified unspecified unspecified unspecified unspecified  	O	null
52 . . . punctuation unspecified unspecified unspecified unspecified unspecified  	O	null

0 תרומת תרומה תרומתה noun feminine singular absolute unspecified unspecified  
0 ה ה תרומתה possessive feminine singular unspecified 3 unspecified 0 	O	null
1 ה ה העיקרית definiteArticle unspecified unspecified unspecified unspecified unspecified 0 
1 העיקרית עיקרי העיקרית adjective feminine singular absolute unspecified unspecified  	O	null
2 ל ל לחקר preposition unspecified unspecified unspecified unspecified unspecified 0 
2 חקר חקר לחקר noun masculine singular construct unspecified unspecified  	O	null
3 ה ה הספרות definiteArticle unspecified unspecified unspecified unspecified unspecified 0 
3 הספרות ספרות הספרות noun feminine singular absolute unspecified unspecified  	O	null
4 ה ה הישראלית definiteArticle unspecified unspecified unspecified unspecified unspecified 0 
4 הישראלית ישראלי הישראלית adjective feminine singular absolute unspecified unspecified  	O	null
5 מרוכזת מרוכז מרוכזת adjective feminine singular absolute unspecified unspecified  	O	null
6 ב ב בסדרת preposition unspecified unspecified unspecified unspecified unspecified 0 
6 סדרת סדרה בסדרת noun feminine singular construct unspecified unspecified  	O	null
7 מאמרים מאמר מאמרים noun masculine plural absolute unspecified unspecified  	O	null
8 על על על preposition unspecified unspecified unspecified unspecified unspecified  	O	null
9 ה ה הרומן definiteArticle unspecified unspecified unspecified unspecified unspecified 0 
9 הרומן רומן הרומן noun masculine singular absolute unspecified unspecified  	O	null
10 זכרון זיכרון זכרון noun masculine singular construct unspecified unspecified  	O	null
11 דברים דבר דברים noun masculine plural absolute unspecified unspecified  	O	null
12 של של של shel-preposition unspecified unspecified unspecified unspecified unspecified  	O	null
13 יעקב יעקב יעקב properName unspecified unspecified unspecified unspecified unspecified  	I_PERS	null
14 שבתאי שבתאי שבתאי properName unspecified unspecified unspecified unspecified unspecified  	I_PERS	null
15 , , , punctuation unspecified unspecified unspecified unspecified unspecified  	O	null
16 ש ש שפורסמו relativizer/subordinatingConjunction unspecified unspecified unspecified unspecified unspecified 0 
16 פורסמו פורסם שפורסמו verb masculine-and-feminine plural unspecified 3 past  	O	null
17 בין בין בין preposition unspecified unspecified unspecified unspecified unspecified  	O	null
18 ###NUMBER### ###NUMBER### ###NUMBER### numeral unspecified unspecified unspecified unspecified unspecified  	I_DATE	null
19 ל ל ל preposition unspecified unspecified unspecified unspecified unspecified 0 	I_ORG	null
20 - - - punctuation unspecified unspecified unspecified unspecified unspecified  	I_ORG	null
21 ###NUMBER### ###NUMBER### ###NUMBER### numeral unspecified unspecified unspecified unspecified unspecified  	I_DATE	null
22 . . . punctuation unspecified unspecified unspecified unspecified unspecified  	O	null

0 עלפי עילף עלפי verb feminine singular unspecified 2 imperative  	O	null
1 תפישת תפישה תפישתה noun feminine singular absolute unspecified unspecified  
1 ה ה תפישתה possessive feminine singular unspecified 3 unspecified 0 	O	null
2 מצויים מצוי מצויים adjective masculine plural absolute unspecified unspecified  	O	null
3 ב ב בספר preposition unspecified unspecified unspecified unspecified unspecified 0 
3 ספר ספר בספר noun masculine singular construct unspecified unspecified  	O	null
4 יסודות יסוד יסודות noun masculine plural absolute unspecified unspecified  	O	null
5 של של של shel-preposition unspecified unspecified unspecified unspecified unspecified  	O	null
6 התעלות התעלות התעלות noun feminine singular absolute unspecified unspecified  	O	null
7 רוחנית רוחני רוחנית adjective feminine singular absolute unspecified unspecified  	O	null
8 ו ו וחתירה conjunction unspecified unspecified unspecified unspecified unspecified 0 
8 חתירה חתירה וחתירה noun feminine singular absolute unspecified unspecified  	O	null
9 ל ל לגאולה preposition unspecified unspecified unspecified unspecified unspecified 0 
9 ה ה לגאולה definiteArticle unspecified unspecified unspecified unspecified unspecified 0 
9 הגאולה גאל לגאולה participle feminine singular absolute any unspecified  	O	null
10 ולהתגלוּת ולהתגלוּת ולהתגלוּת properName unspecified unspecified unspecified unspecified unspecified  	I_PERS	null
11 , , , punctuation unspecified unspecified unspecified unspecified unspecified  	O	null
12 ב ב בניגוד preposition unspecified unspecified unspecified unspecified unspecified 0 
12 ניגוד ניגוד בניגוד noun masculine singular absolute unspecified unspecified  	O	null
13 ל ל לראייתו preposition unspecified unspecified unspecified unspecified unspecified 0 
13 ראיית ראייה לראייתו noun feminine singular absolute unspecified unspecified  
13 ו ו לראייתו possessive masculine singular unspecified 3 unspecified 0 	O	null
14 ה ה המקובלת definiteArticle unspecified unspecified unspecified unspecified unspecified 0 
14 המקובלת מקובל המקובלת adjective feminine singular absolute unspecified unspecified  	O	null
15 כ כ כרומן preposition unspecified unspecified unspecified unspecified unspecified 0 
15 ה ה כרומן definiteArticle unspecified unspecified unspecified unspecified unspecified 0 
15 הרומן רומן כרומן noun masculine singular absolute unspecified unspecified  	O	null
16 של של של shel-preposition unspecified unspecified unspecified unspecified unspecified  	O	null
17 שקיעה שקיעה שקיעה noun feminine singular absolute unspecified unspecified  	O	null
18 ו ו והתפוררות conjunction unspecified unspecified unspecified unspecified unspecified 0 
18 התפוררות התפוררות והתפוררות noun feminine singular absolute unspecified unspecified  	O	null
19 . . . punctuation unspecified unspecified unspecified unspecified unspecified  	O	null

0 בעל בעל בעלה noun masculine singular absolute unspecified unspecified  
0 ה ה בעלה possessive feminine singular unspecified 3 unspecified 0 	O	null
1 הוא הוא הוא pronoun masculine singular unspecified 3 unspecified  	O	null
2 ה ה המשורר definiteArticle unspecified unspecified unspecified unspecified unspecified 0 
2 המשורר משורר המשורר noun masculine singular absolute unspecified unspecified  	O	null
3 , , , punctuation unspecified unspecified unspecified unspecified unspecified  	O	null
4 ה ה המתרגם definiteArticle unspecified unspecified unspecified unspecified unspecified 0 
4 המתרגם מתרגם המתרגם noun masculine singular absolute unspecified unspecified  	O	null
5 ו ו והמחנך conjunction unspecified unspecified unspecified unspecified unspecified 0 
5 ה ה והמחנך definiteArticle unspecified unspecified unspecified unspecified unspecified 0 
5 המחנך מחנך והמחנך noun masculine singular absolute unspecified unspecified  	O	null
6 אליעזר אליעזר אליעזר properName unspecified unspecified unspecified unspecified unspecified  	I_PERS	null
7 כ כ כגן preposition unspecified unspecified unspecified unspecified unspecified 0 
7 גן גן כגן noun masculine singular construct unspecified unspecified  	O	null
8 - - - punctuation unspecified unspecified unspecified unspecified unspecified  	O	null
9 ###NUMBER### ###NUMBER### ###NUMBER### numeral unspecified unspecified unspecified unspecified unspecified  	I_DATE	null
10 ) ) ) punctuation unspecified unspecified unspecified unspecified unspecified  	O	null
11 . . . punctuation unspecified unspecified unspecified unspecified unspecified  	O	null

0 ###NUMBER### ###NUMBER### ###NUMBER### numeral unspecified unspecified unspecified unspecified unspecified  	I_DATE	null
1 References References References foreign unspecified unspecified unspecified unspecified unspecified  	O	null
2 : : : punctuation unspecified unspecified unspecified unspecified unspecified  	O	null

