0 Name Name Name foreign unspecified unspecified unspecified unspecified unspecified  	O	null
1 : : : punctuation unspecified unspecified unspecified unspecified unspecified  	O	null
2 עבאסי עבאסי עבאסי adjective masculine singular absolute unspecified unspecified  	O	null
3 , , , punctuation unspecified unspecified unspecified unspecified unspecified  	O	null
4 מחמוד מחמוד מחמוד properName unspecified unspecified unspecified unspecified unspecified  	I_PERS	null
5 Birth Birth Birth foreign unspecified unspecified unspecified unspecified unspecified  	O	null
6 Year Year Year foreign unspecified unspecified unspecified unspecified unspecified  	O	null
7 : : : punctuation unspecified unspecified unspecified unspecified unspecified  	O	null
8 ###NUMBER### ###NUMBER### ###NUMBER### numeral unspecified unspecified unspecified unspecified unspecified  	I_DATE	null
9 Birth Birth Birth foreign unspecified unspecified unspecified unspecified unspecified  	O	null
10 Place Place Place foreign unspecified unspecified unspecified unspecified unspecified  	O	null
11 : : : punctuation unspecified unspecified unspecified unspecified unspecified  	O	null
12 חיפה חיפה חיפה properName unspecified unspecified unspecified unspecified unspecified  	I_LOC	null
13 Occupation Occupation Occupation foreign unspecified unspecified unspecified unspecified unspecified  	O	null
14 : : : punctuation unspecified unspecified unspecified unspecified unspecified  	O	null
15 מחזאי מחזאי מחזאי noun masculine singular absolute unspecified unspecified  	O	null
16 , , , punctuation unspecified unspecified unspecified unspecified unspecified  	O	null
17 סופר סופר סופר noun masculine singular absolute unspecified unspecified  	O	null
18 , , , punctuation unspecified unspecified unspecified unspecified unspecified  	O	null
19 מתרגם תרגם מתרגם verb masculine singular unspecified any beinoni  	O	null
20 וחוקרבשפה וחוקרבשפה וחוקרבשפה preposition unspecified unspecified unspecified unspecified unspecified  
20 ו ו וחוקרבשפה pronomial masculine singular unspecified 3 unspecified 0 	O	null
21 ה ה הערבית definiteArticle unspecified unspecified unspecified unspecified unspecified 0 
21 הערבית ערבית הערבית noun feminine singular absolute unspecified unspecified  	O	null
22 Entry Entry Entry foreign unspecified unspecified unspecified unspecified unspecified  	O	null
23 writer writer writer foreign unspecified unspecified unspecified unspecified unspecified  	O	null
24 : : : punctuation unspecified unspecified unspecified unspecified unspecified  	O	null
25 חנה חנה חנה properName feminine singular unspecified unspecified unspecified  	I_PERS	null
26 עמית עמית עמית properName unspecified unspecified unspecified unspecified unspecified  	I_PERS	null
27 - - - properName unspecified unspecified unspecified unspecified unspecified  	I_PERS	null
28 כוכבי כוכבי כוכבי properName unspecified unspecified unspecified unspecified unspecified  	I_PERS	null
29 ו ו ואריאל conjunction unspecified unspecified unspecified unspecified unspecified 0 
29 אריאל אריאל ואריאל properName unspecified unspecified unspecified unspecified unspecified  	B_PERS	null
30 שיטרית שיטרית שיטרית properName unspecified unspecified unspecified unspecified unspecified  	I_PERS	null
31 Entry Entry Entry foreign unspecified unspecified unspecified unspecified unspecified  	O	null
32 Value Value Value foreign unspecified unspecified unspecified unspecified unspecified  	O	null
33 : : : punctuation unspecified unspecified unspecified unspecified unspecified  	O	null
34 נולד נולד נולד verb masculine singular unspecified 3 past  	O	null
35 ב ב בחיפה preposition unspecified unspecified unspecified unspecified unspecified 0 
35 חיפה חיפה בחיפה properName unspecified unspecified unspecified unspecified unspecified  	I_LOC	null
36 . . . punctuation unspecified unspecified unspecified unspecified unspecified  	O	null

0 מתגורר התגורר מתגורר verb masculine singular unspecified any beinoni  	I_LOC	null
1 ב ב בשפרעם preposition unspecified unspecified unspecified unspecified unspecified 0 
1 שפרעם שפרעם בשפרעם properName unspecified unspecified unspecified unspecified unspecified  	I_LOC	null
2 . . . punctuation unspecified unspecified unspecified unspecified unspecified  	O	null

0 בוגר בוגר בוגר noun masculine singular construct unspecified unspecified  	O	null
1 תואר תואר תואר noun masculine singular absolute unspecified unspecified  	O	null
2 ראשון ORD1 ראשון numeral masculine singular absolute unspecified unspecified  	O	null
3 ב ב בספרות preposition unspecified unspecified unspecified unspecified unspecified 0 
3 ספרות ספרות בספרות noun feminine singular absolute unspecified unspecified  	O	null
4 ערבית ערבי ערבית adjective feminine singular absolute unspecified unspecified  	O	null
5 ו ו ובספרות conjunction unspecified unspecified unspecified unspecified unspecified 0 
5 ב ב ובספרות preposition unspecified unspecified unspecified unspecified unspecified 0 
5 ספרות ספרות ובספרות noun feminine singular absolute unspecified unspecified  	O	null
6 עברית עברי עברית adjective feminine singular absolute unspecified unspecified  	O	null
7 מ מ מאוניברסיטת preposition unspecified unspecified unspecified unspecified unspecified 0 
7 אוניברסיטת אוניברסיטה מאוניברסיטת noun feminine singular construct unspecified unspecified  	I_ORG	null
8 חיפה חיפה חיפה properName unspecified unspecified unspecified unspecified unspecified  	I_ORG	null
9 ) ) ) punctuation unspecified unspecified unspecified unspecified unspecified  	O	null
10 . . . punctuation unspecified unspecified unspecified unspecified unspecified  	O	null
11 בעל בעל בעל noun masculine singular construct unspecified unspecified  	O	null
12 ###NUMBER### ###NUMBER### ###NUMBER### numeral unspecified unspecified unspecified unspecified unspecified  	I_DATE	null
13 תואר תואר תואר noun masculine singular absolute unspecified unspecified  	O	null
14 שני שני שני noun masculine singular absolute unspecified unspecified  	O	null
15 ב ב בספרות preposition unspecified unspecified unspecified unspecified unspecified 0 
15 ספרות ספרות בספרות noun feminine singular absolute unspecified unspecified  	O	null
16 עברית עברי עברית adjective feminine singular absolute unspecified unspecified  	O	null
17 ) ) ) punctuation unspecified unspecified unspecified unspecified unspecified  	O	null
18 ו ו ותואר conjunction unspecified unspecified unspecified unspecified unspecified 0 
18 תואר תואר ותואר noun masculine singular absolute unspecified unspecified  	O	null
19 ###NUMBER### ###NUMBER### ###NUMBER### numeral unspecified unspecified unspecified unspecified unspecified  	I_DATE	null
20 דוקטור דוקטור דוקטור noun masculine singular absolute unspecified unspecified  	O	null
21 ב ב בנושא preposition unspecified unspecified unspecified unspecified unspecified 0 
21 נושא נושא בנושא noun masculine singular construct unspecified unspecified  	O	null
22 ספרות ספרות ספרות noun feminine singular absolute unspecified unspecified  	O	null
23 ערבית ערבי ערבית adjective feminine singular absolute unspecified unspecified  	O	null
24 ב ב בישראל preposition unspecified unspecified unspecified unspecified unspecified 0 
24 ישראל ישראל בישראל properName unspecified unspecified unspecified unspecified unspecified  	I_LOC	null
25 , , , punctuation unspecified unspecified unspecified unspecified unspecified  	O	null
26 שניים שניים שניהם pronoun unspecified unspecified unspecified unspecified unspecified  
26 הם הם שניהם pronomial masculine plural unspecified 3 unspecified 0 	O	null
27 מ מ מהאוניברסיטה preposition unspecified unspecified unspecified unspecified unspecified 0 
27 ה ה מהאוניברסיטה definiteArticle unspecified unspecified unspecified unspecified unspecified 0 
27 האוניברסיטה אוניברסיטה מהאוניברסיטה noun feminine singular absolute unspecified unspecified  	O	null
28 ה ה העברית definiteArticle unspecified unspecified unspecified unspecified unspecified 0 
28 העברית עברי העברית adjective feminine singular absolute unspecified unspecified  	O	null
29 ב ב בירושלים preposition unspecified unspecified unspecified unspecified unspecified 0 
29 ירושלים ירושלים בירושלים properName unspecified unspecified unspecified unspecified unspecified  	I_LOC	null
30 ) ) ) punctuation unspecified unspecified unspecified unspecified unspecified  	O	null
31 . . . punctuation unspecified unspecified unspecified unspecified unspecified  	O	null
32 ###NUMBER### ###NUMBER### ###NUMBER### numeral unspecified unspecified unspecified unspecified unspecified  	I_DATE	null
33 ב ב בשנים preposition unspecified unspecified unspecified unspecified unspecified 0 
33 שנים שנה בשנים noun feminine plural absolute unspecified unspecified  	O	null
34 ###NUMBER### ###NUMBER### ###NUMBER### numeral unspecified unspecified unspecified unspecified unspecified  	I_DATE	null
35 ו ו ו conjunction unspecified unspecified unspecified unspecified unspecified 0 	O	null
36 - - - punctuation unspecified unspecified unspecified unspecified unspecified  	O	null
37 ###NUMBER### ###NUMBER### ###NUMBER### numeral unspecified unspecified unspecified unspecified unspecified  	I_DATE	null
38 שימש שימש שימש verb masculine singular unspecified 3 past  	O	null
39 כ כ כעורך preposition unspecified unspecified unspecified unspecified unspecified 0 
39 עורך עורך כעורך noun masculine singular construct unspecified unspecified  	O	null
40 ספרותי ספרותי ספרותי adjective masculine singular absolute unspecified unspecified  	O	null
41 ב ב בעיתון preposition unspecified unspecified unspecified unspecified unspecified 0 
41 ה ה בעיתון definiteArticle unspecified unspecified unspecified unspecified unspecified 0 
41 העיתון עיתון בעיתון noun masculine singular absolute unspecified unspecified  	O	null
42 אל אל אל preposition unspecified unspecified unspecified unspecified unspecified  	O	null
43 - - - punctuation unspecified unspecified unspecified unspecified unspecified  	O	null
44 אנבאא אנבאא אנבאא properName unspecified unspecified unspecified unspecified unspecified  	I_ORG	null
45 . . . punctuation unspecified unspecified unspecified unspecified unspecified  	O	null

0 ב ב ב preposition unspecified unspecified unspecified unspecified unspecified 0 	O	null
1 - - - punctuation unspecified unspecified unspecified unspecified unspecified  	O	null
2 ###NUMBER### ###NUMBER### ###NUMBER### numeral unspecified unspecified unspecified unspecified unspecified  	I_DATE	null
3 ייסד ייסד ייסד verb masculine singular unspecified 3 past  	O	null
4 את את את at-preposition unspecified unspecified unspecified unspecified unspecified  	O	null
5 הוצאת הוצאה הוצאת noun feminine singular construct unspecified unspecified  	O	null
6 דאר דאר דאר properName unspecified unspecified unspecified unspecified unspecified  	I_PERS	null
7 אל אל אל properName unspecified unspecified unspecified unspecified unspecified  	I_PERS	null
8 - - - properName unspecified unspecified unspecified unspecified unspecified  	I_PERS	null
9 מש מש משרק temporalSubConj unspecified unspecified unspecified unspecified unspecified 0 
9 רק רק משרק conjunction unspecified unspecified unspecified unspecified unspecified  	O	null
10 ב ב בשפרעם preposition unspecified unspecified unspecified unspecified unspecified 0 
10 שפרעם שפרעם בשפרעם properName unspecified unspecified unspecified unspecified unspecified  	I_LOC	null
11 , , , punctuation unspecified unspecified unspecified unspecified unspecified  	O	null
12 ו ו וב conjunction unspecified unspecified unspecified unspecified unspecified 0 
12 ב ב וב preposition unspecified unspecified unspecified unspecified unspecified 0 	O	null
13 - - - punctuation unspecified unspecified unspecified unspecified unspecified  	O	null
14 ###NUMBER### ###NUMBER### ###NUMBER### numeral unspecified unspecified unspecified unspecified unspecified  	I_DATE	null
15 החל החל החל verb masculine singular unspecified 3 past  	O	null
16 לערוך ערך לערוך verb unspecified unspecified unspecified unspecified infinitive  	O	null
17 את את את at-preposition unspecified unspecified unspecified unspecified unspecified  	O	null
18 כתב כתב כתב noun masculine singular construct unspecified unspecified  	O	null
19 ה ה העת definiteArticle unspecified unspecified unspecified unspecified unspecified 0 
19 העת עת העת noun feminine singular absolute unspecified unspecified  	O	null
20 ה ה הספרותי definiteArticle unspecified unspecified unspecified unspecified unspecified 0 
20 הספרותי ספרותי הספרותי adjective masculine singular absolute unspecified unspecified  	O	null
21 אל אל אל properName unspecified unspecified unspecified unspecified unspecified  	I_LOC	null
22 - - - punctuation unspecified unspecified unspecified unspecified unspecified  	O	null
23 ש ש שרק relativizer/subordinatingConjunction unspecified unspecified unspecified unspecified unspecified 0 
23 רק רק שרק adverb unspecified unspecified unspecified unspecified unspecified  	O	null
24 . . . punctuation unspecified unspecified unspecified unspecified unspecified  	O	null

0 ב ב בשנים preposition unspecified unspecified unspecified unspecified unspecified 0 
0 שנים שנה בשנים noun feminine plural absolute unspecified unspecified  	O	null
1 ###NUMBER### ###NUMBER### ###NUMBER### numeral unspecified unspecified unspecified unspecified unspecified  	I_DATE	null
2 ו ו ו conjunction unspecified unspecified unspecified unspecified unspecified 0 	O	null
3 - - - punctuation unspecified unspecified unspecified unspecified unspecified  	O	null
4 ###NUMBER### ###NUMBER### ###NUMBER### numeral unspecified unspecified unspecified unspecified unspecified  	I_DATE	null
5 שימש שימש שימש verb masculine singular unspecified 3 past  	O	null
6 סגן סגן סגן noun masculine singular construct unspecified unspecified  	O	null
7 שר שר שר noun masculine singular construct unspecified unspecified  	O	null
8 ה ה החינוך definiteArticle unspecified unspecified unspecified unspecified unspecified 0 
8 החינוך חינוך החינוך noun masculine singular absolute unspecified unspecified  	O	null
9 ל ל לענייני preposition unspecified unspecified unspecified unspecified unspecified 0 
9 ענייני עניין לענייני noun masculine plural construct unspecified unspecified  	O	null
10 ה ה התרבות definiteArticle unspecified unspecified unspecified unspecified unspecified 0 
10 התרבות תרבות התרבות noun feminine singular absolute unspecified unspecified  	O	null
11 ה ה הערבית definiteArticle unspecified unspecified unspecified unspecified unspecified 0 
11 הערבית ערבי הערבית adjective feminine singular absolute unspecified unspecified  	O	null
12 ו ו והנוער conjunction unspecified unspecified unspecified unspecified unspecified 0 
12 ה ה והנוער definiteArticle unspecified unspecified unspecified unspecified unspecified 0 
12 הנוער נוער והנוער noun masculine singular absolute unspecified unspecified  	O	null
13 . . . punctuation unspecified unspecified unspecified unspecified unspecified  	O	null

0 מ מ מ preposition unspecified unspecified unspecified unspecified unspecified 0 	O	null
1 - - - punctuation unspecified unspecified unspecified unspecified unspecified  	O	null
2 ###NUMBER### ###NUMBER### ###NUMBER### numeral unspecified unspecified unspecified unspecified unspecified  	I_DATE	null
3 ועד ועד ועד noun masculine singular absolute unspecified unspecified  	O	null
4 ###NUMBER### ###NUMBER### ###NUMBER### numeral unspecified unspecified unspecified unspecified unspecified  	I_DATE	null
5 שימש שימש שימש verb masculine singular unspecified 3 past  	O	null
6 כ כ כמרצה preposition unspecified unspecified unspecified unspecified unspecified 0 
6 ה ה כמרצה definiteArticle unspecified unspecified unspecified unspecified unspecified 0 
6 המרצה הרצה כמרצה participle masculine singular absolute any unspecified  	I_ORG	null
7 ב ב באוניברסיטת preposition unspecified unspecified unspecified unspecified unspecified 0 
7 אוניברסיטת אוניברסיטה באוניברסיטת noun feminine singular construct unspecified unspecified  	I_ORG	null
8 חיפה חיפה חיפה properName unspecified unspecified unspecified unspecified unspecified  	I_ORG	null
9 ב ב בחוגים preposition unspecified unspecified unspecified unspecified unspecified 0 
9 חוגים חוג בחוגים noun masculine plural absolute unspecified unspecified  	I_ORG	null
10 ל ל לערבית preposition unspecified unspecified unspecified unspecified unspecified 0 
10 ערבית ערבית לערבית properName feminine singular unspecified unspecified unspecified  	I_ORG	null
11 ו ו ולחינוך conjunction unspecified unspecified unspecified unspecified unspecified 0 
11 ל ל ולחינוך preposition unspecified unspecified unspecified unspecified unspecified 0 
11 ה ה ולחינוך definiteArticle unspecified unspecified unspecified unspecified unspecified 0 
11 החינוך חינוך ולחינוך noun masculine singular absolute unspecified unspecified  	O	null
12 . . . punctuation unspecified unspecified unspecified unspecified unspecified  	O	null

0 ה ה המחזה definiteArticle unspecified unspecified unspecified unspecified unspecified 0 
0 המחזה מחזה המחזה noun masculine singular absolute unspecified unspecified  	O	null
1 ה ה הראשון definiteArticle unspecified unspecified unspecified unspecified unspecified 0 
1 הראשון ORD1 הראשון numeral masculine singular absolute unspecified unspecified  	O	null
2 של של שלו shel-preposition unspecified unspecified unspecified unspecified unspecified  
2 ו ו שלו pronomial masculine singular unspecified 3 unspecified 0 	O	null
3 , , , punctuation unspecified unspecified unspecified unspecified unspecified  	O	null
4 ראשון ORD1 ראשון numeral masculine singular absolute unspecified unspecified  	O	null
5 ה ה הנביאים definiteArticle unspecified unspecified unspecified unspecified unspecified 0 
5 הנביאים נביא הנביאים noun masculine plural absolute unspecified unspecified  	O	null
6 , , , punctuation unspecified unspecified unspecified unspecified unspecified  	O	null
7 ראה ראה ראה verb masculine singular unspecified 3 past  	O	null
8 אור אור אור noun masculine singular absolute unspecified unspecified  	O	null
9 ב ב ב preposition unspecified unspecified unspecified unspecified unspecified 0 	O	null
10 - - - punctuation unspecified unspecified unspecified unspecified unspecified  	O	null
11 ###NUMBER### ###NUMBER### ###NUMBER### numeral unspecified unspecified unspecified unspecified unspecified  	I_DATE	null
12 ( ( ( punctuation unspecified unspecified unspecified unspecified unspecified  	O	null
13 ב ב בהוצאת preposition unspecified unspecified unspecified unspecified unspecified 0 
13 הוצאת הוצאה בהוצאת noun feminine singular construct unspecified unspecified  	O	null
14 דאר דאר דאר properName unspecified unspecified unspecified unspecified unspecified  	I_PERS	null
15 אל אל אל properName unspecified unspecified unspecified unspecified unspecified  	I_PERS	null
16 - - - punctuation unspecified unspecified unspecified unspecified unspecified  	O	null
17 ג'ליל ג'ליל ג'ליל properName unspecified unspecified unspecified unspecified unspecified  	I_ORG	null
18 ) ) ) punctuation unspecified unspecified unspecified unspecified unspecified  	O	null
19 . . . punctuation unspecified unspecified unspecified unspecified unspecified  	O	null

0 ה ה המחזה definiteArticle unspecified unspecified unspecified unspecified unspecified 0 
0 המחזה מחזה המחזה noun masculine singular absolute unspecified unspecified  	O	null
1 לילה לילה לילה noun masculine singular absolute unspecified unspecified  	O	null
2 אחדבחיים אחדבחיים אחדבחיים preposition unspecified unspecified unspecified unspecified unspecified  	O	null
3 תורגם תורגם תורגם verb masculine singular unspecified 3 past  	O	null
4 לעבריתבידי לעבריתבידי לעבריתבידי properName unspecified unspecified unspecified unspecified unspecified  	I_PERS	null
5 חנה חנה חנה properName feminine singular unspecified unspecified unspecified  	I_PERS	null
6 עמית עמית עמית properName unspecified unspecified unspecified unspecified unspecified  	I_PERS	null
7 - - - punctuation unspecified unspecified unspecified unspecified unspecified  	O	null
8 כוכביועלה כוכביועלה כוכביועלה participle masculine plural construct any unspecified  	O	null
9 ב ב בתיאטרון preposition unspecified unspecified unspecified unspecified unspecified 0 
9 תיאטרון תיאטרון בתיאטרון noun masculine singular absolute unspecified unspecified  	O	null
10 " " " punctuation unspecified unspecified unspecified unspecified unspecified  	O	null
11 בית בית בית properName unspecified unspecified unspecified unspecified unspecified  	I_ORG	null
12 הגפן"ב הגפן"ב הגפן"ב verb feminine singular unspecified 2 past  	O	null
13 - - - punctuation unspecified unspecified unspecified unspecified unspecified  	O	null
14 . . . punctuation unspecified unspecified unspecified unspecified unspecified  	O	null
15 ###NUMBER### ###NUMBER### ###NUMBER### numeral unspecified unspecified unspecified unspecified unspecified  	I_DATE	null
16 תירגם תרגם תירגם verb masculine singular unspecified 3 past  	O	null
17 מ מ מעברית preposition unspecified unspecified unspecified unspecified unspecified 0 
17 עברית עברית מעברית properName feminine singular unspecified unspecified unspecified  	I_PERS	null
18 ל ל לערבית preposition unspecified unspecified unspecified unspecified unspecified 0 
18 ערבית ערבית לערבית properName feminine singular unspecified unspecified unspecified  	I_PERS	null
19 את את את at-preposition unspecified unspecified unspecified unspecified unspecified  	O	null
20 ה ה הרומן definiteArticle unspecified unspecified unspecified unspecified unspecified 0 
20 הרומן רומן הרומן noun masculine singular absolute unspecified unspecified  	O	null
21 של של של shel-preposition unspecified unspecified unspecified unspecified unspecified  	O	null
22 אמנון אמנון אמנון properName unspecified unspecified unspecified unspecified unspecified  	I_PERS	null
23 ש ש שמוש relativizer/subordinatingConjunction unspecified unspecified unspecified unspecified unspecified 0 
23 מוש מוש שמוש properName unspecified unspecified unspecified unspecified unspecified  	I_PERS	null
24 מישלעזראספראובניו מישלעזראספראובניו מישלעזראספראובניו properName unspecified unspecified unspecified unspecified unspecified  	I_PERS	null
25 ( ( ( punctuation unspecified unspecified unspecified unspecified unspecified  	O	null
26 ) ) ) punctuation unspecified unspecified unspecified unspecified unspecified  	O	null
27 ###NUMBER### ###NUMBER### ###NUMBER### numeral unspecified unspecified unspecified unspecified unspecified  	I_DATE	null
28 ו ו וקובצי conjunction unspecified unspecified unspecified unspecified unspecified 0 
28 קובצי קבץ וקובצי participle masculine plural construct any unspecified  	O	null
29 שירה שירה שירה noun feminine singular absolute unspecified unspecified  	O	null
30 של של של shel-preposition unspecified unspecified unspecified unspecified unspecified  	O	null
31 כמה כמה כמה quantifier unspecified unspecified construct unspecified unspecified  	O	null
32 משוררים משורר משוררים noun masculine plural absolute unspecified unspecified  	O	null
33 . . . punctuation unspecified unspecified unspecified unspecified unspecified  	O	null

0 ה ה הרומן definiteArticle unspecified unspecified unspecified unspecified unspecified 0 
0 הרומן רומן הרומן noun masculine singular absolute unspecified unspecified  	O	null
1 ה ה הראשון definiteArticle unspecified unspecified unspecified unspecified unspecified 0 
1 הראשון ORD1 הראשון numeral masculine singular absolute unspecified unspecified  	O	null
2 פרי פרי פרי noun masculine singular construct unspecified unspecified  	O	null
3 עט עט עטו noun masculine singular absolute unspecified unspecified  
3 ו ו עטו possessive masculine singular unspecified 3 unspecified 0 	O	null
4 , , , punctuation unspecified unspecified unspecified unspecified unspecified  	O	null
5 אהבהללאמחר אהבהללאמחר אהבהללאמחר verb masculine singular unspecified 2 imperative  	O	null
6 ( ( ( punctuation unspecified unspecified unspecified unspecified unspecified  	O	null
7 מטבעת מטבעה מטבעת noun feminine singular construct unspecified unspecified  	O	null
8 אל אל אל properName unspecified unspecified unspecified unspecified unspecified  	I_PERS	null
9 - - - properName unspecified unspecified unspecified unspecified unspecified  	I_PERS	null
10 חכים חכים חכים properName unspecified unspecified unspecified unspecified unspecified  	I_PERS	null
11 , , , punctuation unspecified unspecified unspecified unspecified unspecified  	O	null
12 ) ) ) punctuation unspecified unspecified unspecified unspecified unspecified  	O	null
13 , , , punctuation unspecified unspecified unspecified unspecified unspecified  	O	null
14 ###NUMBER### ###NUMBER### ###NUMBER### numeral unspecified unspecified unspecified unspecified unspecified  	I_DATE	null
15 מגולל גולל מגולל verb masculine singular unspecified any beinoni  	O	null
16 את את את at-preposition unspecified unspecified unspecified unspecified unspecified  	O	null
17 קורות קורה קורותיהם noun feminine plural absolute unspecified unspecified  
17 הם הם קורותיהם possessive masculine plural unspecified 3 unspecified 0 	O	null
18 של של של shel-preposition unspecified unspecified unspecified unspecified unspecified  	O	null
19 שני CARD2 שני numeral masculine dual construct unspecified unspecified  	O	null
20 אחים אח אחים noun masculine plural absolute unspecified unspecified  	O	null
21 מוסלמים מוסלמי מוסלמים adjective masculine plural absolute unspecified unspecified  	O	null
22 ב ב בכפר preposition unspecified unspecified unspecified unspecified unspecified 0 
22 ה ה בכפר definiteArticle unspecified unspecified unspecified unspecified unspecified 0 
22 הכפר כפר בכפר noun masculine singular absolute unspecified unspecified  	I_LOC	null
23 ב ב בישראל preposition unspecified unspecified unspecified unspecified unspecified 0 
23 ישראל ישראל בישראל properName unspecified unspecified unspecified unspecified unspecified  	I_LOC	null
24 ה ה המתאהבים definiteArticle unspecified unspecified unspecified unspecified unspecified 0 
24 המתאהבים התאהב המתאהבים participle masculine plural absolute any unspecified  	O	null
25 אחד איחד אחד verb masculine singular unspecified 3 past  	O	null
26 ב ב בצעירה preposition unspecified unspecified unspecified unspecified unspecified 0 
26 צעירה צעיר בצעירה noun feminine singular absolute unspecified unspecified  	O	null
27 נוצרייה נוצרי נוצרייה adjective feminine singular absolute unspecified unspecified  	O	null
28 ו ו והאחר conjunction unspecified unspecified unspecified unspecified unspecified 0 
28 ה ה והאחר definiteArticle unspecified unspecified unspecified unspecified unspecified 0 
28 האחר אחר והאחר adjective masculine singular absolute unspecified unspecified  	O	null
29 ב ב בצעירה preposition unspecified unspecified unspecified unspecified unspecified 0 
29 ה ה בצעירה definiteArticle unspecified unspecified unspecified unspecified unspecified 0 
29 הצעירה צעיר בצעירה noun feminine singular absolute unspecified unspecified  	O	null
30 ה ה החיה definiteArticle unspecified unspecified unspecified unspecified unspecified 0 
30 החיה חי החיה adjective feminine singular absolute unspecified unspecified  	O	null
31 מעבר מעבר מעבר noun masculine singular absolute unspecified unspecified  	O	null
32 ל ל לגבול preposition unspecified unspecified unspecified unspecified unspecified 0 
32 ה ה לגבול definiteArticle unspecified unspecified unspecified unspecified unspecified 0 
32 הגבול גבול לגבול noun masculine singular absolute unspecified unspecified  	O	null
33 . . . punctuation unspecified unspecified unspecified unspecified unspecified  	O	null

0 ה ה הרומן definiteArticle unspecified unspecified unspecified unspecified unspecified 0 
0 הרומן רומן הרומן noun masculine singular absolute unspecified unspecified  	O	null
1 עוסק עסק עוסק verb masculine singular unspecified any beinoni  	O	null
2 ב ב בשינויים preposition unspecified unspecified unspecified unspecified unspecified 0 
2 שינויים שינוי בשינויים noun masculine plural absolute unspecified unspecified  	O	null
3 ש ש שהתחוללו relativizer/subordinatingConjunction unspecified unspecified unspecified unspecified unspecified 0 
3 התחוללו התחולל שהתחוללו verb masculine-and-feminine plural unspecified 3 past  	O	null
4 בקרב בקרב בקרב preposition unspecified unspecified unspecified unspecified unspecified  	O	null
5 ערביי ערבי ערביי noun masculine plural construct unspecified unspecified  	O	null
6 ישראל ישראל ישראל properName unspecified unspecified unspecified unspecified unspecified  	I_LOC	null
7 בעקבות בעקבות בעקבות preposition unspecified unspecified unspecified unspecified unspecified  	O	null
8 ה ה הנכבה definiteArticle unspecified unspecified unspecified unspecified unspecified 0 
8 הנכבה נכבה הנכבה participle masculine singular absolute any unspecified  	I_ORG	null
9 . . . punctuation unspecified unspecified unspecified unspecified unspecified  	O	null

0 סיפור סיפור סיפור noun masculine singular absolute unspecified unspecified  	O	null
1 קצר קצר קצר adjective masculine singular absolute unspecified unspecified  	O	null
2 בולט בולט בולט adjective masculine singular absolute unspecified unspecified  	O	null
3 פרי פרי פרי noun masculine singular construct unspecified unspecified  	O	null
4 עט עט עטו noun masculine singular absolute unspecified unspecified  
4 ו ו עטו possessive masculine singular unspecified 3 unspecified 0 	O	null
5 הוא הוא הוא pronoun masculine singular unspecified 3 unspecified  	O	null
6 ה ה הסיפור definiteArticle unspecified unspecified unspecified unspecified unspecified 0 
6 הסיפור סיפור הסיפור noun masculine singular absolute unspecified unspecified  	O	null
7 ה ה האוטוביוגרפי definiteArticle unspecified unspecified unspecified unspecified unspecified 0 
7 האוטוביוגרפי אוטוביוגרפי האוטוביוגרפי adjective masculine singular absolute unspecified unspecified  	O	null
8 " " " punctuation unspecified unspecified unspecified unspecified unspecified  	O	null
9 שיבת שיבה שיבתו noun feminine singular absolute unspecified unspecified  
9 ו ו שיבתו possessive masculine singular unspecified 3 unspecified 0 	O	null
10 של של של shel-preposition unspecified unspecified unspecified unspecified unspecified  	O	null
11 ה ה הדוד definiteArticle unspecified unspecified unspecified unspecified unspecified 0 
11 הדוד דוד הדוד noun masculine singular absolute unspecified unspecified  	O	null
12 חסן חיסן חסן verb masculine singular unspecified 3 past  	O	null
13 ל ל למולדתו preposition unspecified unspecified unspecified unspecified unspecified 0 
13 מולדת מולדת למולדתו noun feminine singular absolute unspecified unspecified  
13 ו ו למולדתו possessive masculine singular unspecified 3 unspecified 0 	O	null
14 " " " punctuation unspecified unspecified unspecified unspecified unspecified  	O	null
15 , , , punctuation unspecified unspecified unspecified unspecified unspecified  	O	null
16 ה ה הנכלל definiteArticle unspecified unspecified unspecified unspecified unspecified 0 
16 הנכלל נכלל הנכלל participle masculine singular absolute any unspecified  	O	null
17 ב ב בתרגומו preposition unspecified unspecified unspecified unspecified unspecified 0 
17 תרגום תרגום בתרגומו noun masculine singular absolute unspecified unspecified  
17 ו ו בתרגומו possessive masculine singular unspecified 3 unspecified 0 	O	null
18 ב ב באוסף preposition unspecified unspecified unspecified unspecified unspecified 0 
18 אוסף אוסף באוסף noun masculine singular absolute unspecified unspecified  	O	null
19 מ מ מפגשועימות preposition unspecified unspecified unspecified unspecified unspecified 0 
19 פגשועימו פגשועימו מפגשועימות noun masculine-and-feminine plural absolute unspecified unspecified  
19 י י מפגשועימות possessive masculine-and-feminine singular unspecified 1 unspecified 0 	O	null
20 : : : punctuation unspecified unspecified unspecified unspecified unspecified  	O	null
21 ביצירההערביתוהעברית ביצירההערביתוהעברית ביצירההערביתוהעברית properName unspecified unspecified unspecified unspecified unspecified  	I_PERS	null
22 , , , punctuation unspecified unspecified unspecified unspecified unspecified  	O	null
23 , , , punctuation unspecified unspecified unspecified unspecified unspecified  	O	null
24 ###NUMBER### ###NUMBER### ###NUMBER### numeral unspecified unspecified unspecified unspecified unspecified  	I_DATE	null
25 ###NUMBER### ###NUMBER### ###NUMBER### numeral unspecified unspecified unspecified unspecified unspecified  	O	null
26 - - - punctuation unspecified unspecified unspecified unspecified unspecified  	O	null
27 ###NUMBER### ###NUMBER### ###NUMBER### numeral unspecified unspecified unspecified unspecified unspecified  	O	null
28 . . . punctuation unspecified unspecified unspecified unspecified unspecified  	O	null

0 הוא הוא הוא pronoun masculine singular unspecified 3 unspecified  	O	null
1 פותח פותח פותח verb masculine singular unspecified 3 past  	O	null
2 ב ב בהקדשה preposition unspecified unspecified unspecified unspecified unspecified 0 
2 הקדשה הקדשה בהקדשה noun feminine singular absolute unspecified unspecified  	O	null
3 : : : punctuation unspecified unspecified unspecified unspecified unspecified  	O	null
4 " " " punctuation unspecified unspecified unspecified unspecified unspecified  	O	null
5 מוקדש הוקדש מוקדש verb masculine singular unspecified any beinoni  	O	null
6 ל ל לזכרו preposition unspecified unspecified unspecified unspecified unspecified 0 
6 זכר זכר לזכרו noun masculine singular absolute unspecified unspecified  
6 ו ו לזכרו possessive masculine singular unspecified 3 unspecified 0 	O	null
7 של של של shel-preposition unspecified unspecified unspecified unspecified unspecified  	O	null
8 דודי דודי דודי properName unspecified unspecified unspecified unspecified unspecified  	I_PERS	null
9 ה ה האהוב definiteArticle unspecified unspecified unspecified unspecified unspecified 0 
9 האהוב אהוב האהוב adjective masculine singular absolute unspecified unspecified  	O	null
10 חסן חיסן חסן verb masculine singular unspecified 3 past  	O	null
11 , , , punctuation unspecified unspecified unspecified unspecified unspecified  	O	null
12 ו ו וכן conjunction unspecified unspecified unspecified unspecified unspecified 0 
12 כן כן וכן conjunction unspecified unspecified unspecified unspecified unspecified  	O	null
13 ל ל לאלה preposition unspecified unspecified unspecified unspecified unspecified 0 
13 אלה אלה לאלה pronoun masculine-and-feminine plural unspecified 3 unspecified  	O	null
14 ה ה הדוגלים definiteArticle unspecified unspecified unspecified unspecified unspecified 0 
14 הדוגלים דגל הדוגלים participle masculine plural absolute any unspecified  	O	null
15 ב ב ברעיון preposition unspecified unspecified unspecified unspecified unspecified 0 
15 רעיון רעיון ברעיון noun masculine singular absolute unspecified unspecified  	O	null
16 ה ה ה numeral unspecified unspecified unspecified unspecified unspecified  	O	null
17 ' ' ' punctuation unspecified unspecified unspecified unspecified unspecified  	O	null
18 טרנספר טרנספר טרנספר noun masculine singular absolute unspecified unspecified  	O	null
19 ' ' ' punctuation unspecified unspecified unspecified unspecified unspecified  	O	null
20 ש ש שאולי relativizer/subordinatingConjunction unspecified unspecified unspecified unspecified unspecified 0 
20 אולי אולי שאולי adverb unspecified unspecified unspecified unspecified unspecified  	O	null
21 ישתכנעו השתכנע ישתכנעו verb masculine-and-feminine plural unspecified 3 future  	O	null
22 ש ש שאנו relativizer/subordinatingConjunction unspecified unspecified unspecified unspecified unspecified 0 
22 אנו הוא שאנו pronoun masculine-and-feminine plural unspecified 1 unspecified  	O	null
23 מעורים עיוור מעורים verb masculine plural unspecified any beinoni  	O	null
24 ב ב בארצנו preposition unspecified unspecified unspecified unspecified unspecified 0 
24 ארץ ארץ בארצנו noun feminine singular absolute unspecified unspecified  
24 נו נו בארצנו possessive masculine-and-feminine plural unspecified 1 unspecified 0 	O	null
25 לנצח ניצח לנצח verb unspecified unspecified unspecified unspecified infinitive  	O	null
26 " " " punctuation unspecified unspecified unspecified unspecified unspecified  	O	null
27 . . . punctuation unspecified unspecified unspecified unspecified unspecified  	O	null

0 עיקר עיקר עיקרו noun masculine singular absolute unspecified unspecified  
0 ו ו עיקרו possessive masculine singular unspecified 3 unspecified 0 	O	null
1 של של של shel-preposition unspecified unspecified unspecified unspecified unspecified  	O	null
2 ה ה הסיפור definiteArticle unspecified unspecified unspecified unspecified unspecified 0 
2 הסיפור סיפור הסיפור noun masculine singular absolute unspecified unspecified  	O	null
3 ב ב בקשר preposition unspecified unspecified unspecified unspecified unspecified 0 
3 ה ה בקשר definiteArticle unspecified unspecified unspecified unspecified unspecified 0 
3 הקשר קשר בקשר noun masculine singular absolute unspecified unspecified  	O	null
4 ה ה המיוחד definiteArticle unspecified unspecified unspecified unspecified unspecified 0 
4 המיוחד מיוחד המיוחד adjective masculine singular absolute unspecified unspecified  	O	null
5 בין בין בין preposition unspecified unspecified unspecified unspecified unspecified  	O	null
6 אבי אב אביו noun masculine singular absolute unspecified unspecified  
6 ו ו אביו possessive masculine singular unspecified 3 unspecified 0 	O	null
7 ל ל לדודו preposition unspecified unspecified unspecified unspecified unspecified 0 
7 דודו דודו לדודו properName unspecified unspecified unspecified unspecified unspecified  	I_PERS	null
8 חסן חיסן חסן verb masculine singular unspecified 3 past  	O	null
9 , , , punctuation unspecified unspecified unspecified unspecified unspecified  	O	null
10 ש ש שהופרדו relativizer/subordinatingConjunction unspecified unspecified unspecified unspecified unspecified 0 
10 הופרדו הופרד שהופרדו verb masculine-and-feminine plural unspecified 3 past  	O	null
11 ב ב בפעם preposition unspecified unspecified unspecified unspecified unspecified 0 
11 פעם פעם בפעם noun feminine singular absolute unspecified unspecified  	O	null
12 ה ה הראשונה definiteArticle unspecified unspecified unspecified unspecified unspecified 0 
12 הראשונה ORD1 הראשונה numeral feminine singular absolute unspecified unspecified  	O	null
13 ב ב בחייהם preposition unspecified unspecified unspecified unspecified unspecified 0 
13 חיי חיים בחייהם noun masculine plural absolute unspecified unspecified  
13 הם הם בחייהם possessive masculine plural unspecified 3 unspecified 0 	O	null
14 בעקבות בעקבות בעקבות preposition unspecified unspecified unspecified unspecified unspecified  	O	null
15 ה ה הנכבה definiteArticle unspecified unspecified unspecified unspecified unspecified 0 
15 הנכבה נכבה הנכבה participle masculine singular absolute any unspecified  	O	null
16 ב ב ב preposition unspecified unspecified unspecified unspecified unspecified 0 	I_ORG	null
17 - - - punctuation unspecified unspecified unspecified unspecified unspecified  	I_ORG	null
18 ###NUMBER### ###NUMBER### ###NUMBER### numeral unspecified unspecified unspecified unspecified unspecified  	I_DATE	null
19 . . . punctuation unspecified unspecified unspecified unspecified unspecified  	O	null

0 ה ה הסיפור definiteArticle unspecified unspecified unspecified unspecified unspecified 0 
0 הסיפור סיפור הסיפור noun masculine singular absolute unspecified unspecified  	O	null
1 מתאר תיאר מתאר verb masculine singular unspecified any beinoni  	O	null
2 את את את at-preposition unspecified unspecified unspecified unspecified unspecified  	O	null
3 ה ה האהבה definiteArticle unspecified unspecified unspecified unspecified unspecified 0 
3 האהבה אהבה האהבה noun feminine singular absolute unspecified unspecified  	O	null
4 ה ה העזה definiteArticle unspecified unspecified unspecified unspecified unspecified 0 
4 העזה עז העזה adjective feminine singular absolute unspecified unspecified  	I_LOC	null
5 בין בין בין preposition unspecified unspecified unspecified unspecified unspecified  	O	null
6 ה ה האחים definiteArticle unspecified unspecified unspecified unspecified unspecified 0 
6 האחים אח האחים noun masculine plural absolute unspecified unspecified  	O	null
7 ו ו ואת conjunction unspecified unspecified unspecified unspecified unspecified 0 
7 את את ואת at-preposition unspecified unspecified unspecified unspecified unspecified  	O	null
8 ה ה הגעגועים definiteArticle unspecified unspecified unspecified unspecified unspecified 0 
8 הגעגועים געגוע הגעגועים noun masculine plural absolute unspecified unspecified  	O	null
9 ל ל לחיים preposition unspecified unspecified unspecified unspecified unspecified 0 
9 ה ה לחיים definiteArticle unspecified unspecified unspecified unspecified unspecified 0 
9 החיים חיים לחיים noun masculine plural absolute unspecified unspecified  	O	null
10 ש ש שקדמו relativizer/subordinatingConjunction unspecified unspecified unspecified unspecified unspecified 0 
10 קדמו קדם שקדמו verb masculine-and-feminine plural unspecified 3 past  	O	null
11 ל ל לנכבה preposition unspecified unspecified unspecified unspecified unspecified 0 
11 נכבה נכבה לנכבה participle masculine singular absolute any unspecified  	I_ORG	null
12 , , , punctuation unspecified unspecified unspecified unspecified unspecified  	O	null
13 כאשר כאשר כאשר conjunction unspecified unspecified unspecified unspecified unspecified  	O	null
14 חיו חי חיו verb masculine-and-feminine plural unspecified 3 past  	O	null
15 בצוותא בצוותא בצוותא adverb unspecified unspecified unspecified unspecified unspecified  	O	null
16 ב ב במולדתם preposition unspecified unspecified unspecified unspecified unspecified 0 
16 מולדת מולדת במולדתם noun feminine singular absolute unspecified unspecified  
16 ם ם במולדתם possessive masculine plural unspecified 3 unspecified 0 	O	null
17 . . . punctuation unspecified unspecified unspecified unspecified unspecified  	O	null

0 לאחר לאחר לאחר conjunction unspecified unspecified unspecified unspecified unspecified  	O	null
1 יותר יותר יותר quantifier unspecified unspecified construct unspecified unspecified  	O	null
2 משני משנה משני noun masculine plural construct unspecified unspecified  	O	null
3 עשורים עשור עשורים noun masculine plural absolute unspecified unspecified  	O	null
4 ה ה הדוד definiteArticle unspecified unspecified unspecified unspecified unspecified 0 
4 הדוד דוד הדוד noun masculine singular absolute unspecified unspecified  	O	null
5 חס חס חסן participle masculine singular unspecified any unspecified  
5 ן ן חסן possessive feminine plural unspecified 3 unspecified 0 	O	null
6 מקבל קיבל מקבל verb masculine singular unspecified any beinoni  	O	null
7 אישור אישור אישור noun masculine singular construct unspecified unspecified  	O	null
8 , , , punctuation unspecified unspecified unspecified unspecified unspecified  	O	null
9 שב שב שב verb masculine singular unspecified 3 past  	I_LOC	null
10 ל ל למולדת preposition unspecified unspecified unspecified unspecified unspecified 0 
10 מולדת מולדת למולדת properName unspecified unspecified unspecified unspecified unspecified  	I_PERS	null
11 ו ו ואומר conjunction unspecified unspecified unspecified unspecified unspecified 0 
11 אומר אמר ואומר verb masculine-and-feminine singular unspecified 1 future  	O	null
12 : : : punctuation unspecified unspecified unspecified unspecified unspecified  	O	null
13 " " " punctuation unspecified unspecified unspecified unspecified unspecified  	O	null
14 ' ' ' punctuation unspecified unspecified unspecified unspecified unspecified  	O	null
15 איפה איפה איפה interrogative unspecified unspecified unspecified unspecified unspecified  	O	null
16 תמצא מצא תמצא verb feminine singular unspecified 3 future  	O	null
17 פרי פרי פרי noun masculine singular construct unspecified unspecified  	O	null
18 רימון רימון רימון properName unspecified unspecified unspecified unspecified unspecified  	I_PERS	null
19 כזה... כזה... כזה... adverb unspecified unspecified unspecified unspecified unspecified  	O	null
20 כל כול כל quantifier unspecified unspecified construct unspecified unspecified  	O	null
21 דבר דבר דבר noun masculine singular construct unspecified unspecified  	O	null
22 ב ב בארצות preposition unspecified unspecified unspecified unspecified unspecified 0 
22 ארצות ארץ בארצות noun feminine plural construct unspecified unspecified  	O	null
23 נכר ניכר נכר verb masculine singular unspecified any beinoni  	O	null
24 הוא הוא הוא pronoun masculine singular unspecified 3 unspecified  	O	null
25 חסר חסר חסר adjective masculine singular construct unspecified unspecified  	O	null
26 טעם טעם טעם noun masculine singular construct unspecified unspecified  	O	null
27 , , , punctuation unspecified unspecified unspecified unspecified unspecified  	O	null
28 תארו תיאר תארו verb masculine-and-feminine plural unspecified 2 imperative  	O	null
29 לכם... לכם... לכם... properName unspecified unspecified unspecified unspecified unspecified  	I_PERS	null
30 דומה דמה דומה verb feminine singular unspecified any beinoni  	O	null
31 ש ש שאפילו relativizer/subordinatingConjunction unspecified unspecified unspecified unspecified unspecified 0 
31 אפילו אפילו שאפילו conjunction unspecified unspecified unspecified unspecified unspecified  	O	null
32 ה ה המוות definiteArticle unspecified unspecified unspecified unspecified unspecified 0 
32 המוות מוות המוות noun masculine singular absolute unspecified unspecified  	O	null
33 ב ב במחנה preposition unspecified unspecified unspecified unspecified unspecified 0 
33 מחנה מחנה במחנה noun masculine singular construct unspecified unspecified  	O	null
34 בזוי בזוי בזוי adjective masculine singular absolute unspecified unspecified  	O	null
35 הוא הוא הוא pronoun masculine singular unspecified 3 unspecified  	O	null
36 ' ' ' punctuation unspecified unspecified unspecified unspecified unspecified  	O	null
37 " " " punctuation unspecified unspecified unspecified unspecified unspecified  	O	null
38 ) ) ) punctuation unspecified unspecified unspecified unspecified unspecified  	O	null
39 . . . punctuation unspecified unspecified unspecified unspecified unspecified  	O	null
40 ###NUMBER### ###NUMBER### ###NUMBER### numeral unspecified unspecified unspecified unspecified unspecified  	O	null
41 מילים מילה מילים noun feminine plural absolute unspecified unspecified  	O	null
42 אלה אלה אלה pronoun masculine-and-feminine plural unspecified 3 unspecified  	O	null
43 מנבאות ניבא מנבאות verb feminine plural unspecified any beinoni  	O	null
44 את את את at-preposition unspecified unspecified unspecified unspecified unspecified  	O	null
45 מות מוות מותו noun masculine singular absolute unspecified unspecified  
45 ו ו מותו possessive masculine singular unspecified 3 unspecified 0 	O	null
46 , , , punctuation unspecified unspecified unspecified unspecified unspecified  	O	null
47 ש ש שקורה relativizer/subordinatingConjunction unspecified unspecified unspecified unspecified unspecified 0 
47 קורה קרה שקורה verb feminine singular unspecified any beinoni  	O	null
48 מעט מעט מעט quantifier unspecified unspecified construct unspecified unspecified  	O	null
49 אחר איחר אחר verb masculine singular unspecified 2 imperative  	O	null
50 כך כך כך pronoun unspecified unspecified unspecified unspecified unspecified  	O	null
51 , , , punctuation unspecified unspecified unspecified unspecified unspecified  	O	null
52 ו ו ואת conjunction unspecified unspecified unspecified unspecified unspecified 0 
52 את את ואת at-preposition unspecified unspecified unspecified unspecified unspecified  	O	null
53 התאחדות התאחדות התאחדותו noun feminine singular absolute unspecified unspecified  
53 ו ו התאחדותו possessive masculine singular unspecified 3 unspecified 0 	O	null
54 ה ה הטרגית definiteArticle unspecified unspecified unspecified unspecified unspecified 0 
54 הטרגית טרגי הטרגית adjective feminine singular absolute unspecified unspecified  	O	null
55 עם עם עם preposition unspecified unspecified unspecified unspecified unspecified  	O	null
56 מש מש משפחתו temporalSubConj unspecified unspecified unspecified unspecified unspecified 0 
56 פחתו פיחת משפחתו verb masculine-and-feminine plural unspecified 3 past  	O	null
57 ו ו ועם conjunction unspecified unspecified unspecified unspecified unspecified 0 
57 עם עם ועם preposition unspecified unspecified unspecified unspecified unspecified  	O	null
58 אדמת אדמה אדמת noun feminine singular construct unspecified unspecified  	O	null
59 מולדת מולדת מולדתו noun feminine singular absolute unspecified unspecified  
59 ו ו מולדתו possessive masculine singular unspecified 3 unspecified 0 	O	null
60 . . . punctuation unspecified unspecified unspecified unspecified unspecified  	O	null

0 ה ה הקובץ definiteArticle unspecified unspecified unspecified unspecified unspecified 0 
0 הקובץ קובץ הקובץ noun masculine singular absolute unspecified unspecified  	O	null
1 ב ב באשמורתאחרונה preposition unspecified unspecified unspecified unspecified unspecified 0 
1 ה ה באשמורתאחרונה definiteArticle unspecified unspecified unspecified unspecified unspecified 0 
1 האשמורתאחרונה האשמורתאחרונה באשמורתאחרונה adjective feminine singular absolute unspecified unspecified  	O	null
2 , , , punctuation unspecified unspecified unspecified unspecified unspecified  	O	null
3 ###NUMBER### ###NUMBER### ###NUMBER### numeral unspecified unspecified unspecified unspecified unspecified  	I_DATE	null
4 יצא יצא יצא verb masculine singular unspecified 3 past  	O	null
5 ל ל לאור preposition unspecified unspecified unspecified unspecified unspecified 0 
5 אור אור לאור noun masculine singular absolute unspecified unspecified  	O	null
6 ב ב בעברית preposition unspecified unspecified unspecified unspecified unspecified 0 
6 עברית עברית בעברית properName feminine singular unspecified unspecified unspecified  	O	null
7 ב ב ב preposition unspecified unspecified unspecified unspecified unspecified 0 	O	null
8 - - - punctuation unspecified unspecified unspecified unspecified unspecified  	O	null
9 ) ) ) punctuation unspecified unspecified unspecified unspecified unspecified  	O	null
10 ###NUMBER### ###NUMBER### ###NUMBER### numeral unspecified unspecified unspecified unspecified unspecified  	I_DATE	null
11 כולל כולל כולל noun masculine singular construct unspecified unspecified  	O	null
12 שלושה CARD3 שלושה numeral masculine plural absolute unspecified unspecified  	O	null
13 - - - punctuation unspecified unspecified unspecified unspecified unspecified  	O	null
14 עשר CARD10 עשר numeral feminine singular absolute unspecified unspecified  	O	null
15 סיפורים סיפור סיפורים noun masculine plural absolute unspecified unspecified  	O	null
16 ה ה המתמקדים definiteArticle unspecified unspecified unspecified unspecified unspecified 0 
16 המתמקדים התמקד המתמקדים participle masculine plural absolute any unspecified  	O	null
17 ב ב בגורלו preposition unspecified unspecified unspecified unspecified unspecified 0 
17 גורל גורל בגורלו noun masculine singular absolute unspecified unspecified  
17 ו ו בגורלו possessive masculine singular unspecified 3 unspecified 0 	O	null
18 של של של shel-preposition unspecified unspecified unspecified unspecified unspecified  	O	null
19 ה ה היחיד definiteArticle unspecified unspecified unspecified unspecified unspecified 0 
19 היחיד יחיד היחיד adjective masculine singular absolute unspecified unspecified  	O	null
20 בקרב בקרב בקרב preposition unspecified unspecified unspecified unspecified unspecified  	O	null
21 אנשי איש אנשי noun masculine plural construct unspecified unspecified  	O	null
22 ה ה הכפר definiteArticle unspecified unspecified unspecified unspecified unspecified 0 
22 הכפר כפר הכפר noun masculine singular absolute unspecified unspecified  	O	null
23 , , , punctuation unspecified unspecified unspecified unspecified unspecified  	O	null
24 ו ו וכן conjunction unspecified unspecified unspecified unspecified unspecified 0 
24 כן כן וכן conjunction unspecified unspecified unspecified unspecified unspecified  	O	null
25 ב ב בזיכרונות preposition unspecified unspecified unspecified unspecified unspecified 0 
25 זיכרונות זיכרון בזיכרונות noun masculine plural absolute unspecified unspecified  	O	null
26 של של של shel-preposition unspecified unspecified unspecified unspecified unspecified  	O	null
27 " " " punctuation unspecified unspecified unspecified unspecified unspecified  	O	null
28 אז אז אז conjunction unspecified unspecified unspecified unspecified unspecified  	O	null
29 " " " punctuation unspecified unspecified unspecified unspecified unspecified  	O	null
30 , , , punctuation unspecified unspecified unspecified unspecified unspecified  	O	null
31 ה ה התקופה definiteArticle unspecified unspecified unspecified unspecified unspecified 0 
31 התקופה תקופה התקופה noun feminine singular absolute unspecified unspecified  	O	null
32 ש ש שקדמה relativizer/subordinatingConjunction unspecified unspecified unspecified unspecified unspecified 0 
32 קדמה קדם שקדמה verb feminine singular unspecified 3 past  	O	null
33 ל ל לנכבה preposition unspecified unspecified unspecified unspecified unspecified 0 
33 ה ה לנכבה definiteArticle unspecified unspecified unspecified unspecified unspecified 0 
33 הנכבה נכבה לנכבה participle masculine singular absolute any unspecified  	I_ORG	null
34 , , , punctuation unspecified unspecified unspecified unspecified unspecified  	O	null
35 ש ש שעומדת relativizer/subordinatingConjunction unspecified unspecified unspecified unspecified unspecified 0 
35 עומדת עמד שעומדת verb feminine singular unspecified any beinoni  	O	null
36 ב ב בניגוד preposition unspecified unspecified unspecified unspecified unspecified 0 
36 ניגוד ניגוד בניגוד noun masculine singular absolute unspecified unspecified  	O	null
37 חריף חריף חריף adjective masculine singular absolute unspecified unspecified  	O	null
38 ל ל לזמן preposition unspecified unspecified unspecified unspecified unspecified 0 
38 זמן זמן לזמן noun masculine singular construct unspecified unspecified  	O	null
39 ה ה ההווה definiteArticle unspecified unspecified unspecified unspecified unspecified 0 
39 ההווה הווה ההווה noun masculine singular absolute unspecified unspecified  	O	null
40 ב ב בסיפורים preposition unspecified unspecified unspecified unspecified unspecified 0 
40 סיפורים סיפור בסיפורים noun masculine plural absolute unspecified unspecified  	O	null
41 . . . punctuation unspecified unspecified unspecified unspecified unspecified  	O	null

0 ל ל לרבים preposition unspecified unspecified unspecified unspecified unspecified 0 
0 רבים רב לרבים adjective masculine plural absolute unspecified unspecified  	O	null
1 מ מ מהסיפורים preposition unspecified unspecified unspecified unspecified unspecified 0 
1 ה ה מהסיפורים definiteArticle unspecified unspecified unspecified unspecified unspecified 0 
1 הסיפורים סיפור מהסיפורים noun masculine plural absolute unspecified unspecified  	O	null
2 יש יש יש existential unspecified unspecified unspecified unspecified unspecified  	O	null
3 אופי אופי אופי noun masculine singular absolute unspecified unspecified  	O	null
4 מלודרמטי מלודרמטי מלודרמטי adjective masculine singular absolute unspecified unspecified  	O	null
5 . . . punctuation unspecified unspecified unspecified unspecified unspecified  	O	null

0 כך כך כך adverb unspecified unspecified unspecified unspecified unspecified  	I_ORG	null
1 , , , punctuation unspecified unspecified unspecified unspecified unspecified  	O	null
2 למשל למשל למשל conjunction unspecified unspecified unspecified unspecified unspecified  	O	null
3 , , , punctuation unspecified unspecified unspecified unspecified unspecified  	O	null
4 ה ה הסיפור definiteArticle unspecified unspecified unspecified unspecified unspecified 0 
4 הסיפור סיפור הסיפור noun masculine singular absolute unspecified unspecified  	O	null
5 " " " punctuation unspecified unspecified unspecified unspecified unspecified  	O	null
6 ב ב באשמורת preposition unspecified unspecified unspecified unspecified unspecified 0 
6 אשמורת אשמורת באשמורת noun feminine singular absolute unspecified unspecified  	O	null
7 אחרונה אחרון אחרונה adjective feminine singular absolute unspecified unspecified  	O	null
8 " " " punctuation unspecified unspecified unspecified unspecified unspecified  	O	null
9 מספר מספר מספר verb masculine singular unspecified 3 past  	O	null
10 על על על preposition unspecified unspecified unspecified unspecified unspecified  	O	null
11 בת בת בת noun feminine singular construct unspecified unspecified  	O	null
12 ש ש שמגלה relativizer/subordinatingConjunction unspecified unspecified unspecified unspecified unspecified 0 
12 מגלה הגלה שמגלה verb masculine singular unspecified any beinoni  	O	null
13 את את את at-preposition unspecified unspecified unspecified unspecified unspecified  	O	null
14 זהות זהות זהותו noun feminine singular absolute unspecified unspecified  
14 ו ו זהותו possessive masculine singular unspecified 3 unspecified 0 	O	null
15 של של של shel-preposition unspecified unspecified unspecified unspecified unspecified  	O	null
16 אביה אביה אביה properName unspecified unspecified unspecified unspecified unspecified  	I_PERS	null
17 ו ו ואת conjunction unspecified unspecified unspecified unspecified unspecified 0 
17 את את ואת at-preposition unspecified unspecified unspecified unspecified unspecified  	O	null
18 סיפור סיפור סיפור noun masculine singular construct unspecified unspecified  	O	null
19 הריון הריון הריונה noun masculine singular absolute unspecified unspecified  
19 ה ה הריונה possessive feminine singular unspecified 3 unspecified 0 	O	null
20 של של של shel-preposition unspecified unspecified unspecified unspecified unspecified  	O	null
21 אמה אמה אמה properName unspecified unspecified unspecified unspecified unspecified  	I_PERS	null
22 . . . punctuation unspecified unspecified unspecified unspecified unspecified  	O	null

0 היא הוא היא pronoun feminine singular unspecified 3 unspecified  	O	null
1 מגלה הגלה מגלה verb feminine singular unspecified any beinoni  	O	null
2 כי כי כי conjunction unspecified unspecified unspecified unspecified unspecified  	O	null
3 ה ה האב definiteArticle unspecified unspecified unspecified unspecified unspecified 0 
3 האב אב האב noun masculine singular absolute unspecified unspecified  	O	null
4 חזר חזר חזר verb masculine singular unspecified 3 past  	O	null
5 ל ל לכפרו preposition unspecified unspecified unspecified unspecified unspecified 0 
5 כפר כפר לכפרו noun masculine singular absolute unspecified unspecified  
5 ו ו לכפרו possessive masculine singular unspecified 3 unspecified 0 	O	null
6 ב ב בישראל preposition unspecified unspecified unspecified unspecified unspecified 0 
6 ישראל ישראל בישראל properName unspecified unspecified unspecified unspecified unspecified  	I_LOC	null
7 רק רק רק conjunction unspecified unspecified unspecified unspecified unspecified  	O	null
8 ל ל ללילה preposition unspecified unspecified unspecified unspecified unspecified 0 
8 לילה לילה ללילה noun masculine singular absolute unspecified unspecified  	O	null
9 אחד CARD1 אחד numeral masculine singular absolute unspecified unspecified  	O	null
10 , , , punctuation unspecified unspecified unspecified unspecified unspecified  	O	null
11 ה ה הלילה definiteArticle unspecified unspecified unspecified unspecified unspecified 0 
11 הלילה לילה הלילה noun masculine singular absolute unspecified unspecified  	O	null
12 שבו ישב שבו verb masculine-and-feminine plural unspecified 2 imperative  	O	null
13 נכנסה נכנס נכנסה verb feminine singular unspecified 3 past  	O	null
14 אם אמה אמה noun masculine singular absolute unspecified unspecified  
14 ה ה אמה possessive feminine singular unspecified 3 unspecified 0 	O	null
15 ל ל להיריון preposition unspecified unspecified unspecified unspecified unspecified 0 
15 ה ה להיריון definiteArticle unspecified unspecified unspecified unspecified unspecified 0 
15 ההיריון הריון להיריון noun masculine singular absolute unspecified unspecified  	O	null
16 . . . punctuation unspecified unspecified unspecified unspecified unspecified  	O	null

0 מטעמי מטעם מטעמי noun masculine plural construct unspecified unspecified  	O	null
1 ביטחון ביטחון ביטחון noun masculine singular construct unspecified unspecified  	O	null
2 ה ה האם definiteArticle unspecified unspecified unspecified unspecified unspecified 0 
2 האם אם האם noun feminine singular absolute unspecified unspecified  	O	null
3 לא לא לא negation unspecified unspecified unspecified unspecified unspecified  	O	null
4 יכולה יכול יכולה modal feminine singular unspecified any beinoni  	O	null
5 לספר סיפר לספר verb unspecified unspecified unspecified unspecified infinitive  	O	null
6 ש ש שבעלה relativizer/subordinatingConjunction unspecified unspecified unspecified unspecified unspecified 0 
6 בעל בעל שבעלה noun masculine singular absolute unspecified unspecified  
6 ה ה שבעלה possessive feminine singular unspecified 3 unspecified 0 	O	null
7 הוא הוא הוא pronoun masculine singular unspecified 3 unspecified  	O	null
8 אבי אב אבי noun masculine singular construct unspecified unspecified  	O	null
9 ה ה הילדה definiteArticle unspecified unspecified unspecified unspecified unspecified 0 
9 הילדה ילד הילדה noun feminine singular absolute unspecified unspecified  	O	null
10 , , , punctuation unspecified unspecified unspecified unspecified unspecified  	O	null
11 ו ו ועל conjunction unspecified unspecified unspecified unspecified unspecified 0 
11 על על ועל preposition unspecified unspecified unspecified unspecified unspecified  	O	null
12 כן כן כן conjunction unspecified unspecified unspecified unspecified unspecified  	O	null
13 היא הוא היא pronoun feminine singular unspecified 3 unspecified  	O	null
14 ו ו ובתה conjunction unspecified unspecified unspecified unspecified unspecified 0 
14 בת בת ובתה noun feminine singular absolute unspecified unspecified  
14 ה ה ובתה possessive feminine singular unspecified 3 unspecified 0 	O	null
15 חיות חיות חיות noun feminine singular absolute unspecified unspecified  	O	null
16 ב ב בקלון preposition unspecified unspecified unspecified unspecified unspecified 0 
16 קלון קלון בקלון noun masculine singular absolute unspecified unspecified  	O	null
17 . . . punctuation unspecified unspecified unspecified unspecified unspecified  	O	null

0 יחד יחד יחד adverb unspecified unspecified unspecified unspecified unspecified  	O	null
1 עם עם עם preposition unspecified unspecified unspecified unspecified unspecified  	O	null
2 שמואל שמואל שמואל properName unspecified unspecified unspecified unspecified unspecified  	I_PERS	null
3 מורה מורה מורה noun masculine singular absolute unspecified unspecified  	O	null
4 חיבר חיבר חיבר verb masculine singular unspecified 3 past  	O	null
5 מעין מעין מעין preposition unspecified unspecified unspecified unspecified unspecified  	O	null
6 אנציקלופדיה אנציקלופדיה אנציקלופדיה noun feminine singular absolute unspecified unspecified  	O	null
7 ב ב בערבית preposition unspecified unspecified unspecified unspecified unspecified 0 
7 ערבית ערבית בערבית noun feminine singular absolute unspecified unspecified  	O	null
8 ב ב בשם preposition unspecified unspecified unspecified unspecified unspecified 0 
8 שם שם בשם noun masculine singular construct unspecified unspecified  	O	null
9 יוצריםויוצרותבספרותהערביתבישרא יוצריםויוצרותבספרותהערביתבישרא יוצריםויוצרותבספרותהערביתבישראל noun masculine-and-feminine plural absolute unspecified unspecified  
9 י י יוצריםויוצרותבספרותהערביתבישראל possessive masculine-and-feminine singular unspecified 1 unspecified 0 	O	null
10 ###NUMBER### ###NUMBER### ###NUMBER### numeral unspecified unspecified unspecified unspecified unspecified  	I_DATE	null
11 - - - punctuation unspecified unspecified unspecified unspecified unspecified  	O	null
12 ###NUMBER### ###NUMBER### ###NUMBER### numeral unspecified unspecified unspecified unspecified unspecified  	I_DATE	null
13 ( ( ( punctuation unspecified unspecified unspecified unspecified unspecified  	O	null
14 הוצאת הוצאה הוצאת noun feminine singular construct unspecified unspecified  	O	null
15 אל אל אל noun masculine singular construct unspecified unspecified  	O	null
16 - - - properName unspecified unspecified unspecified unspecified unspecified  	I_DATE	null
17 מש מש משרק temporalSubConj unspecified unspecified unspecified unspecified unspecified 0 
17 רק רק משרק conjunction unspecified unspecified unspecified unspecified unspecified  	O	null
18 , , , punctuation unspecified unspecified unspecified unspecified unspecified  	O	null
19 ) ) ) punctuation unspecified unspecified unspecified unspecified unspecified  	O	null
20 , , , punctuation unspecified unspecified unspecified unspecified unspecified  	O	null
21 ###NUMBER### ###NUMBER### ###NUMBER### numeral unspecified unspecified unspecified unspecified unspecified  	I_DATE	null
22 ה ה הכוללת definiteArticle unspecified unspecified unspecified unspecified unspecified 0 
22 הכוללת כלל הכוללת participle feminine singular absolute any unspecified  	O	null
23 פרטים פרט פרטים noun masculine plural absolute unspecified unspecified  	O	null
24 ביוגרפיים ביוגראפי ביוגרפיים adjective masculine plural absolute unspecified unspecified  	O	null
25 של של של shel-preposition unspecified unspecified unspecified unspecified unspecified  	O	null
26 ה ה היוצרים definiteArticle unspecified unspecified unspecified unspecified unspecified 0 
26 היוצרים יוצר היוצרים noun masculine plural absolute unspecified unspecified  	O	null
27 ו ו ורשימה conjunction unspecified unspecified unspecified unspecified unspecified 0 
27 רשימה רשימה ורשימה noun feminine singular absolute unspecified unspecified  	O	null
28 ביבליוגרפית ביבליוגראפי ביבליוגרפית adjective feminine singular absolute unspecified unspecified  	O	null
29 של של של shel-preposition unspecified unspecified unspecified unspecified unspecified  	O	null
30 כתבי כתב כתביהם noun masculine plural absolute unspecified unspecified  
30 הם הם כתביהם possessive masculine plural unspecified 3 unspecified 0 	O	null
31 . . . punctuation unspecified unspecified unspecified unspecified unspecified  	O	null

0 עבאסי עבאסי עבאסי adjective masculine singular absolute unspecified unspecified  	O	null
1 כתב כתב כתב verb masculine singular unspecified 3 past  	O	null
2 גם גם גם conjunction unspecified unspecified unspecified unspecified unspecified  	O	null
3 את את את at-preposition unspecified unspecified unspecified unspecified unspecified  	O	null
4 ה ה הסיפור definiteArticle unspecified unspecified unspecified unspecified unspecified 0 
4 הסיפור סיפור הסיפור noun masculine singular absolute unspecified unspecified  	O	null
5 ה ה הקצר definiteArticle unspecified unspecified unspecified unspecified unspecified 0 
5 הקצר קצר הקצר adjective masculine singular absolute unspecified unspecified  	O	null
6 ב ב בספרות preposition unspecified unspecified unspecified unspecified unspecified 0 
6 ה ה בספרות definiteArticle unspecified unspecified unspecified unspecified unspecified 0 
6 הספרות ספרות בספרות noun feminine singular absolute unspecified unspecified  	O	null
7 ה ה הערבית definiteArticle unspecified unspecified unspecified unspecified unspecified 0 
7 הערבית ערבי הערבית adjective feminine singular absolute unspecified unspecified  	O	null
8 ב ב בישראל preposition unspecified unspecified unspecified unspecified unspecified 0 
8 ישראל ישראל בישראל properName unspecified unspecified unspecified unspecified unspecified  	I_LOC	null
9 ( ( ( punctuation unspecified unspecified unspecified unspecified unspecified  	O	null
10 ###NUMBER### ###NUMBER### ###NUMBER### numeral unspecified unspecified unspecified unspecified unspecified  	I_DATE	null
11 ) ) ) punctuation unspecified unspecified unspecified unspecified unspecified  	O	null
12 ו ו וכן conjunction unspecified unspecified unspecified unspecified unspecified 0 
12 כן כן וכן conjunction unspecified unspecified unspecified unspecified unspecified  	O	null
13 את את את at-preposition unspecified unspecified unspecified unspecified unspecified  	O	null
14 התפתחותהרומן התפתחותהרומן התפתחותהרומן verb masculine singular unspecified 2 future  	O	null
15 ו ו והסיפור conjunction unspecified unspecified unspecified unspecified unspecified 0 
15 ה ה והסיפור definiteArticle unspecified unspecified unspecified unspecified unspecified 0 
15 הסיפור סיפור והסיפור noun masculine singular absolute unspecified unspecified  	O	null
16 ה ה הקצר definiteArticle unspecified unspecified unspecified unspecified unspecified 0 
16 הקצר קצר הקצר adjective masculine singular absolute unspecified unspecified  	O	null
17 ב ב בספרות preposition unspecified unspecified unspecified unspecified unspecified 0 
17 ה ה בספרות definiteArticle unspecified unspecified unspecified unspecified unspecified 0 
17 הספרות ספרות בספרות noun feminine singular absolute unspecified unspecified  	O	null
18 ה ה הערבית definiteArticle unspecified unspecified unspecified unspecified unspecified 0 
18 הערבית ערבי הערבית adjective feminine singular absolute unspecified unspecified  	O	null
19 ב ב בישראל preposition unspecified unspecified unspecified unspecified unspecified 0 
19 ישראל ישראל בישראל properName unspecified unspecified unspecified unspecified unspecified  	I_LOC	null
20 ###NUMBER### ###NUMBER### ###NUMBER### numeral unspecified unspecified unspecified unspecified unspecified  	I_DATE	null
21 - - - punctuation unspecified unspecified unspecified unspecified unspecified  	O	null
22 ###NUMBER### ###NUMBER### ###NUMBER### numeral unspecified unspecified unspecified unspecified unspecified  	I_DATE	null
23 ) ) ) punctuation unspecified unspecified unspecified unspecified unspecified  	O	null
24 . . . punctuation unspecified unspecified unspecified unspecified unspecified  	O	null
25 ###NUMBER### ###NUMBER### ###NUMBER### numeral unspecified unspecified unspecified unspecified unspecified  	I_DATE	null
26 זכה זכה זכה verb masculine singular unspecified 2 imperative  	O	null
27 , , , punctuation unspecified unspecified unspecified unspecified unspecified  	O	null
28 בין בין בין preposition unspecified unspecified unspecified unspecified unspecified  	O	null
29 ה ה השאר definiteArticle unspecified unspecified unspecified unspecified unspecified 0 
29 השאר שאר השאר noun masculine singular absolute unspecified unspecified  	O	null
30 , , , punctuation unspecified unspecified unspecified unspecified unspecified  	O	null
31 ב ב בפרס preposition unspecified unspecified unspecified unspecified unspecified 0 
31 פרס פרס בפרס noun masculine singular construct unspecified unspecified  	O	null
32 ה ה היצירה definiteArticle unspecified unspecified unspecified unspecified unspecified 0 
32 היצירה יצירה היצירה noun feminine singular absolute unspecified unspecified  	O	null
33 של של של shel-preposition unspecified unspecified unspecified unspecified unspecified  	O	null
34 שר שר שר noun masculine singular construct unspecified unspecified  	O	null
35 ה ה החינוך definiteArticle unspecified unspecified unspecified unspecified unspecified 0 
35 החינוך חינוך החינוך noun masculine singular absolute unspecified unspecified  	O	null
36 ) ) ) punctuation unspecified unspecified unspecified unspecified unspecified  	O	null
37 , , , punctuation unspecified unspecified unspecified unspecified unspecified  	O	null
38 ###NUMBER### ###NUMBER### ###NUMBER### numeral unspecified unspecified unspecified unspecified unspecified  	I_DATE	null
39 ב ב בפרס preposition unspecified unspecified unspecified unspecified unspecified 0 
39 פרס פרס בפרס properName masculine singular unspecified unspecified unspecified  	I_LOC	null
40 ראש ראש ראש noun masculine singular construct unspecified unspecified  	O	null
41 ה ה הממשלה definiteArticle unspecified unspecified unspecified unspecified unspecified 0 
41 הממשלה ממשלה הממשלה noun feminine singular absolute unspecified unspecified  	O	null
42 ל ל לספרות preposition unspecified unspecified unspecified unspecified unspecified 0 
42 ספרות ספרות לספרות noun feminine singular absolute unspecified unspecified  	O	null
43 ערבית ערבי ערבית adjective feminine singular absolute unspecified unspecified  	O	null
44 ( ( ( punctuation unspecified unspecified unspecified unspecified unspecified  	O	null
45 ###NUMBER### ###NUMBER### ###NUMBER### numeral unspecified unspecified unspecified unspecified unspecified  	I_DATE	null
46 ) ) ) punctuation unspecified unspecified unspecified unspecified unspecified  	O	null
47 ו ו ובפרס conjunction unspecified unspecified unspecified unspecified unspecified 0 
47 ב ב ובפרס preposition unspecified unspecified unspecified unspecified unspecified 0 
47 פרס פרס ובפרס noun masculine singular absolute unspecified unspecified  	O	null
48 אח"י אח"י אח"י adjective masculine singular absolute unspecified unspecified  	O	null
49 מ מ מהאגודה preposition unspecified unspecified unspecified unspecified unspecified 0 
49 ה ה מהאגודה definiteArticle unspecified unspecified unspecified unspecified unspecified 0 
49 האגודה אגודה מהאגודה noun feminine singular absolute unspecified unspecified  	O	null
50 ל ל לעידוד preposition unspecified unspecified unspecified unspecified unspecified 0 
50 עידוד עידוד לעידוד noun masculine singular construct unspecified unspecified  	O	null
51 ה ה המחקר definiteArticle unspecified unspecified unspecified unspecified unspecified 0 
51 המחקר מחקר המחקר noun masculine singular absolute unspecified unspecified  	O	null
52 , , , punctuation unspecified unspecified unspecified unspecified unspecified  	O	null
53 ה ה הספרות definiteArticle unspecified unspecified unspecified unspecified unspecified 0 
53 הספרות ספרות הספרות noun feminine singular absolute unspecified unspecified  	O	null
54 ו ו והאמנות conjunction unspecified unspecified unspecified unspecified unspecified 0 
54 ה ה והאמנות definiteArticle unspecified unspecified unspecified unspecified unspecified 0 
54 האמנות אמנות והאמנות noun feminine singular absolute unspecified unspecified  	O	null
55 ) ) ) punctuation unspecified unspecified unspecified unspecified unspecified  	O	null
56 . . . punctuation unspecified unspecified unspecified unspecified unspecified  	O	null
57 ###NUMBER### ###NUMBER### ###NUMBER### numeral unspecified unspecified unspecified unspecified unspecified  	I_DATE	null
58 References References References foreign unspecified unspecified unspecified unspecified unspecified  	O	null
59 : : : punctuation unspecified unspecified unspecified unspecified unspecified  	O	null
60 القاسم القاسم القاسم properName unspecified unspecified unspecified unspecified unspecified  	I_ORG	null
61 , , , punctuation unspecified unspecified unspecified unspecified unspecified  	O	null
62 نبيه نبيه نبيه properName unspecified unspecified unspecified unspecified unspecified  	I_PERS	null
63 . . . punctuation unspecified unspecified unspecified unspecified unspecified  	O	null

0 " " " punctuation unspecified unspecified unspecified unspecified unspecified  	I_ORG	null
1 محمود محمود محمود properName unspecified unspecified unspecified unspecified unspecified  	I_ORG	null
2 عباسي عباسي عباسي adjective masculine singular construct unspecified unspecified  	O	null
3 – – – punctuation unspecified unspecified unspecified unspecified unspecified  	O	null
4 وبشائر وبشائر وبشائر adjective masculine singular construct unspecified unspecified  	O	null
5 التحول التحول التحول adjective masculine singular construct unspecified unspecified  	O	null
6 " " " punctuation unspecified unspecified unspecified unspecified unspecified  	O	null
7 . . . punctuation unspecified unspecified unspecified unspecified unspecified  	O	null

0 القصة القصة القصة adjective masculine singular construct unspecified unspecified  	O	null
1 الفلسطينية الفلسطينية الفلسطينية adjective masculine singular construct unspecified unspecified  	O	null
2 في في في adjective masculine singular construct unspecified unspecified  	O	null
3 مواجهة مواجهة مواجهة adjective masculine singular construct unspecified unspecified  	O	null
4 حزيران حزيران حزيران adjective masculine singular construct unspecified unspecified  	O	null
5 : : : punctuation unspecified unspecified unspecified unspecified unspecified  	O	null
6 دراسات دراسات دراسات adjective masculine singular construct unspecified unspecified  	O	null
7 نقدية نقدية نقدية properName unspecified unspecified unspecified unspecified unspecified  	I_LOC	null
8 . . . punctuation unspecified unspecified unspecified unspecified unspecified  	O	null

0 كفر كفر كفر adjective masculine singular construct unspecified unspecified  	O	null
1 قرع قرع قرع adjective masculine singular construct unspecified unspecified  	O	null
2 : : : punctuation unspecified unspecified unspecified unspecified unspecified  	O	null
3 دار دار دار adjective masculine singular construct unspecified unspecified  	O	null
4 الهدى الهدى الهدى properName unspecified unspecified unspecified unspecified unspecified  	I_LOC	null
5 . . . punctuation unspecified unspecified unspecified unspecified unspecified  	O	null

0 ###NUMBER### ###NUMBER### ###NUMBER### numeral unspecified unspecified unspecified unspecified unspecified  	I_DATE	null
1 . . . punctuation unspecified unspecified unspecified unspecified unspecified  	O	null

0 - - - punctuation unspecified unspecified unspecified unspecified unspecified  	O	null
1 ###NUMBER### ###NUMBER### ###NUMBER### numeral unspecified unspecified unspecified unspecified unspecified  	O	null
2 ; ; ; punctuation unspecified unspecified unspecified unspecified unspecified  	O	null
3 ###NUMBER### ###NUMBER### ###NUMBER### numeral unspecified unspecified unspecified unspecified unspecified  	O	null
4 غنايم غنايم غنايم properName unspecified unspecified unspecified unspecified unspecified  	I_PERS	null
5 , , , punctuation unspecified unspecified unspecified unspecified unspecified  	O	null
6 محمود محمود محمود properName unspecified unspecified unspecified unspecified unspecified  	I_PERS	null
7 . . . punctuation unspecified unspecified unspecified unspecified unspecified  	O	null

0 " " " punctuation unspecified unspecified unspecified unspecified unspecified  	I_LOC	null
1 نحو نحو نحو properName unspecified unspecified unspecified unspecified unspecified  	I_ORG	null
2 قصة قصة قصة adjective masculine singular construct unspecified unspecified  	O	null
3 فنيّة فنيّة فنيّة adjective masculine singular construct unspecified unspecified  	O	null
4 : : : punctuation unspecified unspecified unspecified unspecified unspecified  	O	null
5 مرحلة مرحلة مرحلة adjective masculine singular construct unspecified unspecified  	O	null
6 التكوين التكوين التكوين adjective masculine singular construct unspecified unspecified  	O	null
7 " " " punctuation unspecified unspecified unspecified unspecified unspecified  	O	null
8 . . . punctuation unspecified unspecified unspecified unspecified unspecified  	O	null

0 المدار المدار المدار adjective masculine singular construct unspecified unspecified  	O	null
1 الصعب الصعب الصعب adjective masculine singular construct unspecified unspecified  	O	null
2 : : : punctuation unspecified unspecified unspecified unspecified unspecified  	O	null
3 رحلة رحلة رحلة adjective masculine singular construct unspecified unspecified  	O	null
4 القصة القصة القصة adjective masculine singular construct unspecified unspecified  	O	null
5 الفلسطينية الفلسطينية الفلسطينية adjective masculine singular construct unspecified unspecified  	O	null
6 في في في adjective masculine singular construct unspecified unspecified  	O	null
7 إسرائيل إسرائيل إسرائيل properName unspecified unspecified unspecified unspecified unspecified  	I_LOC	null
8 . . . punctuation unspecified unspecified unspecified unspecified unspecified  	O	null

0 كفر كفر كفر adjective masculine singular construct unspecified unspecified  	O	null
1 قرع قرع قرع adjective masculine singular construct unspecified unspecified  	O	null
2 : : : punctuation unspecified unspecified unspecified unspecified unspecified  	O	null
3 الكرمل الكرمل الكرمل properName unspecified unspecified unspecified unspecified unspecified  	O	null
4 . . . punctuation unspecified unspecified unspecified unspecified unspecified  	O	null

0 ###NUMBER### ###NUMBER### ###NUMBER### numeral unspecified unspecified unspecified unspecified unspecified  	I_DATE	null
1 . . . punctuation unspecified unspecified unspecified unspecified unspecified  	O	null

0 - - - punctuation unspecified unspecified unspecified unspecified unspecified  	O	null
1 ###NUMBER### ###NUMBER### ###NUMBER### numeral unspecified unspecified unspecified unspecified unspecified  	O	null
2 ; ; ; punctuation unspecified unspecified unspecified unspecified unspecified  	O	null
3 ###NUMBER### ###NUMBER### ###NUMBER### numeral unspecified unspecified unspecified unspecified unspecified  	O	null
4 Elad Elad Elad foreign unspecified unspecified unspecified unspecified unspecified  	O	null
5 - - - punctuation unspecified unspecified unspecified unspecified unspecified  	O	null
6 Bouskila Bouskila Bouskila foreign unspecified unspecified unspecified unspecified unspecified  	O	null
7 , , , punctuation unspecified unspecified unspecified unspecified unspecified  	O	null
8 Ami Ami Ami foreign unspecified unspecified unspecified unspecified unspecified  	O	null
9 . . . punctuation unspecified unspecified unspecified unspecified unspecified  	O	null

0 " " " punctuation unspecified unspecified unspecified unspecified unspecified  	O	null
1 The The The foreign unspecified unspecified unspecified unspecified unspecified  	O	null
2 Other Other Other foreign unspecified unspecified unspecified unspecified unspecified  	O	null
3 Face Face Face foreign unspecified unspecified unspecified unspecified unspecified  	O	null
4 : : : punctuation unspecified unspecified unspecified unspecified unspecified  	O	null
5 The The The foreign unspecified unspecified unspecified unspecified unspecified  	I_ORG	null
6 Language Language Language foreign unspecified unspecified unspecified unspecified unspecified  	I_ORG	null
7 Choice Choice Choice foreign unspecified unspecified unspecified unspecified unspecified  	I_ORG	null
8 of of of foreign unspecified unspecified unspecified unspecified unspecified  	I_ORG	null
9 Arab Arab Arab foreign unspecified unspecified unspecified unspecified unspecified  	I_ORG	null
10 Writers Writers Writers foreign unspecified unspecified unspecified unspecified unspecified  	I_ORG	null
11 in in in foreign unspecified unspecified unspecified unspecified unspecified  	I_ORG	null
12 Israel Israel Israel foreign unspecified unspecified unspecified unspecified unspecified  	I_ORG	null
13 " " " punctuation unspecified unspecified unspecified unspecified unspecified  	O	null
14 . . . punctuation unspecified unspecified unspecified unspecified unspecified  	O	null

0 Modern Modern Modern foreign unspecified unspecified unspecified unspecified unspecified  	I_ORG	null
1 Palestinian Palestinian Palestinian foreign unspecified unspecified unspecified unspecified unspecified  	I_ORG	null
2 Literature Literature Literature foreign unspecified unspecified unspecified unspecified unspecified  	I_ORG	null
3 and and and foreign unspecified unspecified unspecified unspecified unspecified  	I_ORG	null
4 Culture Culture Culture foreign unspecified unspecified unspecified unspecified unspecified  	I_ORG	null
5 . . . punctuation unspecified unspecified unspecified unspecified unspecified  	O	null

0 London London London foreign unspecified unspecified unspecified unspecified unspecified  	O	null
1 : : : punctuation unspecified unspecified unspecified unspecified unspecified  	O	null
2 Frank Frank Frank foreign unspecified unspecified unspecified unspecified unspecified  	O	null
3 Cass Cass Cass foreign unspecified unspecified unspecified unspecified unspecified  	O	null
4 . . . punctuation unspecified unspecified unspecified unspecified unspecified  	O	null

0 ###NUMBER### ###NUMBER### ###NUMBER### numeral unspecified unspecified unspecified unspecified unspecified  	I_DATE	null
1 . . . punctuation unspecified unspecified unspecified unspecified unspecified  	O	null

0 - - - punctuation unspecified unspecified unspecified unspecified unspecified  	O	null
1 ###NUMBER### ###NUMBER### ###NUMBER### numeral unspecified unspecified unspecified unspecified unspecified  	O	null
2 ; ; ; punctuation unspecified unspecified unspecified unspecified unspecified  	O	null
3 ###NUMBER### ###NUMBER### ###NUMBER### numeral unspecified unspecified unspecified unspecified unspecified  	O	null
4 Ghanayim Ghanayim Ghanayim foreign unspecified unspecified unspecified unspecified unspecified  	O	null
5 , , , punctuation unspecified unspecified unspecified unspecified unspecified  	O	null
6 Mahmud Mahmud Mahmud foreign unspecified unspecified unspecified unspecified unspecified  	O	null
7 . . . punctuation unspecified unspecified unspecified unspecified unspecified  	O	null

0 The The The foreign unspecified unspecified unspecified unspecified unspecified  	I_ORG	null
1 Quest Quest Quest foreign unspecified unspecified unspecified unspecified unspecified  	I_ORG	null
2 for for for foreign unspecified unspecified unspecified unspecified unspecified  	I_ORG	null
3 a a a foreign unspecified unspecified unspecified unspecified unspecified  	I_ORG	null
4 Lost Lost Lost foreign unspecified unspecified unspecified unspecified unspecified  	I_ORG	null
5 Identity Identity Identity foreign unspecified unspecified unspecified unspecified unspecified  	I_ORG	null
6 : : : punctuation unspecified unspecified unspecified unspecified unspecified  	O	null
7 Palestinian Palestinian Palestinian foreign unspecified unspecified unspecified unspecified unspecified  	O	null
8 Fiction Fiction Fiction foreign unspecified unspecified unspecified unspecified unspecified  	O	null
9 in in in foreign unspecified unspecified unspecified unspecified unspecified  	O	null
10 Israel Israel Israel foreign unspecified unspecified unspecified unspecified unspecified  	O	null
11 . . . punctuation unspecified unspecified unspecified unspecified unspecified  	O	null

0 Wiesbaden Wiesbaden Wiesbaden foreign unspecified unspecified unspecified unspecified unspecified  	O	null
1 : : : punctuation unspecified unspecified unspecified unspecified unspecified  	O	null
2 Harrassowitz Harrassowitz Harrassowitz foreign unspecified unspecified unspecified unspecified unspecified  	O	null
3 . . . punctuation unspecified unspecified unspecified unspecified unspecified  	O	null

0 ###NUMBER### ###NUMBER### ###NUMBER### numeral unspecified unspecified unspecified unspecified unspecified  	I_DATE	null
1 . . . punctuation unspecified unspecified unspecified unspecified unspecified  	O	null

0 , , , punctuation unspecified unspecified unspecified unspecified unspecified  	O	null
1 ###NUMBER### ###NUMBER### ###NUMBER### numeral unspecified unspecified unspecified unspecified unspecified  	O	null
2 ###NUMBER### ###NUMBER### ###NUMBER### numeral unspecified unspecified unspecified unspecified unspecified  	O	null
3 - - - punctuation unspecified unspecified unspecified unspecified unspecified  	O	null
4 ###NUMBER### ###NUMBER### ###NUMBER### numeral unspecified unspecified unspecified unspecified unspecified  	O	null
5 . . . punctuation unspecified unspecified unspecified unspecified unspecified  	O	null

