0 Name Name Name foreign unspecified unspecified unspecified unspecified unspecified  	O	null
1 : : : punctuation unspecified unspecified unspecified unspecified unspecified  	O	null
2 עין עין עין properName unspecified unspecified unspecified unspecified unspecified  	I_ORG	null
3 - - - punctuation unspecified unspecified unspecified unspecified unspecified  	O	null
4 גיל גיל גיל noun masculine singular absolute unspecified unspecified  	O	null
5 , , , punctuation unspecified unspecified unspecified unspecified unspecified  	O	null
6 אהוד אהוד אהוד properName masculine singular unspecified unspecified unspecified  	I_PERS	null
7 Birth Birth Birth foreign unspecified unspecified unspecified unspecified unspecified  	O	null
8 Year Year Year foreign unspecified unspecified unspecified unspecified unspecified  	O	null
9 : : : punctuation unspecified unspecified unspecified unspecified unspecified  	O	null
10 ###NUMBER### ###NUMBER### ###NUMBER### numeral unspecified unspecified unspecified unspecified unspecified  	I_DATE	null
11 Birth Birth Birth foreign unspecified unspecified unspecified unspecified unspecified  	O	null
12 Place Place Place foreign unspecified unspecified unspecified unspecified unspecified  	O	null
13 : : : punctuation unspecified unspecified unspecified unspecified unspecified  	O	null
14 פתח פתח פתח verb masculine singular unspecified 2 imperative  	O	null
15 תקווהוגדל תקווהוגדל תקווהוגדל verb masculine singular unspecified 2 future  	O	null
16 ב ב בערים preposition unspecified unspecified unspecified unspecified unspecified 0 
16 ערים עיר בערים noun feminine plural absolute unspecified unspecified  	O	null
17 Occupation Occupation Occupation foreign unspecified unspecified unspecified unspecified unspecified  	O	null
18 : : : punctuation unspecified unspecified unspecified unspecified unspecified  	O	null
19 סופר סופר סופר noun masculine singular absolute unspecified unspecified  	O	null
20 ו ו ועיתונאי conjunction unspecified unspecified unspecified unspecified unspecified 0 
20 עיתונאי עיתונאי ועיתונאי noun masculine singular absolute unspecified unspecified  	O	null
21 Entry Entry Entry foreign unspecified unspecified unspecified unspecified unspecified  	O	null
22 writer writer writer foreign unspecified unspecified unspecified unspecified unspecified  	O	null
23 : : : punctuation unspecified unspecified unspecified unspecified unspecified  	O	null
24 דקל דקל דקל noun masculine singular construct unspecified unspecified  	O	null
25 שי שי שי properName unspecified unspecified unspecified unspecified unspecified  	I_PERS	null
26 ש ש שחורי relativizer/subordinatingConjunction unspecified unspecified unspecified unspecified unspecified 0 
26 חורי חור שחורי noun masculine plural construct unspecified unspecified  	O	null
27 Entry Entry Entry foreign unspecified unspecified unspecified unspecified unspecified  	O	null
28 Value Value Value foreign unspecified unspecified unspecified unspecified unspecified  	O	null
29 : : : punctuation unspecified unspecified unspecified unspecified unspecified  	O	null
30 נולד נולד נולד verb masculine singular unspecified 3 past  	O	null
31 ב ב בפתח preposition unspecified unspecified unspecified unspecified unspecified 0 
31 פתח פתח בפתח noun masculine singular construct unspecified unspecified  	I_ORG	null
32 תקווהוגדל תקווהוגדל תקווהוגדל properName unspecified unspecified unspecified unspecified unspecified  	I_ORG	null
33 ב ב בערים preposition unspecified unspecified unspecified unspecified unspecified 0 
33 ערים עיר בערים noun feminine plural absolute unspecified unspecified  	O	null
34 שונות שונה שונות adjective feminine plural absolute unspecified unspecified  	O	null
35 ב ב בארץ preposition unspecified unspecified unspecified unspecified unspecified 0 
35 ה ה בארץ definiteArticle unspecified unspecified unspecified unspecified unspecified 0 
35 הארץ ארץ בארץ noun feminine singular absolute unspecified unspecified  	O	null
36 . . . punctuation unspecified unspecified unspecified unspecified unspecified  	O	null

0 עבד עבד עבד properName masculine singular unspecified unspecified unspecified  	I_PERS	null
1 כ כ כעורך preposition unspecified unspecified unspecified unspecified unspecified 0 
1 ה ה כעורך definiteArticle unspecified unspecified unspecified unspecified unspecified 0 
1 העורך עורך כעורך noun masculine singular absolute unspecified unspecified  	O	null
2 בהעיר העיר בהעיר verb unspecified unspecified unspecified unspecified infinitive  	O	null
3 ו ו ובכותרת conjunction unspecified unspecified unspecified unspecified unspecified 0 
3 ב ב ובכותרת preposition unspecified unspecified unspecified unspecified unspecified 0 
3 כותרת כותרת ובכותרת noun feminine singular absolute unspecified unspecified  	O	null
4 ראשית ראשי ראשית adjective feminine singular absolute unspecified unspecified  	O	null
5 . . . punctuation unspecified unspecified unspecified unspecified unspecified  	O	null

0 שימש שימש שימש verb masculine singular unspecified 3 past  	O	null
1 כ כ כסגן preposition unspecified unspecified unspecified unspecified unspecified 0 
1 סגן סגן כסגן noun masculine singular construct unspecified unspecified  	O	null
2 עורך עורך עורך noun masculine singular construct unspecified unspecified  	O	null
3 ה ה המוסף definiteArticle unspecified unspecified unspecified unspecified unspecified 0 
3 המוסף מוסף המוסף noun masculine singular absolute unspecified unspecified  	O	null
4 של של של shel-preposition unspecified unspecified unspecified unspecified unspecified  	O	null
5 ה ה העיתון definiteArticle unspecified unspecified unspecified unspecified unspecified 0 
5 העיתון עיתון העיתון noun masculine singular absolute unspecified unspecified  	O	null
6 חדשות חדש חדשות adjective feminine plural absolute unspecified unspecified  	O	null
7 במשך במשך במשך preposition unspecified unspecified unspecified unspecified unspecified  	O	null
8 חמש CARD5 חמש numeral feminine singular absolute unspecified unspecified  	O	null
9 שנים שנה שנים noun feminine plural absolute unspecified unspecified  	O	null
10 , , , punctuation unspecified unspecified unspecified unspecified unspecified  	O	null
11 עד עד עד noun masculine singular absolute unspecified unspecified  	O	null
12 ל ל לסגירת preposition unspecified unspecified unspecified unspecified unspecified 0 
12 סגירת סגירה לסגירת noun feminine singular construct unspecified unspecified  	O	null
13 ה ה העיתון definiteArticle unspecified unspecified unspecified unspecified unspecified 0 
13 העיתון עיתון העיתון noun masculine singular absolute unspecified unspecified  	O	null
14 ב ב ב preposition unspecified unspecified unspecified unspecified unspecified 0 	O	null
15 - - - punctuation unspecified unspecified unspecified unspecified unspecified  	O	null
16 , , , punctuation unspecified unspecified unspecified unspecified unspecified  	I_ORG	null
17 ###NUMBER### ###NUMBER### ###NUMBER### numeral unspecified unspecified unspecified unspecified unspecified  	I_DATE	null
18 אז אז אז conjunction unspecified unspecified unspecified unspecified unspecified  	O	null
19 עבר עבר עבר verb masculine singular unspecified 3 past  	O	null
20 ל ל להארץ preposition unspecified unspecified unspecified unspecified unspecified 0 
20 ה ה להארץ definiteArticle unspecified unspecified unspecified unspecified unspecified 0 
20 ההארץ ארץ להארץ noun feminine singular absolute unspecified unspecified  	O	null
21 . . . punctuation unspecified unspecified unspecified unspecified unspecified  	O	null

0 פעילות פעילות פעילותו noun feminine singular absolute unspecified unspecified  
0 ו ו פעילותו possessive masculine singular unspecified 3 unspecified 0 	O	null
1 ה ה הפוליטית definiteArticle unspecified unspecified unspecified unspecified unspecified 0 
1 הפוליטית פוליטי הפוליטית adjective feminine singular absolute unspecified unspecified  	O	null
2 החלה החל החלה verb feminine singular unspecified 3 past  	O	null
3 מיד מייד מיד adverb unspecified unspecified unspecified unspecified unspecified  	O	null
4 לאחר לאחר לאחר preposition unspecified unspecified unspecified unspecified unspecified  	O	null
5 שירותוהצבאי שירותוהצבאי שירותוהצבאי participle feminine plural construct any unspecified  	I_ORG	null
6 , , , punctuation unspecified unspecified unspecified unspecified unspecified  	O	null
7 כש כש כשהצטרף temporalSubConj unspecified unspecified unspecified unspecified unspecified 0 
7 הצטרף הצטרף כשהצטרף verb masculine singular unspecified 3 past  	O	null
8 ל ל לפעילותה preposition unspecified unspecified unspecified unspecified unspecified 0 
8 פעילות פעילות לפעילותה noun feminine singular absolute unspecified unspecified  
8 ה ה לפעילותה possessive feminine singular unspecified 3 unspecified 0 	O	null
9 של של של shel-preposition unspecified unspecified unspecified unspecified unspecified  	O	null
10 קבוצה קבוצה קבוצה noun feminine singular absolute unspecified unspecified  	O	null
11 אנרכיסטית אנרכיסטית אנרכיסטית adjective feminine singular absolute unspecified unspecified  	O	null
12 ש ש שהוציאה relativizer/subordinatingConjunction unspecified unspecified unspecified unspecified unspecified 0 
12 הוציאה הוציא שהוציאה verb feminine singular unspecified 3 past  	O	null
13 לאור לאור לאור preposition unspecified unspecified unspecified unspecified unspecified  	O	null
14 עיתון עיתון עיתון noun masculine singular absolute unspecified unspecified  	O	null
15 ב ב בשם preposition unspecified unspecified unspecified unspecified unspecified 0 
15 שם שם בשם noun masculine singular construct unspecified unspecified  	O	null
16 ספרטקוס ספרטקוס ספרטקוס properName unspecified unspecified unspecified unspecified unspecified  	I_LOC	null
17 . . . punctuation unspecified unspecified unspecified unspecified unspecified  	O	null

0 למד למד למד verb masculine singular unspecified 3 past  	O	null
1 ב ב במחלקהלהיסטוריה preposition unspecified unspecified unspecified unspecified unspecified 0 
1 ה ה במחלקהלהיסטוריה definiteArticle unspecified unspecified unspecified unspecified unspecified 0 
1 המחלקהלהיסטוריה המחלקהלהיסטוריה במחלקהלהיסטוריה adjective feminine singular absolute unspecified unspecified  	O	null
2 כללית כללי כללית adjective feminine singular absolute unspecified unspecified  	O	null
3 ב ב באוניברסיטת preposition unspecified unspecified unspecified unspecified unspecified 0 
3 אוניברסיטת אוניברסיטה באוניברסיטת noun feminine singular construct unspecified unspecified  	I_ORG	null
4 תלאביב תלאביב תלאביב properName unspecified unspecified unspecified unspecified unspecified  	I_ORG	null
5 . . . punctuation unspecified unspecified unspecified unspecified unspecified  	O	null

0 ב ב ב preposition unspecified unspecified unspecified unspecified unspecified 0 	O	null
1 - - - punctuation unspecified unspecified unspecified unspecified unspecified  	O	null
2 ###NUMBER### ###NUMBER### ###NUMBER### numeral unspecified unspecified unspecified unspecified unspecified  	I_DATE	null
3 הצטרף הצטרף הצטרף verb masculine singular unspecified 3 past  	O	null
4 ל ל לארגון preposition unspecified unspecified unspecified unspecified unspecified 0 
4 ה ה לארגון definiteArticle unspecified unspecified unspecified unspecified unspecified 0 
4 הארגון ארגון לארגון noun masculine singular absolute unspecified unspecified  	O	null
5 ה ה הסוציאליסטי definiteArticle unspecified unspecified unspecified unspecified unspecified 0 
5 הסוציאליסטי סוציאליסטי הסוציאליסטי adjective masculine singular absolute unspecified unspecified  	O	null
6 " " " punctuation unspecified unspecified unspecified unspecified unspecified  	O	null
7 מצפן מצפן מצפן noun masculine singular absolute unspecified unspecified  	O	null
8 " " " punctuation unspecified unspecified unspecified unspecified unspecified  	O	null
9 . . . punctuation unspecified unspecified unspecified unspecified unspecified  	O	null

0 ב ב ב preposition unspecified unspecified unspecified unspecified unspecified 0 	O	null
1 - - - punctuation unspecified unspecified unspecified unspecified unspecified  	O	null
2 ###NUMBER### ###NUMBER### ###NUMBER### numeral unspecified unspecified unspecified unspecified unspecified  	I_DATE	null
3 הצטרף הצטרף הצטרף verb masculine singular unspecified 3 past  	O	null
4 ל ל לעמותת preposition unspecified unspecified unspecified unspecified unspecified 0 
4 עמותת עמותה לעמותת noun feminine singular construct unspecified unspecified  	O	null
5 " " " punctuation unspecified unspecified unspecified unspecified unspecified  	O	null
6 אור אור אור properName unspecified unspecified unspecified unspecified unspecified  	I_ORG	null
7 אדום אדום אדום properName unspecified unspecified unspecified unspecified unspecified  	I_ORG	null
8 " " " punctuation unspecified unspecified unspecified unspecified unspecified  	O	null
9 , , , punctuation unspecified unspecified unspecified unspecified unspecified  	O	null
10 ש ש שהוקמה relativizer/subordinatingConjunction unspecified unspecified unspecified unspecified unspecified 0 
10 הוקמה הוקם שהוקמה verb feminine singular unspecified 3 past  	O	null
11 ב ב במטרה preposition unspecified unspecified unspecified unspecified unspecified 0 
11 ה ה במטרה definiteArticle unspecified unspecified unspecified unspecified unspecified 0 
11 המטרה מטרה במטרה noun feminine singular absolute unspecified unspecified  	O	null
12 להגן הגן להגן verb unspecified unspecified unspecified unspecified infinitive  	O	null
13 על על על preposition unspecified unspecified unspecified unspecified unspecified  	O	null
14 אזרחיםמפני אזרחיםמפני אזרחיםמפני verb feminine singular unspecified 2 imperative  	O	null
15 אלימות אלימות אלימות noun feminine singular absolute unspecified unspecified  	O	null
16 שוטרים שוטר שוטרים noun masculine plural absolute unspecified unspecified  	O	null
17 . . . punctuation unspecified unspecified unspecified unspecified unspecified  	O	null

0 מאז מאז מאז adverb unspecified unspecified unspecified unspecified unspecified  	O	null
1 ###NUMBER### ###NUMBER### ###NUMBER### numeral unspecified unspecified unspecified unspecified unspecified  	I_DATE	null
2 פעיל פעיל פעיל noun masculine singular absolute unspecified unspecified  	O	null
3 ב ב ב preposition unspecified unspecified unspecified unspecified unspecified 0 	O	null
4 " " " punctuation unspecified unspecified unspecified unspecified unspecified  	O	null
5 קו קו קו noun masculine singular absolute unspecified unspecified  	O	null
6 ל ל לעובד preposition unspecified unspecified unspecified unspecified unspecified 0 
6 עובד עובד לעובד noun masculine singular absolute unspecified unspecified  	O	null
7 " " " punctuation unspecified unspecified unspecified unspecified unspecified  	O	null
8 . . . punctuation unspecified unspecified unspecified unspecified unspecified  	O	null

0 פירסם פרסם פירסם verb masculine singular unspecified 3 past  	O	null
1 שני CARD2 שני numeral masculine dual construct unspecified unspecified  	O	null
2 רומנים רומן רומנים noun masculine plural absolute unspecified unspecified  	O	null
3 . . . punctuation unspecified unspecified unspecified unspecified unspecified  	O	null

0 ה ה הראשון definiteArticle unspecified unspecified unspecified unspecified unspecified 0 
0 הראשון ORD1 הראשון numeral masculine singular absolute unspecified unspecified  	O	null
1 , , , punctuation unspecified unspecified unspecified unspecified unspecified  	O	null
2 תחנות תחנה תחנות noun feminine plural absolute unspecified unspecified  	O	null
3 ב ב בדרך preposition unspecified unspecified unspecified unspecified unspecified 0 
3 דרך דרך בדרך noun feminine singular construct unspecified unspecified  	O	null
4 חצרמוות חצרמוות חצרמוות noun feminine plural absolute unspecified unspecified  	O	null
5 ( ( ( punctuation unspecified unspecified unspecified unspecified unspecified  	O	null
6 ה ה הקיבוץ definiteArticle unspecified unspecified unspecified unspecified unspecified 0 
6 הקיבוץ קיבוץ הקיבוץ noun masculine singular absolute unspecified unspecified  	O	null
7 ה ה המאוחד definiteArticle unspecified unspecified unspecified unspecified unspecified 0 
7 המאוחד מאוחד המאוחד adjective masculine singular absolute unspecified unspecified  	O	null
8 , , , punctuation unspecified unspecified unspecified unspecified unspecified  	O	null
9 ) ) ) punctuation unspecified unspecified unspecified unspecified unspecified  	O	null
10 , , , punctuation unspecified unspecified unspecified unspecified unspecified  	O	null
11 ###NUMBER### ###NUMBER### ###NUMBER### numeral unspecified unspecified unspecified unspecified unspecified  	I_DATE	null
12 הוא הוא הוא pronoun masculine singular unspecified 3 unspecified  	O	null
13 סמי סמי סמי wPrefix unspecified unspecified unspecified unspecified unspecified  	O	null
14 - - - punctuation unspecified unspecified unspecified unspecified unspecified  	O	null
15 אוטוביוגרפי אוטוביוגרפי אוטוביוגרפי adjective masculine singular absolute unspecified unspecified  	O	null
16 . . . punctuation unspecified unspecified unspecified unspecified unspecified  	O	null

0 ב ב במרכזו preposition unspecified unspecified unspecified unspecified unspecified 0 
0 מרכז מרכז במרכזו noun masculine singular absolute unspecified unspecified  
0 ו ו במרכזו possessive masculine singular unspecified 3 unspecified 0 	O	null
1 צעיר צעיר צעיר adjective masculine singular absolute unspecified unspecified  	O	null
2 ל ל למשפחה preposition unspecified unspecified unspecified unspecified unspecified 0 
2 משפחה משפחה למשפחה noun feminine singular absolute unspecified unspecified  	O	null
3 מפא"יניקית מפא"יניק מפא"יניקית adjective feminine singular absolute unspecified unspecified  	O	null
4 ה ה המורד definiteArticle unspecified unspecified unspecified unspecified unspecified 0 
4 המורד מורד המורד noun masculine singular absolute unspecified unspecified  	O	null
5 ב ב באתוס preposition unspecified unspecified unspecified unspecified unspecified 0 
5 ה ה באתוס definiteArticle unspecified unspecified unspecified unspecified unspecified 0 
5 האתוס האתוס באתוס noun masculine singular absolute unspecified unspecified  	O	null
6 ה ה הציוני definiteArticle unspecified unspecified unspecified unspecified unspecified 0 
6 הציוני ציוני הציוני adjective masculine singular absolute unspecified unspecified  	O	null
7 בעקבות בעקבות בעקבות preposition unspecified unspecified unspecified unspecified unspecified  	O	null
8 מלחמת מלחמה מלחמת noun feminine singular construct unspecified unspecified  	O	null
9 ה ה ההתשה definiteArticle unspecified unspecified unspecified unspecified unspecified 0 
9 ההתשה התשה ההתשה noun feminine singular absolute unspecified unspecified  	O	null
10 . . . punctuation unspecified unspecified unspecified unspecified unspecified  	O	null

0 עיקרהסיפורהוא עיקרהסיפורהוא עיקרהסיפורהוא adjective feminine plural absolute unspecified unspecified  	O	null
1 תיאור תיאור תיאורה noun masculine singular absolute unspecified unspecified  
1 ה ה תיאורה possessive feminine singular unspecified 3 unspecified 0 	O	null
2 של של של shel-preposition unspecified unspecified unspecified unspecified unspecified  	O	null
3 ה ה הרפובליקה definiteArticle unspecified unspecified unspecified unspecified unspecified 0 
3 הרפובליקה רפובליקה הרפובליקה noun feminine singular absolute unspecified unspecified  	O	null
4 ה ה הסוציאליסטית definiteArticle unspecified unspecified unspecified unspecified unspecified 0 
4 הסוציאליסטית סוציאליסטי הסוציאליסטית adjective feminine singular absolute unspecified unspecified  	O	null
5 קצרת קצרת קצרת noun feminine singular construct unspecified unspecified  	O	null
6 ה ה הימים definiteArticle unspecified unspecified unspecified unspecified unspecified 0 
6 הימים יום הימים noun masculine plural absolute unspecified unspecified  	O	null
7 ש ש שקמה relativizer/subordinatingConjunction unspecified unspecified unspecified unspecified unspecified 0 
7 קמה קם שקמה verb feminine singular unspecified 3 past  	O	null
8 ב ב בסוף preposition unspecified unspecified unspecified unspecified unspecified 0 
8 סוף סוף בסוף noun masculine singular construct unspecified unspecified  	O	null
9 שנות שנה שנות noun feminine plural construct unspecified unspecified  	I_DATE	null
10 ה ה השישים definiteArticle unspecified unspecified unspecified unspecified unspecified 0 
10 השישים ORD-CARD60 השישים numeral masculine-and-feminine plural absolute unspecified unspecified  	I_DATE	null
11 ב ב בדרום preposition unspecified unspecified unspecified unspecified unspecified 0 
11 דרום דרום בדרום noun masculine singular construct unspecified unspecified  	O	null
12 - - - punctuation unspecified unspecified unspecified unspecified unspecified  	I_LOC	null
13 תימן תימן תימן properName unspecified unspecified unspecified unspecified unspecified  	I_LOC	null
14 , , , punctuation unspecified unspecified unspecified unspecified unspecified  	O	null
15 ו ו ופגישותיו conjunction unspecified unspecified unspecified unspecified unspecified 0 
15 פגישות פגישה ופגישותיו noun feminine plural absolute unspecified unspecified  
15 ו ו ופגישותיו possessive masculine singular unspecified 3 unspecified 0 	O	null
16 של של של shel-preposition unspecified unspecified unspecified unspecified unspecified  	O	null
17 ה ה המחבר definiteArticle unspecified unspecified unspecified unspecified unspecified 0 
17 המחבר מחבר המחבר noun masculine singular absolute unspecified unspecified  	O	null
18 עם עם עם preposition unspecified unspecified unspecified unspecified unspecified  	O	null
19 מנהיגה מנהיגה מנהיגה noun feminine singular absolute unspecified unspecified  	O	null
20 , , , punctuation unspecified unspecified unspecified unspecified unspecified  	O	null
21 סאלם סאלם סאלם noun masculine singular absolute unspecified unspecified  	O	null
22 רובייע רובייע רובייע participle masculine plural absolute any unspecified  	O	null
23 על על עלי preposition unspecified unspecified unspecified unspecified unspecified  
23 י י עלי pronomial masculine-and-feminine singular unspecified 1 unspecified 0 	O	null
24 . . . punctuation unspecified unspecified unspecified unspecified unspecified  	O	null

0 ה ה הרומן definiteArticle unspecified unspecified unspecified unspecified unspecified 0 
0 הרומן רומן הרומן noun masculine singular absolute unspecified unspecified  	O	null
1 ה ה השני definiteArticle unspecified unspecified unspecified unspecified unspecified 0 
1 השני ORD2 השני numeral masculine singular absolute unspecified unspecified  	O	null
2 , , , punctuation unspecified unspecified unspecified unspecified unspecified  	O	null
3 כולם כולם כולם pronoun masculine plural unspecified 3 unspecified  	O	null
4 אוהבים אהב אוהבים verb masculine plural unspecified any beinoni  	O	null
5 את את את at-preposition unspecified unspecified unspecified unspecified unspecified  	O	null
6 דור דור דורה noun masculine singular absolute unspecified unspecified  
6 ה ה דורה possessive feminine singular unspecified 3 unspecified 0 	O	null
7 ) ) ) punctuation unspecified unspecified unspecified unspecified unspecified  	O	null
8 , , , punctuation unspecified unspecified unspecified unspecified unspecified  	O	null
9 ###NUMBER### ###NUMBER### ###NUMBER### numeral unspecified unspecified unspecified unspecified unspecified  	I_DATE	null
10 הוא הוא הוא pronoun masculine singular unspecified 3 unspecified  	O	null
11 סיפור סיפור סיפורה noun masculine singular absolute unspecified unspecified  
11 ה ה סיפורה possessive feminine singular unspecified 3 unspecified 0 	O	null
12 של של של shel-preposition unspecified unspecified unspecified unspecified unspecified  	O	null
13 ילדה ילד ילדה noun feminine singular absolute unspecified unspecified  	O	null
14 מחוללת חולל מחוללת verb feminine singular unspecified any beinoni  	O	null
15 נסים נסים נסים properName unspecified unspecified unspecified unspecified unspecified  	I_PERS	null
16 , , , punctuation unspecified unspecified unspecified unspecified unspecified  	O	null
17 ספק ספק ספק noun masculine singular absolute unspecified unspecified  	O	null
18 מ מ מפגרת preposition unspecified unspecified unspecified unspecified unspecified 0 
18 פגרת פגרה מפגרת noun feminine singular construct unspecified unspecified  	O	null
19 ספק ספק ספק noun masculine singular absolute unspecified unspecified  	O	null
20 גאון גאון גאונה noun masculine singular absolute unspecified unspecified  
20 ה ה גאונה possessive feminine singular unspecified 3 unspecified 0 	O	null
21 , , , punctuation unspecified unspecified unspecified unspecified unspecified  	O	null
22 ש ש שיש relativizer/subordinatingConjunction unspecified unspecified unspecified unspecified unspecified 0 
22 יש יש שיש existential unspecified unspecified unspecified unspecified unspecified  	O	null
23 ב ב בו preposition unspecified unspecified unspecified unspecified unspecified  
23 ו ו בו pronomial masculine singular unspecified 3 unspecified 0 	O	null
24 , , , punctuation unspecified unspecified unspecified unspecified unspecified  	O	null
25 ל ל לדבריו preposition unspecified unspecified unspecified unspecified unspecified 0 
25 דברי דבר לדבריו noun masculine plural absolute unspecified unspecified  
25 ו ו לדבריו possessive masculine singular unspecified 3 unspecified 0 	O	null
26 של של של shel-preposition unspecified unspecified unspecified unspecified unspecified  	O	null
27 מבקר מבקר מבקר noun masculine singular construct unspecified unspecified  	O	null
28 ה ה הספרות definiteArticle unspecified unspecified unspecified unspecified unspecified 0 
28 הספרות ספרות הספרות noun feminine singular absolute unspecified unspecified  	O	null
29 עמרי עמרי עמרי properName unspecified unspecified unspecified unspecified unspecified  	I_PERS	null
30 הרצוג הרצוג הרצוג properName unspecified unspecified unspecified unspecified unspecified  	I_PERS	null
31 ) ) ) punctuation unspecified unspecified unspecified unspecified unspecified  	O	null
32 , , , punctuation unspecified unspecified unspecified unspecified unspecified  	O	null
33 ###NUMBER### ###NUMBER### ###NUMBER### numeral unspecified unspecified unspecified unspecified unspecified  	I_DATE	null
34 " " " punctuation unspecified unspecified unspecified unspecified unspecified  	O	null
35 תעוזה תעוזה תעוזה noun feminine singular absolute unspecified unspecified  	O	null
36 ספרותית ספרותי ספרותית adjective feminine singular absolute unspecified unspecified  	O	null
37 סוערתויוצאתדופן סוערתויוצאתדופן סוערתויוצאתדופן preposition unspecified unspecified unspecified unspecified unspecified  	O	null
38 " " " punctuation unspecified unspecified unspecified unspecified unspecified  	O	null
39 . . . punctuation unspecified unspecified unspecified unspecified unspecified  	O	null

0 פרט פרט פרט noun masculine singular absolute unspecified unspecified  	O	null
1 ל ל לכך preposition unspecified unspecified unspecified unspecified unspecified 0 
1 כך כך לכך pronoun unspecified unspecified unspecified unspecified unspecified  	O	null
2 , , , punctuation unspecified unspecified unspecified unspecified unspecified  	O	null
3 תירגם תרגם תירגם verb masculine singular unspecified 3 past  	O	null
4 ו ו והקדים conjunction unspecified unspecified unspecified unspecified unspecified 0 
4 הקדים הקדים והקדים verb masculine singular unspecified 3 past  	O	null
5 מבואות מבוא מבואות noun masculine plural absolute unspecified unspecified  	O	null
6 ל ל לספר preposition unspecified unspecified unspecified unspecified unspecified 0 
6 ה ה לספר definiteArticle unspecified unspecified unspecified unspecified unspecified 0 
6 הספר ספר לספר noun masculine singular absolute unspecified unspecified  	O	null
7 ש ש שעסק relativizer/subordinatingConjunction unspecified unspecified unspecified unspecified unspecified 0 
7 עסק עסק שעסק verb masculine singular unspecified 3 past  	O	null
8 ב ב בתנועה preposition unspecified unspecified unspecified unspecified unspecified 0 
8 ה ה בתנועה definiteArticle unspecified unspecified unspecified unspecified unspecified 0 
8 התנועה תנועה בתנועה noun feminine singular absolute unspecified unspecified  	O	null
9 ה ה האנרכיסטית definiteArticle unspecified unspecified unspecified unspecified unspecified 0 
9 האנרכיסטית האנרכיסטית האנרכיסטית adjective feminine singular absolute unspecified unspecified  	O	null
10 ב ב באוקראינה preposition unspecified unspecified unspecified unspecified unspecified 0 
10 אוקראינה אוקראינה באוקראינה properName unspecified unspecified unspecified unspecified unspecified  	I_LOC	null
11 ( ( ( punctuation unspecified unspecified unspecified unspecified unspecified  	O	null
12 דגלים דגל דגלים noun masculine plural absolute unspecified unspecified  	O	null
13 שחורים שחור שחורים adjective masculine plural absolute unspecified unspecified  	O	null
14 ב ב באוקראינה preposition unspecified unspecified unspecified unspecified unspecified 0 
14 אוקראינה אוקראינה באוקראינה properName unspecified unspecified unspecified unspecified unspecified  	I_LOC	null
15 , , , punctuation unspecified unspecified unspecified unspecified unspecified  	O	null
16 ) ) ) punctuation unspecified unspecified unspecified unspecified unspecified  	O	null
17 ###NUMBER### ###NUMBER### ###NUMBER### numeral unspecified unspecified unspecified unspecified unspecified  	I_DATE	null
18 ו ו וערך conjunction unspecified unspecified unspecified unspecified unspecified 0 
18 ערך ערך וערך noun masculine singular absolute unspecified unspecified  	O	null
19 , , , punctuation unspecified unspecified unspecified unspecified unspecified  	O	null
20 עם עם עם preposition unspecified unspecified unspecified unspecified unspecified  	O	null
21 גיורא גיורא גיורא properName unspecified unspecified unspecified unspecified unspecified  	I_PERS	null
22 נוימן נוימן נוימן properName unspecified unspecified unspecified unspecified unspecified  	I_PERS	null
23 , , , punctuation unspecified unspecified unspecified unspecified unspecified  	O	null
24 אסופת אסופה אסופת noun feminine singular construct unspecified unspecified  	O	null
25 מאמרים מאמר מאמרים noun masculine plural absolute unspecified unspecified  	O	null
26 ה ה הקוראת definiteArticle unspecified unspecified unspecified unspecified unspecified 0 
26 הקוראת קרא הקוראת participle feminine singular absolute any unspecified  	I_ORG	null
27 למזרחתיכון למזרחתיכון למזרחתיכון properName unspecified unspecified unspecified unspecified unspecified  	I_ORG	null
28 חופשי חופשי חופשי adjective masculine singular absolute unspecified unspecified  	O	null
29 מ מ מנשק preposition unspecified unspecified unspecified unspecified unspecified 0 
29 נשק נשק מנשק noun masculine singular absolute unspecified unspecified  	O	null
30 אטומי אטומי אטומי adjective masculine singular absolute unspecified unspecified  	O	null
31 ( ( ( punctuation unspecified unspecified unspecified unspecified unspecified  	O	null
32 ואנונו ואנונו ואנונו properName unspecified unspecified unspecified unspecified unspecified  	I_PERS	null
33 ו ו והפצצה conjunction unspecified unspecified unspecified unspecified unspecified 0 
33 ה ה והפצצה definiteArticle unspecified unspecified unspecified unspecified unspecified 0 
33 הפצצה פצצה והפצצה noun feminine singular absolute unspecified unspecified  	O	null
34 , , , punctuation unspecified unspecified unspecified unspecified unspecified  	O	null
35 ###NUMBER### ###NUMBER### ###NUMBER### numeral unspecified unspecified unspecified unspecified unspecified  	I_DATE	null
36 ) ) ) punctuation unspecified unspecified unspecified unspecified unspecified  	O	null
37 . . . punctuation unspecified unspecified unspecified unspecified unspecified  	O	null

0 References References References foreign unspecified unspecified unspecified unspecified unspecified  	O	null
1 : : : punctuation unspecified unspecified unspecified unspecified unspecified  	O	null
2 הרצוג הרצוג הרצוג properName unspecified unspecified unspecified unspecified unspecified  	I_PERS	null
3 , , , punctuation unspecified unspecified unspecified unspecified unspecified  	O	null
4 עמרי עמרי עמרי properName unspecified unspecified unspecified unspecified unspecified  	I_PERS	null
5 . . . punctuation unspecified unspecified unspecified unspecified unspecified  	O	null

0 " " " punctuation unspecified unspecified unspecified unspecified unspecified  	O	null
1 ה ה הגבול definiteArticle unspecified unspecified unspecified unspecified unspecified 0 
1 הגבול גבול הגבול noun masculine singular absolute unspecified unspecified  	O	null
2 ה ה השברירי definiteArticle unspecified unspecified unspecified unspecified unspecified 0 
2 השברירי שברירי השברירי adjective masculine singular absolute unspecified unspecified  	O	null
3 בין בין בין preposition unspecified unspecified unspecified unspecified unspecified  	O	null
4 רודף רודף רודף noun masculine singular absolute unspecified unspecified  	O	null
5 ל ל לנרדף preposition unspecified unspecified unspecified unspecified unspecified 0 
5 ה ה לנרדף definiteArticle unspecified unspecified unspecified unspecified unspecified 0 
5 הנרדף נרדף לנרדף participle masculine singular absolute any unspecified  	O	null
6 " " " punctuation unspecified unspecified unspecified unspecified unspecified  	O	null
7 . . . punctuation unspecified unspecified unspecified unspecified unspecified  	O	null

0 ה ה הארץ definiteArticle unspecified unspecified unspecified unspecified unspecified 0 
0 הארץ ארץ הארץ noun feminine singular absolute unspecified unspecified  	O	null
1 ספרים ספר ספרים noun masculine plural absolute unspecified unspecified  	O	null
2 . . . punctuation unspecified unspecified unspecified unspecified unspecified  	O	null

0 ###NUMEXP### ###NUMEXP### ###NUMEXP### numberExpression unspecified unspecified unspecified unspecified unspecified  	I_DATE	null
1 . . . punctuation unspecified unspecified unspecified unspecified unspecified  	O	null

0 ; ; ; punctuation unspecified unspecified unspecified unspecified unspecified  	O	null
1 ###NUMBER### ###NUMBER### ###NUMBER### numeral unspecified unspecified unspecified unspecified unspecified  	O	null
2 ש ש שמואלוף relativizer/subordinatingConjunction unspecified unspecified unspecified unspecified unspecified 0 
2 מ מ שמואלוף preposition unspecified unspecified unspecified unspecified unspecified 0 
2 ואלו ואלו שמואלוף noun masculine plural absolute unspecified unspecified  
2 י י שמואלוף possessive masculine-and-feminine singular unspecified 1 unspecified 0 	O	null
3 , , , punctuation unspecified unspecified unspecified unspecified unspecified  	O	null
4 מתי מתי מתי adverb unspecified unspecified unspecified unspecified unspecified  	O	null
5 . . . punctuation unspecified unspecified unspecified unspecified unspecified  	O	null

0 " " " punctuation unspecified unspecified unspecified unspecified unspecified  	O	null
1 ה ה הסובייקט definiteArticle unspecified unspecified unspecified unspecified unspecified 0 
1 הסובייקט הסובייקט הסובייקט noun masculine singular absolute unspecified unspecified  	O	null
2 ה ה המוכפף definiteArticle unspecified unspecified unspecified unspecified unspecified 0 
2 המוכפף הוכפף המוכפף participle masculine singular absolute any unspecified  	O	null
3 " " " punctuation unspecified unspecified unspecified unspecified unspecified  	O	null
4 . . . punctuation unspecified unspecified unspecified unspecified unspecified  	O	null

0 עתון עיתון עתון noun masculine singular construct unspecified unspecified  	O	null
1 ###NUMBER### ###NUMBER### ###NUMBER### numeral unspecified unspecified unspecified unspecified unspecified  	O	null
2 ###NUMBER### ###NUMBER### ###NUMBER### numeral unspecified unspecified unspecified unspecified unspecified  	O	null
3 - - - punctuation unspecified unspecified unspecified unspecified unspecified  	O	null
4 ###NUMBER### ###NUMBER### ###NUMBER### numeral unspecified unspecified unspecified unspecified unspecified  	O	null
5 . . . punctuation unspecified unspecified unspecified unspecified unspecified  	O	null

0 ###NUMBER### ###NUMBER### ###NUMBER### numeral unspecified unspecified unspecified unspecified unspecified  	I_DATE	null
1 . . . punctuation unspecified unspecified unspecified unspecified unspecified  	O	null

0 ###NUMBER### ###NUMBER### ###NUMBER### numeral unspecified unspecified unspecified unspecified unspecified  	O	null
1 . . . punctuation unspecified unspecified unspecified unspecified unspecified  	O	null

