0 Name Name Name foreign unspecified unspecified unspecified unspecified unspecified  	O	null
1 : : : punctuation unspecified unspecified unspecified unspecified unspecified  	O	null
2 ערן ערן ערן properName unspecified unspecified unspecified unspecified unspecified  	I_PERS	null
3 , , , punctuation unspecified unspecified unspecified unspecified unspecified  	O	null
4 עמיר עמיר עמירה noun masculine singular absolute unspecified unspecified  
4 ה ה עמירה possessive feminine singular unspecified 3 unspecified 0 	O	null
5 Birth Birth Birth foreign unspecified unspecified unspecified unspecified unspecified  	O	null
6 Year Year Year foreign unspecified unspecified unspecified unspecified unspecified  	O	null
7 : : : punctuation unspecified unspecified unspecified unspecified unspecified  	O	null
8 ###NUMBER### ###NUMBER### ###NUMBER### numeral unspecified unspecified unspecified unspecified unspecified  	I_DATE	null
9 Birth Birth Birth foreign unspecified unspecified unspecified unspecified unspecified  	O	null
10 Place Place Place foreign unspecified unspecified unspecified unspecified unspecified  	O	null
11 : : : punctuation unspecified unspecified unspecified unspecified unspecified  	O	null
12 קיבוץ קיבוץ קיבוץ noun masculine singular construct unspecified unspecified  	O	null
13 ה ה המעפיל definiteArticle unspecified unspecified unspecified unspecified unspecified 0 
13 המעפיל העפיל המעפיל participle masculine singular absolute any unspecified  	O	null
14 , , , punctuation unspecified unspecified unspecified unspecified unspecified  	O	null
15 לאמה לאמה לאמה properName unspecified unspecified unspecified unspecified unspecified  	I_PERS	null
16 Occupation Occupation Occupation foreign unspecified unspecified unspecified unspecified unspecified  	O	null
17 : : : punctuation unspecified unspecified unspecified unspecified unspecified  	O	null
18 משוררת משורר משוררת noun feminine singular absolute unspecified unspecified  	O	null
19 , , , punctuation unspecified unspecified unspecified unspecified unspecified  	O	null
20 סופרת סופר סופרת noun feminine singular absolute unspecified unspecified  	O	null
21 ו ו וחוקרת conjunction unspecified unspecified unspecified unspecified unspecified 0 
21 חוקרת חקר וחוקרת verb feminine singular unspecified any beinoni  	O	null
22 ספרות ספרות ספרות noun feminine singular construct unspecified unspecified  	O	null
23 Entry Entry Entry foreign unspecified unspecified unspecified unspecified unspecified  	O	null
24 writer writer writer foreign unspecified unspecified unspecified unspecified unspecified  	O	null
25 : : : punctuation unspecified unspecified unspecified unspecified unspecified  	O	null
26 אלישע אלישע אלישע properName unspecified unspecified unspecified unspecified unspecified  	I_PERS	null
27 פורת פורת פורת properName unspecified unspecified unspecified unspecified unspecified  	I_PERS	null
28 Entry Entry Entry foreign unspecified unspecified unspecified unspecified unspecified  	O	null
29 Value Value Value foreign unspecified unspecified unspecified unspecified unspecified  	O	null
30 : : : punctuation unspecified unspecified unspecified unspecified unspecified  	O	null
31 נולדה נולד נולדה verb feminine singular unspecified 3 past  	O	null
32 ב ב בקיבוץ preposition unspecified unspecified unspecified unspecified unspecified 0 
32 קיבוץ קיבוץ בקיבוץ noun masculine singular construct unspecified unspecified  	O	null
33 ה ה המעפיל definiteArticle unspecified unspecified unspecified unspecified unspecified 0 
33 המעפיל העפיל המעפיל participle masculine singular absolute any unspecified  	O	null
34 , , , punctuation unspecified unspecified unspecified unspecified unspecified  	O	null
35 ל ל לאמה preposition unspecified unspecified unspecified unspecified unspecified 0 
35 אמה אמה לאמה noun feminine singular absolute unspecified unspecified  	O	null
36 ש ש שעלתה relativizer/subordinatingConjunction unspecified unspecified unspecified unspecified unspecified 0 
36 עלתה עלה שעלתה verb feminine singular unspecified 3 past  	O	null
37 מ מ מסלובקיה preposition unspecified unspecified unspecified unspecified unspecified 0 
37 סלובקיה סלובקיה מסלובקיה properName unspecified unspecified unspecified unspecified unspecified  	I_LOC	null
38 ו ו ולחמה conjunction unspecified unspecified unspecified unspecified unspecified 0 
38 לחמה לחם ולחמה verb feminine singular unspecified 3 past  	O	null
39 ב ב במחתרת preposition unspecified unspecified unspecified unspecified unspecified 0 
39 מחתרת מחתרת במחתרת noun feminine singular absolute unspecified unspecified  	O	null
40 נגד נגד נגד preposition unspecified unspecified unspecified unspecified unspecified  	O	null
41 ה ה הנאצים definiteArticle unspecified unspecified unspecified unspecified unspecified 0 
41 הנאצים נאצי הנאצים noun masculine plural absolute unspecified unspecified  	O	null
42 ב ב בבודפשט preposition unspecified unspecified unspecified unspecified unspecified 0 
42 בודפשט בודפשט בבודפשט properName unspecified unspecified unspecified unspecified unspecified  	I_LOC	null
43 , , , punctuation unspecified unspecified unspecified unspecified unspecified  	O	null
44 ו ו ולאביה conjunction unspecified unspecified unspecified unspecified unspecified 0 
44 ל ל ולאביה preposition unspecified unspecified unspecified unspecified unspecified 0 
44 אביה אביה ולאביה properName unspecified unspecified unspecified unspecified unspecified  	I_PERS	null
45 ש ש שעלה relativizer/subordinatingConjunction unspecified unspecified unspecified unspecified unspecified 0 
45 עלה עלה שעלה verb masculine singular unspecified 3 past  	I_LOC	null
46 מ מ מאוסטריה preposition unspecified unspecified unspecified unspecified unspecified 0 
46 אוסטריה אוסטריה מאוסטריה properName unspecified unspecified unspecified unspecified unspecified  	I_LOC	null
47 . . . punctuation unspecified unspecified unspecified unspecified unspecified  	O	null

0 למדה למד למדה verb feminine singular unspecified 3 past  	O	null
1 ב ב בבית preposition unspecified unspecified unspecified unspecified unspecified 0 
1 בית בית בבית noun masculine singular construct unspecified unspecified  	O	null
2 ה ה הספר definiteArticle unspecified unspecified unspecified unspecified unspecified 0 
2 הספר ספר הספר noun masculine singular absolute unspecified unspecified  	O	null
3 ה ה היסודי definiteArticle unspecified unspecified unspecified unspecified unspecified 0 
3 היסודי יסודי היסודי adjective masculine singular absolute unspecified unspecified  	O	null
4 ב ב בקיבוצה preposition unspecified unspecified unspecified unspecified unspecified 0 
4 קיבוץ קיבוץ בקיבוצה noun masculine singular absolute unspecified unspecified  
4 ה ה בקיבוצה possessive feminine singular unspecified 3 unspecified 0 	O	null
5 ו ו ובתיכון conjunction unspecified unspecified unspecified unspecified unspecified 0 
5 ב ב ובתיכון preposition unspecified unspecified unspecified unspecified unspecified 0 
5 ה ה ובתיכון definiteArticle unspecified unspecified unspecified unspecified unspecified 0 
5 התיכון תיכון ובתיכון noun masculine singular absolute unspecified unspecified  	O	null
6 " " " punctuation unspecified unspecified unspecified unspecified unspecified  	O	null
7 מעיין מעיין מעיין properName unspecified unspecified unspecified unspecified unspecified  	I_ORG	null
8 " " " punctuation unspecified unspecified unspecified unspecified unspecified  	O	null
9 ב ב בקיבוץ preposition unspecified unspecified unspecified unspecified unspecified 0 
9 קיבוץ קיבוץ בקיבוץ noun masculine singular construct unspecified unspecified  	I_LOC	null
10 עין עין עין properName unspecified unspecified unspecified unspecified unspecified  	I_LOC	null
11 ה ה החורש definiteArticle unspecified unspecified unspecified unspecified unspecified 0 
11 החורש חורש החורש noun masculine singular absolute unspecified unspecified  	O	null
12 . . . punctuation unspecified unspecified unspecified unspecified unspecified  	O	null

0 היתה הוא היתה copula feminine singular unspecified 3 past  	O	null
1 פעילה פעיל פעילה adjective feminine singular absolute unspecified unspecified  	O	null
2 ב ב בתנועת preposition unspecified unspecified unspecified unspecified unspecified 0 
2 תנועת תנועה בתנועת noun feminine singular construct unspecified unspecified  	O	null
3 " " " punctuation unspecified unspecified unspecified unspecified unspecified  	O	null
4 השומר שומר השומר properName unspecified unspecified unspecified unspecified unspecified  	I_ORG	null
5 ה ה הצעיר definiteArticle unspecified unspecified unspecified unspecified unspecified 0 
5 הצעיר צעיר הצעיר adjective masculine singular absolute unspecified unspecified  	O	null
6 " " " punctuation unspecified unspecified unspecified unspecified unspecified  	O	null
7 . . . punctuation unspecified unspecified unspecified unspecified unspecified  	O	null

0 שירתה שירת שירתה verb feminine singular unspecified 3 past  	O	null
1 ב ב בצה"ל preposition unspecified unspecified unspecified unspecified unspecified 0 
1 צה"ל צה"ל בצה"ל properName unspecified unspecified unspecified unspecified unspecified  	I_ORG	null
2 ב ב בחיל preposition unspecified unspecified unspecified unspecified unspecified 0 
2 חיל חיל בחיל noun masculine singular construct unspecified unspecified  	B_ORG	null
3 ה ה המודיעין definiteArticle unspecified unspecified unspecified unspecified unspecified 0 
3 המודיעין מודיעין המודיעין noun masculine singular absolute unspecified unspecified  	I_ORG	null
4 . . . punctuation unspecified unspecified unspecified unspecified unspecified  	O	null

0 למדה למד למדה verb feminine singular unspecified 3 past  	O	null
1 ל ל לתואר preposition unspecified unspecified unspecified unspecified unspecified 0 
1 תואר תואר לתואר noun masculine singular absolute unspecified unspecified  	O	null
2 ראשון ORD1 ראשון numeral masculine singular absolute unspecified unspecified  	O	null
3 ב ב באוניברסיטת preposition unspecified unspecified unspecified unspecified unspecified 0 
3 אוניברסיטת אוניברסיטה באוניברסיטת noun feminine singular construct unspecified unspecified  	O	null
4 חיפה חיפה חיפה properName unspecified unspecified unspecified unspecified unspecified  	I_ORG	null
5 ב ב בחוגים preposition unspecified unspecified unspecified unspecified unspecified 0 
5 חוגים חוג בחוגים noun masculine plural absolute unspecified unspecified  	B_LOC	null
6 ל ל לערבית preposition unspecified unspecified unspecified unspecified unspecified 0 
6 ערבית ערבית לערבית properName feminine singular unspecified unspecified unspecified  	I_LOC	null
7 ו ו ולמחשבת conjunction unspecified unspecified unspecified unspecified unspecified 0 
7 ל ל ולמחשבת preposition unspecified unspecified unspecified unspecified unspecified 0 
7 מחשבת מחשבה ולמחשבת noun feminine singular construct unspecified unspecified  	O	null
8 ישראל ישראל ישראל properName unspecified unspecified unspecified unspecified unspecified  	I_LOC	null
9 . . . punctuation unspecified unspecified unspecified unspecified unspecified  	O	null

0 לאחרמכן לאחרמכן לאחרמכן properName unspecified unspecified unspecified unspecified unspecified  	I_PERS	null
1 לימדה לימד לימדה verb feminine singular unspecified 3 past  	O	null
2 ב ב במכללת preposition unspecified unspecified unspecified unspecified unspecified 0 
2 מכללת מכללה במכללת noun feminine singular construct unspecified unspecified  	O	null
3 " " " punctuation unspecified unspecified unspecified unspecified unspecified  	O	null
4 אורנים אורן אורנים properName unspecified unspecified unspecified unspecified unspecified  	I_ORG	null
5 " " " punctuation unspecified unspecified unspecified unspecified unspecified  	O	null
6 , , , punctuation unspecified unspecified unspecified unspecified unspecified  	O	null
7 ב ב באוניברסיטת preposition unspecified unspecified unspecified unspecified unspecified 0 
7 אוניברסיטת אוניברסיטה באוניברסיטת noun feminine singular construct unspecified unspecified  	I_ORG	null
8 חיפה חיפה חיפה properName unspecified unspecified unspecified unspecified unspecified  	I_ORG	null
9 ו ו ובתיכון conjunction unspecified unspecified unspecified unspecified unspecified 0 
9 ב ב ובתיכון preposition unspecified unspecified unspecified unspecified unspecified 0 
9 ה ה ובתיכון definiteArticle unspecified unspecified unspecified unspecified unspecified 0 
9 התיכון תיכון ובתיכון noun masculine singular absolute unspecified unspecified  	O	null
10 " " " punctuation unspecified unspecified unspecified unspecified unspecified  	O	null
11 מעיין מעיין מעיין properName unspecified unspecified unspecified unspecified unspecified  	I_ORG	null
12 " " " punctuation unspecified unspecified unspecified unspecified unspecified  	O	null
13 שבו ישב שבו verb masculine-and-feminine plural unspecified 2 imperative  	O	null
14 למדה למד למדה verb feminine singular unspecified 3 past  	O	null
15 . . . punctuation unspecified unspecified unspecified unspecified unspecified  	O	null

0 ב ב ב preposition unspecified unspecified unspecified unspecified unspecified 0 	O	null
1 - - - punctuation unspecified unspecified unspecified unspecified unspecified  	O	null
2 ###NUMBER### ###NUMBER### ###NUMBER### numeral unspecified unspecified unspecified unspecified unspecified  	I_DATE	null
3 סיימה סיים סיימה verb feminine singular unspecified 3 past  	O	null
4 תואר תואר תואר noun masculine singular absolute unspecified unspecified  	O	null
5 שלישי ORD3 שלישי numeral masculine singular absolute unspecified unspecified  	O	null
6 ב ב במחשבת preposition unspecified unspecified unspecified unspecified unspecified 0 
6 מחשבת מחשבה במחשבת noun feminine singular construct unspecified unspecified  	O	null
7 ישראל ישראל ישראל properName unspecified unspecified unspecified unspecified unspecified  	I_LOC	null
8 . . . punctuation unspecified unspecified unspecified unspecified unspecified  	O	null

0 עבודת עבודה עבודת noun feminine singular construct unspecified unspecified  	O	null
1 ה ה הדוקטור definiteArticle unspecified unspecified unspecified unspecified unspecified 0 
1 הדוקטור דוקטור הדוקטור noun masculine singular absolute unspecified unspecified  	O	null
2 של של שלה shel-preposition unspecified unspecified unspecified unspecified unspecified  
2 ה ה שלה pronomial feminine singular unspecified 3 unspecified 0 	O	null
3 מוקדשת הוקדש מוקדשת verb feminine singular unspecified any beinoni  	O	null
4 ל ל לפילוסוף preposition unspecified unspecified unspecified unspecified unspecified 0 
4 ה ה לפילוסוף definiteArticle unspecified unspecified unspecified unspecified unspecified 0 
4 הפילוסוף פילוסוף לפילוסוף adjective masculine singular absolute unspecified unspecified  	O	null
5 ה ה האריסטוטלי definiteArticle unspecified unspecified unspecified unspecified unspecified 0 
5 האריסטוטלי האריסטוטלי האריסטוטלי adjective masculine singular absolute unspecified unspecified  	O	null
6 ה ה הראשון definiteArticle unspecified unspecified unspecified unspecified unspecified 0 
6 הראשון ORD1 הראשון numeral masculine singular absolute unspecified unspecified  	O	null
7 , , , punctuation unspecified unspecified unspecified unspecified unspecified  	O	null
8 אברהם אברהם אברהם properName unspecified unspecified unspecified unspecified unspecified  	I_PERS	null
9 אבן אבן אבן properName unspecified unspecified unspecified unspecified unspecified  	I_PERS	null
10 דאוד דאוד דאוד properName unspecified unspecified unspecified unspecified unspecified  	I_PERS	null
11 . . . punctuation unspecified unspecified unspecified unspecified unspecified  	O	null

0 ל ל לדוקטורט preposition unspecified unspecified unspecified unspecified unspecified 0 
0 ה ה לדוקטורט definiteArticle unspecified unspecified unspecified unspecified unspecified 0 
0 הדוקטורט דוקטורט לדוקטורט noun masculine singular absolute unspecified unspecified  	O	null
1 נספחת נספח נספחת verb feminine singular unspecified any beinoni  	O	null
2 מהדורה מהדורה מהדורה noun feminine singular absolute unspecified unspecified  	O	null
3 ביקורתית ביקורתי ביקורתית adjective feminine singular absolute unspecified unspecified  	O	null
4 ראשונה ראשונה ראשונה adverb unspecified unspecified unspecified unspecified unspecified  	O	null
5 של של של shel-preposition unspecified unspecified unspecified unspecified unspecified  	O	null
6 תרגום תרגום תרגומו noun masculine singular absolute unspecified unspecified  
6 ו ו תרגומו possessive masculine singular unspecified 3 unspecified 0 	O	null
7 של של של shel-preposition unspecified unspecified unspecified unspecified unspecified  	O	null
8 שמואל שמואל שמואל properName unspecified unspecified unspecified unspecified unspecified  	I_PERS	null
9 מ מ מוטוט preposition unspecified unspecified unspecified unspecified unspecified 0 
9 וטו וטו מוטוט noun masculine singular absolute unspecified unspecified  
9 ה ה מוטוט possessive feminine singular unspecified 3 unspecified 0 	O	null
10 ל ל לחיבורו preposition unspecified unspecified unspecified unspecified unspecified 0 
10 חיבור חיבור לחיבורו noun masculine singular absolute unspecified unspecified  
10 ו ו לחיבורו possessive masculine singular unspecified 3 unspecified 0 	O	null
11 של של של shel-preposition unspecified unspecified unspecified unspecified unspecified  	O	null
12 אברהם אברהם אברהם properName unspecified unspecified unspecified unspecified unspecified  	I_PERS	null
13 אבן אבן אבן properName unspecified unspecified unspecified unspecified unspecified  	I_PERS	null
14 דאוד דאוד דאוד properName unspecified unspecified unspecified unspecified unspecified  	I_PERS	null
15 , , , punctuation unspecified unspecified unspecified unspecified unspecified  	O	null
16 ה ה האמונה definiteArticle unspecified unspecified unspecified unspecified unspecified 0 
16 האמונה אמונה האמונה noun feminine singular absolute unspecified unspecified  	O	null
17 ה ה הנישאה definiteArticle unspecified unspecified unspecified unspecified unspecified 0 
17 הנישאה הנישאה הנישאה properName unspecified unspecified unspecified unspecified unspecified  	I_PERS	null
18 . . . punctuation unspecified unspecified unspecified unspecified unspecified  	O	null

0 ב ב באותה preposition unspecified unspecified unspecified unspecified unspecified 0 
0 אותו אותו באותה quantifier unspecified unspecified unspecified unspecified unspecified  
0 ה ה באותה pronomial feminine singular unspecified 3 unspecified 0 	O	null
1 שנה שנה שנה noun feminine singular absolute unspecified unspecified  	O	null
2 עזבה עזב עזבה verb feminine singular unspecified 3 past  	O	null
3 את את את at-preposition unspecified unspecified unspecified unspecified unspecified  	O	null
4 ה ה הקיבוץ definiteArticle unspecified unspecified unspecified unspecified unspecified 0 
4 הקיבוץ קיבוץ הקיבוץ noun masculine singular absolute unspecified unspecified  	O	null
5 ו ו ולימדה conjunction unspecified unspecified unspecified unspecified unspecified 0 
5 לימדה לימד ולימדה verb feminine singular unspecified 3 past  	O	null
6 שנתיים שנתי שנתיים adjective masculine plural absolute unspecified unspecified  	O	null
7 פילוסופיה פילוסופיה פילוסופיה noun feminine singular absolute unspecified unspecified  	O	null
8 ב ב באוניברסיטת preposition unspecified unspecified unspecified unspecified unspecified 0 
8 אוניברסיטת אוניברסיטה באוניברסיטת noun feminine singular construct unspecified unspecified  	I_ORG	null
9 אירווין אירווין אירווין properName unspecified unspecified unspecified unspecified unspecified  	I_ORG	null
10 , , , punctuation unspecified unspecified unspecified unspecified unspecified  	O	null
11 קליפורניה קליפורניה קליפורניה properName unspecified unspecified unspecified unspecified unspecified  	I_LOC	null
12 . . . punctuation unspecified unspecified unspecified unspecified unspecified  	O	null

0 עם עם עם preposition unspecified unspecified unspecified unspecified unspecified  	O	null
1 שובה שובה שובה noun masculine singular absolute unspecified unspecified  	O	null
2 ארצה ארצה ארצה adverb unspecified unspecified unspecified unspecified unspecified  	I_LOC	null
3 ( ( ( punctuation unspecified unspecified unspecified unspecified unspecified  	O	null
4 ###NUMBER### ###NUMBER### ###NUMBER### numeral unspecified unspecified unspecified unspecified unspecified  	I_DATE	null
5 ) ) ) punctuation unspecified unspecified unspecified unspecified unspecified  	O	null
6 חזרה חזר חזרה verb feminine singular unspecified 3 past  	O	null
7 ל ל להוראה preposition unspecified unspecified unspecified unspecified unspecified 0 
7 הוראה הוראה להוראה noun feminine singular absolute unspecified unspecified  	O	null
8 ב ב במכללת preposition unspecified unspecified unspecified unspecified unspecified 0 
8 מכללת מכללה במכללת noun feminine singular construct unspecified unspecified  	O	null
9 " " " punctuation unspecified unspecified unspecified unspecified unspecified  	O	null
10 אורנים אורן אורנים properName unspecified unspecified unspecified unspecified unspecified  	I_ORG	null
11 " " " punctuation unspecified unspecified unspecified unspecified unspecified  	O	null
12 , , , punctuation unspecified unspecified unspecified unspecified unspecified  	O	null
13 ו ו וכן conjunction unspecified unspecified unspecified unspecified unspecified 0 
13 כן כן וכן conjunction unspecified unspecified unspecified unspecified unspecified  	O	null
14 ב ב בסמינר preposition unspecified unspecified unspecified unspecified unspecified 0 
14 ה ה בסמינר definiteArticle unspecified unspecified unspecified unspecified unspecified 0 
14 הסמינר סמינר בסמינר noun masculine singular absolute unspecified unspecified  	O	null
15 לוינסקי לוינסקי לוינסקי properName unspecified unspecified unspecified unspecified unspecified  	I_PERS	null
16 ו ו ובאוניברסיטה conjunction unspecified unspecified unspecified unspecified unspecified 0 
16 ב ב ובאוניברסיטה preposition unspecified unspecified unspecified unspecified unspecified 0 
16 ה ה ובאוניברסיטה definiteArticle unspecified unspecified unspecified unspecified unspecified 0 
16 האוניברסיטה אוניברסיטה ובאוניברסיטה noun feminine singular absolute unspecified unspecified  	O	null
17 ה ה העברית definiteArticle unspecified unspecified unspecified unspecified unspecified 0 
17 העברית עברי העברית adjective feminine singular absolute unspecified unspecified  	O	null
18 ב ב בירושלים preposition unspecified unspecified unspecified unspecified unspecified 0 
18 ירושלים ירושלים בירושלים properName unspecified unspecified unspecified unspecified unspecified  	I_LOC	null
19 . . . punctuation unspecified unspecified unspecified unspecified unspecified  	O	null

0 ב ב ב preposition unspecified unspecified unspecified unspecified unspecified 0 	I_ORG	null
1 - - - punctuation unspecified unspecified unspecified unspecified unspecified  	I_ORG	null
2 ###NUMBER### ###NUMBER### ###NUMBER### numeral unspecified unspecified unspecified unspecified unspecified  	I_DATE	null
3 התמנתה התמנה התמנתה verb feminine singular unspecified 3 past  	O	null
4 ל ל לפרופסור preposition unspecified unspecified unspecified unspecified unspecified 0 
4 ה ה לפרופסור definiteArticle unspecified unspecified unspecified unspecified unspecified 0 
4 הפרופסור פרופסור לפרופסור noun masculine singular absolute unspecified unspecified  	O	null
5 . . . punctuation unspecified unspecified unspecified unspecified unspecified  	O	null

0 החלה החל החלה verb feminine singular unspecified 3 past  	O	null
1 לפרסם פרסם לפרסם verb unspecified unspecified unspecified unspecified infinitive  	O	null
2 מ מ משיריה preposition unspecified unspecified unspecified unspecified unspecified 0 
2 שירי שיר משיריה noun masculine plural absolute unspecified unspecified  
2 ה ה משיריה possessive feminine singular unspecified 3 unspecified 0 	O	null
3 ב ב ב preposition unspecified unspecified unspecified unspecified unspecified 0 	O	null
4 - - - punctuation unspecified unspecified unspecified unspecified unspecified  	O	null
5 ###NUMBER### ###NUMBER### ###NUMBER### numeral unspecified unspecified unspecified unspecified unspecified  	I_DATE	null
6 ב ב בכתב preposition unspecified unspecified unspecified unspecified unspecified 0 
6 כתב כתב בכתב noun masculine singular construct unspecified unspecified  	O	null
7 ה ה העת definiteArticle unspecified unspecified unspecified unspecified unspecified 0 
7 העת עת העת noun feminine singular absolute unspecified unspecified  	O	null
8 ש ש שדמות relativizer/subordinatingConjunction unspecified unspecified unspecified unspecified unspecified 0 
8 דמות דמות שדמות noun feminine singular absolute unspecified unspecified  	O	null
9 , , , punctuation unspecified unspecified unspecified unspecified unspecified  	O	null
10 ו ו וב conjunction unspecified unspecified unspecified unspecified unspecified 0 
10 ב ב וב preposition unspecified unspecified unspecified unspecified unspecified 0 	O	null
11 - - - punctuation unspecified unspecified unspecified unspecified unspecified  	O	null
12 ###NUMBER### ###NUMBER### ###NUMBER### numeral unspecified unspecified unspecified unspecified unspecified  	I_DATE	null
13 יצא יצא יצא verb masculine singular unspecified 3 past  	O	null
14 לאור לאור לאור preposition unspecified unspecified unspecified unspecified unspecified  	O	null
15 ספר ספר ספר noun masculine singular construct unspecified unspecified  	O	null
16 שירי שיר שיריה noun masculine plural absolute unspecified unspecified  
16 ה ה שיריה possessive feminine singular unspecified 3 unspecified 0 	O	null
17 ה ה הראשון definiteArticle unspecified unspecified unspecified unspecified unspecified 0 
17 הראשון ORD1 הראשון numeral masculine singular absolute unspecified unspecified  	O	null
18 , , , punctuation unspecified unspecified unspecified unspecified unspecified  	O	null
19 ו ו ואיך conjunction unspecified unspecified unspecified unspecified unspecified 0 
19 איך איך ואיך adverb unspecified unspecified unspecified unspecified unspecified  	O	null
20 תהיה תהייה תהיה noun feminine singular absolute unspecified unspecified  	O	null
21 ל ל לי preposition unspecified unspecified unspecified unspecified unspecified  
21 י י לי pronomial masculine-and-feminine singular unspecified 1 unspecified 0 	O	null
22 תשובה תשובה תשובה noun feminine singular absolute unspecified unspecified  	O	null
23 ( ( ( punctuation unspecified unspecified unspecified unspecified unspecified  	O	null
24 עקד עקד עקד verb masculine singular unspecified 3 past  	O	null
25 ) ) ) punctuation unspecified unspecified unspecified unspecified unspecified  	O	null
26 . . . punctuation unspecified unspecified unspecified unspecified unspecified  	O	null

0 חרף חרף חרף preposition unspecified unspecified unspecified unspecified unspecified  	O	null
1 עבר עבר עברה noun masculine singular absolute unspecified unspecified  
1 ה ה עברה possessive feminine singular unspecified 3 unspecified 0 	O	null
2 ה ה השמאלי definiteArticle unspecified unspecified unspecified unspecified unspecified 0 
2 השמאלי שמאלי השמאלי adjective masculine singular absolute unspecified unspecified  	O	null
3 - - - punctuation unspecified unspecified unspecified unspecified unspecified  	O	null
4 רדיקלי רדיקלי רדיקלי adjective masculine singular absolute unspecified unspecified  	O	null
5 , , , punctuation unspecified unspecified unspecified unspecified unspecified  	O	null
6 ש ש שירתה relativizer/subordinatingConjunction unspecified unspecified unspecified unspecified unspecified 0 
6 ירתה ירה שירתה verb feminine singular unspecified 3 past  	O	null
7 היא הוא היא pronoun feminine singular unspecified 3 unspecified  	O	null
8 כ כ כעין preposition unspecified unspecified unspecified unspecified unspecified 0 
8 עין עין כעין noun feminine singular absolute unspecified unspecified  	O	null
9 דתית דתי דתית adjective feminine singular absolute unspecified unspecified  	O	null
10 ו ו ומשובצים conjunction unspecified unspecified unspecified unspecified unspecified 0 
10 משובצים שובץ ומשובצים verb masculine plural unspecified any beinoni  	O	null
11 ב ב בה preposition unspecified unspecified unspecified unspecified unspecified  
11 ה ה בה pronomial feminine singular unspecified 3 unspecified 0 	O	null
12 מקורות מקור מקורות noun masculine plural absolute unspecified unspecified  	O	null
13 מ מ מדרשיים preposition unspecified unspecified unspecified unspecified unspecified 0 
13 דרשיים דרשיים מדרשיים noun masculine dual absolute unspecified unspecified  	O	null
14 ופילוסופיים ופילוסופיים ופילוסופיים adjective masculine plural absolute unspecified unspecified  	O	null
15 יהודיים יהודי יהודיים adjective masculine plural absolute unspecified unspecified  	O	null
16 מ מ מימי preposition unspecified unspecified unspecified unspecified unspecified 0 
16 ימי יום מימי noun masculine plural construct unspecified unspecified  	O	null
17 ה ה הביניים definiteArticle unspecified unspecified unspecified unspecified unspecified 0 
17 הביניים ביניים הביניים noun masculine singular absolute unspecified unspecified  	O	null
18 . . . punctuation unspecified unspecified unspecified unspecified unspecified  	O	null

0 ספר ספר ספר noun masculine singular construct unspecified unspecified  	O	null
1 שירי שיר שיריה noun masculine plural absolute unspecified unspecified  
1 ה ה שיריה possessive feminine singular unspecified 3 unspecified 0 	O	null
2 ה ה השני definiteArticle unspecified unspecified unspecified unspecified unspecified 0 
2 השני ORD2 השני numeral masculine singular absolute unspecified unspecified  	O	null
3 , , , punctuation unspecified unspecified unspecified unspecified unspecified  	O	null
4 בין בין בין preposition unspecified unspecified unspecified unspecified unspecified  	O	null
5 כה כה כה adverb unspecified unspecified unspecified unspecified unspecified  	O	null
6 ו ו וכה conjunction unspecified unspecified unspecified unspecified unspecified 0 
6 כה כה וכה adverb unspecified unspecified unspecified unspecified unspecified  	O	null
7 , , , punctuation unspecified unspecified unspecified unspecified unspecified  	O	null
8 ראה ראה ראה verb masculine singular unspecified 3 past  	O	null
9 אור אור אור noun masculine singular absolute unspecified unspecified  	O	null
10 ב ב ב preposition unspecified unspecified unspecified unspecified unspecified 0 	O	null
11 - - - punctuation unspecified unspecified unspecified unspecified unspecified  	O	null
12 ###NUMBER### ###NUMBER### ###NUMBER### numeral unspecified unspecified unspecified unspecified unspecified  	I_DATE	null
13 . . . punctuation unspecified unspecified unspecified unspecified unspecified  	O	null

0 כמו כמו כמו conjunction unspecified unspecified unspecified unspecified unspecified  	O	null
1 כן כן כן conjunction unspecified unspecified unspecified unspecified unspecified  	O	null
2 פירסמה פרסם פירסמה verb feminine singular unspecified 3 past  	O	null
3 שלושה CARD3 שלושה numeral masculine plural absolute unspecified unspecified  	O	null
4 ספרים ספר ספרים noun masculine plural absolute unspecified unspecified  	O	null
5 , , , punctuation unspecified unspecified unspecified unspecified unspecified  	O	null
6 מאמרים מאמר מאמרים noun masculine plural absolute unspecified unspecified  	O	null
7 רבים רב רבים adjective masculine plural absolute unspecified unspecified  	O	null
8 ו ו וספרי conjunction unspecified unspecified unspecified unspecified unspecified 0 
8 ספרי ספר וספרי noun masculine plural construct unspecified unspecified  	O	null
9 לימוד לימוד לימוד noun masculine singular absolute unspecified unspecified  	O	null
10 ב ב בנושאי preposition unspecified unspecified unspecified unspecified unspecified 0 
10 נושאי נושא בנושאי noun masculine plural construct unspecified unspecified  	O	null
11 מחקרי מחקר מחקריה noun masculine plural absolute unspecified unspecified  
11 ה ה מחקריה possessive feminine singular unspecified 3 unspecified 0 	O	null
12 . . . punctuation unspecified unspecified unspecified unspecified unspecified  	O	null

0 מחקרי מחקר מחקריה noun masculine plural absolute unspecified unspecified  
0 ה ה מחקריה possessive feminine singular unspecified 3 unspecified 0 	O	null
1 ב ב במחשבת preposition unspecified unspecified unspecified unspecified unspecified 0 
1 מחשבת מחשבה במחשבת noun feminine singular construct unspecified unspecified  	O	null
2 ישראל ישראל ישראל properName unspecified unspecified unspecified unspecified unspecified  	I_LOC	null
3 ו ו ובפילוסופיה conjunction unspecified unspecified unspecified unspecified unspecified 0 
3 ב ב ובפילוסופיה preposition unspecified unspecified unspecified unspecified unspecified 0 
3 ה ה ובפילוסופיה definiteArticle unspecified unspecified unspecified unspecified unspecified 0 
3 הפילוסופיה פילוסופיה ובפילוסופיה noun feminine singular absolute unspecified unspecified  	O	null
4 ה ה הערבית definiteArticle unspecified unspecified unspecified unspecified unspecified 0 
4 הערבית ערבי הערבית adjective feminine singular absolute unspecified unspecified  	O	null
5 ב ב בימי preposition unspecified unspecified unspecified unspecified unspecified 0 
5 ימי יום בימי noun masculine plural construct unspecified unspecified  	O	null
6 ה ה הביניים definiteArticle unspecified unspecified unspecified unspecified unspecified 0 
6 הביניים ביניים הביניים noun masculine singular absolute unspecified unspecified  	O	null
7 זכו זכה זכו verb masculine-and-feminine plural unspecified 3 past  	O	null
8 ל ל להערכה preposition unspecified unspecified unspecified unspecified unspecified 0 
8 הערכה הערכה להערכה noun feminine singular absolute unspecified unspecified  	O	null
9 ב ב בארץ preposition unspecified unspecified unspecified unspecified unspecified 0 
9 ה ה בארץ definiteArticle unspecified unspecified unspecified unspecified unspecified 0 
9 הארץ ארץ בארץ noun feminine singular absolute unspecified unspecified  	O	null
10 ו ו ובחו"ל conjunction unspecified unspecified unspecified unspecified unspecified 0 
10 ב ב ובחו"ל preposition unspecified unspecified unspecified unspecified unspecified 0 
10 חו"ל חו"ל ובחו"ל noun masculine singular absolute unspecified unspecified  	O	null
11 . . . punctuation unspecified unspecified unspecified unspecified unspecified  	O	null

0 שירי שיר שיריה noun masculine plural absolute unspecified unspecified  
0 ה ה שיריה possessive feminine singular unspecified 3 unspecified 0 	O	null
1 הם הוא הם pronoun masculine plural unspecified 3 unspecified  	O	null
2 בעלי בעל בעלי noun masculine plural construct unspecified unspecified  	O	null
3 עוצמה עוצמה עוצמה noun feminine singular absolute unspecified unspecified  	O	null
4 מיסטית מיסטי מיסטית adjective feminine singular absolute unspecified unspecified  	O	null
5 חזקה חזק חזקה adjective feminine singular absolute unspecified unspecified  	O	null
6 ו ו ופואטיקה conjunction unspecified unspecified unspecified unspecified unspecified 0 
6 פואטיקה פואטיקה ופואטיקה noun feminine singular absolute unspecified unspecified  	O	null
7 ייחודית ייחודי ייחודית adjective feminine singular absolute unspecified unspecified  	O	null
8 , , , punctuation unspecified unspecified unspecified unspecified unspecified  	O	null
9 ה ה הנשענת definiteArticle unspecified unspecified unspecified unspecified unspecified 0 
9 הנשענת נשען הנשענת participle feminine singular absolute any unspecified  	O	null
10 על על על preposition unspecified unspecified unspecified unspecified unspecified  	O	null
11 ה ה המקרא definiteArticle unspecified unspecified unspecified unspecified unspecified 0 
11 המקרא מקרא המקרא noun masculine singular absolute unspecified unspecified  	O	null
12 , , , punctuation unspecified unspecified unspecified unspecified unspecified  	O	null
13 על על על preposition unspecified unspecified unspecified unspecified unspecified  	O	null
14 ה ה הפילוסופיה definiteArticle unspecified unspecified unspecified unspecified unspecified 0 
14 הפילוסופיה פילוסופיה הפילוסופיה noun feminine singular absolute unspecified unspecified  	O	null
15 ה ה היהודית definiteArticle unspecified unspecified unspecified unspecified unspecified 0 
15 היהודית יהודי היהודית adjective feminine singular absolute unspecified unspecified  	O	null
16 ב ב בימי preposition unspecified unspecified unspecified unspecified unspecified 0 
16 ימי יום בימי noun masculine plural construct unspecified unspecified  	O	null
17 ה ה הביניים definiteArticle unspecified unspecified unspecified unspecified unspecified 0 
17 הביניים ביניים הביניים noun masculine singular absolute unspecified unspecified  	O	null
18 ו ו ועל conjunction unspecified unspecified unspecified unspecified unspecified 0 
18 על על ועל preposition unspecified unspecified unspecified unspecified unspecified  	O	null
19 ספרות ספרות ספרות noun feminine singular construct unspecified unspecified  	O	null
20 ה ה הקבלה definiteArticle unspecified unspecified unspecified unspecified unspecified 0 
20 הקבלה קבלה הקבלה noun feminine singular absolute unspecified unspecified  	O	null
21 ו ו והאגדה conjunction unspecified unspecified unspecified unspecified unspecified 0 
21 ה ה והאגדה definiteArticle unspecified unspecified unspecified unspecified unspecified 0 
21 האגדה אגדה והאגדה noun feminine singular absolute unspecified unspecified  	O	null
22 . . . punctuation unspecified unspecified unspecified unspecified unspecified  	O	null

0 פרק פארק פרק noun masculine singular absolute unspecified unspecified  	O	null
1 ל ל לעצמו preposition unspecified unspecified unspecified unspecified unspecified 0 
1 עצמו עצמו לעצמו pronoun unspecified unspecified unspecified unspecified unspecified  
1 ו ו לעצמו pronomial masculine singular unspecified 3 unspecified 0 	O	null
2 הם הוא הם pronoun masculine plural unspecified 3 unspecified  	O	null
3 שירי שיר שיריה noun masculine plural absolute unspecified unspecified  
3 ה ה שיריה possessive feminine singular unspecified 3 unspecified 0 	O	null
4 ה ה המוקדשים definiteArticle unspecified unspecified unspecified unspecified unspecified 0 
4 המוקדשים הוקדש המוקדשים participle masculine plural absolute any unspecified  	O	null
5 ל ל לבתה preposition unspecified unspecified unspecified unspecified unspecified 0 
5 בת בת לבתה noun feminine singular absolute unspecified unspecified  
5 ה ה לבתה possessive feminine singular unspecified 3 unspecified 0 	O	null
6 ה ה החולה definiteArticle unspecified unspecified unspecified unspecified unspecified 0 
6 החולה חולה החולה adjective masculine singular absolute unspecified unspecified  	O	null
7 , , , punctuation unspecified unspecified unspecified unspecified unspecified  	O	null
8 ה ה הנוגים definiteArticle unspecified unspecified unspecified unspecified unspecified 0 
8 הנוגים נוגה הנוגים adjective masculine plural absolute unspecified unspecified  	O	null
9 ו ו ומתריסים conjunction unspecified unspecified unspecified unspecified unspecified 0 
9 מתריסים התריס ומתריסים verb masculine plural unspecified any beinoni  	O	null
10 כ כ כאחד preposition unspecified unspecified unspecified unspecified unspecified 0 
10 אחד CARD1 כאחד numeral masculine singular absolute unspecified unspecified  	O	null
11 . . . punctuation unspecified unspecified unspecified unspecified unspecified  	O	null

0 ספר ספר ספר noun masculine singular construct unspecified unspecified  	O	null
1 ה ה הפרוזה definiteArticle unspecified unspecified unspecified unspecified unspecified 0 
1 הפרוזה פרוזה הפרוזה noun feminine singular absolute unspecified unspecified  	O	null
2 ה ה הראשון definiteArticle unspecified unspecified unspecified unspecified unspecified 0 
2 הראשון ORD1 הראשון numeral masculine singular absolute unspecified unspecified  	O	null
3 של של שלה shel-preposition unspecified unspecified unspecified unspecified unspecified  
3 ה ה שלה pronomial feminine singular unspecified 3 unspecified 0 	O	null
4 , , , punctuation unspecified unspecified unspecified unspecified unspecified  	O	null
5 מראית מראית מראית noun feminine singular construct unspecified unspecified  	O	null
6 עין עין עין properName unspecified unspecified unspecified unspecified unspecified  	I_ORG	null
7 ) ) ) punctuation unspecified unspecified unspecified unspecified unspecified  	O	null
8 , , , punctuation unspecified unspecified unspecified unspecified unspecified  	O	null
9 ###NUMBER### ###NUMBER### ###NUMBER### numeral unspecified unspecified unspecified unspecified unspecified  	I_DATE	null
10 ש ש שיצא relativizer/subordinatingConjunction unspecified unspecified unspecified unspecified unspecified 0 
10 יצא יצא שיצא verb masculine singular unspecified 3 past  	O	null
11 ב ב בהוצאת preposition unspecified unspecified unspecified unspecified unspecified 0 
11 הוצאת הוצאה בהוצאת noun feminine singular construct unspecified unspecified  	O	null
12 ה ה הקיבוץ definiteArticle unspecified unspecified unspecified unspecified unspecified 0 
12 הקיבוץ קיבוץ הקיבוץ noun masculine singular absolute unspecified unspecified  	O	null
13 ה ה המאוחד definiteArticle unspecified unspecified unspecified unspecified unspecified 0 
13 המאוחד מאוחד המאוחד adjective masculine singular absolute unspecified unspecified  	O	null
14 , , , punctuation unspecified unspecified unspecified unspecified unspecified  	O	null
15 הוא הוא הוא pronoun masculine singular unspecified 3 unspecified  	O	null
16 רומן רומן רומן noun masculine singular construct unspecified unspecified  	O	null
17 מכתבים מכתב מכתבים noun masculine plural absolute unspecified unspecified  	O	null
18 וירטואליים וירטואלי וירטואליים adjective masculine plural absolute unspecified unspecified  	O	null
19 ה ה המתעדים definiteArticle unspecified unspecified unspecified unspecified unspecified 0 
19 המתעדים תיעד המתעדים participle masculine plural absolute any unspecified  	O	null
20 השתלשלות השתלשלות השתלשלות noun feminine singular construct unspecified unspecified  	O	null
21 יחסים יחס יחסים noun masculine plural absolute unspecified unspecified  	O	null
22 בין בין בין preposition unspecified unspecified unspecified unspecified unspecified  	O	null
23 אישה איש אישה noun feminine singular absolute unspecified unspecified  	O	null
24 חולה חולה חולה adjective feminine singular absolute unspecified unspecified  	O	null
25 , , , punctuation unspecified unspecified unspecified unspecified unspecified  	O	null
26 פרופסור פרופסור פרופסור noun masculine singular absolute unspecified unspecified  	O	null
27 ל ל לניתוח preposition unspecified unspecified unspecified unspecified unspecified 0 
27 ניתוח ניתוח לניתוח noun masculine singular construct unspecified unspecified  	O	null
28 טקסטים טקסט טקסטים noun masculine plural absolute unspecified unspecified  	O	null
29 , , , punctuation unspecified unspecified unspecified unspecified unspecified  	O	null
30 ל ל לרופאה preposition unspecified unspecified unspecified unspecified unspecified 0 
30 רופא רופא לרופאה noun masculine singular absolute unspecified unspecified  
30 ה ה לרופאה possessive feminine singular unspecified 3 unspecified 0 	O	null
31 , , , punctuation unspecified unspecified unspecified unspecified unspecified  	O	null
32 מנתח מנתח מנתח noun masculine singular absolute unspecified unspecified  	O	null
33 פלסטי פלסטי פלסטי adjective masculine singular absolute unspecified unspecified  	O	null
34 מומחה מומחה מומחה adjective masculine singular absolute unspecified unspecified  	O	null
35 ל ל לשחזור preposition unspecified unspecified unspecified unspecified unspecified 0 
35 ה ה לשחזור definiteArticle unspecified unspecified unspecified unspecified unspecified 0 
35 השחזור שחזור לשחזור noun masculine singular absolute unspecified unspecified  	O	null
36 . . . punctuation unspecified unspecified unspecified unspecified unspecified  	O	null

0 ב ב במהלך preposition unspecified unspecified unspecified unspecified unspecified 0 
0 מהלך מהלך במהלך noun masculine singular construct unspecified unspecified  	O	null
1 ה ה ההתכתבויות definiteArticle unspecified unspecified unspecified unspecified unspecified 0 
1 ההתכתבויות התכתבות ההתכתבויות noun feminine plural absolute unspecified unspecified  	O	null
2 עולות עלה עולות verb feminine plural unspecified any beinoni  	O	null
3 סוגיות סוגיה סוגיות noun feminine plural absolute unspecified unspecified  	O	null
4 אתיות אתי אתיות adjective feminine plural absolute unspecified unspecified  	O	null
5 ו ו ופילוסופיות conjunction unspecified unspecified unspecified unspecified unspecified 0 
5 פילוסופיות פילוסוף ופילוסופיות adjective feminine plural absolute unspecified unspecified  	O	null
6 שונות שונה שונות adjective feminine plural absolute unspecified unspecified  	O	null
7 . . . punctuation unspecified unspecified unspecified unspecified unspecified  	O	null

0 References References References foreign unspecified unspecified unspecified unspecified unspecified  	O	null
1 : : : punctuation unspecified unspecified unspecified unspecified unspecified  	O	null
2 ל ל לעאל preposition unspecified unspecified unspecified unspecified unspecified 0 
2 עאל עאל לעאל properName unspecified unspecified unspecified unspecified unspecified  	I_ORG	null
3 , , , punctuation unspecified unspecified unspecified unspecified unspecified  	O	null
4 איריס איריס איריס properName unspecified unspecified unspecified unspecified unspecified  	I_PERS	null
5 . . . punctuation unspecified unspecified unspecified unspecified unspecified  	O	null

0 " " " punctuation unspecified unspecified unspecified unspecified unspecified  	O	null
1 איכויות איכות איכויות noun feminine plural absolute unspecified unspecified  	O	null
2 מרשימות מרשים מרשימות adjective feminine plural absolute unspecified unspecified  	O	null
3 " " " punctuation unspecified unspecified unspecified unspecified unspecified  	O	null
4 . . . punctuation unspecified unspecified unspecified unspecified unspecified  	O	null

0 מ מ מעריבספרות preposition unspecified unspecified unspecified unspecified unspecified 0 
0 עריבספרות עריבספרות מעריבספרות properName unspecified unspecified unspecified unspecified unspecified  	O	null
1 . . . punctuation unspecified unspecified unspecified unspecified unspecified  	O	null

0 . . . punctuation unspecified unspecified unspecified unspecified unspecified  	O	null
1 ###NUMEXP### ###NUMEXP### ###NUMEXP### numberExpression unspecified unspecified unspecified unspecified unspecified  	I_DATE	null
2 ; ; ; punctuation unspecified unspecified unspecified unspecified unspecified  	O	null
3 ###NUMBER### ###NUMBER### ###NUMBER### numeral unspecified unspecified unspecified unspecified unspecified  	O	null
4 רוזנפלד רוזנפלד רוזנפלד properName unspecified unspecified unspecified unspecified unspecified  	I_PERS	null
5 , , , punctuation unspecified unspecified unspecified unspecified unspecified  	O	null
6 ברכה ברכה ברכה properName masculine singular unspecified unspecified unspecified  	I_PERS	null
7 . . . punctuation unspecified unspecified unspecified unspecified unspecified  	O	null

0 " " " punctuation unspecified unspecified unspecified unspecified unspecified  	O	null
1 ה ה המילים definiteArticle unspecified unspecified unspecified unspecified unspecified 0 
1 המילים מילה המילים noun feminine plural absolute unspecified unspecified  	O	null
2 משיבות השיב משיבות verb feminine plural unspecified any beinoni  	O	null
3 ל ל לה preposition unspecified unspecified unspecified unspecified unspecified  
3 ה ה לה pronomial feminine singular unspecified 3 unspecified 0 	O	null
4 אהבה אהבה אהבה noun feminine singular absolute unspecified unspecified  	O	null
5 " " " punctuation unspecified unspecified unspecified unspecified unspecified  	O	null
6 . . . punctuation unspecified unspecified unspecified unspecified unspecified  	O	null
7 מאזניים מאזניים מאזניים noun masculine plural absolute unspecified unspecified  	O	null
8 ע"א ע"א ע"א properName unspecified unspecified unspecified unspecified unspecified  	I_ORG	null
9 ) ) ) punctuation unspecified unspecified unspecified unspecified unspecified  	O	null
10 . . . punctuation unspecified unspecified unspecified unspecified unspecified  	O	null
11 ###NUMBER### ###NUMBER### ###NUMBER### numeral unspecified unspecified unspecified unspecified unspecified  	O	null
12 ###NUMBER### ###NUMBER### ###NUMBER### numeral unspecified unspecified unspecified unspecified unspecified  	I_DATE	null
13 . . . punctuation unspecified unspecified unspecified unspecified unspecified  	O	null

0 ###NUMBER### ###NUMBER### ###NUMBER### numeral unspecified unspecified unspecified unspecified unspecified  	O	null
1 - - - punctuation unspecified unspecified unspecified unspecified unspecified  	O	null
2 ###NUMBER### ###NUMBER### ###NUMBER### numeral unspecified unspecified unspecified unspecified unspecified  	O	null
3 . . . punctuation unspecified unspecified unspecified unspecified unspecified  	O	null

