0 Name Name Name foreign unspecified unspecified unspecified unspecified unspecified  	O	null
1 : : : punctuation unspecified unspecified unspecified unspecified unspecified  	O	null
2 צין צין צינס noun masculine singular absolute unspecified unspecified  
2 י י צינס possessive masculine-and-feminine singular unspecified 1 unspecified 0 	O	null
3 , , , punctuation unspecified unspecified unspecified unspecified unspecified  	O	null
4 יפה יפה יפה adverb unspecified unspecified unspecified unspecified unspecified  	O	null
5 Birth Birth Birth foreign unspecified unspecified unspecified unspecified unspecified  	O	null
6 Year Year Year foreign unspecified unspecified unspecified unspecified unspecified  	O	null
7 : : : punctuation unspecified unspecified unspecified unspecified unspecified  	O	null
8 ###NUMBER### ###NUMBER### ###NUMBER### numeral unspecified unspecified unspecified unspecified unspecified  	I_DATE	null
9 Birth Birth Birth foreign unspecified unspecified unspecified unspecified unspecified  	O	null
10 Place Place Place foreign unspecified unspecified unspecified unspecified unspecified  	O	null
11 : : : punctuation unspecified unspecified unspecified unspecified unspecified  	O	null
12 גליציה גליציה גליציה properName unspecified unspecified unspecified unspecified unspecified  	I_ORG	null
13 , , , punctuation unspecified unspecified unspecified unspecified unspecified  	O	null
14 פולין פולין פולין properName unspecified unspecified unspecified unspecified unspecified  	I_LOC	null
15 , , , punctuation unspecified unspecified unspecified unspecified unspecified  	O	null
16 ל ל למשפחה preposition unspecified unspecified unspecified unspecified unspecified 0 
16 משפחה משפחה למשפחה noun feminine singular absolute unspecified unspecified  	O	null
17 Occupation Occupation Occupation foreign unspecified unspecified unspecified unspecified unspecified  	O	null
18 : : : punctuation unspecified unspecified unspecified unspecified unspecified  	O	null
19 משוררת משורר משוררת noun feminine singular absolute unspecified unspecified  	O	null
20 Entry Entry Entry foreign unspecified unspecified unspecified unspecified unspecified  	O	null
21 writer writer writer foreign unspecified unspecified unspecified unspecified unspecified  	O	null
22 : : : punctuation unspecified unspecified unspecified unspecified unspecified  	O	null
23 נעה נעה נעה properName unspecified unspecified unspecified unspecified unspecified  	I_PERS	null
24 ו ו ולדן conjunction unspecified unspecified unspecified unspecified unspecified 0 
24 ל ל ולדן preposition unspecified unspecified unspecified unspecified unspecified 0 
24 דן דן ולדן properName unspecified unspecified unspecified unspecified unspecified  	I_PERS	null
25 Entry Entry Entry foreign unspecified unspecified unspecified unspecified unspecified  	O	null
26 Value Value Value foreign unspecified unspecified unspecified unspecified unspecified  	O	null
27 : : : punctuation unspecified unspecified unspecified unspecified unspecified  	O	null
28 נולדה נולד נולדה verb feminine singular unspecified 3 past  	O	null
29 בגליציה בגליציה בגליציה properName unspecified unspecified unspecified unspecified unspecified  	I_PERS	null
30 , , , punctuation unspecified unspecified unspecified unspecified unspecified  	O	null
31 פולין פולין פולין properName unspecified unspecified unspecified unspecified unspecified  	I_LOC	null
32 , , , punctuation unspecified unspecified unspecified unspecified unspecified  	O	null
33 ל ל למשפחה preposition unspecified unspecified unspecified unspecified unspecified 0 
33 משפחה משפחה למשפחה noun feminine singular absolute unspecified unspecified  	O	null
34 ציונית ציוני ציונית adjective feminine singular absolute unspecified unspecified  	O	null
35 מ מ מצאצאי preposition unspecified unspecified unspecified unspecified unspecified 0 
35 צאצאי צאצא מצאצאי noun masculine plural construct unspecified unspecified  	O	null
36 הבעש"ט הבעש"ט הבעש"ט properName unspecified unspecified unspecified unspecified unspecified  	I_LOC	null
37 . . . punctuation unspecified unspecified unspecified unspecified unspecified  	O	null

0 למדה למד למדה verb feminine singular unspecified 3 past  	O	null
1 ב ב בבית preposition unspecified unspecified unspecified unspecified unspecified 0 
1 בית בית בבית noun masculine singular construct unspecified unspecified  	O	null
2 ספר ספר ספר noun masculine singular absolute unspecified unspecified  	O	null
3 פולני פולני פולני adjective masculine singular absolute unspecified unspecified  	O	null
4 ב ב בשילוב preposition unspecified unspecified unspecified unspecified unspecified 0 
4 שילוב שילוב בשילוב noun masculine singular construct unspecified unspecified  	O	null
5 שיעורי שיעור שיעורי noun masculine plural construct unspecified unspecified  	O	null
6 השלמה השלמה השלמה noun feminine singular absolute unspecified unspecified  	O	null
7 ב ב בבית preposition unspecified unspecified unspecified unspecified unspecified 0 
7 בית בית בבית noun masculine singular construct unspecified unspecified  	O	null
8 ספר ספר ספר noun masculine singular absolute unspecified unspecified  	O	null
9 יהודי יהודי יהודי adjective masculine singular absolute unspecified unspecified  	O	null
10 מ מ מרשת preposition unspecified unspecified unspecified unspecified unspecified 0 
10 רשת רשת מרשת noun feminine singular construct unspecified unspecified  	O	null
11 " " " punctuation unspecified unspecified unspecified unspecified unspecified  	O	null
12 תרבות תרבות תרבות noun feminine singular absolute unspecified unspecified  	O	null
13 " " " punctuation unspecified unspecified unspecified unspecified unspecified  	O	null
14 . . . punctuation unspecified unspecified unspecified unspecified unspecified  	O	null

0 מרבית מרבית מרבית noun feminine singular construct unspecified unspecified  	O	null
1 בני בן בני noun masculine plural construct unspecified unspecified  	O	null
2 משפחת משפחה משפחתה noun feminine singular absolute unspecified unspecified  
2 ה ה משפחתה possessive feminine singular unspecified 3 unspecified 0 	O	null
3 נספו נספה נספו verb masculine-and-feminine plural unspecified 3 past  	O	null
4 ב ב בשואה preposition unspecified unspecified unspecified unspecified unspecified 0 
4 ה ה בשואה definiteArticle unspecified unspecified unspecified unspecified unspecified 0 
4 השואה שואה בשואה noun feminine singular absolute unspecified unspecified  	O	null
5 . . . punctuation unspecified unspecified unspecified unspecified unspecified  	O	null

0 ב ב ב preposition unspecified unspecified unspecified unspecified unspecified 0 	I_ORG	null
1 - - - punctuation unspecified unspecified unspecified unspecified unspecified  	I_ORG	null
2 ###NUMBER### ###NUMBER### ###NUMBER### numeral unspecified unspecified unspecified unspecified unspecified  	I_DATE	null
3 עלתה עלה עלתה verb feminine singular unspecified 3 past  	O	null
4 ארצה ארצה ארצה adverb unspecified unspecified unspecified unspecified unspecified  	O	null
5 דרך דרך דרך preposition unspecified unspecified unspecified unspecified unspecified  	O	null
6 מחנות מחנה מחנות noun masculine plural construct unspecified unspecified  	O	null
7 ה ה העקורים definiteArticle unspecified unspecified unspecified unspecified unspecified 0 
7 העקורים עקור העקורים noun masculine plural absolute unspecified unspecified  	O	null
8 . . . punctuation unspecified unspecified unspecified unspecified unspecified  	O	null

0 עורכת עורך עורכת noun feminine singular construct unspecified unspecified  	O	null
1 ו ו ומנחה conjunction unspecified unspecified unspecified unspecified unspecified 0 
1 מנחה מנחה ומנחה noun feminine singular absolute unspecified unspecified  	O	null
2 של של של shel-preposition unspecified unspecified unspecified unspecified unspecified  	O	null
3 ערבי ערבי ערבי noun masculine singular absolute unspecified unspecified  	O	null
4 ספרות ספרות ספרות noun feminine singular absolute unspecified unspecified  	O	null
5 , , , punctuation unspecified unspecified unspecified unspecified unspecified  	O	null
6 מרצה הרצה מרצה verb masculine singular unspecified any beinoni  	O	null
7 ב ב בנושא preposition unspecified unspecified unspecified unspecified unspecified 0 
7 נושא נושא בנושא noun masculine singular construct unspecified unspecified  	O	null
8 ה ה השואה definiteArticle unspecified unspecified unspecified unspecified unspecified 0 
8 השואה שואה השואה noun feminine singular absolute unspecified unspecified  	O	null
9 ב ב בארץ preposition unspecified unspecified unspecified unspecified unspecified 0 
9 ה ה בארץ definiteArticle unspecified unspecified unspecified unspecified unspecified 0 
9 הארץ ארץ בארץ noun feminine singular absolute unspecified unspecified  	O	null
10 ו ו ובחו"ל conjunction unspecified unspecified unspecified unspecified unspecified 0 
10 ב ב ובחו"ל preposition unspecified unspecified unspecified unspecified unspecified 0 
10 חו"ל חו"ל ובחו"ל noun masculine singular absolute unspecified unspecified  	O	null
11 . . . punctuation unspecified unspecified unspecified unspecified unspecified  	O	null

0 פירסמה פרסם פירסמה verb feminine singular unspecified 3 past  	O	null
1 שמונה CARD8 שמונה numeral feminine plural absolute unspecified unspecified  	O	null
2 ספרי ספר ספרי noun masculine plural construct unspecified unspecified  	O	null
3 שירה שירה שירה noun feminine singular absolute unspecified unspecified  	O	null
4 : : : punctuation unspecified unspecified unspecified unspecified unspecified  	O	null
5 אדיאשד אדיאשד אדיאשד properName unspecified unspecified unspecified unspecified unspecified  	I_ORG	null
6 ( ( ( punctuation unspecified unspecified unspecified unspecified unspecified  	O	null
7 אל"ף אל"ף אל"ף properName unspecified unspecified unspecified unspecified unspecified  	I_ORG	null
8 , , , punctuation unspecified unspecified unspecified unspecified unspecified  	O	null
9 ) ) ) punctuation unspecified unspecified unspecified unspecified unspecified  	O	null
10 ; ; ; punctuation unspecified unspecified unspecified unspecified unspecified  	O	null
11 ###NUMBER### ###NUMBER### ###NUMBER### numeral unspecified unspecified unspecified unspecified unspecified  	I_DATE	null
12 פרחהבזלת פרחהבזלת פרחהבזלת noun feminine singular absolute unspecified unspecified  	O	null
13 ) ) ) punctuation unspecified unspecified unspecified unspecified unspecified  	O	null
14 ; ; ; punctuation unspecified unspecified unspecified unspecified unspecified  	O	null
15 ###NUMBER### ###NUMBER### ###NUMBER### numeral unspecified unspecified unspecified unspecified unspecified  	I_DATE	null
16 ב ב בסודהצרופים preposition unspecified unspecified unspecified unspecified unspecified 0 
16 סודהצרופים סודהצרופים בסודהצרופים noun feminine singular absolute unspecified unspecified  	O	null
17 ) ) ) punctuation unspecified unspecified unspecified unspecified unspecified  	O	null
18 ; ; ; punctuation unspecified unspecified unspecified unspecified unspecified  	O	null
19 ###NUMBER### ###NUMBER### ###NUMBER### numeral unspecified unspecified unspecified unspecified unspecified  	I_DATE	null
20 אוראחר אוראחר אוראחר properName unspecified unspecified unspecified unspecified unspecified  	I_DATE	null
21 ) ) ) punctuation unspecified unspecified unspecified unspecified unspecified  	O	null
22 ; ; ; punctuation unspecified unspecified unspecified unspecified unspecified  	O	null
23 ###NUMBER### ###NUMBER### ###NUMBER### numeral unspecified unspecified unspecified unspecified unspecified  	I_DATE	null
24 אקוורלטהור אקוורלטהור אקוורלטהור adjective masculine singular absolute unspecified unspecified  	O	null
25 ) ) ) punctuation unspecified unspecified unspecified unspecified unspecified  	O	null
26 ; ; ; punctuation unspecified unspecified unspecified unspecified unspecified  	O	null
27 ###NUMBER### ###NUMBER### ###NUMBER### numeral unspecified unspecified unspecified unspecified unspecified  	I_DATE	null
28 ש ש שםעלגדתנהרצ'רמוש relativizer/subordinatingConjunction unspecified unspecified unspecified unspecified unspecified 0 
28 מ מ שםעלגדתנהרצ'רמוש preposition unspecified unspecified unspecified unspecified unspecified 0 
28 עלגדתנהרצ'רמו עלגדתנהרצ'רמו שםעלגדתנהרצ'רמוש noun masculine singular absolute unspecified unspecified  
28 י י שםעלגדתנהרצ'רמוש possessive masculine-and-feminine singular unspecified 1 unspecified 0 	O	null
29 ) ) ) punctuation unspecified unspecified unspecified unspecified unspecified  	O	null
30 ; ; ; punctuation unspecified unspecified unspecified unspecified unspecified  	O	null
31 ###NUMBER### ###NUMBER### ###NUMBER### numeral unspecified unspecified unspecified unspecified unspecified  	I_DATE	null
32 שיינדלה שיינדלה שיינדלה properName unspecified unspecified unspecified unspecified unspecified  	I_DATE	null
33 ) ) ) punctuation unspecified unspecified unspecified unspecified unspecified  	O	null
34 ; ; ; punctuation unspecified unspecified unspecified unspecified unspecified  	O	null
35 קשת קשה קשת adjective feminine singular construct unspecified unspecified  	O	null
36 ###NUMBER### ###NUMBER### ###NUMBER### numeral unspecified unspecified unspecified unspecified unspecified  	I_DATE	null
37 ה ה התחושות definiteArticle unspecified unspecified unspecified unspecified unspecified 0 
37 התחושות תחושה התחושות noun feminine plural absolute unspecified unspecified  	O	null
38 ( ( ( punctuation unspecified unspecified unspecified unspecified unspecified  	O	null
39 ) ) ) punctuation unspecified unspecified unspecified unspecified unspecified  	O	null
40 . . . punctuation unspecified unspecified unspecified unspecified unspecified  	O	null
41 ###NUMBER### ###NUMBER### ###NUMBER### numeral unspecified unspecified unspecified unspecified unspecified  	I_DATE	null
42 חוויית חוויה חוויית noun feminine singular construct unspecified unspecified  	O	null
43 ה ה השואה definiteArticle unspecified unspecified unspecified unspecified unspecified 0 
43 השואה שואה השואה noun feminine singular absolute unspecified unspecified  	O	null
44 נוכחת נוכח נוכחת verb feminine singular unspecified any beinoni  	O	null
45 ב ב במרבית preposition unspecified unspecified unspecified unspecified unspecified 0 
45 מרבית מרבית במרבית quantifier unspecified unspecified construct unspecified unspecified  	O	null
46 שירי שיר שיריה noun masculine plural absolute unspecified unspecified  
46 ה ה שיריה possessive feminine singular unspecified 3 unspecified 0 	O	null
47 . . . punctuation unspecified unspecified unspecified unspecified unspecified  	O	null

0 ב ב בכתיבתה preposition unspecified unspecified unspecified unspecified unspecified 0 
0 כתיבת כתיבה בכתיבתה noun feminine singular absolute unspecified unspecified  
0 ה ה בכתיבתה possessive feminine singular unspecified 3 unspecified 0 	O	null
1 על על על preposition unspecified unspecified unspecified unspecified unspecified  	O	null
2 ה ה השואה definiteArticle unspecified unspecified unspecified unspecified unspecified 0 
2 השואה שואה השואה noun feminine singular absolute unspecified unspecified  	O	null
3 קולה קולה קולה noun feminine singular absolute unspecified unspecified  	O	null
4 נטול נטול נטול adjective masculine singular absolute unspecified unspecified  	O	null
5 זעם זעם זעם noun masculine singular absolute unspecified unspecified  	O	null
6 ו ו ותביעות conjunction unspecified unspecified unspecified unspecified unspecified 0 
6 תביעות תביעה ותביעות noun feminine plural absolute unspecified unspecified  	O	null
7 נקם נקם נקם noun masculine singular absolute unspecified unspecified  	O	null
8 , , , punctuation unspecified unspecified unspecified unspecified unspecified  	O	null
9 ו ו והנימה conjunction unspecified unspecified unspecified unspecified unspecified 0 
9 ה ה והנימה definiteArticle unspecified unspecified unspecified unspecified unspecified 0 
9 הנימה נימה והנימה noun feminine singular absolute unspecified unspecified  	O	null
10 ה ה המרכזית definiteArticle unspecified unspecified unspecified unspecified unspecified 0 
10 המרכזית מרכזי המרכזית adjective feminine singular absolute unspecified unspecified  	O	null
11 ב ב בה preposition unspecified unspecified unspecified unspecified unspecified  
11 ה ה בה pronomial feminine singular unspecified 3 unspecified 0 	O	null
12 היא הוא היא pronoun feminine singular unspecified 3 unspecified  	O	null
13 צער צער צער noun masculine singular absolute unspecified unspecified  	O	null
14 עמוק עמוק עמוק adjective masculine singular absolute unspecified unspecified  	O	null
15 ו ו וכבוש conjunction unspecified unspecified unspecified unspecified unspecified 0 
15 כבוש כבוש וכבוש adjective masculine singular absolute unspecified unspecified  	O	null
16 . . . punctuation unspecified unspecified unspecified unspecified unspecified  	O	null

0 שירי שיר שיריה noun masculine plural absolute unspecified unspecified  
0 ה ה שיריה possessive feminine singular unspecified 3 unspecified 0 	O	null
1 ליריים לירי ליריים adjective masculine plural absolute unspecified unspecified  	O	null
2 ו ו ומתאפיינים conjunction unspecified unspecified unspecified unspecified unspecified 0 
2 מתאפיינים התאפיין ומתאפיינים verb masculine plural unspecified any beinoni  	O	null
3 ב ב בסגנון preposition unspecified unspecified unspecified unspecified unspecified 0 
3 סגנון סגנון בסגנון noun masculine singular construct unspecified unspecified  	O	null
4 טלגרפי טלגרף טלגרפי noun masculine plural construct unspecified unspecified  	O	null
5 ו ו ותמציתי conjunction unspecified unspecified unspecified unspecified unspecified 0 
5 תמציתי תמציתי ותמציתי adjective masculine singular absolute unspecified unspecified  	O	null
6 , , , punctuation unspecified unspecified unspecified unspecified unspecified  	O	null
7 כש כש כשהסמוי temporalSubConj unspecified unspecified unspecified unspecified unspecified 0 
7 ה ה כשהסמוי definiteArticle unspecified unspecified unspecified unspecified unspecified 0 
7 הסמוי סמוי כשהסמוי adjective masculine singular absolute unspecified unspecified  	O	null
8 ו ו והנרמז conjunction unspecified unspecified unspecified unspecified unspecified 0 
8 ה ה והנרמז definiteArticle unspecified unspecified unspecified unspecified unspecified 0 
8 הנרמז נרמז והנרמז participle masculine singular absolute any unspecified  	O	null
9 ב ב בהם preposition unspecified unspecified unspecified unspecified unspecified  
9 הם הם בהם pronomial masculine plural unspecified 3 unspecified 0 	O	null
10 עולה עלה עולה verb masculine singular unspecified any beinoni  	O	null
11 על על על preposition unspecified unspecified unspecified unspecified unspecified  	O	null
12 ה ה הגלוי definiteArticle unspecified unspecified unspecified unspecified unspecified 0 
12 הגלוי גלוי הגלוי adjective masculine singular absolute unspecified unspecified  	O	null
13 ו ו והמובן conjunction unspecified unspecified unspecified unspecified unspecified 0 
13 ה ה והמובן definiteArticle unspecified unspecified unspecified unspecified unspecified 0 
13 המובן מובן והמובן noun masculine singular absolute unspecified unspecified  	O	null
14 . . . punctuation unspecified unspecified unspecified unspecified unspecified  	O	null

0 מוטיב מוטיב מוטיב noun masculine singular absolute unspecified unspecified  	O	null
1 מרכזי מרכזי מרכזי adjective masculine singular absolute unspecified unspecified  	O	null
2 ה ה המופיע definiteArticle unspecified unspecified unspecified unspecified unspecified 0 
2 המופיע הופיע המופיע participle masculine singular absolute any unspecified  	O	null
3 ב ב בשיריה preposition unspecified unspecified unspecified unspecified unspecified 0 
3 שירי שיר בשיריה noun masculine plural absolute unspecified unspecified  
3 ה ה בשיריה possessive feminine singular unspecified 3 unspecified 0 	O	null
4 הוא הוא הוא pronoun masculine singular unspecified 3 unspecified  	O	null
5 מוטיב מוטיב מוטיב noun masculine singular construct unspecified unspecified  	O	null
6 ה ה האור definiteArticle unspecified unspecified unspecified unspecified unspecified 0 
6 האור אור האור noun masculine singular absolute unspecified unspecified  	O	null
7 , , , punctuation unspecified unspecified unspecified unspecified unspecified  	O	null
8 ה ה המתגלה definiteArticle unspecified unspecified unspecified unspecified unspecified 0 
8 המתגלה התגלה המתגלה participle masculine singular absolute any unspecified  	O	null
9 ב ב בשירים preposition unspecified unspecified unspecified unspecified unspecified 0 
9 שירים שיר בשירים noun masculine plural absolute unspecified unspecified  	O	null
10 שונים שונה שונים adjective masculine plural absolute unspecified unspecified  	O	null
11 ב ב בייצוגים preposition unspecified unspecified unspecified unspecified unspecified 0 
11 ייצוגים ייצוג בייצוגים noun masculine plural absolute unspecified unspecified  	O	null
12 שונים שונה שונים adjective masculine plural absolute unspecified unspecified  	O	null
13 : : : punctuation unspecified unspecified unspecified unspecified unspecified  	O	null
14 מ מ מאורו preposition unspecified unspecified unspecified unspecified unspecified 0 
14 אור אור מאורו noun masculine singular absolute unspecified unspecified  
14 ו ו מאורו possessive masculine singular unspecified 3 unspecified 0 	O	null
15 ה ה הפיזי definiteArticle unspecified unspecified unspecified unspecified unspecified 0 
15 הפיזי פיסי הפיזי adjective masculine singular absolute unspecified unspecified  	O	null
16 של של של shel-preposition unspecified unspecified unspecified unspecified unspecified  	O	null
17 ה ה הנר definiteArticle unspecified unspecified unspecified unspecified unspecified 0 
17 הנר נר הנר noun masculine singular absolute unspecified unspecified  	O	null
18 ו ו ועד conjunction unspecified unspecified unspecified unspecified unspecified 0 
18 עד עד ועד noun masculine singular absolute unspecified unspecified  	O	null
19 ל ל לאורו preposition unspecified unspecified unspecified unspecified unspecified 0 
19 אור אור לאורו noun masculine singular absolute unspecified unspecified  
19 ו ו לאורו possessive masculine singular unspecified 3 unspecified 0 	O	null
20 ה ה המיסטי definiteArticle unspecified unspecified unspecified unspecified unspecified 0 
20 המיסטי מיסטי המיסטי adjective masculine singular absolute unspecified unspecified  	O	null
21 או או או conjunction unspecified unspecified unspecified unspecified unspecified  	O	null
22 ה ה הרליגיוזי definiteArticle unspecified unspecified unspecified unspecified unspecified 0 
22 הרליגיוזי הרליגיוזי הרליגיוזי adjective masculine singular absolute unspecified unspecified  	O	null
23 של של של shel-preposition unspecified unspecified unspecified unspecified unspecified  	O	null
24 ה ה העולם definiteArticle unspecified unspecified unspecified unspecified unspecified 0 
24 העולם עולם העולם noun masculine singular absolute unspecified unspecified  	O	null
25 , , , punctuation unspecified unspecified unspecified unspecified unspecified  	O	null
26 ש ש שישוב relativizer/subordinatingConjunction unspecified unspecified unspecified unspecified unspecified 0 
26 ישוב שב שישוב verb masculine singular unspecified 3 future  	I_LOC	null
27 ו ו ויאיר conjunction unspecified unspecified unspecified unspecified unspecified 0 
27 יאיר האיר ויאיר properName unspecified unspecified unspecified unspecified unspecified  	I_PERS	null
28 לאחר לאחר לאחר conjunction unspecified unspecified unspecified unspecified unspecified  	O	null
29 ש ש שתסתלק relativizer/subordinatingConjunction unspecified unspecified unspecified unspecified unspecified 0 
29 תסתלק הסתלק שתסתלק verb feminine singular unspecified 3 future  	O	null
30 מן מן ממנו preposition unspecified unspecified unspecified unspecified unspecified  
30 ו ו ממנו pronomial masculine singular unspecified 3 unspecified 0 	O	null
31 חשכת חשכה חשכת noun feminine singular construct unspecified unspecified  	O	null
32 ה ה המלחמה definiteArticle unspecified unspecified unspecified unspecified unspecified 0 
32 המלחמה מלחמה המלחמה noun feminine singular absolute unspecified unspecified  	O	null
33 ו ו ואימתה conjunction unspecified unspecified unspecified unspecified unspecified 0 
33 אימת אימה ואימתה noun feminine singular absolute unspecified unspecified  
33 ה ה ואימתה possessive feminine singular unspecified 3 unspecified 0 	O	null
34 . . . punctuation unspecified unspecified unspecified unspecified unspecified  	O	null

0 זכתה זכה זכתה verb feminine singular unspecified 3 past  	O	null
1 ב ב בפרסים preposition unspecified unspecified unspecified unspecified unspecified 0 
1 פרסים פרס בפרסים noun masculine plural absolute unspecified unspecified  	O	null
2 ו ו ובתארים conjunction unspecified unspecified unspecified unspecified unspecified 0 
2 ב ב ובתארים preposition unspecified unspecified unspecified unspecified unspecified 0 
2 תארים תואר ובתארים noun masculine plural absolute unspecified unspecified  	O	null
3 , , , punctuation unspecified unspecified unspecified unspecified unspecified  	O	null
4 ב ב בהם preposition unspecified unspecified unspecified unspecified unspecified  
4 הם הם בהם pronomial masculine plural unspecified 3 unspecified 0 	O	null
5 תוארדוקטורלשםכבודמטעם תוארדוקטורלשםכבודמטעם תוארדוקטורלשםכבודמטעם verb masculine singular unspecified 2 imperative  	O	null
6 World World World foreign unspecified unspecified unspecified unspecified unspecified  	I_ORG	null
7 Academy Academy Academy foreign unspecified unspecified unspecified unspecified unspecified  	I_ORG	null
8 of of of foreign unspecified unspecified unspecified unspecified unspecified  	I_ORG	null
9 Art Art Art foreign unspecified unspecified unspecified unspecified unspecified  	I_ORG	null
10 and and and foreign unspecified unspecified unspecified unspecified unspecified  	I_ORG	null
11 Culture Culture Culture foreign unspecified unspecified unspecified unspecified unspecified  	I_ORG	null
12 , , , punctuation unspecified unspecified unspecified unspecified unspecified  	O	null
13 ו ו וכן conjunction unspecified unspecified unspecified unspecified unspecified 0 
13 כן כן וכן conjunction unspecified unspecified unspecified unspecified unspecified  	O	null
14 ב ב בפרסים preposition unspecified unspecified unspecified unspecified unspecified 0 
14 פרסים פרס בפרסים noun masculine plural absolute unspecified unspecified  	O	null
15 ו ו ובמענקים conjunction unspecified unspecified unspecified unspecified unspecified 0 
15 ב ב ובמענקים preposition unspecified unspecified unspecified unspecified unspecified 0 
15 מענקים מענק ובמענקים noun masculine plural absolute unspecified unspecified  	O	null
16 מ מ מקרנות preposition unspecified unspecified unspecified unspecified unspecified 0 
16 קרנות קרן מקרנות noun feminine plural absolute unspecified unspecified  	O	null
17 שונות שונה שונות adjective feminine plural absolute unspecified unspecified  	O	null
18 כגון כגון כגון preposition unspecified unspecified unspecified unspecified unspecified  	O	null
19 קרןתלאביבלספרותואמנות קרןתלאביבלספרותואמנות קרןתלאביבלספרותואמנות adjective feminine plural construct unspecified unspecified  	O	null
20 , , , punctuation unspecified unspecified unspecified unspecified unspecified  	O	null
21 קרןעירייתבתיםלספרותואמנות קרןעירייתבתיםלספרותואמנות קרןעירייתבתיםלספרותואמנות adjective masculine singular construct unspecified unspecified  	O	null
22 ו ו וקרן conjunction unspecified unspecified unspecified unspecified unspecified 0 
22 קרן קרן וקרן verb masculine singular unspecified 3 past  	I_LOC	null
23 עמו"ס עמו"ס עמו"ס properName unspecified unspecified unspecified unspecified unspecified  	I_PERS	null
24 . . . punctuation unspecified unspecified unspecified unspecified unspecified  	O	null

0 References References References foreign unspecified unspecified unspecified unspecified unspecified  	O	null
1 : : : punctuation unspecified unspecified unspecified unspecified unspecified  	O	null
2 רוזנפלד רוזנפלד רוזנפלד properName unspecified unspecified unspecified unspecified unspecified  	I_PERS	null
3 , , , punctuation unspecified unspecified unspecified unspecified unspecified  	O	null
4 ברכה ברכה ברכה properName masculine singular unspecified unspecified unspecified  	I_PERS	null
5 . . . punctuation unspecified unspecified unspecified unspecified unspecified  	O	null

0 " " " punctuation unspecified unspecified unspecified unspecified unspecified  	O	null
1 לכודה לכוד לכודה adjective feminine singular absolute unspecified unspecified  	O	null
2 בתוך בתוך בתוך preposition unspecified unspecified unspecified unspecified unspecified  	O	null
3 ה ה האש definiteArticle unspecified unspecified unspecified unspecified unspecified 0 
3 האש אש האש noun feminine singular absolute unspecified unspecified  	O	null
4 " " " punctuation unspecified unspecified unspecified unspecified unspecified  	O	null
5 . . . punctuation unspecified unspecified unspecified unspecified unspecified  	O	null

0 מאזניים מאזניים מאזניים noun masculine plural absolute unspecified unspecified  	O	null
1 ס"ח ס"ח ס"ח noun masculine singular absolute unspecified unspecified  	O	null
2 ) ) ) punctuation unspecified unspecified unspecified unspecified unspecified  	O	null
3 . . . punctuation unspecified unspecified unspecified unspecified unspecified  	O	null
4 ###NUMBER### ###NUMBER### ###NUMBER### numeral unspecified unspecified unspecified unspecified unspecified  	O	null
5 ###NUMBER### ###NUMBER### ###NUMBER### numeral unspecified unspecified unspecified unspecified unspecified  	I_DATE	null
6 . . . punctuation unspecified unspecified unspecified unspecified unspecified  	O	null

0 - - - punctuation unspecified unspecified unspecified unspecified unspecified  	O	null
1 ###NUMBER### ###NUMBER### ###NUMBER### numeral unspecified unspecified unspecified unspecified unspecified  	O	null
2 ; ; ; punctuation unspecified unspecified unspecified unspecified unspecified  	O	null
3 ###NUMBER### ###NUMBER### ###NUMBER### numeral unspecified unspecified unspecified unspecified unspecified  	O	null
4 גודא גודא גודאל noun masculine singular absolute unspecified unspecified  
4 ו ו גודאל possessive masculine singular unspecified 3 unspecified 0 	O	null
5 , , , punctuation unspecified unspecified unspecified unspecified unspecified  	O	null
6 מרים מרים מרים properName unspecified unspecified unspecified unspecified unspecified  	I_PERS	null
7 . . . punctuation unspecified unspecified unspecified unspecified unspecified  	O	null

0 " " " punctuation unspecified unspecified unspecified unspecified unspecified  	O	null
1 מסע מסע מסע noun masculine singular construct unspecified unspecified  	O	null
2 אל אל אל noun masculine singular construct unspecified unspecified  	O	null
3 ה ה האור definiteArticle unspecified unspecified unspecified unspecified unspecified 0 
3 האור אור האור noun masculine singular absolute unspecified unspecified  	O	null
4 בין בין בין preposition unspecified unspecified unspecified unspecified unspecified  	O	null
5 ה ה האין definiteArticle unspecified unspecified unspecified unspecified unspecified 0 
5 האין אין האין noun masculine singular absolute unspecified unspecified  	O	null
6 ו ו והשתיקות conjunction unspecified unspecified unspecified unspecified unspecified 0 
6 ה ה והשתיקות definiteArticle unspecified unspecified unspecified unspecified unspecified 0 
6 השתיקות שתיקה והשתיקות noun feminine plural absolute unspecified unspecified  	O	null
7 " " " punctuation unspecified unspecified unspecified unspecified unspecified  	O	null
8 . . . punctuation unspecified unspecified unspecified unspecified unspecified  	O	null

0 מעמקים מעמקים מעמקים noun masculine plural absolute unspecified unspecified  	O	null
1 ###NUMBER### ###NUMBER### ###NUMBER### numeral unspecified unspecified unspecified unspecified unspecified  	O	null
2 . . . punctuation unspecified unspecified unspecified unspecified unspecified  	O	null

0 ###NUMBER### ###NUMBER### ###NUMBER### numeral unspecified unspecified unspecified unspecified unspecified  	I_DATE	null
1 . . . punctuation unspecified unspecified unspecified unspecified unspecified  	O	null

