0 Name Name Name foreign unspecified unspecified unspecified unspecified unspecified  	O	null
1 : : : punctuation unspecified unspecified unspecified unspecified unspecified  	O	null
2 קרמר קרמר קרמר properName unspecified unspecified unspecified unspecified unspecified  	I_PERS	null
3 , , , punctuation unspecified unspecified unspecified unspecified unspecified  	O	null
4 שלום שלום שלום noun masculine singular absolute unspecified unspecified  	O	null
5 Birth Birth Birth foreign unspecified unspecified unspecified unspecified unspecified  	O	null
6 Year Year Year foreign unspecified unspecified unspecified unspecified unspecified  	O	null
7 : : : punctuation unspecified unspecified unspecified unspecified unspecified  	O	null
8 ###NUMBER### ###NUMBER### ###NUMBER### numeral unspecified unspecified unspecified unspecified unspecified  	I_DATE	null
9 Death Death Death foreign unspecified unspecified unspecified unspecified unspecified  	O	null
10 Year Year Year foreign unspecified unspecified unspecified unspecified unspecified  	O	null
11 : : : punctuation unspecified unspecified unspecified unspecified unspecified  	O	null
12 ###NUMBER### ###NUMBER### ###NUMBER### numeral unspecified unspecified unspecified unspecified unspecified  	I_DATE	null
13 Birth Birth Birth foreign unspecified unspecified unspecified unspecified unspecified  	O	null
14 Place Place Place foreign unspecified unspecified unspecified unspecified unspecified  	O	null
15 : : : punctuation unspecified unspecified unspecified unspecified unspecified  	O	null
16 סאנוק סאנוק סאנוק properName unspecified unspecified unspecified unspecified unspecified  	I_ORG	null
17 , , , punctuation unspecified unspecified unspecified unspecified unspecified  	O	null
18 גליציה גליציה גליציה properName unspecified unspecified unspecified unspecified unspecified  	O	null
19 Occupation Occupation Occupation foreign unspecified unspecified unspecified unspecified unspecified  	O	null
20 : : : punctuation unspecified unspecified unspecified unspecified unspecified  	O	null
21 מבקרועורך מבקרועורך מבקרועורך verb masculine singular unspecified 2 imperative  	O	null
22 Entry Entry Entry foreign unspecified unspecified unspecified unspecified unspecified  	O	null
23 writer writer writer foreign unspecified unspecified unspecified unspecified unspecified  	O	null
24 : : : punctuation unspecified unspecified unspecified unspecified unspecified  	O	null
25 שושי שושי שושי properName unspecified unspecified unspecified unspecified unspecified  	I_ORG	null
26 ש ש שפרבר relativizer/subordinatingConjunction unspecified unspecified unspecified unspecified unspecified 0 
26 פרבר פרבר שפרבר noun masculine singular absolute unspecified unspecified  	O	null
27 Entry Entry Entry foreign unspecified unspecified unspecified unspecified unspecified  	O	null
28 Value Value Value foreign unspecified unspecified unspecified unspecified unspecified  	O	null
29 : : : punctuation unspecified unspecified unspecified unspecified unspecified  	O	null
30 נולד נולד נולד verb masculine singular unspecified 3 past  	O	null
31 בסאנוק בסאנוק בסאנוק properName unspecified unspecified unspecified unspecified unspecified  	I_PERS	null
32 , , , punctuation unspecified unspecified unspecified unspecified unspecified  	O	null
33 גליציה גליציה גליציה noun feminine singular absolute unspecified unspecified  	O	null
34 . . . punctuation unspecified unspecified unspecified unspecified unspecified  	O	null

0 למד למד למד verb masculine singular unspecified 3 past  	O	null
1 ב ב בבית preposition unspecified unspecified unspecified unspecified unspecified 0 
1 בית בית בבית noun masculine singular construct unspecified unspecified  	O	null
2 ה ה המדרש definiteArticle unspecified unspecified unspecified unspecified unspecified 0 
2 המדרש מדרש המדרש noun masculine singular absolute unspecified unspecified  	O	null
3 ל ל למורים preposition unspecified unspecified unspecified unspecified unspecified 0 
3 ה ה למורים definiteArticle unspecified unspecified unspecified unspecified unspecified 0 
3 המורים מורה למורים noun masculine plural absolute unspecified unspecified  	O	null
4 " " " punctuation unspecified unspecified unspecified unspecified unspecified  	O	null
5 תחכמוני תחכמוני תחכמוני noun masculine singular absolute unspecified unspecified  	O	null
6 " " " punctuation unspecified unspecified unspecified unspecified unspecified  	O	null
7 ב ב בוורשה preposition unspecified unspecified unspecified unspecified unspecified 0 
7 וורשה ורשה בוורשה properName unspecified unspecified unspecified unspecified unspecified  	I_LOC	null
8 . . . punctuation unspecified unspecified unspecified unspecified unspecified  	O	null

0 ב ב ב preposition unspecified unspecified unspecified unspecified unspecified 0 	I_ORG	null
1 - - - punctuation unspecified unspecified unspecified unspecified unspecified  	I_ORG	null
2 ###NUMBER### ###NUMBER### ###NUMBER### numeral unspecified unspecified unspecified unspecified unspecified  	I_DATE	null
3 למד למד למד verb masculine singular unspecified 3 past  	O	null
4 משפטים משפט משפטים noun masculine plural absolute unspecified unspecified  	O	null
5 ב ב בלבוב preposition unspecified unspecified unspecified unspecified unspecified 0 
5 לבוב לבוב בלבוב noun masculine singular absolute unspecified unspecified  	O	null
6 במשך במשך במשך preposition unspecified unspecified unspecified unspecified unspecified  	O	null
7 שנה שנה שנה noun feminine singular absolute unspecified unspecified  	O	null
8 , , , punctuation unspecified unspecified unspecified unspecified unspecified  	O	null
9 הפסיק הפסיק הפסיק verb masculine singular unspecified 3 past  	O	null
10 ו ו ועלה conjunction unspecified unspecified unspecified unspecified unspecified 0 
10 עלה עלה ועלה verb masculine singular unspecified 3 past  	O	null
11 ארצה ארצה ארצה adverb unspecified unspecified unspecified unspecified unspecified  	O	null
12 ב ב ב preposition unspecified unspecified unspecified unspecified unspecified 0 	I_ORG	null
13 - - - punctuation unspecified unspecified unspecified unspecified unspecified  	I_ORG	null
14 ###NUMBER### ###NUMBER### ###NUMBER### numeral unspecified unspecified unspecified unspecified unspecified  	I_DATE	null
15 . . . punctuation unspecified unspecified unspecified unspecified unspecified  	O	null

0 ב ב בשנים preposition unspecified unspecified unspecified unspecified unspecified 0 
0 שנים שנה בשנים noun feminine plural absolute unspecified unspecified  	O	null
1 ###NUMBER### ###NUMBER### ###NUMBER### numeral unspecified unspecified unspecified unspecified unspecified  	I_DATE	null
2 - - - punctuation unspecified unspecified unspecified unspecified unspecified  	O	null
3 ###NUMBER### ###NUMBER### ###NUMBER### numeral unspecified unspecified unspecified unspecified unspecified  	I_DATE	null
4 למד למד למד verb masculine singular unspecified 3 past  	O	null
5 ב ב באוניברסיטה preposition unspecified unspecified unspecified unspecified unspecified 0 
5 ה ה באוניברסיטה definiteArticle unspecified unspecified unspecified unspecified unspecified 0 
5 האוניברסיטה אוניברסיטה באוניברסיטה noun feminine singular absolute unspecified unspecified  	O	null
6 ה ה העברית definiteArticle unspecified unspecified unspecified unspecified unspecified 0 
6 העברית עברי העברית adjective feminine singular absolute unspecified unspecified  	O	null
7 ב ב בירושלים preposition unspecified unspecified unspecified unspecified unspecified 0 
7 ירושלים ירושלים בירושלים properName unspecified unspecified unspecified unspecified unspecified  	I_LOC	null
8 ו ו וקיבל conjunction unspecified unspecified unspecified unspecified unspecified 0 
8 קיבל קיבל וקיבל verb masculine singular unspecified 3 past  	O	null
9 תואר תואר תואר noun masculine singular absolute unspecified unspecified  	O	null
10 מוסמך הוסמך מוסמך verb masculine singular unspecified any beinoni  	O	null
11 ל ל למדעי preposition unspecified unspecified unspecified unspecified unspecified 0 
11 מדעי מדע למדעי noun masculine plural construct unspecified unspecified  	O	null
12 ה ה הרוח definiteArticle unspecified unspecified unspecified unspecified unspecified 0 
12 הרוח רוח הרוח noun feminine singular absolute unspecified unspecified  	O	null
13 . . . punctuation unspecified unspecified unspecified unspecified unspecified  	O	null

0 לימד לימד לימד verb masculine singular unspecified 3 past  	O	null
1 ב ב בבתי preposition unspecified unspecified unspecified unspecified unspecified 0 
1 בתי בית בבתי noun masculine plural construct unspecified unspecified  	O	null
2 ספר ספר ספר noun masculine singular absolute unspecified unspecified  	O	null
3 תיכוניים תיכוני תיכוניים adjective masculine plural absolute unspecified unspecified  	O	null
4 ב ב בחיפה preposition unspecified unspecified unspecified unspecified unspecified 0 
4 חיפה חיפה בחיפה properName unspecified unspecified unspecified unspecified unspecified  	I_LOC	null
5 ו ו ובירושלים conjunction unspecified unspecified unspecified unspecified unspecified 0 
5 ב ב ובירושלים preposition unspecified unspecified unspecified unspecified unspecified 0 
5 ירושלים ירושלים ובירושלים properName unspecified unspecified unspecified unspecified unspecified  	I_LOC	null
6 ו ו והרצה conjunction unspecified unspecified unspecified unspecified unspecified 0 
6 הרצה הרצה והרצה verb masculine singular unspecified 3 past  	O	null
7 ב ב באוניברסיטת preposition unspecified unspecified unspecified unspecified unspecified 0 
7 אוניברסיטת אוניברסיטה באוניברסיטת noun feminine singular construct unspecified unspecified  	I_ORG	null
8 תלאביב תלאביב תלאביב properName unspecified unspecified unspecified unspecified unspecified  	I_ORG	null
9 . . . punctuation unspecified unspecified unspecified unspecified unspecified  	O	null

0 מאמרי מאמר מאמריו noun masculine plural absolute unspecified unspecified  
0 ו ו מאמריו possessive masculine singular unspecified 3 unspecified 0 	O	null
1 ו ו ומסותיו conjunction unspecified unspecified unspecified unspecified unspecified 0 
1 מסות מסה ומסותיו noun feminine plural absolute unspecified unspecified  
1 ו ו ומסותיו possessive masculine singular unspecified 3 unspecified 0 	O	null
2 פורסמובכתביעת פורסמובכתביעת פורסמובכתביעת properName unspecified unspecified unspecified unspecified unspecified  	O	null
3 ל ל לספרות preposition unspecified unspecified unspecified unspecified unspecified 0 
3 ה ה לספרות definiteArticle unspecified unspecified unspecified unspecified unspecified 0 
3 הספרות ספרות לספרות noun feminine singular absolute unspecified unspecified  	O	null
4 ו ו וחלקם conjunction unspecified unspecified unspecified unspecified unspecified 0 
4 חלק חלק וחלקם noun masculine singular absolute unspecified unspecified  
4 ם ם וחלקם possessive masculine plural unspecified 3 unspecified 0 	O	null
5 כונסובספריו כונסובספריו כונסובספריו properName unspecified unspecified unspecified unspecified unspecified  	I_PERS	null
6 . . . punctuation unspecified unspecified unspecified unspecified unspecified  	O	null

0 כתב כתב כתב verb masculine singular unspecified 3 past  	O	null
1 על על על preposition unspecified unspecified unspecified unspecified unspecified  	O	null
2 סופרים סופר סופרים noun masculine plural absolute unspecified unspecified  	O	null
3 ו ו ומשוררים conjunction unspecified unspecified unspecified unspecified unspecified 0 
3 משוררים משורר ומשוררים noun masculine plural absolute unspecified unspecified  	O	null
4 בני בן בני noun masculine plural construct unspecified unspecified  	O	null
5 דורות דור דורות noun masculine plural absolute unspecified unspecified  	O	null
6 שונים שונה שונים adjective masculine plural absolute unspecified unspecified  	O	null
7 , , , punctuation unspecified unspecified unspecified unspecified unspecified  	O	null
8 ש ש שפעלו relativizer/subordinatingConjunction unspecified unspecified unspecified unspecified unspecified 0 
8 פעלו פעל שפעלו verb masculine-and-feminine plural unspecified 3 past  	O	null
9 החל החל החל verb unspecified unspecified unspecified unspecified infinitive  	O	null
10 מ מ מתקופת preposition unspecified unspecified unspecified unspecified unspecified 0 
10 תקופת תקופה מתקופת noun feminine singular construct unspecified unspecified  	O	null
11 ה ה ההשכלה definiteArticle unspecified unspecified unspecified unspecified unspecified 0 
11 ההשכלה השכלה ההשכלה noun feminine singular absolute unspecified unspecified  	O	null
12 ו ו ועד conjunction unspecified unspecified unspecified unspecified unspecified 0 
12 עד עד ועד preposition unspecified unspecified unspecified unspecified unspecified  	O	null
13 דור דור דור noun masculine singular construct unspecified unspecified  	O	null
14 ה ה המדינה definiteArticle unspecified unspecified unspecified unspecified unspecified 0 
14 המדינה מדינה המדינה noun feminine singular absolute unspecified unspecified  	O	null
15 . . . punctuation unspecified unspecified unspecified unspecified unspecified  	O	null

0 ב ב ב preposition unspecified unspecified unspecified unspecified unspecified 0 	I_ORG	null
1 - - - punctuation unspecified unspecified unspecified unspecified unspecified  	I_ORG	null
2 ###NUMBER### ###NUMBER### ###NUMBER### numeral unspecified unspecified unspecified unspecified unspecified  	I_DATE	null
3 יצא יצא יצא verb masculine singular unspecified 3 past  	O	null
4 לאור לאור לאור preposition unspecified unspecified unspecified unspecified unspecified  	O	null
5 ספר ספר ספרו noun masculine singular absolute unspecified unspecified  
5 ו ו ספרו possessive masculine singular unspecified 3 unspecified 0 	O	null
6 ה ה המבקר definiteArticle unspecified unspecified unspecified unspecified unspecified 0 
6 המבקר מבקר המבקר noun masculine singular absolute unspecified unspecified  	O	null
7 ה ה הנידח definiteArticle unspecified unspecified unspecified unspecified unspecified 0 
7 הנידח נידח הנידח adjective masculine singular absolute unspecified unspecified  	O	null
8 ( ( ( punctuation unspecified unspecified unspecified unspecified unspecified  	O	null
9 ספרית ספר ספרית noun feminine singular construct unspecified unspecified  	O	null
10 פועלים פועל פועלים noun masculine plural absolute unspecified unspecified  	O	null
11 ) ) ) punctuation unspecified unspecified unspecified unspecified unspecified  	O	null
12 , , , punctuation unspecified unspecified unspecified unspecified unspecified  	O	null
13 שבו ישב שבו verb masculine-and-feminine plural unspecified 2 imperative  	O	null
14 כינס כינס כינס verb masculine singular unspecified 3 past  	O	null
15 את את את at-preposition unspecified unspecified unspecified unspecified unspecified  	O	null
16 מאמרי מאמר מאמריו noun masculine plural absolute unspecified unspecified  
16 ו ו מאמריו possessive masculine singular unspecified 3 unspecified 0 	O	null
17 של של של shel-preposition unspecified unspecified unspecified unspecified unspecified  	O	null
18 אברהם אברהם אברהם properName unspecified unspecified unspecified unspecified unspecified  	I_PERS	null
19 אורי אורי אורי properName unspecified unspecified unspecified unspecified unspecified  	I_PERS	null
20 קובנר קובנר קובנר properName unspecified unspecified unspecified unspecified unspecified  	I_PERS	null
21 . . . punctuation unspecified unspecified unspecified unspecified unspecified  	O	null

0 הוא הוא הוא pronoun masculine singular unspecified 3 unspecified  	O	null
1 ביקש ביקש ביקש verb masculine singular unspecified 3 past  	O	null
2 להסביר הסביר להסביר verb unspecified unspecified unspecified unspecified infinitive  	O	null
3 ו ו ולפענח conjunction unspecified unspecified unspecified unspecified unspecified 0 
3 לפענח פענח ולפענח verb unspecified unspecified unspecified unspecified infinitive  	O	null
4 את את את at-preposition unspecified unspecified unspecified unspecified unspecified  	O	null
5 דמות דמות דמותו noun feminine singular absolute unspecified unspecified  
5 ו ו דמותו possessive masculine singular unspecified 3 unspecified 0 	O	null
6 של של של shel-preposition unspecified unspecified unspecified unspecified unspecified  	O	null
7 ה ה המבקר definiteArticle unspecified unspecified unspecified unspecified unspecified 0 
7 המבקר מבקר המבקר noun masculine singular absolute unspecified unspecified  	O	null
8 ה ה הנשכח definiteArticle unspecified unspecified unspecified unspecified unspecified 0 
8 הנשכח נשכח הנשכח participle masculine singular absolute any unspecified  	O	null
9 ו ו ולקבוע conjunction unspecified unspecified unspecified unspecified unspecified 0 
9 לקבוע קבע ולקבוע verb unspecified unspecified unspecified unspecified infinitive  	O	null
10 את את את at-preposition unspecified unspecified unspecified unspecified unspecified  	O	null
11 מקום מקום מקומו noun masculine singular absolute unspecified unspecified  
11 ו ו מקומו possessive masculine singular unspecified 3 unspecified 0 	O	null
12 ה ה הראוי definiteArticle unspecified unspecified unspecified unspecified unspecified 0 
12 הראוי ראוי הראוי adjective masculine singular absolute unspecified unspecified  	O	null
13 ב ב בביקורת preposition unspecified unspecified unspecified unspecified unspecified 0 
13 ה ה בביקורת definiteArticle unspecified unspecified unspecified unspecified unspecified 0 
13 הביקורת ביקורת בביקורת noun feminine singular absolute unspecified unspecified  	O	null
14 ה ה העברית definiteArticle unspecified unspecified unspecified unspecified unspecified 0 
14 העברית עברי העברית adjective feminine singular absolute unspecified unspecified  	O	null
15 . . . punctuation unspecified unspecified unspecified unspecified unspecified  	O	null

0 ב ב בספרים preposition unspecified unspecified unspecified unspecified unspecified 0 
0 ספרים ספר בספרים noun masculine plural absolute unspecified unspecified  	O	null
1 אחרים אחר אחרים adjective masculine plural absolute unspecified unspecified  	O	null
2 עסק עסק עסק verb masculine singular unspecified 3 past  	O	null
3 ב ב בסופרים preposition unspecified unspecified unspecified unspecified unspecified 0 
3 סופרים סופר בסופרים noun masculine plural absolute unspecified unspecified  	O	null
4 ו ו ומשוררים conjunction unspecified unspecified unspecified unspecified unspecified 0 
4 משוררים משורר ומשוררים noun masculine plural absolute unspecified unspecified  	O	null
5 בני בן בני noun masculine plural construct unspecified unspecified  	O	null
6 דור דור דור noun masculine singular construct unspecified unspecified  	O	null
7 ה ה התחייה definiteArticle unspecified unspecified unspecified unspecified unspecified 0 
7 התחייה תחייה התחייה noun feminine singular absolute unspecified unspecified  	O	null
8 . . . punctuation unspecified unspecified unspecified unspecified unspecified  	O	null

0 בין בין בין preposition unspecified unspecified unspecified unspecified unspecified  	O	null
1 ה ה השאר definiteArticle unspecified unspecified unspecified unspecified unspecified 0 
1 השאר שאר השאר noun masculine singular absolute unspecified unspecified  	O	null
2 כתב כתב כתב verb masculine singular unspecified 3 past  	O	null
3 על על על preposition unspecified unspecified unspecified unspecified unspecified  	O	null
4 טשרניחובסקי טשרניחובסקי טשרניחובסקי properName unspecified unspecified unspecified unspecified unspecified  	I_PERS	null
5 , , , punctuation unspecified unspecified unspecified unspecified unspecified  	O	null
6 יעקב יעקב יעקב properName unspecified unspecified unspecified unspecified unspecified  	I_PERS	null
7 פיכמן פיכמן פיכמן properName unspecified unspecified unspecified unspecified unspecified  	I_PERS	null
8 ו ו וזלמן conjunction unspecified unspecified unspecified unspecified unspecified 0 
8 זלמן זלמן וזלמן properName unspecified unspecified unspecified unspecified unspecified  	B_PERS	null
9 שניאור שניאור שניאור properName unspecified unspecified unspecified unspecified unspecified  	I_PERS	null
10 . . . punctuation unspecified unspecified unspecified unspecified unspecified  	O	null

0 כתב כתב כתב noun masculine singular construct unspecified unspecified  	O	null
1 מונוגרפיה מונוגרפיה מונוגרפיה properName unspecified unspecified unspecified unspecified unspecified  	I_ORG	null
2 מקיפה מקיף מקיפה adjective feminine singular absolute unspecified unspecified  	O	null
3 על על על preposition unspecified unspecified unspecified unspecified unspecified  	O	null
4 דוד דוד דוד properName unspecified unspecified unspecified unspecified unspecified  	I_PERS	null
5 פרישמן פרישמן פרישמן properName unspecified unspecified unspecified unspecified unspecified  	I_PERS	null
6 , , , punctuation unspecified unspecified unspecified unspecified unspecified  	O	null
7 ש ש שיצאה relativizer/subordinatingConjunction unspecified unspecified unspecified unspecified unspecified 0 
7 יצאה יצא שיצאה verb feminine singular unspecified 3 past  	O	null
8 ל ל לאור preposition unspecified unspecified unspecified unspecified unspecified 0 
8 אור אור לאור noun masculine singular absolute unspecified unspecified  	O	null
9 אחרי אחרי אחרי preposition unspecified unspecified unspecified unspecified unspecified  	O	null
10 מות מוות מותו noun masculine singular absolute unspecified unspecified  
10 ו ו מותו possessive masculine singular unspecified 3 unspecified 0 	O	null
11 ) ) ) punctuation unspecified unspecified unspecified unspecified unspecified  	O	null
12 . . . punctuation unspecified unspecified unspecified unspecified unspecified  	I_MONEY	null
13 ###NUMBER### ###NUMBER### ###NUMBER### numeral unspecified unspecified unspecified unspecified unspecified  	I_DATE	null
14 ב ב בספרו preposition unspecified unspecified unspecified unspecified unspecified 0 
14 ספר ספר בספרו noun masculine singular absolute unspecified unspecified  
14 ו ו בספרו possessive masculine singular unspecified 3 unspecified 0 	I_MONEY	null
15 חילופי חילוף חילופי noun masculine plural construct unspecified unspecified  	O	null
16 משמרות משמרת משמרות noun feminine plural absolute unspecified unspecified  	O	null
17 ב ב בספרותנו preposition unspecified unspecified unspecified unspecified unspecified 0 
17 ספרות ספרות בספרותנו noun feminine singular absolute unspecified unspecified  
17 נו נו בספרותנו possessive masculine-and-feminine plural unspecified 1 unspecified 0 	O	null
18 ( ( ( punctuation unspecified unspecified unspecified unspecified unspecified  	O	null
19 ###NUMBER### ###NUMBER### ###NUMBER### numeral unspecified unspecified unspecified unspecified unspecified  	I_DATE	null
20 ) ) ) punctuation unspecified unspecified unspecified unspecified unspecified  	O	null
21 עסק עסק עסק verb masculine singular unspecified 3 past  	O	null
22 בין בין בין preposition unspecified unspecified unspecified unspecified unspecified  	O	null
23 ה ה השאר definiteArticle unspecified unspecified unspecified unspecified unspecified 0 
23 השאר שאר השאר noun masculine singular absolute unspecified unspecified  	O	null
24 ב ב בפרוזה preposition unspecified unspecified unspecified unspecified unspecified 0 
24 פרוזה פרוזה בפרוזה noun feminine singular absolute unspecified unspecified  	O	null
25 ה ה הארץ definiteArticle unspecified unspecified unspecified unspecified unspecified 0 
25 הארץ ארץ הארץ noun feminine singular absolute unspecified unspecified  	O	null
26 - - - punctuation unspecified unspecified unspecified unspecified unspecified  	O	null
27 ישראלית ישראלי ישראלית adjective feminine singular absolute unspecified unspecified  	O	null
28 ה ה החדשה definiteArticle unspecified unspecified unspecified unspecified unspecified 0 
28 החדשה חדש החדשה adjective feminine singular absolute unspecified unspecified  	O	null
29 . . . punctuation unspecified unspecified unspecified unspecified unspecified  	O	null

0 הואכתב הואכתב הואכתב verb masculine plural unspecified 2 past  	O	null
1 על על על preposition unspecified unspecified unspecified unspecified unspecified  	O	null
2 ה ה המספרים definiteArticle unspecified unspecified unspecified unspecified unspecified 0 
2 המספרים מספר המספרים noun masculine plural absolute unspecified unspecified  	O	null
3 ה ה השונים definiteArticle unspecified unspecified unspecified unspecified unspecified 0 
3 השונים שונה השונים adjective masculine plural absolute unspecified unspecified  	O	null
4 בני בן בני noun masculine plural construct unspecified unspecified  	O	null
5 אותו אותו אותו quantifier unspecified unspecified construct unspecified unspecified  	O	null
6 דור דור דור noun masculine singular absolute unspecified unspecified  	O	null
7 , , , punctuation unspecified unspecified unspecified unspecified unspecified  	O	null
8 ו ו ובהם conjunction unspecified unspecified unspecified unspecified unspecified 0 
8 ב ב ובהם preposition unspecified unspecified unspecified unspecified unspecified  
8 הם הם ובהם pronomial masculine plural unspecified 3 unspecified 0 	O	null
9 דוד דוד דוד properName unspecified unspecified unspecified unspecified unspecified  	I_PERS	null
10 מ מ מלץ preposition unspecified unspecified unspecified unspecified unspecified 0 
10 לץ לץ מלץ noun masculine singular absolute unspecified unspecified  	O	null
11 ו ו ויהושע conjunction unspecified unspecified unspecified unspecified unspecified 0 
11 יהושע יהושע ויהושע properName unspecified unspecified unspecified unspecified unspecified  	I_PERS	null
12 בר בר בר properName unspecified unspecified unspecified unspecified unspecified  	I_PERS	null
13 - - - properName unspecified unspecified unspecified unspecified unspecified  	I_PERS	null
14 יוסף יוסף יוסף properName unspecified unspecified unspecified unspecified unspecified  	I_PERS	null
15 , , , punctuation unspecified unspecified unspecified unspecified unspecified  	O	null
16 ו ו והגדיר conjunction unspecified unspecified unspecified unspecified unspecified 0 
16 הגדיר הגדיר והגדיר verb masculine singular unspecified 3 past  	O	null
17 את את אותם at-preposition unspecified unspecified unspecified unspecified unspecified  
17 הם הם אותם pronomial masculine plural unspecified 3 unspecified 0 	O	null
18 כדור כדור כדור noun masculine singular construct unspecified unspecified  	O	null
19 ה ה הביניים definiteArticle unspecified unspecified unspecified unspecified unspecified 0 
19 הביניים ביניים הביניים noun masculine singular absolute unspecified unspecified  	O	null
20 שהורתו שהורתו שהורתו adjective masculine singular absolute unspecified unspecified  	O	null
21 ב ב בגולה preposition unspecified unspecified unspecified unspecified unspecified 0 
21 ה ה בגולה definiteArticle unspecified unspecified unspecified unspecified unspecified 0 
21 הגולה גולה בגולה noun masculine singular absolute unspecified unspecified  	O	null
22 אך אך אך conjunction unspecified unspecified unspecified unspecified unspecified  	O	null
23 צמיחת צמיחה צמיחתו noun feminine singular absolute unspecified unspecified  
23 ו ו צמיחתו possessive masculine singular unspecified 3 unspecified 0 	O	null
24 ב ב בארץ preposition unspecified unspecified unspecified unspecified unspecified 0 
24 ה ה בארץ definiteArticle unspecified unspecified unspecified unspecified unspecified 0 
24 הארץ ארץ בארץ noun feminine singular absolute unspecified unspecified  	O	null
25 . . . punctuation unspecified unspecified unspecified unspecified unspecified  	O	null

0 ל ל לטענתו preposition unspecified unspecified unspecified unspecified unspecified 0 
0 טענת טענה לטענתו noun feminine singular absolute unspecified unspecified  
0 ו ו לטענתו possessive masculine singular unspecified 3 unspecified 0 	O	null
1 , , , punctuation unspecified unspecified unspecified unspecified unspecified  	O	null
2 יצירות יצירה יצירותיהם noun feminine plural absolute unspecified unspecified  
2 הם הם יצירותיהם possessive masculine plural unspecified 3 unspecified 0 	O	null
3 אינן הוא אינן copula feminine plural unspecified 3 beinoni  	O	null
4 נותנות נתן נותנות verb feminine plural unspecified any beinoni  	O	null
5 מבע מבע מבע noun masculine singular absolute unspecified unspecified  	O	null
6 שלם שלם שלם adjective masculine singular absolute unspecified unspecified  	O	null
7 ו ו ונאמן conjunction unspecified unspecified unspecified unspecified unspecified 0 
7 נאמן נאמן ונאמן adjective masculine singular absolute unspecified unspecified  	O	null
8 של של של shel-preposition unspecified unspecified unspecified unspecified unspecified  	O	null
9 ה ה התקופה definiteArticle unspecified unspecified unspecified unspecified unspecified 0 
9 התקופה תקופה התקופה noun feminine singular absolute unspecified unspecified  	O	null
10 , , , punctuation unspecified unspecified unspecified unspecified unspecified  	O	null
11 כי כי כי conjunction unspecified unspecified unspecified unspecified unspecified  	O	null
12 הם הוא הם pronoun masculine plural unspecified 3 unspecified  	O	null
13 לא לא לא negation unspecified unspecified unspecified unspecified unspecified  	O	null
14 קלטו קלט קלטו verb masculine-and-feminine plural unspecified 3 past  	O	null
15 את את את at-preposition unspecified unspecified unspecified unspecified unspecified  	O	null
16 ה ה התרבות definiteArticle unspecified unspecified unspecified unspecified unspecified 0 
16 התרבות תרבות התרבות noun feminine singular absolute unspecified unspecified  	O	null
17 ה ה הישנה definiteArticle unspecified unspecified unspecified unspecified unspecified 0 
17 הישנה ישן הישנה adjective feminine singular absolute unspecified unspecified  	O	null
18 בת בת בת noun feminine singular construct unspecified unspecified  	O	null
19 ה ה הגולה definiteArticle unspecified unspecified unspecified unspecified unspecified 0 
19 הגולה גולה הגולה noun masculine singular absolute unspecified unspecified  	O	null
20 מחד מחד מחד adverb unspecified unspecified unspecified unspecified unspecified  	O	null
21 גיסא גיסא גיסא properName unspecified unspecified unspecified unspecified unspecified  	I_PERS	null
22 , , , punctuation unspecified unspecified unspecified unspecified unspecified  	O	null
23 ו ו ומאידך conjunction unspecified unspecified unspecified unspecified unspecified 0 
23 מאידך מאידך ומאידך conjunction unspecified unspecified unspecified unspecified unspecified  	O	null
24 גיסא גיסא גיסא properName unspecified unspecified unspecified unspecified unspecified  	I_PERS	null
25 לא לא לא negation unspecified unspecified unspecified unspecified unspecified  	O	null
26 נטמעו נטמע נטמעו verb masculine-and-feminine plural unspecified 3 past  	O	null
27 ב ב בארץ preposition unspecified unspecified unspecified unspecified unspecified 0 
27 ארץ ארץ בארץ noun feminine singular construct unspecified unspecified  	I_LOC	null
28 ישראל ישראל ישראל properName unspecified unspecified unspecified unspecified unspecified  	I_LOC	null
29 . . . punctuation unspecified unspecified unspecified unspecified unspecified  	O	null

0 ב ב בספר preposition unspecified unspecified unspecified unspecified unspecified 0 
0 ה ה בספר definiteArticle unspecified unspecified unspecified unspecified unspecified 0 
0 הספר ספר בספר noun masculine singular absolute unspecified unspecified  	O	null
1 כינס כינס כינס verb masculine singular unspecified 3 past  	O	null
2 מבחר מבחר מבחר quantifier unspecified unspecified construct unspecified unspecified  	O	null
3 מ מ ממסותיו preposition unspecified unspecified unspecified unspecified unspecified 0 
3 מסות מסה ממסותיו noun feminine plural absolute unspecified unspecified  
3 ו ו ממסותיו possessive masculine singular unspecified 3 unspecified 0 	O	null
4 ו ו וחילק conjunction unspecified unspecified unspecified unspecified unspecified 0 
4 חילק חילק וחילק verb masculine singular unspecified 3 past  	O	null
5 את את אותן at-preposition unspecified unspecified unspecified unspecified unspecified  
5 הן הן אותן pronomial feminine plural unspecified 3 unspecified 0 	O	null
6 ל ל למדורים preposition unspecified unspecified unspecified unspecified unspecified 0 
6 מדורים מדור למדורים noun masculine plural absolute unspecified unspecified  	O	null
7 שונים שונה שונים adjective masculine plural absolute unspecified unspecified  	O	null
8 . . . punctuation unspecified unspecified unspecified unspecified unspecified  	O	null

0 חלוקה חלוקה חלוקה noun feminine singular absolute unspecified unspecified  	O	null
1 זו זו זו pronoun feminine singular unspecified 3 unspecified  	O	null
2 נועדה נועד נועדה verb feminine singular unspecified 3 past  	O	null
3 להצביע הצביע להצביע verb unspecified unspecified unspecified unspecified infinitive  	O	null
4 על על על preposition unspecified unspecified unspecified unspecified unspecified  	O	null
5 ה ה השינויים definiteArticle unspecified unspecified unspecified unspecified unspecified 0 
5 השינויים שינוי השינויים noun masculine plural absolute unspecified unspecified  	O	null
6 ה ה התוכניים definiteArticle unspecified unspecified unspecified unspecified unspecified 0 
6 התוכניים תוכני התוכניים adjective masculine plural absolute unspecified unspecified  	O	null
7 , , , punctuation unspecified unspecified unspecified unspecified unspecified  	O	null
8 ה ה הצורניים definiteArticle unspecified unspecified unspecified unspecified unspecified 0 
8 הצורניים צורני הצורניים adjective masculine plural absolute unspecified unspecified  	O	null
9 ו ו והסגנוניים conjunction unspecified unspecified unspecified unspecified unspecified 0 
9 ה ה והסגנוניים definiteArticle unspecified unspecified unspecified unspecified unspecified 0 
9 הסגנוניים הסגנוניים והסגנוניים adjective masculine plural absolute unspecified unspecified  	O	null
10 ש ש שנבעו relativizer/subordinatingConjunction unspecified unspecified unspecified unspecified unspecified 0 
10 נבעו נבע שנבעו verb masculine-and-feminine plural unspecified 3 past  	O	null
11 מ מ מהמעבר preposition unspecified unspecified unspecified unspecified unspecified 0 
11 ה ה מהמעבר definiteArticle unspecified unspecified unspecified unspecified unspecified 0 
11 המעבר מעבר מהמעבר noun masculine singular absolute unspecified unspecified  	O	null
12 מ מ מהגולה preposition unspecified unspecified unspecified unspecified unspecified 0 
12 ה ה מהגולה definiteArticle unspecified unspecified unspecified unspecified unspecified 0 
12 הגולה גולה מהגולה noun masculine singular absolute unspecified unspecified  	O	null
13 ל ל לארץ preposition unspecified unspecified unspecified unspecified unspecified 0 
13 ארץ ארץ לארץ noun feminine singular construct unspecified unspecified  	I_LOC	null
14 ישראל ישראל ישראל properName unspecified unspecified unspecified unspecified unspecified  	I_LOC	null
15 . . . punctuation unspecified unspecified unspecified unspecified unspecified  	O	null

0 על על על preposition unspecified unspecified unspecified unspecified unspecified  	O	null
1 פי פה פי noun masculine singular construct unspecified unspecified  	O	null
2 גישת גישה גישתו noun feminine singular absolute unspecified unspecified  
2 ו ו גישתו possessive masculine singular unspecified 3 unspecified 0 	O	null
3 , , , punctuation unspecified unspecified unspecified unspecified unspecified  	O	null
4 ה ה היצירה definiteArticle unspecified unspecified unspecified unspecified unspecified 0 
4 היצירה יצירה היצירה noun feminine singular absolute unspecified unspecified  	O	null
5 ה ה העברית definiteArticle unspecified unspecified unspecified unspecified unspecified 0 
5 העברית עברי העברית adjective feminine singular absolute unspecified unspecified  	O	null
6 ה ה הלאומית definiteArticle unspecified unspecified unspecified unspecified unspecified 0 
6 הלאומית לאומי הלאומית adjective feminine singular absolute unspecified unspecified  	O	null
7 תיבנה נבנה תיבנה verb feminine singular unspecified 3 future  	O	null
8 על על על preposition unspecified unspecified unspecified unspecified unspecified  	O	null
9 ידי יד ידי noun feminine plural construct unspecified unspecified  	O	null
10 מיזוג מיזוג מיזוג noun masculine singular absolute unspecified unspecified  	O	null
11 בין בין בין preposition unspecified unspecified unspecified unspecified unspecified  	O	null
12 ה ה החדש definiteArticle unspecified unspecified unspecified unspecified unspecified 0 
12 החדש חדש החדש adjective masculine singular absolute unspecified unspecified  	O	null
13 ל ל לישן preposition unspecified unspecified unspecified unspecified unspecified 0 
13 ה ה לישן definiteArticle unspecified unspecified unspecified unspecified unspecified 0 
13 הישן ישן לישן adjective masculine singular absolute unspecified unspecified  	O	null
14 . . . punctuation unspecified unspecified unspecified unspecified unspecified  	O	null

0 ה ה המשמרת definiteArticle unspecified unspecified unspecified unspecified unspecified 0 
0 המשמרת משמרת המשמרת noun feminine singular absolute unspecified unspecified  	O	null
1 ה ה השנייה definiteArticle unspecified unspecified unspecified unspecified unspecified 0 
1 השנייה ORD2 השנייה numeral feminine singular absolute unspecified unspecified  	I_ORG	null
2 ש ש שקרמר relativizer/subordinatingConjunction unspecified unspecified unspecified unspecified unspecified 0 
2 קרמר קרמר שקרמר properName unspecified unspecified unspecified unspecified unspecified  	I_PERS	null
3 התייחס התייחס התייחס verb masculine singular unspecified 3 past  	O	null
4 אל אל אליה preposition unspecified unspecified unspecified unspecified unspecified  
4 ה ה אליה pronomial feminine singular unspecified 3 unspecified 0 	O	null
5 כוללת כלל כוללת verb feminine singular unspecified any beinoni  	O	null
6 את את את at-preposition unspecified unspecified unspecified unspecified unspecified  	O	null
7 יוצרי יוצר יוצרי noun masculine plural construct unspecified unspecified  	O	null
8 דור דור דור properName unspecified unspecified unspecified unspecified unspecified  	I_PERS	null
9 תש"ח תש"ח תש"ח properName unspecified unspecified unspecified unspecified unspecified  	I_PERS	null
10 . . . punctuation unspecified unspecified unspecified unspecified unspecified  	O	null

0 הוא הוא הוא pronoun masculine singular unspecified 3 unspecified  	O	null
1 סבר סבר סבר verb masculine singular unspecified 3 past  	O	null
2 כי כי כי conjunction unspecified unspecified unspecified unspecified unspecified  	O	null
3 ה ה הספרות definiteArticle unspecified unspecified unspecified unspecified unspecified 0 
3 הספרות ספרות הספרות noun feminine singular absolute unspecified unspecified  	O	null
4 ה ה העברית definiteArticle unspecified unspecified unspecified unspecified unspecified 0 
4 העברית עברי העברית adjective feminine singular absolute unspecified unspecified  	O	null
5 ב ב בגולה preposition unspecified unspecified unspecified unspecified unspecified 0 
5 ה ה בגולה definiteArticle unspecified unspecified unspecified unspecified unspecified 0 
5 הגולה גולה בגולה noun feminine singular absolute unspecified unspecified  	O	null
6 ו ו ובארץ conjunction unspecified unspecified unspecified unspecified unspecified 0 
6 ב ב ובארץ preposition unspecified unspecified unspecified unspecified unspecified 0 
6 ארץ ארץ ובארץ noun feminine singular construct unspecified unspecified  	I_LOC	null
7 ישראל ישראל ישראל properName unspecified unspecified unspecified unspecified unspecified  	I_LOC	null
8 היא הוא היא pronoun feminine singular unspecified 3 unspecified  	O	null
9 בעלת בעל בעלת noun feminine singular construct unspecified unspecified  	O	null
10 צביון צביון צביון noun masculine singular absolute unspecified unspecified  	O	null
11 לאומי לאומי לאומי adjective masculine singular absolute unspecified unspecified  	O	null
12 , , , punctuation unspecified unspecified unspecified unspecified unspecified  	O	null
13 ו ו ולכן conjunction unspecified unspecified unspecified unspecified unspecified 0 
13 לכן לכן ולכן conjunction unspecified unspecified unspecified unspecified unspecified  	O	null
14 העדיף העדיף העדיף verb masculine singular unspecified 3 past  	O	null
15 את את את at-preposition unspecified unspecified unspecified unspecified unspecified  	O	null
16 ה ה הנוסח definiteArticle unspecified unspecified unspecified unspecified unspecified 0 
16 הנוסח נוסח הנוסח noun masculine singular absolute unspecified unspecified  	O	null
17 ה ה הריאליסטי definiteArticle unspecified unspecified unspecified unspecified unspecified 0 
17 הריאליסטי ריאליסטי הריאליסטי adjective masculine singular absolute unspecified unspecified  	O	null
18 ב ב בספרות preposition unspecified unspecified unspecified unspecified unspecified 0 
18 ה ה בספרות definiteArticle unspecified unspecified unspecified unspecified unspecified 0 
18 הספרות ספרות בספרות noun feminine singular absolute unspecified unspecified  	O	null
19 . . . punctuation unspecified unspecified unspecified unspecified unspecified  	O	null

0 הוא הוא הוא pronoun masculine singular unspecified 3 unspecified  	O	null
1 ראה ראה ראה verb masculine singular unspecified 3 past  	O	null
2 ב ב בכך preposition unspecified unspecified unspecified unspecified unspecified 0 
2 כך כך בכך pronoun unspecified unspecified unspecified unspecified unspecified  	O	null
3 ש ש שיוצרים relativizer/subordinatingConjunction unspecified unspecified unspecified unspecified unspecified 0 
3 יוצרים יוצר שיוצרים noun masculine plural absolute unspecified unspecified  	O	null
4 אלה אלה אלה pronoun masculine-and-feminine plural unspecified 3 unspecified  	O	null
5 ב ב ברובם preposition unspecified unspecified unspecified unspecified unspecified 0 
5 רוב רוב ברובם noun masculine singular absolute unspecified unspecified  
5 ם ם ברובם possessive masculine plural unspecified 3 unspecified 0 	O	null
6 נולדו נולד נולדו verb masculine-and-feminine plural unspecified 3 past  	O	null
7 ו ו וגדלו conjunction unspecified unspecified unspecified unspecified unspecified 0 
7 גדלו גדל וגדלו verb masculine-and-feminine plural unspecified 3 past  	O	null
8 ב ב בארץ preposition unspecified unspecified unspecified unspecified unspecified 0 
8 ארץ ארץ בארץ noun feminine singular construct unspecified unspecified  	O	null
9 עובדה עובדה עובדה noun feminine singular absolute unspecified unspecified  	O	null
10 מספקת סיפק מספקת verb feminine singular unspecified any beinoni  	O	null
11 כדי כדי כדי conjunction unspecified unspecified unspecified unspecified unspecified  	O	null
12 להעיד העיד להעיד verb unspecified unspecified unspecified unspecified infinitive  	O	null
13 על על על preposition unspecified unspecified unspecified unspecified unspecified  	O	null
14 טיב טיב טיבם noun masculine singular absolute unspecified unspecified  
14 ם ם טיבם possessive masculine plural unspecified 3 unspecified 0 	O	null
15 , , , punctuation unspecified unspecified unspecified unspecified unspecified  	O	null
16 ו ו וסבר conjunction unspecified unspecified unspecified unspecified unspecified 0 
16 סבר סבר וסבר verb masculine singular unspecified 3 past  	O	null
17 כי כי כי conjunction unspecified unspecified unspecified unspecified unspecified  	O	null
18 ב ב ביוצרם preposition unspecified unspecified unspecified unspecified unspecified 0 
18 יוצר יוצר ביוצרם noun masculine singular absolute unspecified unspecified  
18 ם ם ביוצרם possessive masculine plural unspecified 3 unspecified 0 	O	null
19 ספרות ספרות ספרות noun feminine singular absolute unspecified unspecified  	O	null
20 ריאליסטית ריאליסטי ריאליסטית adjective feminine singular absolute unspecified unspecified  	O	null
21 הצליחו הצליח הצליחו verb masculine-and-feminine plural unspecified 3 past  	O	null
22 לתאר תיאר לתאר verb unspecified unspecified unspecified unspecified infinitive  	O	null
23 את את את at-preposition unspecified unspecified unspecified unspecified unspecified  	O	null
24 ה ה המציאות definiteArticle unspecified unspecified unspecified unspecified unspecified 0 
24 המציאות מציאות המציאות noun feminine singular absolute unspecified unspecified  	O	null
25 ה ה המתהווה definiteArticle unspecified unspecified unspecified unspecified unspecified 0 
25 המתהווה התהווה המתהווה participle feminine singular absolute any unspecified  	O	null
26 ב ב בארץ preposition unspecified unspecified unspecified unspecified unspecified 0 
26 ארץ ארץ בארץ noun feminine singular construct unspecified unspecified  	I_LOC	null
27 ישראל ישראל ישראל properName unspecified unspecified unspecified unspecified unspecified  	I_LOC	null
28 ו ו ופיתחו conjunction unspecified unspecified unspecified unspecified unspecified 0 
28 פיתחו פיתח ופיתחו verb masculine-and-feminine plural unspecified 3 past  	O	null
29 סגנון סגנון סגנון noun masculine singular absolute unspecified unspecified  	O	null
30 חופשי חופשי חופשי adjective masculine singular absolute unspecified unspecified  	O	null
31 ה ה המרחיב definiteArticle unspecified unspecified unspecified unspecified unspecified 0 
31 המרחיב הרחיב המרחיב participle masculine singular absolute any unspecified  	O	null
32 את את את at-preposition unspecified unspecified unspecified unspecified unspecified  	O	null
33 שדה שדה שדה noun masculine singular construct unspecified unspecified  	O	null
34 ה ה הלשון definiteArticle unspecified unspecified unspecified unspecified unspecified 0 
34 הלשון לשון הלשון noun feminine singular absolute unspecified unspecified  	O	null
35 ה ה העברית definiteArticle unspecified unspecified unspecified unspecified unspecified 0 
35 העברית עברי העברית adjective feminine singular absolute unspecified unspecified  	O	null
36 . . . punctuation unspecified unspecified unspecified unspecified unspecified  	O	null

0 עם עם עם preposition unspecified unspecified unspecified unspecified unspecified  	O	null
1 יוצרי יוצר יוצרי noun masculine plural construct unspecified unspecified  	O	null
2 דור דור דור properName unspecified unspecified unspecified unspecified unspecified  	I_PERS	null
3 תש"ח תש"ח תש"ח properName unspecified unspecified unspecified unspecified unspecified  	I_PERS	null
4 ש ש שעליהם relativizer/subordinatingConjunction unspecified unspecified unspecified unspecified unspecified 0 
4 על על שעליהם preposition unspecified unspecified unspecified unspecified unspecified  
4 הם הם שעליהם pronomial masculine plural unspecified 3 unspecified 0 	O	null
5 כתב כתב כתב verb masculine singular unspecified 3 past  	O	null
6 נמנים נמנה נמנים verb masculine plural unspecified any beinoni  	O	null
7 ס' ס' ס' properName unspecified unspecified unspecified unspecified unspecified  	I_PERS	null
8 יזהר יזהר יזהר properName unspecified unspecified unspecified unspecified unspecified  	I_PERS	null
9 , , , punctuation unspecified unspecified unspecified unspecified unspecified  	O	null
10 משה משה משה properName unspecified unspecified unspecified unspecified unspecified  	I_PERS	null
11 שמיר שמיר שמיר properName unspecified unspecified unspecified unspecified unspecified  	I_PERS	null
12 , , , punctuation unspecified unspecified unspecified unspecified unspecified  	O	null
13 יהודית יהודי יהודית adjective feminine singular absolute unspecified unspecified  	O	null
14 ה ה הנדל definiteArticle unspecified unspecified unspecified unspecified unspecified 0 
14 הנדל נדל הנדל noun masculine singular absolute unspecified unspecified  	O	null
15 ו ו ויגאל conjunction unspecified unspecified unspecified unspecified unspecified 0 
15 יגאל יגאל ויגאל properName unspecified unspecified unspecified unspecified unspecified  	I_PERS	null
16 מוסינזון מוסינזון מוסינזון properName unspecified unspecified unspecified unspecified unspecified  	I_PERS	null
17 . . . punctuation unspecified unspecified unspecified unspecified unspecified  	O	null

0 ב ב בספרו preposition unspecified unspecified unspecified unspecified unspecified 0 
0 ספר ספר בספרו noun masculine singular absolute unspecified unspecified  
0 ו ו בספרו possessive masculine singular unspecified 3 unspecified 0 	O	null
1 פנים פנים פנים noun masculine singular absolute unspecified unspecified  	O	null
2 ו ו ואופן conjunction unspecified unspecified unspecified unspecified unspecified 0 
2 אופן אופן ואופן noun masculine singular absolute unspecified unspecified  	O	null
3 ( ( ( punctuation unspecified unspecified unspecified unspecified unspecified  	O	null
4 ###NUMBER### ###NUMBER### ###NUMBER### numeral unspecified unspecified unspecified unspecified unspecified  	I_DATE	null
5 ) ) ) punctuation unspecified unspecified unspecified unspecified unspecified  	O	null
6 כינס כינס כינס verb masculine singular unspecified 3 past  	O	null
7 מאמרי מאמר מאמרי noun masculine plural construct unspecified unspecified  	O	null
8 ביקורת ביקורת ביקורת noun feminine singular absolute unspecified unspecified  	O	null
9 על על על preposition unspecified unspecified unspecified unspecified unspecified  	O	null
10 משוררים משורר משוררים noun masculine plural absolute unspecified unspecified  	O	null
11 צעירים צעיר צעירים adjective masculine plural absolute unspecified unspecified  	O	null
12 יותר יותר יותר adverb unspecified unspecified unspecified unspecified unspecified  	O	null
13 , , , punctuation unspecified unspecified unspecified unspecified unspecified  	O	null
14 ב ב בהם preposition unspecified unspecified unspecified unspecified unspecified  
14 הם הם בהם pronomial masculine plural unspecified 3 unspecified 0 	O	null
15 נתן נתן נתן verb masculine singular unspecified 3 past  	O	null
16 זך זך זך adjective masculine singular absolute unspecified unspecified  	O	null
17 , , , punctuation unspecified unspecified unspecified unspecified unspecified  	O	null
18 יהודה יהודה יהודה properName unspecified unspecified unspecified unspecified unspecified  	I_PERS	null
19 עמיחי עמיחי עמיחי properName unspecified unspecified unspecified unspecified unspecified  	I_PERS	null
20 ו ו ודן conjunction unspecified unspecified unspecified unspecified unspecified 0 
20 דן דן ודן properName unspecified unspecified unspecified unspecified unspecified  	I_PERS	null
21 פגי פגי פגיס noun masculine plural absolute unspecified unspecified  
21 י י פגיס possessive masculine-and-feminine singular unspecified 1 unspecified 0 	O	null
22 . . . punctuation unspecified unspecified unspecified unspecified unspecified  	O	null

0 ב ב בספרו preposition unspecified unspecified unspecified unspecified unspecified 0 
0 ספר ספר בספרו noun masculine singular absolute unspecified unspecified  
0 ו ו בספרו possessive masculine singular unspecified 3 unspecified 0 	O	null
1 על על על preposition unspecified unspecified unspecified unspecified unspecified  	O	null
2 ביקורת ביקורת ביקורת noun feminine singular absolute unspecified unspecified  	O	null
3 ו ו ומבקרים conjunction unspecified unspecified unspecified unspecified unspecified 0 
3 מבקרים מבקר ומבקרים noun masculine plural absolute unspecified unspecified  	O	null
4 ( ( ( punctuation unspecified unspecified unspecified unspecified unspecified  	O	null
5 ###NUMBER### ###NUMBER### ###NUMBER### numeral unspecified unspecified unspecified unspecified unspecified  	I_DATE	null
6 ) ) ) punctuation unspecified unspecified unspecified unspecified unspecified  	O	null
7 נאספו נאסף נאספו verb masculine-and-feminine plural unspecified 3 past  	O	null
8 מסות מסה מסות noun feminine plural absolute unspecified unspecified  	O	null
9 שונות שונה שונות adjective feminine plural absolute unspecified unspecified  	O	null
10 על על על preposition unspecified unspecified unspecified unspecified unspecified  	O	null
11 תולדות תולדה תולדות noun feminine plural construct unspecified unspecified  	O	null
12 ה ה הביקורת definiteArticle unspecified unspecified unspecified unspecified unspecified 0 
12 הביקורת ביקורת הביקורת noun feminine singular absolute unspecified unspecified  	O	null
13 ה ה העברית definiteArticle unspecified unspecified unspecified unspecified unspecified 0 
13 העברית עברי העברית adjective feminine singular absolute unspecified unspecified  	O	null
14 . . . punctuation unspecified unspecified unspecified unspecified unspecified  	O	null

0 ב ב בספר preposition unspecified unspecified unspecified unspecified unspecified 0 
0 ה ה בספר definiteArticle unspecified unspecified unspecified unspecified unspecified 0 
0 הספר ספר בספר noun masculine singular absolute unspecified unspecified  	O	null
1 נפרשת נפרש נפרשת verb feminine singular unspecified any beinoni  	O	null
2 גלריה גלריה גלריה noun feminine singular absolute unspecified unspecified  	O	null
3 רחבה רחב רחבה adjective feminine singular absolute unspecified unspecified  	O	null
4 של של של shel-preposition unspecified unspecified unspecified unspecified unspecified  	O	null
5 מבקרים מבקר מבקרים noun masculine plural absolute unspecified unspecified  	O	null
6 עבריים עברי עבריים adjective masculine plural absolute unspecified unspecified  	O	null
7 , , , punctuation unspecified unspecified unspecified unspecified unspecified  	O	null
8 מ מ מאברהם preposition unspecified unspecified unspecified unspecified unspecified 0 
8 אברהם אברהם מאברהם properName unspecified unspecified unspecified unspecified unspecified  	I_PERS	null
9 אורי אורי אורי properName unspecified unspecified unspecified unspecified unspecified  	I_PERS	null
10 קובנר קובנר קובנר properName unspecified unspecified unspecified unspecified unspecified  	I_PERS	null
11 ו ו ועד conjunction unspecified unspecified unspecified unspecified unspecified 0 
11 עד עד ועד preposition unspecified unspecified unspecified unspecified unspecified  	O	null
12 שמעון שמעון שמעון properName unspecified unspecified unspecified unspecified unspecified  	I_PERS	null
13 הלקין הלקין הלקין properName unspecified unspecified unspecified unspecified unspecified  	I_PERS	null
14 . . . punctuation unspecified unspecified unspecified unspecified unspecified  	O	null

0 ב ב במסתו preposition unspecified unspecified unspecified unspecified unspecified 0 
0 מסת מסה במסתו noun feminine singular absolute unspecified unspecified  
0 ו ו במסתו possessive masculine singular unspecified 3 unspecified 0 	O	null
1 " " " punctuation unspecified unspecified unspecified unspecified unspecified  	O	null
2 נתיבות נתיבות נתיבות properName unspecified unspecified unspecified unspecified unspecified  	I_LOC	null
3 ב ב בביקורת preposition unspecified unspecified unspecified unspecified unspecified 0 
3 ה ה בביקורת definiteArticle unspecified unspecified unspecified unspecified unspecified 0 
3 הביקורת ביקורת בביקורת noun feminine singular absolute unspecified unspecified  	O	null
4 ה ה העברית definiteArticle unspecified unspecified unspecified unspecified unspecified 0 
4 העברית עברי העברית adjective feminine singular absolute unspecified unspecified  	O	null
5 " " " punctuation unspecified unspecified unspecified unspecified unspecified  	O	null
6 אפיין אפיין אפיין verb masculine singular unspecified 3 past  	O	null
7 סוגי סוג סוגי noun masculine plural construct unspecified unspecified  	O	null
8 ביקורת ביקורת ביקורת noun feminine singular absolute unspecified unspecified  	O	null
9 שונים שונה שונים adjective masculine plural absolute unspecified unspecified  	O	null
10 ו ו ושיבץ conjunction unspecified unspecified unspecified unspecified unspecified 0 
10 שיבץ שיבץ ושיבץ verb masculine singular unspecified 3 past  	O	null
11 את את את at-preposition unspecified unspecified unspecified unspecified unspecified  	O	null
12 ה ה המבקרים definiteArticle unspecified unspecified unspecified unspecified unspecified 0 
12 המבקרים מבקר המבקרים noun masculine plural absolute unspecified unspecified  	O	null
13 ב ב בקטגוריות preposition unspecified unspecified unspecified unspecified unspecified 0 
13 קטגוריות קטגוריה בקטגוריות noun feminine plural absolute unspecified unspecified  	O	null
14 ש ש שיצר relativizer/subordinatingConjunction unspecified unspecified unspecified unspecified unspecified 0 
14 יצר יצר שיצר verb masculine singular unspecified 3 past  	O	null
15 . . . punctuation unspecified unspecified unspecified unspecified unspecified  	O	null

0 בין בין בין preposition unspecified unspecified unspecified unspecified unspecified  	O	null
1 ה ה השאר definiteArticle unspecified unspecified unspecified unspecified unspecified 0 
1 השאר שאר השאר noun masculine singular absolute unspecified unspecified  	O	null
2 מנה מנה מנה verb masculine singular unspecified 3 past  	O	null
3 את את את at-preposition unspecified unspecified unspecified unspecified unspecified  	O	null
4 ה ה הביקורת definiteArticle unspecified unspecified unspecified unspecified unspecified 0 
4 הביקורת ביקורת הביקורת noun feminine singular absolute unspecified unspecified  	O	null
5 ה ה הרעיונית definiteArticle unspecified unspecified unspecified unspecified unspecified 0 
5 הרעיונית רעיוני הרעיונית adjective feminine singular absolute unspecified unspecified  	O	null
6 - - - punctuation unspecified unspecified unspecified unspecified unspecified  	O	null
7 לאומית לאומי לאומית adjective feminine singular absolute unspecified unspecified  	O	null
8 , , , punctuation unspecified unspecified unspecified unspecified unspecified  	O	null
9 את את את at-preposition unspecified unspecified unspecified unspecified unspecified  	O	null
10 ה ה הביקורת definiteArticle unspecified unspecified unspecified unspecified unspecified 0 
10 הביקורת ביקורת הביקורת noun feminine singular absolute unspecified unspecified  	O	null
11 ה ה האימפרסיוניסטית definiteArticle unspecified unspecified unspecified unspecified unspecified 0 
11 האימפרסיוניסטית אימפרסיוניסטי האימפרסיוניסטית adjective feminine singular absolute unspecified unspecified  	O	null
12 ו ו ואת conjunction unspecified unspecified unspecified unspecified unspecified 0 
12 את את ואת at-preposition unspecified unspecified unspecified unspecified unspecified  	O	null
13 ה ה הביקורת definiteArticle unspecified unspecified unspecified unspecified unspecified 0 
13 הביקורת ביקורת הביקורת noun feminine singular absolute unspecified unspecified  	O	null
14 ה ה האידיאולוגית definiteArticle unspecified unspecified unspecified unspecified unspecified 0 
14 האידיאולוגית אידיאולוגי האידיאולוגית adjective feminine singular absolute unspecified unspecified  	O	null
15 . . . punctuation unspecified unspecified unspecified unspecified unspecified  	O	null

0 ספר ספר ספר noun masculine singular absolute unspecified unspecified  	O	null
1 חשוב חשוב חשוב adjective masculine singular absolute unspecified unspecified  	O	null
2 נוסף נוסף נוסף adjective masculine singular absolute unspecified unspecified  	O	null
3 פרי פרי פרי noun masculine singular construct unspecified unspecified  	O	null
4 עט עט עטו noun masculine singular absolute unspecified unspecified  
4 ו ו עטו possessive masculine singular unspecified 3 unspecified 0 	O	null
5 הוא הוא הוא pronoun masculine singular unspecified 3 unspecified  	O	null
6 ריאליזם ריאליזם ריאליזם noun masculine singular absolute unspecified unspecified  	O	null
7 ו ו ושבירתו conjunction unspecified unspecified unspecified unspecified unspecified 0 
7 שבירת שבירה ושבירתו noun feminine singular absolute unspecified unspecified  
7 ו ו ושבירתו possessive masculine singular unspecified 3 unspecified 0 	O	null
8 : : : punctuation unspecified unspecified unspecified unspecified unspecified  	O	null
9 מ מ מסַפּרים preposition unspecified unspecified unspecified unspecified unspecified 0 
9 סַפּרים סַפּרים מסַפּרים adjective masculine singular construct unspecified unspecified  	O	null
10 עבריים עברי עבריים adjective masculine plural absolute unspecified unspecified  	O	null
11 מ מ מגנסין preposition unspecified unspecified unspecified unspecified unspecified 0 
11 גנסין גנסין מגנסין properName unspecified unspecified unspecified unspecified unspecified  	I_ORG	null
12 עדאפלפלד עדאפלפלד עדאפלפלד properName unspecified unspecified unspecified unspecified unspecified  	I_ORG	null
13 ) ) ) punctuation unspecified unspecified unspecified unspecified unspecified  	O	null
14 . . . punctuation unspecified unspecified unspecified unspecified unspecified  	O	null
15 ###NUMBER### ###NUMBER### ###NUMBER### numeral unspecified unspecified unspecified unspecified unspecified  	I_DATE	null
16 ה ה הספר definiteArticle unspecified unspecified unspecified unspecified unspecified 0 
16 הספר ספר הספר noun masculine singular absolute unspecified unspecified  	O	null
17 בוחן בחן בוחן verb masculine singular unspecified any beinoni  	O	null
18 יצירות יצירה יצירות noun feminine plural absolute unspecified unspecified  	O	null
19 ה ה המעוגנות definiteArticle unspecified unspecified unspecified unspecified unspecified 0 
19 המעוגנות עוגן המעוגנות participle feminine plural absolute any unspecified  	O	null
20 ב ב במסורת preposition unspecified unspecified unspecified unspecified unspecified 0 
20 ה ה במסורת definiteArticle unspecified unspecified unspecified unspecified unspecified 0 
20 המסורת מסורת במסורת noun feminine singular absolute unspecified unspecified  	O	null
21 ה ה הריאליסטית definiteArticle unspecified unspecified unspecified unspecified unspecified 0 
21 הריאליסטית ריאליסטי הריאליסטית adjective feminine singular absolute unspecified unspecified  	O	null
22 אך אך אך conjunction unspecified unspecified unspecified unspecified unspecified  	O	null
23 גם גם גם conjunction unspecified unspecified unspecified unspecified unspecified  	O	null
24 חורגות חרג חורגות verb feminine plural unspecified any beinoni  	O	null
25 מן מן ממנה preposition unspecified unspecified unspecified unspecified unspecified  
25 ה ה ממנה pronomial feminine singular unspecified 3 unspecified 0 	O	null
26 , , , punctuation unspecified unspecified unspecified unspecified unspecified  	O	null
27 כל כול כל quantifier unspecified unspecified construct unspecified unspecified  	O	null
28 יוצר יוצר יוצר noun masculine singular absolute unspecified unspecified  	O	null
29 עלפי עילף עלפי verb feminine singular unspecified 2 imperative  	O	null
30 אופי אופה אופיו noun masculine plural absolute unspecified unspecified  
30 ו ו אופיו possessive masculine singular unspecified 3 unspecified 0 	O	null
31 ו ו וכישוריו conjunction unspecified unspecified unspecified unspecified unspecified 0 
31 כישורי כישור וכישוריו noun masculine plural absolute unspecified unspecified  
31 ו ו וכישוריו possessive masculine singular unspecified 3 unspecified 0 	O	null
32 . . . punctuation unspecified unspecified unspecified unspecified unspecified  	O	null

0 חשיבות חשיבות חשיבותו noun feminine singular absolute unspecified unspecified  
0 ו ו חשיבותו possessive masculine singular unspecified 3 unspecified 0 	O	null
1 של של של shel-preposition unspecified unspecified unspecified unspecified unspecified  	O	null
2 ה ה הספר definiteArticle unspecified unspecified unspecified unspecified unspecified 0 
2 הספר ספר הספר noun masculine singular absolute unspecified unspecified  	O	null
3 נובעת נבע נובעת verb feminine singular unspecified any beinoni  	O	null
4 , , , punctuation unspecified unspecified unspecified unspecified unspecified  	O	null
5 בין בין בין preposition unspecified unspecified unspecified unspecified unspecified  	O	null
6 ה ה השאר definiteArticle unspecified unspecified unspecified unspecified unspecified 0 
6 השאר שאר השאר noun masculine singular absolute unspecified unspecified  	O	null
7 , , , punctuation unspecified unspecified unspecified unspecified unspecified  	O	null
8 מן מן מן preposition unspecified unspecified unspecified unspecified unspecified  	O	null
9 ה ה ההבחנה definiteArticle unspecified unspecified unspecified unspecified unspecified 0 
9 ההבחנה הבחנה ההבחנה noun feminine singular absolute unspecified unspecified  	O	null
10 ה ה העקרונית definiteArticle unspecified unspecified unspecified unspecified unspecified 0 
10 העקרונית עקרוני העקרונית adjective feminine singular absolute unspecified unspecified  	O	null
11 ה ה העולה definiteArticle unspecified unspecified unspecified unspecified unspecified 0 
11 העולה עלה העולה participle feminine singular absolute any unspecified  	O	null
12 מן מן ממנו preposition unspecified unspecified unspecified unspecified unspecified  
12 ו ו ממנו pronomial masculine singular unspecified 3 unspecified 0 	O	null
13 ה ה המעמידה definiteArticle unspecified unspecified unspecified unspecified unspecified 0 
13 המעמידה העמיד המעמידה participle feminine singular absolute any unspecified  	O	null
14 מסורת מסורת מסורת noun feminine singular absolute unspecified unspecified  	O	null
15 של של של shel-preposition unspecified unspecified unspecified unspecified unspecified  	O	null
16 כתיבה כתיבה כתיבה noun feminine singular absolute unspecified unspecified  	O	null
17 מטא מטא מטא preposition unspecified unspecified unspecified unspecified unspecified  	O	null
18 - - - punctuation unspecified unspecified unspecified unspecified unspecified  	O	null
19 ריאליסטית ריאליסטי ריאליסטית adjective feminine singular absolute unspecified unspecified  	O	null
20 ו/או ו/או ו/או adverb unspecified unspecified unspecified unspecified unspecified  	O	null
21 היפר היפר היפר preposition unspecified unspecified unspecified unspecified unspecified  	O	null
22 - - - punctuation unspecified unspecified unspecified unspecified unspecified  	O	null
23 ריאליסטית ריאליסטי ריאליסטית adjective feminine singular absolute unspecified unspecified  	O	null
24 ב ב בספרות preposition unspecified unspecified unspecified unspecified unspecified 0 
24 ה ה בספרות definiteArticle unspecified unspecified unspecified unspecified unspecified 0 
24 הספרות ספרות בספרות noun feminine singular absolute unspecified unspecified  	O	null
25 ה ה העברית definiteArticle unspecified unspecified unspecified unspecified unspecified 0 
25 העברית עברי העברית adjective feminine singular absolute unspecified unspecified  	O	null
26 . . . punctuation unspecified unspecified unspecified unspecified unspecified  	O	null

0 ב ב בספר preposition unspecified unspecified unspecified unspecified unspecified 0 
0 ספר ספר בספר noun masculine singular construct unspecified unspecified  	O	null
1 כלולות כלולות כלולות noun feminine plural absolute unspecified unspecified  	O	null
2 הבחנות הבחנה הבחנות noun feminine plural absolute unspecified unspecified  	O	null
3 חשובות חשוב חשובות adjective feminine plural absolute unspecified unspecified  	O	null
4 ש ש שהורחבו relativizer/subordinatingConjunction unspecified unspecified unspecified unspecified unspecified 0 
4 הורחבו הורחב שהורחבו verb masculine-and-feminine plural unspecified 3 past  	O	null
5 ו ו ופותחו conjunction unspecified unspecified unspecified unspecified unspecified 0 
5 פותחו פותח ופותחו verb masculine-and-feminine plural unspecified 3 past  	O	null
6 על על על preposition unspecified unspecified unspecified unspecified unspecified  	O	null
7 ידי יד ידי noun feminine plural construct unspecified unspecified  	O	null
8 מבקרים מבקר מבקרים noun masculine plural absolute unspecified unspecified  	O	null
9 ו ו וחוקרים conjunction unspecified unspecified unspecified unspecified unspecified 0 
9 חוקרים חוקר וחוקרים noun masculine plural absolute unspecified unspecified  	O	null
10 ש ש שבאו relativizer/subordinatingConjunction unspecified unspecified unspecified unspecified unspecified 0 
10 באו בא שבאו verb masculine-and-feminine plural unspecified 3 past  	O	null
11 אחרי אחרי אחריו preposition unspecified unspecified unspecified unspecified unspecified  
11 ו ו אחריו pronomial masculine singular unspecified 3 unspecified 0 	O	null
12 . . . punctuation unspecified unspecified unspecified unspecified unspecified  	O	null

0 ב ב במסות preposition unspecified unspecified unspecified unspecified unspecified 0 
0 מסות מסה במסות noun feminine plural construct unspecified unspecified  	O	null
1 ה ה הדיוקן definiteArticle unspecified unspecified unspecified unspecified unspecified 0 
1 הדיוקן דיוקן הדיוקן noun masculine singular absolute unspecified unspecified  	O	null
2 של של שלו shel-preposition unspecified unspecified unspecified unspecified unspecified  
2 ו ו שלו pronomial masculine singular unspecified 3 unspecified 0 	O	null
3 שירטט שרטט שירטט verb masculine singular unspecified 3 past  	O	null
4 דמויות דמות דמויות noun feminine plural absolute unspecified unspecified  	O	null
5 של של של shel-preposition unspecified unspecified unspecified unspecified unspecified  	O	null
6 מספר מספר מספר noun masculine singular absolute unspecified unspecified  	O	null
7 , , , punctuation unspecified unspecified unspecified unspecified unspecified  	O	null
8 מבקר ביקר מבקר verb masculine singular unspecified any beinoni  	O	null
9 או או או conjunction unspecified unspecified unspecified unspecified unspecified  	O	null
10 משורר משורר משורר noun masculine singular absolute unspecified unspecified  	O	null
11 ו ו וניסה conjunction unspecified unspecified unspecified unspecified unspecified 0 
11 ניסה ניסה וניסה verb masculine singular unspecified 3 past  	O	null
12 להגיע הגיע להגיע verb unspecified unspecified unspecified unspecified infinitive  	O	null
13 ל ל לידי preposition unspecified unspecified unspecified unspecified unspecified 0 
13 ידי יד לידי noun feminine plural construct unspecified unspecified  	O	null
14 היכרות היכרות היכרות noun feminine singular absolute unspecified unspecified  	O	null
15 עם עם עם preposition unspecified unspecified unspecified unspecified unspecified  	O	null
16 ה ה האישיות definiteArticle unspecified unspecified unspecified unspecified unspecified 0 
16 האישיות אישיות האישיות noun feminine singular absolute unspecified unspecified  	O	null
17 ה ה הספרותית definiteArticle unspecified unspecified unspecified unspecified unspecified 0 
17 הספרותית ספרותי הספרותית adjective feminine singular absolute unspecified unspecified  	O	null
18 , , , punctuation unspecified unspecified unspecified unspecified unspecified  	O	null
19 ו ו וכך conjunction unspecified unspecified unspecified unspecified unspecified 0 
19 כך כך וכך adverb unspecified unspecified unspecified unspecified unspecified  	I_ORG	null
20 לעמוד עמד לעמוד verb unspecified unspecified unspecified unspecified infinitive  	O	null
21 על על על preposition unspecified unspecified unspecified unspecified unspecified  	O	null
22 טבע טבע טבעו noun masculine singular absolute unspecified unspecified  
22 ו ו טבעו possessive masculine singular unspecified 3 unspecified 0 	O	null
23 של של של shel-preposition unspecified unspecified unspecified unspecified unspecified  	O	null
24 ה ה היוצר definiteArticle unspecified unspecified unspecified unspecified unspecified 0 
24 היוצר יוצר היוצר noun masculine singular absolute unspecified unspecified  	O	null
25 ו ו ועל conjunction unspecified unspecified unspecified unspecified unspecified 0 
25 על על ועל preposition unspecified unspecified unspecified unspecified unspecified  	O	null
26 טיב טיב טיבה noun masculine singular absolute unspecified unspecified  
26 ה ה טיבה possessive feminine singular unspecified 3 unspecified 0 	O	null
27 של של של shel-preposition unspecified unspecified unspecified unspecified unspecified  	O	null
28 יצירת יצירה יצירתו noun feminine singular absolute unspecified unspecified  
28 ו ו יצירתו possessive masculine singular unspecified 3 unspecified 0 	O	null
29 . . . punctuation unspecified unspecified unspecified unspecified unspecified  	O	null

0 הוא הוא הוא pronoun masculine singular unspecified 3 unspecified  	O	null
1 סבר סבר סבר verb masculine singular unspecified 3 past  	O	null
2 כי כי כי conjunction unspecified unspecified unspecified unspecified unspecified  	O	null
3 ל ל לחיי preposition unspecified unspecified unspecified unspecified unspecified 0 
3 חיי חיים לחיי noun masculine plural construct unspecified unspecified  	O	null
4 ה ה היוצר definiteArticle unspecified unspecified unspecified unspecified unspecified 0 
4 היוצר יוצר היוצר noun masculine singular absolute unspecified unspecified  	O	null
5 נודעת נודע נודעת verb feminine singular unspecified any beinoni  	O	null
6 חשיבות חשיבות חשיבות noun feminine singular absolute unspecified unspecified  	O	null
7 רבה רב רבה adjective feminine singular absolute unspecified unspecified  	O	null
8 ב ב בהבנת preposition unspecified unspecified unspecified unspecified unspecified 0 
8 הבנת הבנה בהבנת noun feminine singular construct unspecified unspecified  	O	null
9 יצירת יצירה יצירתו noun feminine singular absolute unspecified unspecified  
9 ו ו יצירתו possessive masculine singular unspecified 3 unspecified 0 	O	null
10 , , , punctuation unspecified unspecified unspecified unspecified unspecified  	O	null
11 ו ו ולכן conjunction unspecified unspecified unspecified unspecified unspecified 0 
11 לכן לכן ולכן conjunction unspecified unspecified unspecified unspecified unspecified  	O	null
12 הקדים הקדים הקדים verb masculine singular unspecified 3 past  	O	null
13 ל ל למאמרים preposition unspecified unspecified unspecified unspecified unspecified 0 
13 מאמרים מאמר למאמרים noun masculine plural absolute unspecified unspecified  	O	null
14 רבים רב רבים adjective masculine plural absolute unspecified unspecified  	O	null
15 סקירה סקירה סקירה noun feminine singular absolute unspecified unspecified  	O	null
16 תמציתית תמציתי תמציתית adjective feminine singular absolute unspecified unspecified  	O	null
17 של של של shel-preposition unspecified unspecified unspecified unspecified unspecified  	O	null
18 חיי חיים חיי noun masculine plural construct unspecified unspecified  	O	null
19 ה ה הדמות definiteArticle unspecified unspecified unspecified unspecified unspecified 0 
19 הדמות דמות הדמות noun feminine singular absolute unspecified unspecified  	O	null
20 ה ה הנדונה definiteArticle unspecified unspecified unspecified unspecified unspecified 0 
20 הנדונה נדון הנדונה participle feminine singular absolute any unspecified  	O	null
21 . . . punctuation unspecified unspecified unspecified unspecified unspecified  	O	null

0 הוא הוא הוא pronoun masculine singular unspecified 3 unspecified  	O	null
1 נהג נהג נהג verb masculine singular unspecified 3 past  	O	null
2 לשלב שילב לשלב verb unspecified unspecified unspecified unspecified infinitive  	O	null
3 ב ב במסות preposition unspecified unspecified unspecified unspecified unspecified 0 
3 מסות מסה במסות noun feminine plural construct unspecified unspecified  	O	null
4 ה ה הביקורת definiteArticle unspecified unspecified unspecified unspecified unspecified 0 
4 הביקורת ביקורת הביקורת noun feminine singular absolute unspecified unspecified  	O	null
5 של של שלו shel-preposition unspecified unspecified unspecified unspecified unspecified  
5 ו ו שלו pronomial masculine singular unspecified 3 unspecified 0 	O	null
6 גם גם גם conjunction unspecified unspecified unspecified unspecified unspecified  	O	null
7 רשמים רושם רשמים noun masculine plural absolute unspecified unspecified  	O	null
8 אישיים אישי אישיים adjective masculine plural absolute unspecified unspecified  	O	null
9 ו ו וזיכרונות conjunction unspecified unspecified unspecified unspecified unspecified 0 
9 זיכרונות זיכרון וזיכרונות noun masculine plural absolute unspecified unspecified  	O	null
10 , , , punctuation unspecified unspecified unspecified unspecified unspecified  	O	null
11 כך כך כך pronoun unspecified unspecified unspecified unspecified unspecified  	O	null
12 למשל למשל למשל conjunction unspecified unspecified unspecified unspecified unspecified  	O	null
13 ב ב במסה preposition unspecified unspecified unspecified unspecified unspecified 0 
13 מסה מסה במסה noun feminine singular absolute unspecified unspecified  	O	null
14 על על על preposition unspecified unspecified unspecified unspecified unspecified  	O	null
15 פיכמן פיכמן פיכמן properName unspecified unspecified unspecified unspecified unspecified  	I_PERS	null
16 סיפר סיפר סיפר verb masculine singular unspecified 3 past  	O	null
17 על על על preposition unspecified unspecified unspecified unspecified unspecified  	O	null
18 פגישה פגישה פגישה noun feminine singular absolute unspecified unspecified  	O	null
19 עם עם עמו preposition unspecified unspecified unspecified unspecified unspecified  
19 ו ו עמו pronomial masculine singular unspecified 3 unspecified 0 	O	null
20 ב ב בשדרות preposition unspecified unspecified unspecified unspecified unspecified 0 
20 שדרות שדרה בשדרות noun feminine plural absolute unspecified unspecified  	I_LOC	null
21 ח"ן ח"ן ח"ן properName unspecified unspecified unspecified unspecified unspecified  	I_LOC	null
22 ב ב בתל preposition unspecified unspecified unspecified unspecified unspecified 0 
22 תל תל בתל properName unspecified unspecified unspecified unspecified unspecified  	I_LOC	null
23 אביב אביב אביב properName unspecified unspecified unspecified unspecified unspecified  	I_LOC	null
24 . . . punctuation unspecified unspecified unspecified unspecified unspecified  	O	null

0 ערך ערך ערך noun masculine singular construct unspecified unspecified  	O	null
1 כמה כמה כמה quantifier unspecified unspecified construct unspecified unspecified  	O	null
2 ספרים ספר ספרים noun masculine plural absolute unspecified unspecified  	O	null
3 , , , punctuation unspecified unspecified unspecified unspecified unspecified  	O	null
4 ב ב בהם preposition unspecified unspecified unspecified unspecified unspecified  
4 הם הם בהם pronomial masculine plural unspecified 3 unspecified 0 	O	null
5 : : : punctuation unspecified unspecified unspecified unspecified unspecified  	O	null
6 פרץ פרץ פרץ properName unspecified unspecified unspecified unspecified unspecified  	I_PERS	null
7 סמולנסקין סמולנסקין סמולנסקין properName unspecified unspecified unspecified unspecified unspecified  	I_PERS	null
8 : : : punctuation unspecified unspecified unspecified unspecified unspecified  	O	null
9 מבחר מבחר מבחר quantifier unspecified unspecified construct unspecified unspecified  	O	null
10 מאמרי מאמר מאמריו noun masculine plural absolute unspecified unspecified  
10 ו ו מאמריו possessive masculine singular unspecified 3 unspecified 0 	O	null
11 ( ( ( punctuation unspecified unspecified unspecified unspecified unspecified  	O	null
12 תש"ב תש"ב תש"ב properName unspecified unspecified unspecified unspecified unspecified  	I_ORG	null
13 ) ) ) punctuation unspecified unspecified unspecified unspecified unspecified  	O	null
14 ; ; ; punctuation unspecified unspecified unspecified unspecified unspecified  	O	null
15 ילקוט ילקוט ילקוט noun masculine singular construct unspecified unspecified  	O	null
16 מסות מסה מסות noun feminine plural absolute unspecified unspecified  	O	null
17 ל ל לדוד preposition unspecified unspecified unspecified unspecified unspecified 0 
17 דוד דוד לדוד properName unspecified unspecified unspecified unspecified unspecified  	I_PERS	null
18 פרישמן פרישמן פרישמן properName unspecified unspecified unspecified unspecified unspecified  	I_PERS	null
19 ( ( ( punctuation unspecified unspecified unspecified unspecified unspecified  	O	null
20 ליקט ליקט ליקט verb masculine singular unspecified 3 past  	O	null
21 ו ו והוסיף conjunction unspecified unspecified unspecified unspecified unspecified 0 
21 הוסיף הוסיף והוסיף verb masculine singular unspecified 3 past  	O	null
22 מ מ מבוא preposition unspecified unspecified unspecified unspecified unspecified 0 
22 בוא בוא מבוא noun masculine singular construct unspecified unspecified  	O	null
23 ו ו והסברים conjunction unspecified unspecified unspecified unspecified unspecified 0 
23 הסברים הסבר והסברים noun masculine plural absolute unspecified unspecified  	O	null
24 , , , punctuation unspecified unspecified unspecified unspecified unspecified  	O	null
25 ) ) ) punctuation unspecified unspecified unspecified unspecified unspecified  	O	null
26 ; ; ; punctuation unspecified unspecified unspecified unspecified unspecified  	O	null
27 ילקוט ילקוט ילקוט noun masculine singular absolute unspecified unspecified  	O	null
28 ###NUMBER### ###NUMBER### ###NUMBER### numeral unspecified unspecified unspecified unspecified unspecified  	I_DATE	null
29 סיפוריםלג' סיפוריםלג' סיפוריםלג' properName unspecified unspecified unspecified unspecified unspecified  	I_PERS	null
30 שופמן שופמן שופמן properName unspecified unspecified unspecified unspecified unspecified  	I_PERS	null
31 ) ) ) punctuation unspecified unspecified unspecified unspecified unspecified  	O	null
32 . . . punctuation unspecified unspecified unspecified unspecified unspecified  	O	null
33 ###NUMBER### ###NUMBER### ###NUMBER### numeral unspecified unspecified unspecified unspecified unspecified  	I_DATE	null
34 References References References foreign unspecified unspecified unspecified unspecified unspecified  	O	null
35 : : : punctuation unspecified unspecified unspecified unspecified unspecified  	O	null
36 ברזל ברזל ברזל noun masculine singular absolute unspecified unspecified  	O	null
37 , , , punctuation unspecified unspecified unspecified unspecified unspecified  	O	null
38 הלל הילל הלל properName unspecified unspecified unspecified unspecified unspecified  	I_PERS	null
39 . . . punctuation unspecified unspecified unspecified unspecified unspecified  	O	null

0 " " " punctuation unspecified unspecified unspecified unspecified unspecified  	O	null
1 ה ה המלווה definiteArticle unspecified unspecified unspecified unspecified unspecified 0 
1 המלווה מלווה המלווה noun masculine singular absolute unspecified unspecified  	O	null
2 ה ה הנאמן definiteArticle unspecified unspecified unspecified unspecified unspecified 0 
2 הנאמן נאמן הנאמן adjective masculine singular absolute unspecified unspecified  	O	null
3 : : : punctuation unspecified unspecified unspecified unspecified unspecified  	O	null
4 שלום שלום שלום noun masculine singular construct unspecified unspecified  	O	null
5 קרמר קרמר קרמר properName unspecified unspecified unspecified unspecified unspecified  	I_ORG	null
6 כמבקרספרות כמבקרספרות כמבקרספרות adjective feminine plural construct unspecified unspecified  	O	null
7 " " " punctuation unspecified unspecified unspecified unspecified unspecified  	O	null
8 . . . punctuation unspecified unspecified unspecified unspecified unspecified  	O	null
9 מאזניים מאזניים מאזניים noun masculine plural absolute unspecified unspecified  	O	null
10 מ"ט מ"ט מ"ט properName unspecified unspecified unspecified unspecified unspecified  	I_ORG	null
11 . . . punctuation unspecified unspecified unspecified unspecified unspecified  	O	null

0 ###NUMBER### ###NUMBER### ###NUMBER### numeral unspecified unspecified unspecified unspecified unspecified  	O	null
1 - - - punctuation unspecified unspecified unspecified unspecified unspecified  	O	null
2 ###NUMBER### ###NUMBER### ###NUMBER### numeral unspecified unspecified unspecified unspecified unspecified  	O	null
3 , , , punctuation unspecified unspecified unspecified unspecified unspecified  	O	null
4 ; ; ; punctuation unspecified unspecified unspecified unspecified unspecified  	O	null
5 ###NUMBER### ###NUMBER### ###NUMBER### numeral unspecified unspecified unspecified unspecified unspecified  	O	null
6 גולן גולן גולן properName unspecified unspecified unspecified unspecified unspecified  	I_LOC	null
7 , , , punctuation unspecified unspecified unspecified unspecified unspecified  	O	null
8 ארנה ארנה ארנה properName unspecified unspecified unspecified unspecified unspecified  	I_PERS	null
9 . . . punctuation unspecified unspecified unspecified unspecified unspecified  	O	null

0 " " " punctuation unspecified unspecified unspecified unspecified unspecified  	O	null
1 ריאליזם ריאליזם ריאליזם noun masculine singular absolute unspecified unspecified  	O	null
2 ו ו ושבירתו conjunction unspecified unspecified unspecified unspecified unspecified 0 
2 שבירת שבירה ושבירתו noun feminine singular absolute unspecified unspecified  
2 ו ו ושבירתו possessive masculine singular unspecified 3 unspecified 0 	O	null
3 " " " punctuation unspecified unspecified unspecified unspecified unspecified  	O	null
4 . . . punctuation unspecified unspecified unspecified unspecified unspecified  	O	null
5 מאזניים מאזניים מאזניים noun masculine plural absolute unspecified unspecified  	O	null
6 כ"ז כ"ז כ"ז noun masculine singular absolute unspecified unspecified  	O	null
7 ) ) ) punctuation unspecified unspecified unspecified unspecified unspecified  	O	null
8 . . . punctuation unspecified unspecified unspecified unspecified unspecified  	O	null
9 ###NUMBER### ###NUMBER### ###NUMBER### numeral unspecified unspecified unspecified unspecified unspecified  	O	null
10 ###NUMBER### ###NUMBER### ###NUMBER### numeral unspecified unspecified unspecified unspecified unspecified  	I_DATE	null
11 . . . punctuation unspecified unspecified unspecified unspecified unspecified  	O	null

0 - - - punctuation unspecified unspecified unspecified unspecified unspecified  	O	null
1 ###NUMBER### ###NUMBER### ###NUMBER### numeral unspecified unspecified unspecified unspecified unspecified  	O	null
2 ; ; ; punctuation unspecified unspecified unspecified unspecified unspecified  	O	null
3 ###NUMBER### ###NUMBER### ###NUMBER### numeral unspecified unspecified unspecified unspecified unspecified  	O	null
4 ליפשיץ ליפשיץ ליפשיץ properName unspecified unspecified unspecified unspecified unspecified  	I_PERS	null
5 , , , punctuation unspecified unspecified unspecified unspecified unspecified  	O	null
6 אריה אריה אריה properName unspecified unspecified unspecified unspecified unspecified  	I_PERS	null
7 . . . punctuation unspecified unspecified unspecified unspecified unspecified  	O	null

0 " " " punctuation unspecified unspecified unspecified unspecified unspecified  	O	null
1 דורות דור דורות noun masculine plural absolute unspecified unspecified  	O	null
2 אחרונים אחרון אחרונים adjective masculine plural absolute unspecified unspecified  	O	null
3 ו ו ודור conjunction unspecified unspecified unspecified unspecified unspecified 0 
3 דור דור ודור noun masculine singular construct unspecified unspecified  	O	null
4 - - - punctuation unspecified unspecified unspecified unspecified unspecified  	O	null
5 ביניים ביניים ביניים noun masculine singular absolute unspecified unspecified  	O	null
6 – – – punctuation unspecified unspecified unspecified unspecified unspecified  	O	null
7 שדה שדה שדה noun masculine singular construct unspecified unspecified  	O	null
8 ה ה הביקורת definiteArticle unspecified unspecified unspecified unspecified unspecified 0 
8 הביקורת ביקורת הביקורת noun feminine singular absolute unspecified unspecified  	O	null
9 ל ל לשלום preposition unspecified unspecified unspecified unspecified unspecified 0 
9 שלום שלום לשלום noun masculine singular construct unspecified unspecified  	O	null
10 קרמר קרמר קרמר properName unspecified unspecified unspecified unspecified unspecified  	O	null
11 " " " punctuation unspecified unspecified unspecified unspecified unspecified  	O	null
12 . . . punctuation unspecified unspecified unspecified unspecified unspecified  	O	null

0 מאזניים מאזניים מאזניים noun masculine plural absolute unspecified unspecified  	O	null
1 נ"ב נ"ב נ"ב properName unspecified unspecified unspecified unspecified unspecified  	I_PERS	null
2 . . . punctuation unspecified unspecified unspecified unspecified unspecified  	O	null

0 ###NUMBER### ###NUMBER### ###NUMBER### numeral unspecified unspecified unspecified unspecified unspecified  	O	null
1 - - - punctuation unspecified unspecified unspecified unspecified unspecified  	O	null
2 ###NUMBER### ###NUMBER### ###NUMBER### numeral unspecified unspecified unspecified unspecified unspecified  	O	null
3 ; ; ; punctuation unspecified unspecified unspecified unspecified unspecified  	O	null
4 תורן תורן תורן noun masculine singular absolute unspecified unspecified  	O	null
5 , , , punctuation unspecified unspecified unspecified unspecified unspecified  	O	null
6 חיים חיים חיים noun masculine plural absolute unspecified unspecified  	O	null
7 . . . punctuation unspecified unspecified unspecified unspecified unspecified  	O	null

0 " " " punctuation unspecified unspecified unspecified unspecified unspecified  	O	null
1 על על על preposition unspecified unspecified unspecified unspecified unspecified  	O	null
2 שלום שלום שלום noun masculine singular construct unspecified unspecified  	O	null
3 קרמר קרמר קרמר properName unspecified unspecified unspecified unspecified unspecified  	O	null
4 ז"ל ז"ל ז"ל title masculine-and-feminine singular-and-plural unspecified unspecified unspecified  	O	null
5 " " " punctuation unspecified unspecified unspecified unspecified unspecified  	O	null
6 . . . punctuation unspecified unspecified unspecified unspecified unspecified  	O	null

0 מאזנייםמ"ח מאזנייםמ"ח מאזנייםמ"ח properName unspecified unspecified unspecified unspecified unspecified  	I_PERS	null
1 . . . punctuation unspecified unspecified unspecified unspecified unspecified  	O	null

0 ###NUMBER### ###NUMBER### ###NUMBER### numeral unspecified unspecified unspecified unspecified unspecified  	O	null
1 - - - punctuation unspecified unspecified unspecified unspecified unspecified  	O	null
2 ###NUMBER### ###NUMBER### ###NUMBER### numeral unspecified unspecified unspecified unspecified unspecified  	O	null
3 . . . punctuation unspecified unspecified unspecified unspecified unspecified  	O	null

