0 Name Name Name foreign unspecified unspecified unspecified unspecified unspecified  	O	null
1 : : : punctuation unspecified unspecified unspecified unspecified unspecified  	O	null
2 רבינזון רבינזון רבינזון properName unspecified unspecified unspecified unspecified unspecified  	I_ORG	null
3 - - - punctuation unspecified unspecified unspecified unspecified unspecified  	O	null
4 ב ב בכרך preposition unspecified unspecified unspecified unspecified unspecified 0 
4 ה ה בכרך definiteArticle unspecified unspecified unspecified unspecified unspecified 0 
4 הכרך כרך בכרך noun masculine singular absolute unspecified unspecified  	O	null
5 , , , punctuation unspecified unspecified unspecified unspecified unspecified  	O	null
6 חדווה חדווה חדווה noun feminine singular absolute unspecified unspecified  	O	null
7 Birth Birth Birth foreign unspecified unspecified unspecified unspecified unspecified  	O	null
8 Year Year Year foreign unspecified unspecified unspecified unspecified unspecified  	O	null
9 : : : punctuation unspecified unspecified unspecified unspecified unspecified  	O	null
10 ###NUMBER### ###NUMBER### ###NUMBER### numeral unspecified unspecified unspecified unspecified unspecified  	I_DATE	null
11 Birth Birth Birth foreign unspecified unspecified unspecified unspecified unspecified  	O	null
12 Place Place Place foreign unspecified unspecified unspecified unspecified unspecified  	O	null
13 : : : punctuation unspecified unspecified unspecified unspecified unspecified  	O	null
14 רומניה רומני רומניה properName unspecified unspecified unspecified unspecified unspecified  	I_LOC	null
15 לשלימה לשלימה לשלימה properName unspecified unspecified unspecified unspecified unspecified  	I_LOC	null
16 ( ( ( punctuation unspecified unspecified unspecified unspecified unspecified  	O	null
17 ל ל לבית preposition unspecified unspecified unspecified unspecified unspecified 0 
17 בית בית לבית noun masculine singular construct unspecified unspecified  	O	null
18 Occupation Occupation Occupation foreign unspecified unspecified unspecified unspecified unspecified  	O	null
19 : : : punctuation unspecified unspecified unspecified unspecified unspecified  	O	null
20 משוררת משורר משוררת noun feminine singular absolute unspecified unspecified  	O	null
21 , , , punctuation unspecified unspecified unspecified unspecified unspecified  	O	null
22 סופרת סופר סופרת noun feminine singular absolute unspecified unspecified  	O	null
23 ו ו וחוקרת conjunction unspecified unspecified unspecified unspecified unspecified 0 
23 חוקרת חקר וחוקרת verb feminine singular unspecified any beinoni  	O	null
24 ספרות ספרות ספרות noun feminine singular construct unspecified unspecified  	O	null
25 Entry Entry Entry foreign unspecified unspecified unspecified unspecified unspecified  	O	null
26 writer writer writer foreign unspecified unspecified unspecified unspecified unspecified  	O	null
27 : : : punctuation unspecified unspecified unspecified unspecified unspecified  	O	null
28 מוריה מוריה מוריה properName unspecified unspecified unspecified unspecified unspecified  	I_PERS	null
29 דיין דיין דיין properName unspecified unspecified unspecified unspecified unspecified  	I_PERS	null
30 Entry Entry Entry foreign unspecified unspecified unspecified unspecified unspecified  	O	null
31 Value Value Value foreign unspecified unspecified unspecified unspecified unspecified  	O	null
32 : : : punctuation unspecified unspecified unspecified unspecified unspecified  	O	null
33 נולדה נולד נולדה verb feminine singular unspecified 3 past  	O	null
34 ב ב ברומניה preposition unspecified unspecified unspecified unspecified unspecified 0 
34 רומניה רומני ברומניה properName unspecified unspecified unspecified unspecified unspecified  	I_LOC	null
35 לשלימה לשלימה לשלימה verb feminine singular unspecified 2 imperative  	O	null
36 ( ( ( punctuation unspecified unspecified unspecified unspecified unspecified  	O	null
37 ל ל לבית preposition unspecified unspecified unspecified unspecified unspecified 0 
37 בית בית לבית noun masculine singular construct unspecified unspecified  	O	null
38 גרם גרם גרמן noun masculine singular absolute unspecified unspecified  
38 ן ן גרמן possessive feminine plural unspecified 3 unspecified 0 	O	null
39 ) ) ) punctuation unspecified unspecified unspecified unspecified unspecified  	O	null
40 ו ו ולמשורר conjunction unspecified unspecified unspecified unspecified unspecified 0 
40 ל ל ולמשורר preposition unspecified unspecified unspecified unspecified unspecified 0 
40 ה ה ולמשורר definiteArticle unspecified unspecified unspecified unspecified unspecified 0 
40 המשורר משורר ולמשורר noun masculine singular absolute unspecified unspecified  	O	null
41 חיים חיים חיים properName unspecified unspecified unspecified unspecified unspecified  	I_PERS	null
42 רבינזון רבינזון רבינזון properName unspecified unspecified unspecified unspecified unspecified  	I_PERS	null
43 . . . punctuation unspecified unspecified unspecified unspecified unspecified  	O	null

0 עלתה עלה עלתה verb feminine singular unspecified 3 past  	O	null
1 ארצה ארצה ארצה adverb unspecified unspecified unspecified unspecified unspecified  	O	null
2 עם עם עם preposition unspecified unspecified unspecified unspecified unspecified  	O	null
3 משפחת משפחה משפחתה noun feminine singular absolute unspecified unspecified  
3 ה ה משפחתה possessive feminine singular unspecified 3 unspecified 0 	O	null
4 ב ב ב preposition unspecified unspecified unspecified unspecified unspecified 0 	I_ORG	null
5 - - - punctuation unspecified unspecified unspecified unspecified unspecified  	I_ORG	null
6 ###NUMBER### ###NUMBER### ###NUMBER### numeral unspecified unspecified unspecified unspecified unspecified  	I_DATE	null
7 . . . punctuation unspecified unspecified unspecified unspecified unspecified  	O	null

0 נדדה נדד נדדה verb feminine singular unspecified 3 past  	O	null
1 בין בין בין preposition unspecified unspecified unspecified unspecified unspecified  	O	null
2 ארצות ארץ ארצות noun feminine plural construct unspecified unspecified  	O	null
3 ו ו ועיסוקים conjunction unspecified unspecified unspecified unspecified unspecified 0 
3 עיסוקים עיסוק ועיסוקים noun masculine plural absolute unspecified unspecified  	O	null
4 . . . punctuation unspecified unspecified unspecified unspecified unspecified  	O	null

0 בין בין בין preposition unspecified unspecified unspecified unspecified unspecified  	O	null
1 ה ה השאר definiteArticle unspecified unspecified unspecified unspecified unspecified 0 
1 השאר שאר השאר noun masculine singular absolute unspecified unspecified  	O	null
2 הרצתה הרצה הרצתה verb feminine singular unspecified 3 past  	O	null
3 ב ב בנושאי preposition unspecified unspecified unspecified unspecified unspecified 0 
3 נושאי נושא בנושאי noun masculine plural construct unspecified unspecified  	O	null
4 ממשל ממשל ממשל noun masculine singular absolute unspecified unspecified  	O	null
5 , , , punctuation unspecified unspecified unspecified unspecified unspecified  	O	null
6 פולקלור פולקלור פולקלור properName unspecified unspecified unspecified unspecified unspecified  	O	null
7 ו ו ואנתרופולוגיה conjunction unspecified unspecified unspecified unspecified unspecified 0 
7 אנתרופולוגיה אנתרופולוגיה ואנתרופולוגיה noun feminine singular absolute unspecified unspecified  	O	null
8 ו ו ועסקה conjunction unspecified unspecified unspecified unspecified unspecified 0 
8 עסקה עסקה ועסקה noun feminine singular absolute unspecified unspecified  	O	null
9 ב ב בהוראה preposition unspecified unspecified unspecified unspecified unspecified 0 
9 הוראה הוראה בהוראה noun feminine singular absolute unspecified unspecified  	O	null
10 ו ו ובתרגום conjunction unspecified unspecified unspecified unspecified unspecified 0 
10 ב ב ובתרגום preposition unspecified unspecified unspecified unspecified unspecified 0 
10 ה ה ובתרגום definiteArticle unspecified unspecified unspecified unspecified unspecified 0 
10 התרגום תרגום ובתרגום noun masculine singular absolute unspecified unspecified  	O	null
11 . . . punctuation unspecified unspecified unspecified unspecified unspecified  	O	null

0 אל אל אל preposition unspecified unspecified unspecified unspecified unspecified  	O	null
1 לימודי לימוד לימודיה noun masculine plural absolute unspecified unspecified  
1 ה ה לימודיה possessive feminine singular unspecified 3 unspecified 0 	O	null
2 ה ה האקדמיים definiteArticle unspecified unspecified unspecified unspecified unspecified 0 
2 האקדמיים אקדמי האקדמיים adjective masculine plural absolute unspecified unspecified  	O	null
3 ב ב באוניברסיטת preposition unspecified unspecified unspecified unspecified unspecified 0 
3 אוניברסיטת אוניברסיטה באוניברסיטת noun feminine singular construct unspecified unspecified  	I_ORG	null
4 בר בר בר properName unspecified unspecified unspecified unspecified unspecified  	I_ORG	null
5 - - - punctuation unspecified unspecified unspecified unspecified unspecified  	O	null
6 אילן אילן אילן properName unspecified unspecified unspecified unspecified unspecified  	I_PERS	null
7 הגיעה הגיע הגיעה verb feminine singular unspecified 3 past  	O	null
8 ב ב בשלב preposition unspecified unspecified unspecified unspecified unspecified 0 
8 שלב שלב בשלב noun masculine singular absolute unspecified unspecified  	O	null
9 מאוחר מאוחר מאוחר adjective masculine singular absolute unspecified unspecified  	O	null
10 יחסית יחסית יחסית adverb unspecified unspecified unspecified unspecified unspecified  	O	null
11 . . . punctuation unspecified unspecified unspecified unspecified unspecified  	O	null

0 עבודת עבודה עבודת noun feminine singular construct unspecified unspecified  	O	null
1 ה ה המאסטר definiteArticle unspecified unspecified unspecified unspecified unspecified 0 
1 המאסטר המאסטר המאסטר noun masculine singular absolute unspecified unspecified  	O	null
2 ו ו ועבודת conjunction unspecified unspecified unspecified unspecified unspecified 0 
2 עבודת עבודה ועבודת noun feminine singular construct unspecified unspecified  	O	null
3 ה ה הדוקטור definiteArticle unspecified unspecified unspecified unspecified unspecified 0 
3 הדוקטור דוקטור הדוקטור noun masculine singular absolute unspecified unspecified  	O	null
4 של של שלה shel-preposition unspecified unspecified unspecified unspecified unspecified  
4 ה ה שלה pronomial feminine singular unspecified 3 unspecified 0 	O	null
5 ( ( ( punctuation unspecified unspecified unspecified unspecified unspecified  	O	null
6 ###NUMBER### ###NUMBER### ###NUMBER### numeral unspecified unspecified unspecified unspecified unspecified  	I_DATE	null
7 ) ) ) punctuation unspecified unspecified unspecified unspecified unspecified  	O	null
8 עוסקות עסק עוסקות verb feminine plural unspecified any beinoni  	O	null
9 ב ב בסיפוריה preposition unspecified unspecified unspecified unspecified unspecified 0 
9 סיפורי סיפור בסיפוריה noun masculine plural absolute unspecified unspecified  
9 ה ה בסיפוריה possessive feminine singular unspecified 3 unspecified 0 	O	null
10 של של של shel-preposition unspecified unspecified unspecified unspecified unspecified  	O	null
11 מרי מרי מרי noun masculine singular absolute unspecified unspecified  	O	null
12 פלאנרי פלאנרי פלאנרי properName unspecified unspecified unspecified unspecified unspecified  	I_PERS	null
13 אוקונור אוקונור אוקונור properName unspecified unspecified unspecified unspecified unspecified  	I_PERS	null
14 . . . punctuation unspecified unspecified unspecified unspecified unspecified  	O	null

0 ספר ספר ספר noun masculine singular construct unspecified unspecified  	O	null
1 שירי שיר שיריה noun masculine plural absolute unspecified unspecified  
1 ה ה שיריה possessive feminine singular unspecified 3 unspecified 0 	O	null
2 ה ה הראשון definiteArticle unspecified unspecified unspecified unspecified unspecified 0 
2 הראשון ORD1 הראשון numeral masculine singular absolute unspecified unspecified  	O	null
3 , , , punctuation unspecified unspecified unspecified unspecified unspecified  	O	null
4 רגע רגע רגע noun masculine singular absolute unspecified unspecified  	O	null
5 , , , punctuation unspecified unspecified unspecified unspecified unspecified  	O	null
6 התפרסם התפרסם התפרסם verb masculine singular unspecified 3 past  	O	null
7 ב ב ב preposition unspecified unspecified unspecified unspecified unspecified 0 	O	null
8 - - - punctuation unspecified unspecified unspecified unspecified unspecified  	O	null
9 ###NUMBER### ###NUMBER### ###NUMBER### numeral unspecified unspecified unspecified unspecified unspecified  	I_DATE	null
10 ( ( ( punctuation unspecified unspecified unspecified unspecified unspecified  	O	null
11 עקד עקד עקד verb masculine singular unspecified 3 past  	O	null
12 ) ) ) punctuation unspecified unspecified unspecified unspecified unspecified  	O	null
13 . . . punctuation unspecified unspecified unspecified unspecified unspecified  	O	null

0 ב ב ב preposition unspecified unspecified unspecified unspecified unspecified 0 	O	null
1 - - - punctuation unspecified unspecified unspecified unspecified unspecified  	O	null
2 ###NUMBER### ###NUMBER### ###NUMBER### numeral unspecified unspecified unspecified unspecified unspecified  	I_DATE	null
3 ראה ראה ראה verb masculine singular unspecified 3 past  	O	null
4 אור אור אור noun masculine singular construct unspecified unspecified  	O	null
5 ספר ספר ספרה noun masculine singular absolute unspecified unspecified  
5 ה ה ספרה possessive feminine singular unspecified 3 unspecified 0 	O	null
6 נופי נוף נופי noun masculine plural construct unspecified unspecified  	O	null
7 ארץ ארץ ארץ noun feminine singular absolute unspecified unspecified  	O	null
8 – – – punctuation unspecified unspecified unspecified unspecified unspecified  	O	null
9 ו ו ואני conjunction unspecified unspecified unspecified unspecified unspecified 0 
9 אני הוא ואני pronoun masculine-and-feminine singular unspecified 1 unspecified  	O	null
10 . . . punctuation unspecified unspecified unspecified unspecified unspecified  	O	null

0 זהו זהו זהו pronoun masculine singular unspecified 3 unspecified  	O	null
1 קובץ קובץ קובץ noun masculine singular construct unspecified unspecified  	O	null
2 אגדות אגדה אגדות noun feminine plural construct unspecified unspecified  	O	null
3 ארץ ארץ ארץ noun feminine singular construct unspecified unspecified  	O	null
4 - - - punctuation unspecified unspecified unspecified unspecified unspecified  	O	null
5 ישראליות ישראלי ישראליות adjective feminine plural absolute unspecified unspecified  	O	null
6 פרי פרי פרי noun masculine singular construct unspecified unspecified  	O	null
7 רוח רוח רוחה noun feminine singular absolute unspecified unspecified  
7 ה ה רוחה possessive feminine singular unspecified 3 unspecified 0 	O	null
8 , , , punctuation unspecified unspecified unspecified unspecified unspecified  	O	null
9 ב ב בפרוזה preposition unspecified unspecified unspecified unspecified unspecified 0 
9 פרוזה פרוזה בפרוזה noun feminine singular absolute unspecified unspecified  	O	null
10 ו ו ובשירה conjunction unspecified unspecified unspecified unspecified unspecified 0 
10 ב ב ובשירה preposition unspecified unspecified unspecified unspecified unspecified 0 
10 שירה שירה ובשירה properName unspecified unspecified unspecified unspecified unspecified  	I_PERS	null
11 , , , punctuation unspecified unspecified unspecified unspecified unspecified  	O	null
12 ה ה המתמקד definiteArticle unspecified unspecified unspecified unspecified unspecified 0 
12 המתמקד התמקד המתמקד participle masculine singular absolute any unspecified  	O	null
13 ב ב באמונתם preposition unspecified unspecified unspecified unspecified unspecified 0 
13 אמונת אמונה באמונתם noun feminine singular absolute unspecified unspecified  
13 ם ם באמונתם possessive masculine plural unspecified 3 unspecified 0 	O	null
14 ו ו ובדתם conjunction unspecified unspecified unspecified unspecified unspecified 0 
14 ב ב ובדתם preposition unspecified unspecified unspecified unspecified unspecified 0 
14 דת דת ובדתם noun feminine singular absolute unspecified unspecified  
14 ם ם ובדתם possessive masculine plural unspecified 3 unspecified 0 	O	null
15 של של של shel-preposition unspecified unspecified unspecified unspecified unspecified  	O	null
16 בני בן בני noun masculine plural construct unspecified unspecified  	O	null
17 ה ה הארץ definiteArticle unspecified unspecified unspecified unspecified unspecified 0 
17 הארץ ארץ הארץ noun feminine singular absolute unspecified unspecified  	O	null
18 , , , punctuation unspecified unspecified unspecified unspecified unspecified  	O	null
19 יהודים יהודי יהודים noun masculine plural absolute unspecified unspecified  	O	null
20 ו ו וערבים conjunction unspecified unspecified unspecified unspecified unspecified 0 
20 ערבים ערב וערבים noun masculine plural absolute unspecified unspecified  	O	null
21 כ כ כאחד preposition unspecified unspecified unspecified unspecified unspecified 0 
21 אחד CARD1 כאחד numeral masculine singular absolute unspecified unspecified  	O	null
22 . . . punctuation unspecified unspecified unspecified unspecified unspecified  	O	null

0 ב ב בספר preposition unspecified unspecified unspecified unspecified unspecified 0 
0 ה ה בספר definiteArticle unspecified unspecified unspecified unspecified unspecified 0 
0 הספר ספר בספר noun masculine singular absolute unspecified unspecified  	O	null
1 ש ש שיריהאני relativizer/subordinatingConjunction unspecified unspecified unspecified unspecified unspecified 0 
1 יריהאני יריהאני שיריהאני noun feminine plural absolute unspecified unspecified  	O	null
2 את את אתה at-preposition unspecified unspecified unspecified unspecified unspecified  
2 ה ה אתה pronomial feminine singular unspecified 3 unspecified 0 	O	null
3 ו ו ואת conjunction unspecified unspecified unspecified unspecified unspecified 0 
3 את את ואת at-preposition unspecified unspecified unspecified unspecified unspecified  	O	null
4 – – – punctuation unspecified unspecified unspecified unspecified unspecified  	O	null
5 נופים נוף נופים noun masculine plural absolute unspecified unspecified  	O	null
6 של של של shel-preposition unspecified unspecified unspecified unspecified unspecified  	O	null
7 נגיעות נגיעה נגיעות noun feminine plural absolute unspecified unspecified  	O	null
8 ( ( ( punctuation unspecified unspecified unspecified unspecified unspecified  	O	null
9 ###NUMBER### ###NUMBER### ###NUMBER### numeral unspecified unspecified unspecified unspecified unspecified  	I_DATE	null
10 ) ) ) punctuation unspecified unspecified unspecified unspecified unspecified  	O	null
11 היא הוא היא pronoun feminine singular unspecified 3 unspecified  	O	null
12 עוסקת עסק עוסקת verb feminine singular unspecified any beinoni  	O	null
13 ב ב בטבע preposition unspecified unspecified unspecified unspecified unspecified 0 
13 ה ה בטבע definiteArticle unspecified unspecified unspecified unspecified unspecified 0 
13 הטבע טבע בטבע noun masculine singular absolute unspecified unspecified  	O	null
14 ו ו ובנוף conjunction unspecified unspecified unspecified unspecified unspecified 0 
14 ב ב ובנוף preposition unspecified unspecified unspecified unspecified unspecified 0 
14 ה ה ובנוף definiteArticle unspecified unspecified unspecified unspecified unspecified 0 
14 הנוף נוף ובנוף noun masculine singular absolute unspecified unspecified  	O	null
15 , , , punctuation unspecified unspecified unspecified unspecified unspecified  	O	null
16 ו ו ובכך conjunction unspecified unspecified unspecified unspecified unspecified 0 
16 בכך בכך ובכך adverb unspecified unspecified unspecified unspecified unspecified  	O	null
17 היא הוא היא pronoun feminine singular unspecified 3 unspecified  	O	null
18 ממשיכה המשיך ממשיכה verb feminine singular unspecified any beinoni  	O	null
19 את את את at-preposition unspecified unspecified unspecified unspecified unspecified  	O	null
20 דרך דרך דרכו noun feminine singular absolute unspecified unspecified  
20 ו ו דרכו possessive masculine singular unspecified 3 unspecified 0 	O	null
21 של של של shel-preposition unspecified unspecified unspecified unspecified unspecified  	O	null
22 אביה אביה אביה properName unspecified unspecified unspecified unspecified unspecified  	I_PERS	null
23 ( ( ( punctuation unspecified unspecified unspecified unspecified unspecified  	O	null
24 בן-שאול בן-שאול בן-שאול properName unspecified unspecified unspecified unspecified unspecified  	I_PERS	null
25 , , , punctuation unspecified unspecified unspecified unspecified unspecified  	O	null
26 ###NUMBER### ###NUMBER### ###NUMBER### numeral unspecified unspecified unspecified unspecified unspecified  	I_DATE	null
27 ) ) ) punctuation unspecified unspecified unspecified unspecified unspecified  	O	null
28 . . . punctuation unspecified unspecified unspecified unspecified unspecified  	O	null

0 ה ה הספר definiteArticle unspecified unspecified unspecified unspecified unspecified 0 
0 הספר ספר הספר noun masculine singular absolute unspecified unspecified  	O	null
1 כולל כלל כולל verb masculine singular unspecified any beinoni  	O	null
2 שירים שיר שירים noun masculine plural absolute unspecified unspecified  	O	null
3 רבים רב רבים adjective masculine plural absolute unspecified unspecified  	O	null
4 ה ה העוסקים definiteArticle unspecified unspecified unspecified unspecified unspecified 0 
4 העוסקים עסק העוסקים participle masculine plural absolute any unspecified  	O	null
5 ב ב בחוויותיה preposition unspecified unspecified unspecified unspecified unspecified 0 
5 חוויות חוויה בחוויותיה noun feminine plural absolute unspecified unspecified  
5 ה ה בחוויותיה possessive feminine singular unspecified 3 unspecified 0 	O	null
6 ו ו ובמשפחתה conjunction unspecified unspecified unspecified unspecified unspecified 0 
6 ב ב ובמשפחתה preposition unspecified unspecified unspecified unspecified unspecified 0 
6 משפחת משפחה ובמשפחתה noun feminine singular absolute unspecified unspecified  
6 ה ה ובמשפחתה possessive feminine singular unspecified 3 unspecified 0 	O	null
7 ( ( ( punctuation unspecified unspecified unspecified unspecified unspecified  	O	null
8 " " " punctuation unspecified unspecified unspecified unspecified unspecified  	O	null
9 אבא אבא אבא noun masculine singular absolute unspecified unspecified  	O	null
10 של של שלי shel-preposition unspecified unspecified unspecified unspecified unspecified  
10 י י שלי pronomial masculine-and-feminine singular unspecified 1 unspecified 0 	O	null
11 היה הוא היה copula masculine singular unspecified 3 past  	O	null
12 קוץ קוץ קוץ noun masculine singular absolute unspecified unspecified  	O	null
13 גֵּא גֵּא גֵּא properName unspecified unspecified unspecified unspecified unspecified  	I_LOC	null
14 / / / punctuation unspecified unspecified unspecified unspecified unspecified  	O	null
15 ו ו ואמא conjunction unspecified unspecified unspecified unspecified unspecified 0 
15 אמא אמא ואמא noun feminine singular absolute unspecified unspecified  	O	null
16 של של שלי shel-preposition unspecified unspecified unspecified unspecified unspecified  
16 י י שלי pronomial masculine-and-feminine singular unspecified 1 unspecified 0 	O	null
17 אדמה אדמה אדמה noun feminine singular absolute unspecified unspecified  	O	null
18 / / / punctuation unspecified unspecified unspecified unspecified unspecified  	O	null
19 הוא הוא הוא pronoun masculine singular unspecified 3 unspecified  	O	null
20 ב ב בקוציו preposition unspecified unspecified unspecified unspecified unspecified 0 
20 קוצי קוץ בקוציו noun masculine plural absolute unspecified unspecified  
20 ו ו בקוציו possessive masculine singular unspecified 3 unspecified 0 	O	null
21 , , , punctuation unspecified unspecified unspecified unspecified unspecified  	O	null
22 מיוסר יוסר מיוסר verb masculine singular unspecified any beinoni  	O	null
23 , , , punctuation unspecified unspecified unspecified unspecified unspecified  	O	null
24 מתנשא התנשא מתנשא verb masculine singular unspecified any beinoni  	O	null
25 / / / punctuation unspecified unspecified unspecified unspecified unspecified  	O	null
26 ו ו והיא conjunction unspecified unspecified unspecified unspecified unspecified 0 
26 היא הוא והיא pronoun feminine singular unspecified 3 unspecified  	O	null
27 נתנה נתן נתנה verb feminine singular unspecified 3 past  	O	null
28 ל ל לו preposition unspecified unspecified unspecified unspecified unspecified  
28 ו ו לו pronomial masculine singular unspecified 3 unspecified 0 	O	null
29 מחֻמָה מחֻמָה מחֻמָה adjective feminine singular construct unspecified unspecified  	O	null
30 " " " punctuation unspecified unspecified unspecified unspecified unspecified  	O	null
31 ) ) ) punctuation unspecified unspecified unspecified unspecified unspecified  	O	null
32 , , , punctuation unspecified unspecified unspecified unspecified unspecified  	O	null
33 ו ו והוא conjunction unspecified unspecified unspecified unspecified unspecified 0 
33 הוא הוא והוא pronoun masculine singular unspecified 3 unspecified  	O	null
34 נקרא נקרא נקרא verb masculine singular unspecified 3 past  	O	null
35 כ כ כיצירה preposition unspecified unspecified unspecified unspecified unspecified 0 
35 יצירה יצירה כיצירה noun feminine singular absolute unspecified unspecified  	O	null
36 אוטוביוגרפית אוטוביוגרפי אוטוביוגרפית adjective feminine singular absolute unspecified unspecified  	O	null
37 . . . punctuation unspecified unspecified unspecified unspecified unspecified  	O	null

0 בן בן בן properName unspecified unspecified unspecified unspecified unspecified  	I_PERS	null
1 - - - properName unspecified unspecified unspecified unspecified unspecified  	I_PERS	null
2 שאול שאול שאול properName unspecified unspecified unspecified unspecified unspecified  	I_PERS	null
3 , , , punctuation unspecified unspecified unspecified unspecified unspecified  	O	null
4 משה משה משה properName unspecified unspecified unspecified unspecified unspecified  	I_PERS	null
5 . . . punctuation unspecified unspecified unspecified unspecified unspecified  	O	null

0 " " " punctuation unspecified unspecified unspecified unspecified unspecified  	O	null
1 ב ב בעקבותיו preposition unspecified unspecified unspecified unspecified unspecified 0 
1 עקבותי עקב בעקבותיו noun masculine plural absolute unspecified unspecified  
1 ו ו בעקבותיו possessive masculine singular unspecified 3 unspecified 0 	O	null
2 של של של shel-preposition unspecified unspecified unspecified unspecified unspecified  	O	null
3 ה ה האב definiteArticle unspecified unspecified unspecified unspecified unspecified 0 
3 האב אב האב noun masculine singular absolute unspecified unspecified  	O	null
4 " " " punctuation unspecified unspecified unspecified unspecified unspecified  	O	null
5 . . . punctuation unspecified unspecified unspecified unspecified unspecified  	O	null

0 מאזניים מאזניים מאזניים noun masculine plural absolute unspecified unspecified  	O	null
1 ע"ח ע"ח ע"ח preposition unspecified unspecified unspecified unspecified unspecified  	O	null
2 ) ) ) punctuation unspecified unspecified unspecified unspecified unspecified  	O	null
3 . . . punctuation unspecified unspecified unspecified unspecified unspecified  	O	null
4 ###NUMBER### ###NUMBER### ###NUMBER### numeral unspecified unspecified unspecified unspecified unspecified  	O	null
5 ###NUMBER### ###NUMBER### ###NUMBER### numeral unspecified unspecified unspecified unspecified unspecified  	I_DATE	null
6 . . . punctuation unspecified unspecified unspecified unspecified unspecified  	O	null

0 ; ; ; punctuation unspecified unspecified unspecified unspecified unspecified  	O	null
1 ###NUMBER### ###NUMBER### ###NUMBER### numeral unspecified unspecified unspecified unspecified unspecified  	O	null
2 עוזיאל עוזיאל עוזיאל properName unspecified unspecified unspecified unspecified unspecified  	I_LOC	null
3 - - - punctuation unspecified unspecified unspecified unspecified unspecified  	O	null
4 פרחי פרח פרחי noun masculine plural construct unspecified unspecified  	O	null
5 , , , punctuation unspecified unspecified unspecified unspecified unspecified  	O	null
6 רחל רחל רחל properName feminine singular unspecified unspecified unspecified  	I_PERS	null
7 . . . punctuation unspecified unspecified unspecified unspecified unspecified  	O	null

0 " " " punctuation unspecified unspecified unspecified unspecified unspecified  	O	null
1 על על על preposition unspecified unspecified unspecified unspecified unspecified  	O	null
2 ' ' ' punctuation unspecified unspecified unspecified unspecified unspecified  	O	null
3 נופי נוף נופי noun masculine plural construct unspecified unspecified  	O	null
4 ארץ ארץ ארץ noun feminine singular absolute unspecified unspecified  	O	null
5 – – – punctuation unspecified unspecified unspecified unspecified unspecified  	O	null
6 ו ו ואני conjunction unspecified unspecified unspecified unspecified unspecified 0 
6 אני הוא ואני pronoun masculine-and-feminine singular unspecified 1 unspecified  	O	null
7 ' ' ' punctuation unspecified unspecified unspecified unspecified unspecified  	O	null
8 " " " punctuation unspecified unspecified unspecified unspecified unspecified  	O	null
9 . . . punctuation unspecified unspecified unspecified unspecified unspecified  	O	null

0 אפיריון אפיריון אפיריון noun masculine singular absolute unspecified unspecified  	O	null
1 . . . punctuation unspecified unspecified unspecified unspecified unspecified  	O	null
2 ###NUMBER### ###NUMBER### ###NUMBER### numeral unspecified unspecified unspecified unspecified unspecified  	O	null
3 ###NUMBER### ###NUMBER### ###NUMBER### numeral unspecified unspecified unspecified unspecified unspecified  	I_DATE	null
4 . . . punctuation unspecified unspecified unspecified unspecified unspecified  	O	null

0 ###NUMBER### ###NUMBER### ###NUMBER### numeral unspecified unspecified unspecified unspecified unspecified  	O	null
1 . . . punctuation unspecified unspecified unspecified unspecified unspecified  	O	null

0 References References References foreign unspecified unspecified unspecified unspecified unspecified  	O	null
1 : : : punctuation unspecified unspecified unspecified unspecified unspecified  	O	null

