0 Name Name Name foreign unspecified unspecified unspecified unspecified unspecified  	O	null
1 : : : punctuation unspecified unspecified unspecified unspecified unspecified  	O	null
2 שץ שץ שץ properName unspecified unspecified unspecified unspecified unspecified  	I_ORG	null
3 , , , punctuation unspecified unspecified unspecified unspecified unspecified  	O	null
4 אבנר אבנר אבנר properName unspecified unspecified unspecified unspecified unspecified  	I_PERS	null
5 Birth Birth Birth foreign unspecified unspecified unspecified unspecified unspecified  	O	null
6 Year Year Year foreign unspecified unspecified unspecified unspecified unspecified  	O	null
7 : : : punctuation unspecified unspecified unspecified unspecified unspecified  	O	null
8 ###NUMBER### ###NUMBER### ###NUMBER### numeral unspecified unspecified unspecified unspecified unspecified  	I_DATE	null
9 Birth Birth Birth foreign unspecified unspecified unspecified unspecified unspecified  	O	null
10 Place Place Place foreign unspecified unspecified unspecified unspecified unspecified  	O	null
11 : : : punctuation unspecified unspecified unspecified unspecified unspecified  	O	null
12 Occupation Occupation Occupation foreign unspecified unspecified unspecified unspecified unspecified  	O	null
13 : : : punctuation unspecified unspecified unspecified unspecified unspecified  	O	null
14 סופר סופר סופר noun masculine singular absolute unspecified unspecified  	O	null
15 , , , punctuation unspecified unspecified unspecified unspecified unspecified  	O	null
16 משורר משורר משורר noun masculine singular absolute unspecified unspecified  	O	null
17 ו ו ומבקר conjunction unspecified unspecified unspecified unspecified unspecified 0 
17 מבקר מבקר ומבקר noun masculine singular construct unspecified unspecified  	O	null
18 Entry Entry Entry foreign unspecified unspecified unspecified unspecified unspecified  	O	null
19 writer writer writer foreign unspecified unspecified unspecified unspecified unspecified  	O	null
20 : : : punctuation unspecified unspecified unspecified unspecified unspecified  	O	null
21 יגאל יגאל יגאל properName unspecified unspecified unspecified unspecified unspecified  	I_PERS	null
22 שוורץ שוורץ שוורץ properName unspecified unspecified unspecified unspecified unspecified  	I_PERS	null
23 Entry Entry Entry foreign unspecified unspecified unspecified unspecified unspecified  	O	null
24 Value Value Value foreign unspecified unspecified unspecified unspecified unspecified  	O	null
25 : : : punctuation unspecified unspecified unspecified unspecified unspecified  	O	null
26 גדל גדל גדל verb masculine singular unspecified 3 past  	O	null
27 ב ב בקריית preposition unspecified unspecified unspecified unspecified unspecified 0 
27 קריית קריה בקריית properName unspecified unspecified unspecified unspecified unspecified  	I_PERS	null
28 ים ים ים properName unspecified unspecified unspecified unspecified unspecified  	I_PERS	null
29 ב ב בבית preposition unspecified unspecified unspecified unspecified unspecified 0 
29 בית בית בבית noun masculine singular absolute unspecified unspecified  	O	null
30 חילוני חילוני חילוני adjective masculine singular absolute unspecified unspecified  	O	null
31 של של של shel-preposition unspecified unspecified unspecified unspecified unspecified  	O	null
32 הורים הורה הורים noun masculine plural absolute unspecified unspecified  	O	null
33 פליטי פליט פליטי noun masculine plural construct unspecified unspecified  	O	null
34 מלחמת מלחמה מלחמת noun feminine singular construct unspecified unspecified  	O	null
35 ה ה העולם definiteArticle unspecified unspecified unspecified unspecified unspecified 0 
35 העולם עולם העולם noun masculine singular absolute unspecified unspecified  	O	null
36 ה ה השנייה definiteArticle unspecified unspecified unspecified unspecified unspecified 0 
36 השנייה ORD2 השנייה numeral feminine singular absolute unspecified unspecified  	O	null
37 . . . punctuation unspecified unspecified unspecified unspecified unspecified  	O	null

0 אם אם אמו noun feminine singular absolute unspecified unspecified  
0 ו ו אמו possessive masculine singular unspecified 3 unspecified 0 	O	null
1 , , , punctuation unspecified unspecified unspecified unspecified unspecified  	O	null
2 ילידת ילידה ילידת noun feminine singular construct unspecified unspecified  	O	null
3 קראקוב קראקוב קראקוב properName unspecified unspecified unspecified unspecified unspecified  	I_ORG	null
4 ( ( ( punctuation unspecified unspecified unspecified unspecified unspecified  	O	null
5 פולין פולין פולין properName unspecified unspecified unspecified unspecified unspecified  	I_LOC	null
6 ) ) ) punctuation unspecified unspecified unspecified unspecified unspecified  	O	null
7 , , , punctuation unspecified unspecified unspecified unspecified unspecified  	O	null
8 נמלטה נמלט נמלטה verb feminine singular unspecified 3 past  	O	null
9 עם עם עם preposition unspecified unspecified unspecified unspecified unspecified  	O	null
10 משפחת משפחה משפחתה noun feminine singular absolute unspecified unspecified  
10 ה ה משפחתה possessive feminine singular unspecified 3 unspecified 0 	O	null
11 ב ב ב preposition unspecified unspecified unspecified unspecified unspecified 0 	I_ORG	null
12 - - - punctuation unspecified unspecified unspecified unspecified unspecified  	I_ORG	null
13 ###NUMBER### ###NUMBER### ###NUMBER### numeral unspecified unspecified unspecified unspecified unspecified  	I_DATE	null
14 ל ל לרוסיה preposition unspecified unspecified unspecified unspecified unspecified 0 
14 רוסיה רוסי לרוסיה properName unspecified unspecified unspecified unspecified unspecified  	I_LOC	null
15 ה ה האסייתית definiteArticle unspecified unspecified unspecified unspecified unspecified 0 
15 האסייתית אסייתי האסייתית adjective feminine singular absolute unspecified unspecified  	O	null
16 ו ו ועלתה conjunction unspecified unspecified unspecified unspecified unspecified 0 
16 עלתה עלה ועלתה verb feminine singular unspecified 3 past  	O	null
17 ארצה ארצה ארצה adverb unspecified unspecified unspecified unspecified unspecified  	O	null
18 ב ב ב preposition unspecified unspecified unspecified unspecified unspecified 0 	I_ORG	null
19 - - - punctuation unspecified unspecified unspecified unspecified unspecified  	I_ORG	null
20 ###NUMBER### ###NUMBER### ###NUMBER### numeral unspecified unspecified unspecified unspecified unspecified  	I_DATE	null
21 . . . punctuation unspecified unspecified unspecified unspecified unspecified  	O	null

0 אבי אב אביו noun masculine singular absolute unspecified unspecified  
0 ו ו אביו possessive masculine singular unspecified 3 unspecified 0 	O	null
1 , , , punctuation unspecified unspecified unspecified unspecified unspecified  	O	null
2 יליד יליד יליד noun masculine singular construct unspecified unspecified  	O	null
3 עיירה עיירה עיירה noun feminine singular absolute unspecified unspecified  	O	null
4 סמוכה סמוך סמוכה adjective feminine singular absolute unspecified unspecified  	O	null
5 ל ל לקישינב preposition unspecified unspecified unspecified unspecified unspecified 0 
5 קישינב קישינב לקישינב properName unspecified unspecified unspecified unspecified unspecified  	I_LOC	null
6 , , , punctuation unspecified unspecified unspecified unspecified unspecified  	O	null
7 ה ה היום definiteArticle unspecified unspecified unspecified unspecified unspecified 0 
7 היום יום היום noun masculine singular absolute unspecified unspecified  	O	null
8 מולדובה מולדובה מולדובה properName unspecified unspecified unspecified unspecified unspecified  	I_PERS	null
9 , , , punctuation unspecified unspecified unspecified unspecified unspecified  	O	null
10 נשלח נשלח נשלח verb masculine singular unspecified 3 past  	O	null
11 עם עם עם preposition unspecified unspecified unspecified unspecified unspecified  	O	null
12 משפחת משפחה משפחתו noun feminine singular absolute unspecified unspecified  
12 ו ו משפחתו possessive masculine singular unspecified 3 unspecified 0 	O	null
13 ל ל לרוסיה preposition unspecified unspecified unspecified unspecified unspecified 0 
13 רוסיה רוסי לרוסיה properName unspecified unspecified unspecified unspecified unspecified  	I_LOC	null
14 , , , punctuation unspecified unspecified unspecified unspecified unspecified  	O	null
15 גויס גויס גויס verb masculine singular unspecified 3 past  	O	null
16 ל ל לצבא preposition unspecified unspecified unspecified unspecified unspecified 0 
16 ה ה לצבא definiteArticle unspecified unspecified unspecified unspecified unspecified 0 
16 הצבא צבא לצבא noun masculine singular absolute unspecified unspecified  	O	null
17 ה ה האדום definiteArticle unspecified unspecified unspecified unspecified unspecified 0 
17 האדום אדום האדום adjective masculine singular absolute unspecified unspecified  	O	null
18 ו ו ועלה conjunction unspecified unspecified unspecified unspecified unspecified 0 
18 עלה עלה ועלה verb masculine singular unspecified 3 past  	O	null
19 ארצה ארצה ארצה adverb unspecified unspecified unspecified unspecified unspecified  	O	null
20 ב ב ב preposition unspecified unspecified unspecified unspecified unspecified 0 	I_ORG	null
21 - - - punctuation unspecified unspecified unspecified unspecified unspecified  	I_ORG	null
22 ###NUMBER### ###NUMBER### ###NUMBER### numeral unspecified unspecified unspecified unspecified unspecified  	I_DATE	null
23 . . . punctuation unspecified unspecified unspecified unspecified unspecified  	O	null

0 ל ל למדבבית preposition unspecified unspecified unspecified unspecified unspecified 0 
0 מדבבי מדבבי למדבבית noun masculine-and-feminine plural absolute unspecified unspecified  
0 י י למדבבית possessive masculine-and-feminine singular unspecified 1 unspecified 0 	O	null
1 ה ה הספר definiteArticle unspecified unspecified unspecified unspecified unspecified 0 
1 הספר ספר הספר noun masculine singular absolute unspecified unspecified  	O	null
2 ל ל לקציניים preposition unspecified unspecified unspecified unspecified unspecified 0 
2 קציניים קציניים לקציניים noun masculine plural absolute unspecified unspecified  	O	null
3 ב ב בעכו preposition unspecified unspecified unspecified unspecified unspecified 0 
3 עכו עכו בעכו properName unspecified unspecified unspecified unspecified unspecified  	I_LOC	null
4 . . . punctuation unspecified unspecified unspecified unspecified unspecified  	O	null

0 ב ב בסיום preposition unspecified unspecified unspecified unspecified unspecified 0 
0 סיום סיום בסיום noun masculine singular construct unspecified unspecified  	O	null
1 לימודי לימוד לימודיו noun masculine plural absolute unspecified unspecified  
1 ו ו לימודיו possessive masculine singular unspecified 3 unspecified 0 	O	null
2 ערך ערך ערך verb masculine singular unspecified 3 past  	O	null
3 כמה כמה כמה quantifier unspecified unspecified construct unspecified unspecified  	O	null
4 הפלגות הפלגה הפלגות noun feminine plural absolute unspecified unspecified  	O	null
5 ב ב בצי preposition unspecified unspecified unspecified unspecified unspecified 0 
5 צי צי בצי noun masculine singular construct unspecified unspecified  	O	null
6 ה ה הסוחר definiteArticle unspecified unspecified unspecified unspecified unspecified 0 
6 הסוחר סוחר הסוחר noun masculine singular absolute unspecified unspecified  	O	null
7 . . . punctuation unspecified unspecified unspecified unspecified unspecified  	O	null

0 את את את at-preposition unspecified unspecified unspecified unspecified unspecified  	O	null
1 שירות שירות שירותו noun masculine singular absolute unspecified unspecified  
1 ו ו שירותו possessive masculine singular unspecified 3 unspecified 0 	O	null
2 ה ה הצבאי definiteArticle unspecified unspecified unspecified unspecified unspecified 0 
2 הצבאי צבאי הצבאי adjective masculine singular absolute unspecified unspecified  	O	null
3 עשה עשה עשה verb masculine singular unspecified 3 past  	O	null
4 ב ב בחיל preposition unspecified unspecified unspecified unspecified unspecified 0 
4 חיל חיל בחיל noun masculine singular construct unspecified unspecified  	I_ORG	null
5 ה ה הים definiteArticle unspecified unspecified unspecified unspecified unspecified 0 
5 הים ים הים noun masculine singular absolute unspecified unspecified  	I_ORG	null
6 . . . punctuation unspecified unspecified unspecified unspecified unspecified  	O	null

0 ב ב בתום preposition unspecified unspecified unspecified unspecified unspecified 0 
0 תום תום בתום noun masculine singular construct unspecified unspecified  	O	null
1 שירות שירות שירותו noun masculine singular absolute unspecified unspecified  
1 ו ו שירותו possessive masculine singular unspecified 3 unspecified 0 	O	null
2 למד למד למד verb masculine singular unspecified 3 past  	O	null
3 ל ל לתואר preposition unspecified unspecified unspecified unspecified unspecified 0 
3 תואר תואר לתואר noun masculine singular absolute unspecified unspecified  	O	null
4 ראשון ORD1 ראשון numeral masculine singular absolute unspecified unspecified  	O	null
5 ב ב בחוג preposition unspecified unspecified unspecified unspecified unspecified 0 
5 ה ה בחוג definiteArticle unspecified unspecified unspecified unspecified unspecified 0 
5 החוג חוג בחוג noun masculine singular absolute unspecified unspecified  	O	null
6 למזרחנות למזרחנות למזרחנות verb masculine-and-feminine plural unspecified 3 past  	O	null
7 ב ב באוניברסיטת preposition unspecified unspecified unspecified unspecified unspecified 0 
7 אוניברסיטת אוניברסיטה באוניברסיטת noun feminine singular construct unspecified unspecified  	I_ORG	null
8 חיפה חיפה חיפה properName unspecified unspecified unspecified unspecified unspecified  	I_ORG	null
9 . . . punctuation unspecified unspecified unspecified unspecified unspecified  	O	null

0 המשיך המשיך המשיך verb masculine singular unspecified 3 past  	O	null
1 ל ל ללימודי preposition unspecified unspecified unspecified unspecified unspecified 0 
1 לימודי לימוד ללימודי noun masculine plural construct unspecified unspecified  	O	null
2 ה ה התואר definiteArticle unspecified unspecified unspecified unspecified unspecified 0 
2 התואר תואר התואר noun masculine singular absolute unspecified unspecified  	O	null
3 ה ה השני definiteArticle unspecified unspecified unspecified unspecified unspecified 0 
3 השני ORD2 השני numeral masculine singular absolute unspecified unspecified  	O	null
4 , , , punctuation unspecified unspecified unspecified unspecified unspecified  	O	null
5 אך אך אך conjunction unspecified unspecified unspecified unspecified unspecified  	O	null
6 לא לא לא negation unspecified unspecified unspecified unspecified unspecified  	O	null
7 השלים השלים השלים verb masculine singular unspecified 3 past  	O	null
8 את את אותם at-preposition unspecified unspecified unspecified unspecified unspecified  
8 הם הם אותם pronomial masculine plural unspecified 3 unspecified 0 	O	null
9 . . . punctuation unspecified unspecified unspecified unspecified unspecified  	O	null

0 ב ב בסיום preposition unspecified unspecified unspecified unspecified unspecified 0 
0 סיום סיום בסיום noun masculine singular construct unspecified unspecified  	O	null
1 לימודי לימוד לימודיו noun masculine plural absolute unspecified unspecified  
1 ו ו לימודיו possessive masculine singular unspecified 3 unspecified 0 	O	null
2 עבד עבד עבד verb masculine singular unspecified 3 past  	O	null
3 כ כ כמדריך preposition unspecified unspecified unspecified unspecified unspecified 0 
3 מדריך מדריך כמדריך noun masculine singular construct unspecified unspecified  	O	null
4 נוער נוער נוער noun masculine singular absolute unspecified unspecified  	O	null
5 , , , punctuation unspecified unspecified unspecified unspecified unspecified  	O	null
6 ו ו ואחר conjunction unspecified unspecified unspecified unspecified unspecified 0 
6 אחר אחר ואחר preposition unspecified unspecified unspecified unspecified unspecified  	O	null
7 כך כך כך pronoun unspecified unspecified unspecified unspecified unspecified  	O	null
8 ב ב בחברת preposition unspecified unspecified unspecified unspecified unspecified 0 
8 חברת חבר בחברת noun feminine singular construct unspecified unspecified  	O	null
9 ה ה הספנות definiteArticle unspecified unspecified unspecified unspecified unspecified 0 
9 הספנות ספנות הספנות noun feminine singular absolute unspecified unspecified  	O	null
10 " " " punctuation unspecified unspecified unspecified unspecified unspecified  	O	null
11 צים צי צים properName unspecified unspecified unspecified unspecified unspecified  	I_ORG	null
12 " " " punctuation unspecified unspecified unspecified unspecified unspecified  	O	null
13 , , , punctuation unspecified unspecified unspecified unspecified unspecified  	O	null
14 שם שם שם adverb unspecified unspecified unspecified unspecified unspecified  	O	null
15 הוא הוא הוא pronoun masculine singular unspecified 3 unspecified  	O	null
16 עובד עבד עובד verb masculine singular unspecified any beinoni  	O	null
17 עד עד עד preposition unspecified unspecified unspecified unspecified unspecified  	O	null
18 ה ה היום definiteArticle unspecified unspecified unspecified unspecified unspecified 0 
18 היום יום היום noun masculine singular absolute unspecified unspecified  	O	null
19 . . . punctuation unspecified unspecified unspecified unspecified unspecified  	O	null

0 מילא מילא מילא verb masculine singular unspecified 3 past  	O	null
1 ב ב בחברה preposition unspecified unspecified unspecified unspecified unspecified 0 
1 ה ה בחברה definiteArticle unspecified unspecified unspecified unspecified unspecified 0 
1 החברה חבר בחברה noun feminine singular absolute unspecified unspecified  	O	null
2 תפקידים תפקיד תפקידים noun masculine plural absolute unspecified unspecified  	O	null
3 מסחריים מסחרי מסחריים adjective masculine plural absolute unspecified unspecified  	O	null
4 ו ו ותקשורתיים conjunction unspecified unspecified unspecified unspecified unspecified 0 
4 תקשורתיים תקשורתי ותקשורתיים adjective masculine plural absolute unspecified unspecified  	O	null
5 . . . punctuation unspecified unspecified unspecified unspecified unspecified  	O	null

0 החל החל החל verb masculine singular unspecified 3 past  	O	null
1 לכתוב כתב לכתוב verb unspecified unspecified unspecified unspecified infinitive  	O	null
2 ב ב בגיל preposition unspecified unspecified unspecified unspecified unspecified 0 
2 גיל גיל בגיל noun masculine singular absolute unspecified unspecified  	O	null
3 צעיר צעיר צעיר adjective masculine singular absolute unspecified unspecified  	O	null
4 . . . punctuation unspecified unspecified unspecified unspecified unspecified  	O	null

0 פרסום פרסום פרסומו noun masculine singular absolute unspecified unspecified  
0 ו ו פרסומו possessive masculine singular unspecified 3 unspecified 0 	O	null
1 ה ה החשוב definiteArticle unspecified unspecified unspecified unspecified unspecified 0 
1 החשוב חשוב החשוב adjective masculine singular absolute unspecified unspecified  	O	null
2 ה ה הראשון definiteArticle unspecified unspecified unspecified unspecified unspecified 0 
2 הראשון ORD1 הראשון numeral masculine singular absolute unspecified unspecified  	O	null
3 היה הוא היה copula masculine singular unspecified 3 past  	O	null
4 ה ה הסיפור definiteArticle unspecified unspecified unspecified unspecified unspecified 0 
4 הסיפור סיפור הסיפור noun masculine singular absolute unspecified unspecified  	O	null
5 " " " punctuation unspecified unspecified unspecified unspecified unspecified  	O	null
6 תאנים תאנה תאנים noun feminine plural absolute unspecified unspecified  	O	null
7 " " " punctuation unspecified unspecified unspecified unspecified unspecified  	O	null
8 , , , punctuation unspecified unspecified unspecified unspecified unspecified  	O	null
9 ש ש שראה relativizer/subordinatingConjunction unspecified unspecified unspecified unspecified unspecified 0 
9 ראה ראה שראה verb masculine singular unspecified 3 past  	O	null
10 אור אור אור noun masculine singular absolute unspecified unspecified  	O	null
11 ב ב במסגרת preposition unspecified unspecified unspecified unspecified unspecified 0 
11 מסגרת מסגרת במסגרת noun feminine singular construct unspecified unspecified  	O	null
12 תחרות תחרות תחרות noun feminine singular construct unspecified unspecified  	O	null
13 ה ה הסיפור definiteArticle unspecified unspecified unspecified unspecified unspecified 0 
13 הסיפור סיפור הסיפור noun masculine singular absolute unspecified unspecified  	O	null
14 ה ה הקצר definiteArticle unspecified unspecified unspecified unspecified unspecified 0 
14 הקצר קצר הקצר adjective masculine singular absolute unspecified unspecified  	O	null
15 של של של shel-preposition unspecified unspecified unspecified unspecified unspecified  	O	null
16 ה ה הארץ definiteArticle unspecified unspecified unspecified unspecified unspecified 0 
16 הארץ ארץ הארץ properName unspecified unspecified unspecified unspecified unspecified  	I_LOC	null
17 ) ) ) punctuation unspecified unspecified unspecified unspecified unspecified  	O	null
18 . . . punctuation unspecified unspecified unspecified unspecified unspecified  	O	null
19 ###NUMBER### ###NUMBER### ###NUMBER### numeral unspecified unspecified unspecified unspecified unspecified  	I_DATE	null
20 פרסום פרסום פרסומו noun masculine singular absolute unspecified unspecified  
20 ו ו פרסומו possessive masculine singular unspecified 3 unspecified 0 	O	null
21 ה ה החשוב definiteArticle unspecified unspecified unspecified unspecified unspecified 0 
21 החשוב חשוב החשוב adjective masculine singular absolute unspecified unspecified  	O	null
22 ה ה השני definiteArticle unspecified unspecified unspecified unspecified unspecified 0 
22 השני ORD2 השני numeral masculine singular absolute unspecified unspecified  	I_DATE	null
23 היה הוא היה copula masculine singular unspecified 3 past  	O	null
24 ה ה הסיפור definiteArticle unspecified unspecified unspecified unspecified unspecified 0 
24 הסיפור סיפור הסיפור noun masculine singular absolute unspecified unspecified  	O	null
25 " " " punctuation unspecified unspecified unspecified unspecified unspecified  	O	null
26 תרבות תרבות תרבות noun feminine singular absolute unspecified unspecified  	O	null
27 מטריארכאלית מטריארכאלית מטריארכאלית preposition unspecified unspecified unspecified unspecified unspecified  
27 י י מטריארכאלית pronomial masculine-and-feminine singular unspecified 1 unspecified 0 	O	null
28 ב ב באוקיינוס preposition unspecified unspecified unspecified unspecified unspecified 0 
28 ה ה באוקיינוס definiteArticle unspecified unspecified unspecified unspecified unspecified 0 
28 האוקיינוס אוקיינוס באוקיינוס noun masculine singular absolute unspecified unspecified  	O	null
29 ה ה השקט definiteArticle unspecified unspecified unspecified unspecified unspecified 0 
29 השקט שקט השקט adjective masculine singular absolute unspecified unspecified  	O	null
30 " " " punctuation unspecified unspecified unspecified unspecified unspecified  	O	null
31 , , , punctuation unspecified unspecified unspecified unspecified unspecified  	O	null
32 ש ש שראה relativizer/subordinatingConjunction unspecified unspecified unspecified unspecified unspecified 0 
32 ראה ראה שראה verb masculine singular unspecified 3 past  	O	null
33 אור אור אור noun masculine singular absolute unspecified unspecified  	O	null
34 ב ב באפס preposition unspecified unspecified unspecified unspecified unspecified 0 
34 אפס אפס באפס noun masculine singular construct unspecified unspecified  	O	null
35 שתיים CARD2 שתיים numeral feminine singular absolute unspecified unspecified  	I_DATE	null
36 , , , punctuation unspecified unspecified unspecified unspecified unspecified  	O	null
37 גיליון גיליון גיליון noun masculine singular absolute unspecified unspecified  	O	null
38 , , , punctuation unspecified unspecified unspecified unspecified unspecified  	O	null
39 ###NUMBER### ###NUMBER### ###NUMBER### numeral unspecified unspecified unspecified unspecified unspecified  	O	null
40 ###NUMBER### ###NUMBER### ###NUMBER### numeral unspecified unspecified unspecified unspecified unspecified  	I_DATE	null
41 . . . punctuation unspecified unspecified unspecified unspecified unspecified  	O	null

0 ב ב ב preposition unspecified unspecified unspecified unspecified unspecified 0 	O	null
1 - - - punctuation unspecified unspecified unspecified unspecified unspecified  	O	null
2 ###NUMBER### ###NUMBER### ###NUMBER### numeral unspecified unspecified unspecified unspecified unspecified  	I_DATE	null
3 פורסם פורסם פורסם verb masculine singular unspecified 3 past  	O	null
4 קובץ קובץ קובץ noun masculine singular construct unspecified unspecified  	O	null
5 סיפורי סיפור סיפוריו noun masculine plural absolute unspecified unspecified  
5 ו ו סיפוריו possessive masculine singular unspecified 3 unspecified 0 	O	null
6 מעגלים מעגל מעגלים properName unspecified unspecified unspecified unspecified unspecified  	I_PERS	null
7 מודפסים הודפס מודפסים verb masculine plural unspecified any beinoni  	O	null
8 ( ( ( punctuation unspecified unspecified unspecified unspecified unspecified  	O	null
9 כתר כתר כתר noun masculine singular absolute unspecified unspecified  	O	null
10 , , , punctuation unspecified unspecified unspecified unspecified unspecified  	O	null
11 " " " punctuation unspecified unspecified unspecified unspecified unspecified  	O	null
12 צד צד צד noun masculine singular construct unspecified unspecified  	O	null
13 ה ה התפר definiteArticle unspecified unspecified unspecified unspecified unspecified 0 
13 התפר תפר התפר noun masculine singular absolute unspecified unspecified  	O	null
14 " " " punctuation unspecified unspecified unspecified unspecified unspecified  	O	null
15 ) ) ) punctuation unspecified unspecified unspecified unspecified unspecified  	O	null
16 . . . punctuation unspecified unspecified unspecified unspecified unspecified  	O	null

0 זהו זהו זהו pronoun masculine singular unspecified 3 unspecified  	O	null
1 קובץ קובץ קובץ noun masculine singular construct unspecified unspecified  	O	null
2 סיפורים סיפור סיפורים noun masculine plural absolute unspecified unspecified  	O	null
3 קצרים קצר קצרים adjective masculine plural absolute unspecified unspecified  	O	null
4 ו ו וקצרים conjunction unspecified unspecified unspecified unspecified unspecified 0 
4 קצרים קצר וקצרים adjective masculine plural absolute unspecified unspecified  	O	null
5 מאוד מאוד מאוד adverb unspecified unspecified unspecified unspecified unspecified  	O	null
6 , , , punctuation unspecified unspecified unspecified unspecified unspecified  	O	null
7 שנונים שינון שנונים noun masculine plural absolute unspecified unspecified  	O	null
8 ו ו ומוזרים conjunction unspecified unspecified unspecified unspecified unspecified 0 
8 מוזרים מוזר ומוזרים adjective masculine plural absolute unspecified unspecified  	O	null
9 , , , punctuation unspecified unspecified unspecified unspecified unspecified  	O	null
10 ה ה העוסקים definiteArticle unspecified unspecified unspecified unspecified unspecified 0 
10 העוסקים עסק העוסקים participle masculine plural absolute any unspecified  	O	null
11 ב ב בקשרים preposition unspecified unspecified unspecified unspecified unspecified 0 
11 ה ה בקשרים definiteArticle unspecified unspecified unspecified unspecified unspecified 0 
11 הקשרים קשר בקשרים noun masculine plural absolute unspecified unspecified  	O	null
12 ה ה החמקמקים definiteArticle unspecified unspecified unspecified unspecified unspecified 0 
12 החמקמקים חמקמק החמקמקים adjective masculine plural absolute unspecified unspecified  	O	null
13 , , , punctuation unspecified unspecified unspecified unspecified unspecified  	O	null
14 ה ה הסמויים definiteArticle unspecified unspecified unspecified unspecified unspecified 0 
14 הסמויים סמוי הסמויים adjective masculine plural absolute unspecified unspecified  	O	null
15 מן מן מן preposition unspecified unspecified unspecified unspecified unspecified  	O	null
16 ה ה העין definiteArticle unspecified unspecified unspecified unspecified unspecified 0 
16 העין עין העין noun feminine singular absolute unspecified unspecified  	O	null
17 , , , punctuation unspecified unspecified unspecified unspecified unspecified  	O	null
18 בין בין בין preposition unspecified unspecified unspecified unspecified unspecified  	O	null
19 ה ה הסופר definiteArticle unspecified unspecified unspecified unspecified unspecified 0 
19 הסופר סופר הסופר noun masculine singular absolute unspecified unspecified  	O	null
20 או או או conjunction unspecified unspecified unspecified unspecified unspecified  	O	null
21 בןדמותו בןדמותו בןדמותו participle feminine plural construct any unspecified  	O	null
22 לבין לבין לבין preposition unspecified unspecified unspecified unspecified unspecified  	O	null
23 יצירי יציר יצירי noun masculine plural construct unspecified unspecified  	O	null
24 רוח רוח רוחו noun feminine singular absolute unspecified unspecified  
24 ו ו רוחו possessive masculine singular unspecified 3 unspecified 0 	O	null
25 ה ה הבדיוניים definiteArticle unspecified unspecified unspecified unspecified unspecified 0 
25 הבדיוניים בדיוני הבדיוניים adjective masculine plural absolute unspecified unspecified  	O	null
26 . . . punctuation unspecified unspecified unspecified unspecified unspecified  	O	null

0 ה ה הספר definiteArticle unspecified unspecified unspecified unspecified unspecified 0 
0 הספר ספר הספר noun masculine singular absolute unspecified unspecified  	O	null
1 בנוי בנוי בנוי adjective masculine singular absolute unspecified unspecified  	O	null
2 מ מ משתי preposition unspecified unspecified unspecified unspecified unspecified 0 
2 שתי CARD2 משתי numeral feminine dual construct unspecified unspecified  	O	null
3 חטיבות חטיבה חטיבות noun feminine plural absolute unspecified unspecified  	O	null
4 עיקריות עיקרי עיקריות adjective feminine plural absolute unspecified unspecified  	O	null
5 . . . punctuation unspecified unspecified unspecified unspecified unspecified  	O	null

0 ה ה החטיבה definiteArticle unspecified unspecified unspecified unspecified unspecified 0 
0 החטיבה חטיבה החטיבה noun feminine singular absolute unspecified unspecified  	O	null
1 ה ה הראשונה definiteArticle unspecified unspecified unspecified unspecified unspecified 0 
1 הראשונה ORD1 הראשונה numeral feminine singular absolute unspecified unspecified  	O	null
2 כוללת כלל כוללת verb feminine singular unspecified any beinoni  	O	null
3 סיפורים סיפור סיפורים noun masculine plural absolute unspecified unspecified  	O	null
4 ה ה המתמקדים definiteArticle unspecified unspecified unspecified unspecified unspecified 0 
4 המתמקדים התמקד המתמקדים participle masculine plural absolute any unspecified  	O	null
5 , , , punctuation unspecified unspecified unspecified unspecified unspecified  	O	null
6 לפחות לפחות לפחות adverb unspecified unspecified unspecified unspecified unspecified  	O	null
7 לכאורה לכאורה לכאורה adverb unspecified unspecified unspecified unspecified unspecified  	O	null
8 , , , punctuation unspecified unspecified unspecified unspecified unspecified  	O	null
9 ב ב במעמד preposition unspecified unspecified unspecified unspecified unspecified 0 
9 מעמד מעמד במעמד noun masculine singular construct unspecified unspecified  	O	null
10 ה ה האישה definiteArticle unspecified unspecified unspecified unspecified unspecified 0 
10 האישה איש האישה noun feminine singular absolute unspecified unspecified  	O	null
11 . . . punctuation unspecified unspecified unspecified unspecified unspecified  	O	null

0 ל ל לסיפורים preposition unspecified unspecified unspecified unspecified unspecified 0 
0 ה ה לסיפורים definiteArticle unspecified unspecified unspecified unspecified unspecified 0 
0 הסיפורים סיפור לסיפורים noun masculine plural absolute unspecified unspecified  	O	null
1 הללו הללו הללו pronoun masculine plural unspecified 3 unspecified  	O	null
2 , , , punctuation unspecified unspecified unspecified unspecified unspecified  	O	null
3 ה ה המתרחשים definiteArticle unspecified unspecified unspecified unspecified unspecified 0 
3 המתרחשים התרחש המתרחשים participle masculine plural absolute any unspecified  	O	null
4 ב ב במקומות preposition unspecified unspecified unspecified unspecified unspecified 0 
4 מקומות מקום במקומות noun masculine plural absolute unspecified unspecified  	O	null
5 אקזוטיים אקזוטי אקזוטיים adjective masculine plural absolute unspecified unspecified  	O	null
6 , , , punctuation unspecified unspecified unspecified unspecified unspecified  	O	null
7 יש יש יש existential unspecified unspecified unspecified unspecified unspecified  	O	null
8 עלילה עלילה עלילה noun feminine singular absolute unspecified unspecified  	O	null
9 " " " punctuation unspecified unspecified unspecified unspecified unspecified  	O	null
10 מסורתית מסורתי מסורתית adjective feminine singular absolute unspecified unspecified  	O	null
11 " " " punctuation unspecified unspecified unspecified unspecified unspecified  	O	null
12 , , , punctuation unspecified unspecified unspecified unspecified unspecified  	O	null
13 ש ש ששיאה relativizer/subordinatingConjunction unspecified unspecified unspecified unspecified unspecified 0 
13 שיא שיא ששיאה noun masculine singular absolute unspecified unspecified  
13 ה ה ששיאה possessive feminine singular unspecified 3 unspecified 0 	O	null
14 פואנטה פואנטה פואנטה noun feminine singular absolute unspecified unspecified  	O	null
15 מחודדת מחודד מחודדת adjective feminine singular absolute unspecified unspecified  	O	null
16 . . . punctuation unspecified unspecified unspecified unspecified unspecified  	O	null

0 עם עם עם preposition unspecified unspecified unspecified unspecified unspecified  	O	null
1 זאת זאת זאת pronoun feminine singular unspecified 3 unspecified  	O	null
2 יש יש יש existential unspecified unspecified unspecified unspecified unspecified  	O	null
3 כאן כאן כאן adverb unspecified unspecified unspecified unspecified unspecified  	O	null
4 הלעגה הלעגה הלעגה noun feminine singular absolute unspecified unspecified  	O	null
5 מחויכת מחויך מחויכת adjective feminine singular absolute unspecified unspecified  	O	null
6 על על על preposition unspecified unspecified unspecified unspecified unspecified  	O	null
7 ה ה הניסיון definiteArticle unspecified unspecified unspecified unspecified unspecified 0 
7 הניסיון ניסיון הניסיון noun masculine singular absolute unspecified unspecified  	O	null
8 לכתוב כתב לכתוב verb unspecified unspecified unspecified unspecified infinitive  	O	null
9 ב ב בשם preposition unspecified unspecified unspecified unspecified unspecified 0 
9 שם שם בשם noun masculine singular construct unspecified unspecified  	O	null
10 מישהו מישהו מישהו noun masculine singular absolute unspecified unspecified  	O	null
11 אחר אחר אחר adjective masculine singular absolute unspecified unspecified  	O	null
12 – – – punctuation unspecified unspecified unspecified unspecified unspecified  	O	null
13 בייחוד בייחוד בייחוד adverb unspecified unspecified unspecified unspecified unspecified  	O	null
14 על על על preposition unspecified unspecified unspecified unspecified unspecified  	O	null
15 ה ה הניסיון definiteArticle unspecified unspecified unspecified unspecified unspecified 0 
15 הניסיון ניסיון הניסיון noun masculine singular absolute unspecified unspecified  	O	null
16 של של של shel-preposition unspecified unspecified unspecified unspecified unspecified  	O	null
17 גבר גבר גבר noun masculine singular absolute unspecified unspecified  	O	null
18 לכתוב כתב לכתוב verb unspecified unspecified unspecified unspecified infinitive  	O	null
19 כ כ כאישה preposition unspecified unspecified unspecified unspecified unspecified 0 
19 ה ה כאישה definiteArticle unspecified unspecified unspecified unspecified unspecified 0 
19 האישה איש כאישה noun feminine singular absolute unspecified unspecified  	O	null
20 . . . punctuation unspecified unspecified unspecified unspecified unspecified  	O	null

0 ה ה החטיבה definiteArticle unspecified unspecified unspecified unspecified unspecified 0 
0 החטיבה חטיבה החטיבה noun feminine singular absolute unspecified unspecified  	O	null
1 ה ה השנייה definiteArticle unspecified unspecified unspecified unspecified unspecified 0 
1 השנייה ORD2 השנייה numeral feminine singular absolute unspecified unspecified  	O	null
2 כוללת כלל כוללת verb feminine singular unspecified any beinoni  	O	null
3 פנטזיות פנטזיה פנטזיות noun feminine plural absolute unspecified unspecified  	O	null
4 ה ה המסתיימות definiteArticle unspecified unspecified unspecified unspecified unspecified 0 
4 המסתיימות הסתיים המסתיימות participle feminine plural absolute any unspecified  	O	null
5 ב ב בפרדוקסים preposition unspecified unspecified unspecified unspecified unspecified 0 
5 פרדוקסים פרדוקס בפרדוקסים noun masculine plural absolute unspecified unspecified  	O	null
6 מפתיעים מפתיע מפתיעים adjective masculine plural absolute unspecified unspecified  	O	null
7 , , , punctuation unspecified unspecified unspecified unspecified unspecified  	O	null
8 ה ה השופכים definiteArticle unspecified unspecified unspecified unspecified unspecified 0 
8 השופכים שפך השופכים participle masculine plural absolute any unspecified  	O	null
9 אור אור אור noun masculine singular absolute unspecified unspecified  	O	null
10 על על על preposition unspecified unspecified unspecified unspecified unspecified  	O	null
11 ה ה הקשר definiteArticle unspecified unspecified unspecified unspecified unspecified 0 
11 הקשר קשר הקשר noun masculine singular absolute unspecified unspecified  	O	null
12 בין בין בין preposition unspecified unspecified unspecified unspecified unspecified  	O	null
13 ה ה המציאות definiteArticle unspecified unspecified unspecified unspecified unspecified 0 
13 המציאות מציאות המציאות noun feminine singular absolute unspecified unspecified  	O	null
14 ל ל לכתיבה preposition unspecified unspecified unspecified unspecified unspecified 0 
14 ה ה לכתיבה definiteArticle unspecified unspecified unspecified unspecified unspecified 0 
14 הכתיבה כתיבה לכתיבה noun feminine singular absolute unspecified unspecified  	O	null
15 ה ה הספרותית definiteArticle unspecified unspecified unspecified unspecified unspecified 0 
15 הספרותית ספרותי הספרותית adjective feminine singular absolute unspecified unspecified  	O	null
16 – – – punctuation unspecified unspecified unspecified unspecified unspecified  	O	null
17 בייחוד בייחוד בייחוד adverb unspecified unspecified unspecified unspecified unspecified  	O	null
18 על על על preposition unspecified unspecified unspecified unspecified unspecified  	O	null
19 טיב טיב טיבה noun masculine singular absolute unspecified unspecified  
19 ה ה טיבה possessive feminine singular unspecified 3 unspecified 0 	O	null
20 של של של shel-preposition unspecified unspecified unspecified unspecified unspecified  	O	null
21 ה ה המחיצה definiteArticle unspecified unspecified unspecified unspecified unspecified 0 
21 המחיצה מחיצה המחיצה noun feminine singular absolute unspecified unspecified  	O	null
22 בין בין בין preposition unspecified unspecified unspecified unspecified unspecified  	O	null
23 ה ה הדמויות definiteArticle unspecified unspecified unspecified unspecified unspecified 0 
23 הדמויות דמות הדמויות noun feminine plural absolute unspecified unspecified  	O	null
24 ה ה הבדויות definiteArticle unspecified unspecified unspecified unspecified unspecified 0 
24 הבדויות בדוי הבדויות adjective feminine plural absolute unspecified unspecified  	O	null
25 לבין לבין לבין preposition unspecified unspecified unspecified unspecified unspecified  	O	null
26 מי מי מי interrogative unspecified unspecified unspecified unspecified unspecified  	O	null
27 ש ש שבדה relativizer/subordinatingConjunction unspecified unspecified unspecified unspecified unspecified 0 
27 בדה בדה שבדה verb masculine singular unspecified 3 past  	O	null
28 את את אותן at-preposition unspecified unspecified unspecified unspecified unspecified  
28 הן הן אותן pronomial feminine plural unspecified 3 unspecified 0 	O	null
29 . . . punctuation unspecified unspecified unspecified unspecified unspecified  	O	null

0 ב ב ב preposition unspecified unspecified unspecified unspecified unspecified 0 	O	null
1 - - - punctuation unspecified unspecified unspecified unspecified unspecified  	O	null
2 ###NUMBER### ###NUMBER### ###NUMBER### numeral unspecified unspecified unspecified unspecified unspecified  	I_DATE	null
3 פורסמו פורסם פורסמו verb masculine-and-feminine plural unspecified 3 past  	O	null
4 שירי שיר שיריו noun masculine plural absolute unspecified unspecified  
4 ו ו שיריו possessive masculine singular unspecified 3 unspecified 0 	O	null
5 ה ה הראשונים definiteArticle unspecified unspecified unspecified unspecified unspecified 0 
5 הראשונים ראשונים הראשונים noun masculine plural absolute unspecified unspecified  	O	null
6 ב ב בכתב preposition unspecified unspecified unspecified unspecified unspecified 0 
6 כתב כתב בכתב noun masculine singular construct unspecified unspecified  	O	null
7 ה ה העת definiteArticle unspecified unspecified unspecified unspecified unspecified 0 
7 העת עת העת noun feminine singular absolute unspecified unspecified  	O	null
8 ל ל לשירה preposition unspecified unspecified unspecified unspecified unspecified 0 
8 ה ה לשירה definiteArticle unspecified unspecified unspecified unspecified unspecified 0 
8 השירה שירה לשירה noun feminine singular absolute unspecified unspecified  	O	null
9 הליקון הליקון הליקון properName unspecified unspecified unspecified unspecified unspecified  	I_PERS	null
10 . . . punctuation unspecified unspecified unspecified unspecified unspecified  	O	null

0 במקביל במקביל במקביל adverb unspecified unspecified unspecified unspecified unspecified  	O	null
1 החל החל החל verb masculine singular unspecified 3 past  	O	null
2 לפרסם פרסם לפרסם verb unspecified unspecified unspecified unspecified infinitive  	O	null
3 רשימות רשימה רשימות noun feminine plural absolute unspecified unspecified  	O	null
4 ביקורת ביקורת ביקורת noun feminine singular absolute unspecified unspecified  	O	null
5 ב ב באפס preposition unspecified unspecified unspecified unspecified unspecified 0 
5 אפס אפס באפס noun masculine singular construct unspecified unspecified  	O	null
6 שתיים CARD2 שתיים numeral feminine singular absolute unspecified unspecified  	O	null
7 , , , punctuation unspecified unspecified unspecified unspecified unspecified  	O	null
8 ידיעות ידיעה ידיעות noun feminine plural absolute unspecified unspecified  	I_ORG	null
9 אחרונות אחרון אחרונות adjective feminine plural absolute unspecified unspecified  	I_ORG	null
10 , , , punctuation unspecified unspecified unspecified unspecified unspecified  	O	null
11 ה ה הארץ definiteArticle unspecified unspecified unspecified unspecified unspecified 0 
11 הארץ ארץ הארץ noun feminine singular absolute unspecified unspecified  	O	null
12 ו ו ועוד conjunction unspecified unspecified unspecified unspecified unspecified 0 
12 עוד עוד ועוד adverb unspecified unspecified unspecified unspecified unspecified  	I_LOC	null
13 . . . punctuation unspecified unspecified unspecified unspecified unspecified  	O	null

0 רשימות רשימה רשימות noun feminine plural construct unspecified unspecified  	O	null
1 ה ה הביקורת definiteArticle unspecified unspecified unspecified unspecified unspecified 0 
1 הביקורת ביקורת הביקורת noun feminine singular absolute unspecified unspecified  	O	null
2 של של שלו shel-preposition unspecified unspecified unspecified unspecified unspecified  
2 ו ו שלו pronomial masculine singular unspecified 3 unspecified 0 	O	null
3 כתובות כתובה כתובות noun feminine plural absolute unspecified unspecified  	O	null
4 ב ב בלשון preposition unspecified unspecified unspecified unspecified unspecified 0 
4 לשון לשון בלשון noun feminine singular absolute unspecified unspecified  	O	null
5 פשוטה פשוט פשוטה adjective feminine singular absolute unspecified unspecified  	O	null
6 ו ו וברורה conjunction unspecified unspecified unspecified unspecified unspecified 0 
6 ברורה ברור וברורה adjective feminine singular absolute unspecified unspecified  	O	null
7 ו ו ועם conjunction unspecified unspecified unspecified unspecified unspecified 0 
7 עם עם ועם preposition unspecified unspecified unspecified unspecified unspecified  	O	null
8 זאת זאת זאת pronoun feminine singular unspecified 3 unspecified  	O	null
9 הן הוא הן pronoun feminine plural unspecified 3 unspecified  	O	null
10 מעמיקות העמיק מעמיקות verb feminine plural unspecified any beinoni  	O	null
11 ו ו וניחנות conjunction unspecified unspecified unspecified unspecified unspecified 0 
11 ניחנות ניחנות וניחנות adjective feminine plural construct unspecified unspecified  	O	null
12 ב ב ברגישות preposition unspecified unspecified unspecified unspecified unspecified 0 
12 רגישות רגישות ברגישות noun feminine singular absolute unspecified unspecified  	O	null
13 ספרותית ספרותי ספרותית adjective feminine singular absolute unspecified unspecified  	O	null
14 דקה דק דקה adjective feminine singular absolute unspecified unspecified  	O	null
15 . . . punctuation unspecified unspecified unspecified unspecified unspecified  	O	null

0 ספר ספר ספרו noun masculine singular absolute unspecified unspecified  
0 ו ו ספרו possessive masculine singular unspecified 3 unspecified 0 	O	null
1 ה ה השני definiteArticle unspecified unspecified unspecified unspecified unspecified 0 
1 השני ORD2 השני numeral masculine singular absolute unspecified unspecified  	O	null
2 של של של shel-preposition unspecified unspecified unspecified unspecified unspecified  	O	null
3 שץ שץ שץ properName unspecified unspecified unspecified unspecified unspecified  	I_PERS	null
4 , , , punctuation unspecified unspecified unspecified unspecified unspecified  	O	null
5 ה ה הרומן definiteArticle unspecified unspecified unspecified unspecified unspecified 0 
5 הרומן רומן הרומן noun masculine singular absolute unspecified unspecified  	O	null
6 לשוט שט לשוט verb unspecified unspecified unspecified unspecified infinitive  	O	null
7 אל אל אל preposition unspecified unspecified unspecified unspecified unspecified  	O	null
8 ה ה השקיעה definiteArticle unspecified unspecified unspecified unspecified unspecified 0 
8 השקיעה שקיעה השקיעה noun feminine singular absolute unspecified unspecified  	O	null
9 ) ) ) punctuation unspecified unspecified unspecified unspecified unspecified  	O	null
10 , , , punctuation unspecified unspecified unspecified unspecified unspecified  	O	null
11 ###NUMBER### ###NUMBER### ###NUMBER### numeral unspecified unspecified unspecified unspecified unspecified  	I_DATE	null
12 הוא הוא הוא pronoun masculine singular unspecified 3 unspecified  	O	null
13 סיפור סיפור סיפור noun masculine singular construct unspecified unspecified  	O	null
14 אהבה אהבה אהבה noun feminine singular absolute unspecified unspecified  	O	null
15 ה ה המתחזה definiteArticle unspecified unspecified unspecified unspecified unspecified 0 
15 המתחזה התחזה המתחזה participle masculine singular absolute any unspecified  	O	null
16 ל ל לספר preposition unspecified unspecified unspecified unspecified unspecified 0 
16 ספר ספר לספר noun masculine singular construct unspecified unspecified  	O	null
17 מתח מתח מתח noun masculine singular absolute unspecified unspecified  	O	null
18 ו ו ולהפך conjunction unspecified unspecified unspecified unspecified unspecified 0 
18 להפך היפך ולהפך verb unspecified unspecified unspecified unspecified infinitive  	O	null
19 . . . punctuation unspecified unspecified unspecified unspecified unspecified  	O	null

0 זהו זהו זהו pronoun masculine singular unspecified 3 unspecified  	O	null
1 מסע מסע מסע noun masculine singular construct unspecified unspecified  	O	null
2 ה ה הבוחן definiteArticle unspecified unspecified unspecified unspecified unspecified 0 
2 הבוחן בוחן הבוחן noun masculine singular absolute unspecified unspecified  	O	null
3 כמה כמה כמה verb masculine singular unspecified 3 past  	O	null
4 מ מ מצומתי preposition unspecified unspecified unspecified unspecified unspecified 0 
4 צומת צומת מצומתי noun feminine singular absolute unspecified unspecified  
4 י י מצומתי possessive masculine-and-feminine singular unspecified 1 unspecified 0 	O	null
5 ה ה העצבים definiteArticle unspecified unspecified unspecified unspecified unspecified 0 
5 העצבים עצב העצבים noun masculine plural absolute unspecified unspecified  	O	null
6 ה ה המרכזיים definiteArticle unspecified unspecified unspecified unspecified unspecified 0 
6 המרכזיים מרכזי המרכזיים adjective masculine plural absolute unspecified unspecified  	O	null
7 של של של shel-preposition unspecified unspecified unspecified unspecified unspecified  	O	null
8 ה ה התרבות definiteArticle unspecified unspecified unspecified unspecified unspecified 0 
8 התרבות תרבות התרבות noun feminine singular absolute unspecified unspecified  	O	null
9 ה ה הישראלית definiteArticle unspecified unspecified unspecified unspecified unspecified 0 
9 הישראלית ישראלי הישראלית adjective feminine singular absolute unspecified unspecified  	O	null
10 ו ו ובה conjunction unspecified unspecified unspecified unspecified unspecified 0 
10 ב ב ובה preposition unspecified unspecified unspecified unspecified unspecified  
10 ה ה ובה pronomial feminine singular unspecified 3 unspecified 0 	O	null
11 ב ב בעת preposition unspecified unspecified unspecified unspecified unspecified 0 
11 עת עת בעת noun feminine singular construct unspecified unspecified  	O	null
12 סיפור סיפור סיפור noun masculine singular construct unspecified unspecified  	O	null
13 כיסוי כיסוי כיסוי noun masculine singular absolute unspecified unspecified  	O	null
14 פוסט פוסט פוסט wPrefix unspecified unspecified unspecified unspecified unspecified  	I_ORG	null
15 - - - punctuation unspecified unspecified unspecified unspecified unspecified  	I_ORG	null
16 מודרני מודרני מודרני adjective masculine singular absolute unspecified unspecified  	I_ORG	null
17 מבריק מבריק מבריק adjective masculine singular absolute unspecified unspecified  	O	null
18 על על על preposition unspecified unspecified unspecified unspecified unspecified  	O	null
19 מסע מסע מסע noun masculine singular absolute unspecified unspecified  	O	null
20 רומנטי רומנטי רומנטי adjective masculine singular absolute unspecified unspecified  	O	null
21 הזוי הזה הזוי participle masculine singular absolute any unspecified  	O	null
22 ב ב בנוסח preposition unspecified unspecified unspecified unspecified unspecified 0 
22 נוסח נוסח בנוסח noun masculine singular construct unspecified unspecified  	O	null
23 אדגר אדגר אדגר properName unspecified unspecified unspecified unspecified unspecified  	I_PERS	null
24 אלן אלן אלן properName unspecified unspecified unspecified unspecified unspecified  	I_PERS	null
25 פו פו פו properName unspecified unspecified unspecified unspecified unspecified  	I_PERS	null
26 . . . punctuation unspecified unspecified unspecified unspecified unspecified  	O	null

0 ה ה הספר definiteArticle unspecified unspecified unspecified unspecified unspecified 0 
0 הספר ספר הספר noun masculine singular absolute unspecified unspecified  	O	null
1 זכה זך זכה adjective feminine singular absolute unspecified unspecified  	O	null
2 ב ב במלגת preposition unspecified unspecified unspecified unspecified unspecified 0 
2 מלגת מלגה במלגת noun feminine singular construct unspecified unspecified  	O	null
3 " " " punctuation unspecified unspecified unspecified unspecified unspecified  	O	null
4 קרן קרן קרן properName feminine singular unspecified unspecified unspecified  	I_ORG	null
5 תרבות תרבות תרבות properName unspecified unspecified unspecified unspecified unspecified  	I_ORG	null
6 חיפה חיפה חיפה properName unspecified unspecified unspecified unspecified unspecified  	I_ORG	null
7 " " " punctuation unspecified unspecified unspecified unspecified unspecified  	O	null
8 ( ( ( punctuation unspecified unspecified unspecified unspecified unspecified  	O	null
9 ###NUMBER### ###NUMBER### ###NUMBER### numeral unspecified unspecified unspecified unspecified unspecified  	I_DATE	null
10 ) ) ) punctuation unspecified unspecified unspecified unspecified unspecified  	O	null
11 ו ו ובפרס conjunction unspecified unspecified unspecified unspecified unspecified 0 
11 ב ב ובפרס preposition unspecified unspecified unspecified unspecified unspecified 0 
11 פרס פרס ובפרס noun masculine singular construct unspecified unspecified  	O	null
12 על על על preposition unspecified unspecified unspecified unspecified unspecified  	O	null
13 שם שם שם adverb unspecified unspecified unspecified unspecified unspecified  	O	null
14 פטר פיטר פטר verb masculine singular unspecified 3 past  	O	null
15 ש ש שביפרט relativizer/subordinatingConjunction unspecified unspecified unspecified unspecified unspecified 0 
15 ביפרט ביפרט שביפרט noun masculine singular construct unspecified unspecified  	O	null
16 מטעם מטעם מטעם preposition unspecified unspecified unspecified unspecified unspecified  	O	null
17 ה ה האוניברסיטה definiteArticle unspecified unspecified unspecified unspecified unspecified 0 
17 האוניברסיטה אוניברסיטה האוניברסיטה noun feminine singular absolute unspecified unspecified  	O	null
18 ה ה העברית definiteArticle unspecified unspecified unspecified unspecified unspecified 0 
18 העברית עברית העברית properName feminine singular unspecified unspecified unspecified  	I_ORG	null
19 ב ב בירושלים preposition unspecified unspecified unspecified unspecified unspecified 0 
19 ירושלים ירושלים בירושלים properName unspecified unspecified unspecified unspecified unspecified  	I_LOC	null
20 ) ) ) punctuation unspecified unspecified unspecified unspecified unspecified  	O	null
21 . . . punctuation unspecified unspecified unspecified unspecified unspecified  	O	null
22 ###NUMBER### ###NUMBER### ###NUMBER### numeral unspecified unspecified unspecified unspecified unspecified  	I_DATE	null
23 ב ב בנימוקים preposition unspecified unspecified unspecified unspecified unspecified 0 
23 ה ה בנימוקים definiteArticle unspecified unspecified unspecified unspecified unspecified 0 
23 הנימוקים נימוק בנימוקים noun masculine plural absolute unspecified unspecified  	O	null
24 ל ל למתן preposition unspecified unspecified unspecified unspecified unspecified 0 
24 מתן מתן למתן properName masculine singular unspecified unspecified unspecified  	I_PERS	null
25 ה ה הפרס definiteArticle unspecified unspecified unspecified unspecified unspecified 0 
25 הפרס פרס הפרס noun masculine singular absolute unspecified unspecified  	O	null
26 ציינו ציין ציינו verb masculine-and-feminine plural unspecified 1 past  	O	null
27 חברי חבר חברי noun masculine plural construct unspecified unspecified  	O	null
28 ו ו ועדת conjunction unspecified unspecified unspecified unspecified unspecified 0 
28 עדת עדה ועדת noun feminine singular construct unspecified unspecified  	O	null
29 ה ה הפרס definiteArticle unspecified unspecified unspecified unspecified unspecified 0 
29 הפרס פרס הפרס noun masculine singular absolute unspecified unspecified  	O	null
30 ( ( ( punctuation unspecified unspecified unspecified unspecified unspecified  	O	null
31 חיים חיים חיים properName unspecified unspecified unspecified unspecified unspecified  	I_PERS	null
32 גורי גור גורי noun masculine plural construct unspecified unspecified  	O	null
33 , , , punctuation unspecified unspecified unspecified unspecified unspecified  	O	null
34 ד"ר ד"ר ד"ר title unspecified singular unspecified unspecified unspecified  	O	null
35 איריס איריס איריס properName unspecified unspecified unspecified unspecified unspecified  	I_PERS	null
36 פרוש פרש פרוש verb masculine singular unspecified 2 imperative  	O	null
37 ו ו וד"ר conjunction unspecified unspecified unspecified unspecified unspecified 0 
37 ד"ר ד"ר וד"ר noun masculine singular absolute unspecified unspecified  	O	null
38 יגאל יגאל יגאל properName unspecified unspecified unspecified unspecified unspecified  	I_PERS	null
39 שוורץ שוורץ שוורץ properName unspecified unspecified unspecified unspecified unspecified  	I_PERS	null
40 ) ) ) punctuation unspecified unspecified unspecified unspecified unspecified  	O	null
41 כי כי כי conjunction unspecified unspecified unspecified unspecified unspecified  	O	null
42 : : : punctuation unspecified unspecified unspecified unspecified unspecified  	O	null
43 " " " punctuation unspecified unspecified unspecified unspecified unspecified  	O	null
44 שץ שץ שץ properName unspecified unspecified unspecified unspecified unspecified  	O	null
45 הוא הוא הוא pronoun masculine singular unspecified 3 unspecified  	O	null
46 בעל בעל בעל verb masculine singular unspecified 2 imperative  	O	null
47 יכולת יכולת יכולת noun feminine singular construct unspecified unspecified  	O	null
48 וירטואוזית וירטואוז וירטואוזית adjective feminine singular construct unspecified unspecified  	O	null
49 לחקות חיקה לחקות verb unspecified unspecified unspecified unspecified infinitive  	O	null
50 סגנונות סגנון סגנונות noun masculine plural construct unspecified unspecified  	O	null
51 אמנותיים אמנותי אמנותיים adjective masculine plural absolute unspecified unspecified  	O	null
52 מ מ מאסכולות preposition unspecified unspecified unspecified unspecified unspecified 0 
52 אסכולות אסכולה מאסכולות noun feminine plural construct unspecified unspecified  	O	null
53 ו ו ומתקופות conjunction unspecified unspecified unspecified unspecified unspecified 0 
53 מ מ ומתקופות preposition unspecified unspecified unspecified unspecified unspecified 0 
53 תקופות תקף ומתקופות participle feminine plural construct any unspecified  	O	null
54 שונות שנה שונות verb feminine plural unspecified any beinoni  	O	null
55 , , , punctuation unspecified unspecified unspecified unspecified unspecified  	O	null
56 הוא הוא הוא pronoun masculine singular unspecified 3 unspecified  	O	null
57 משתמש משתמש משתמש noun masculine singular construct unspecified unspecified  	O	null
58 ב ב בסגולה preposition unspecified unspecified unspecified unspecified unspecified 0 
58 ה ה בסגולה definiteArticle unspecified unspecified unspecified unspecified unspecified 0 
58 הסגולה סגול בסגולה adjective feminine singular absolute unspecified unspecified  	O	null
59 ה ה הנפלאה definiteArticle unspecified unspecified unspecified unspecified unspecified 0 
59 הנפלאה נפלא הנפלאה adjective feminine singular absolute unspecified unspecified  	O	null
60 ה ה הזו definiteArticle unspecified unspecified unspecified unspecified unspecified 0 
60 הזו זו הזו pronoun feminine singular unspecified 3 unspecified  	O	null
61 כדי כדי כדי conjunction unspecified unspecified unspecified unspecified unspecified  	O	null
62 לתעתע תעתע לתעתע verb unspecified unspecified unspecified unspecified infinitive  	O	null
63 ב ב בקורא preposition unspecified unspecified unspecified unspecified unspecified 0 
63 קורא קורא בקורא noun masculine singular construct unspecified unspecified  	O	null
64 , , , punctuation unspecified unspecified unspecified unspecified unspecified  	O	null
65 לשעשע שיעשע לשעשע verb unspecified unspecified unspecified unspecified infinitive  	O	null
66 אותו אותו אותו quantifier unspecified unspecified construct unspecified unspecified  	O	null
67 ו ו וגם conjunction unspecified unspecified unspecified unspecified unspecified 0 
67 גם גם וגם conjunction unspecified unspecified unspecified unspecified unspecified  	O	null
68 לרמוז רמז לרמוז verb unspecified unspecified unspecified unspecified infinitive  	O	null
69 לו לו לו conjunction unspecified unspecified unspecified unspecified unspecified  	O	null
70 על על על preposition unspecified unspecified unspecified unspecified unspecified  	O	null
71 ה ה הקושי definiteArticle unspecified unspecified unspecified unspecified unspecified 0 
71 הקושי קושי הקושי noun masculine singular absolute unspecified unspecified  	O	null
72 ה ה העצום definiteArticle unspecified unspecified unspecified unspecified unspecified 0 
72 העצום עצם העצום participle masculine singular absolute any unspecified  	O	null
73 – – – punctuation unspecified unspecified unspecified unspecified unspecified  	O	null
74 ב ב בעיקר preposition unspecified unspecified unspecified unspecified unspecified 0 
74 עיקר עיקר בעיקר quantifier unspecified unspecified construct unspecified unspecified  	O	null
75 ל ל למי preposition unspecified unspecified unspecified unspecified unspecified 0 
75 מי מים למי noun masculine plural construct unspecified unspecified  	O	null
76 ש ש שצמח relativizer/subordinatingConjunction unspecified unspecified unspecified unspecified unspecified 0 
76 צמח צימח שצמח verb masculine singular unspecified 3 past  	O	null
77 ב ב בתרבות preposition unspecified unspecified unspecified unspecified unspecified 0 
77 תרבות תרבות בתרבות noun feminine singular construct unspecified unspecified  	O	null
78 בת בת בת noun feminine singular construct unspecified unspecified  	O	null
79 - - - punctuation unspecified unspecified unspecified unspecified unspecified  	O	null
80 זמן זמן זמננו noun masculine singular absolute unspecified unspecified  
80 נו נו זמננו possessive masculine-and-feminine plural unspecified 1 unspecified 0 	O	null
81 – – – punctuation unspecified unspecified unspecified unspecified unspecified  	O	null
82 לחוות חיווה לחוות verb unspecified unspecified unspecified unspecified infinitive  	O	null
83 חוויות חוויה חוויות noun feminine plural construct unspecified unspecified  	O	null
84 אותנטיות אותנטי אותנטיות adjective feminine plural absolute unspecified unspecified  	O	null
85 , , , punctuation unspecified unspecified unspecified unspecified unspecified  	O	null
86 קל קל קל modal masculine singular unspecified unspecified past  	O	null
87 ו ו וחומר conjunction unspecified unspecified unspecified unspecified unspecified 0 
87 חומר חומר וחומר noun masculine singular construct unspecified unspecified  	O	null
88 , , , punctuation unspecified unspecified unspecified unspecified unspecified  	O	null
89 לשחזר שחזר לשחזר verb unspecified unspecified unspecified unspecified infinitive  	O	null
90 את את אותן at-preposition unspecified unspecified unspecified unspecified unspecified  
90 הן הן אותן pronomial feminine plural unspecified 3 unspecified 0 	O	null
91 בספר...'לשוט בספר...'לשוט בספר...'לשוט adverb unspecified unspecified unspecified unspecified unspecified  	O	null
92 אל אל אל modal masculine singular unspecified unspecified past  	O	null
93 השקיעה השקיע השקיעה verb feminine singular unspecified 3 past  	O	null
94 ' ' ' punctuation unspecified unspecified unspecified unspecified unspecified  	O	null
95 הוא הוא הוא pronoun masculine singular unspecified 3 unspecified  	O	null
96 ספר ספר ספר noun masculine singular construct unspecified unspecified  	O	null
97 ש ש שכולו relativizer/subordinatingConjunction unspecified unspecified unspecified unspecified unspecified 0 
97 כול כול שכולו quantifier unspecified unspecified unspecified unspecified unspecified  
97 ו ו שכולו pronomial masculine singular unspecified 3 unspecified 0 	O	null
98 הצדעה הצדעה הצדעה noun feminine singular absolute unspecified unspecified  	O	null
99 ל ל לספרות preposition unspecified unspecified unspecified unspecified unspecified 0 
99 ספרות ספרה לספרות noun feminine plural construct unspecified unspecified  	O	null
100 ו ו ולכתיבה conjunction unspecified unspecified unspecified unspecified unspecified 0 
100 ל ל ולכתיבה preposition unspecified unspecified unspecified unspecified unspecified 0 
100 ה ה ולכתיבה definiteArticle unspecified unspecified unspecified unspecified unspecified 0 
100 הכתיבה כתיבה ולכתיבה noun feminine singular absolute unspecified unspecified  	O	null
101 ה ה הספרותית definiteArticle unspecified unspecified unspecified unspecified unspecified 0 
101 הספרותית ספרותי הספרותית adjective feminine singular absolute unspecified unspecified  	O	null
102 , , , punctuation unspecified unspecified unspecified unspecified unspecified  	O	null
103 ו ו ויחד conjunction unspecified unspecified unspecified unspecified unspecified 0 
103 יחד יחד ויחד adverb unspecified unspecified unspecified unspecified unspecified  	O	null
104 עם עם עם preposition unspecified unspecified unspecified unspecified unspecified  	O	null
105 זאת זאת זאת pronoun feminine singular unspecified 3 unspecified  	O	null
106 ספר ספר ספר noun masculine singular construct unspecified unspecified  	O	null
107 ש ש שכולו relativizer/subordinatingConjunction unspecified unspecified unspecified unspecified unspecified 0 
107 כול כול שכולו quantifier unspecified unspecified unspecified unspecified unspecified  
107 ו ו שכולו pronomial masculine singular unspecified 3 unspecified 0 	O	null
108 ספקות ספק ספקות noun masculine plural construct unspecified unspecified  	O	null
109 ב ב ביחס preposition unspecified unspecified unspecified unspecified unspecified 0 
109 יחס יחס ביחס noun masculine singular construct unspecified unspecified  	O	null
110 ל ל לכוחה preposition unspecified unspecified unspecified unspecified unspecified 0 
110 כוח כוח לכוחה noun masculine singular absolute unspecified unspecified  
110 ה ה לכוחה possessive feminine singular unspecified 3 unspecified 0 	O	null
111 של של של shel-preposition unspecified unspecified unspecified unspecified unspecified  	O	null
112 ה ה הספרות definiteArticle unspecified unspecified unspecified unspecified unspecified 0 
112 הספרות ספרה הספרות noun feminine plural absolute unspecified unspecified  	O	null
113 לבטא ביטא לבטא verb unspecified unspecified unspecified unspecified infinitive  	O	null
114 את את את at-preposition unspecified unspecified unspecified unspecified unspecified  	O	null
115 רגשותי רגש רגשותינו noun masculine plural absolute unspecified unspecified  
115 נו נו רגשותינו possessive masculine-and-feminine plural unspecified 1 unspecified 0 	O	null
116 ו ו ומחשבותינו conjunction unspecified unspecified unspecified unspecified unspecified 0 
116 מחשבות חישב ומחשבותינו participle feminine plural unspecified any unspecified  
116 נו נו ומחשבותינו possessive masculine-and-feminine plural unspecified 1 unspecified 0 	O	null
117 . . . punctuation unspecified unspecified unspecified unspecified unspecified  	O	null

0 ספר ספר ספר noun masculine singular construct unspecified unspecified  	O	null
1 פוסט פוסט פוסט noun masculine singular absolute unspecified unspecified  	O	null
2 - - - punctuation unspecified unspecified unspecified unspecified unspecified  	O	null
3 מודרניסטי מודרניסטי מודרניסטי noun masculine singular absolute unspecified unspecified  	O	null
4 משוכלל משוכלל משוכלל adjective masculine singular absolute unspecified unspecified  	O	null
5 ו ו ומבריק conjunction unspecified unspecified unspecified unspecified unspecified 0 
5 מבריק מבריק ומבריק adjective masculine singular absolute unspecified unspecified  	O	null
6 , , , punctuation unspecified unspecified unspecified unspecified unspecified  	O	null
7 ביטוי ביטוי ביטוי noun masculine singular absolute unspecified unspecified  	O	null
8 מובהק מובהק מובהק adjective masculine singular absolute unspecified unspecified  	O	null
9 מאין מאין מאין adverb unspecified unspecified unspecified unspecified unspecified  	O	null
10 כמו כמו כמוהו preposition unspecified unspecified unspecified unspecified unspecified  
10 ו ו כמוהו pronomial masculine singular unspecified 3 unspecified 0 	O	null
11 ל ל לפסגות preposition unspecified unspecified unspecified unspecified unspecified 0 
11 ה ה לפסגות definiteArticle unspecified unspecified unspecified unspecified unspecified 0 
11 הפסגות פסגה לפסגות noun feminine plural absolute unspecified unspecified  	O	null
12 ה ה האמנותיות definiteArticle unspecified unspecified unspecified unspecified unspecified 0 
12 האמנותיות אמנותי האמנותיות adjective feminine plural absolute unspecified unspecified  	O	null
13 ש ש שהתופעה relativizer/subordinatingConjunction unspecified unspecified unspecified unspecified unspecified 0 
13 ה ה שהתופעה definiteArticle unspecified unspecified unspecified unspecified unspecified 0 
13 התופעה תופעה שהתופעה noun feminine singular absolute unspecified unspecified  	O	null
14 ה ה החברתית definiteArticle unspecified unspecified unspecified unspecified unspecified 0 
14 החברתית חברתי החברתית adjective feminine singular absolute unspecified unspecified  	O	null
15 - - - punctuation unspecified unspecified unspecified unspecified unspecified  	O	null
16 תרבותית תרבותי תרבותית adjective feminine singular absolute unspecified unspecified  	O	null
17 ה ה הזו definiteArticle unspecified unspecified unspecified unspecified unspecified 0 
17 הזו זו הזו pronoun feminine singular unspecified 3 unspecified  	O	null
18 מאפשרת אפשר מאפשרת verb feminine singular unspecified any beinoni  	O	null
19 לכבוש כבש לכבוש verb unspecified unspecified unspecified unspecified infinitive  	O	null
20 , , , punctuation unspecified unspecified unspecified unspecified unspecified  	O	null
21 אבל אבל אבל conjunction unspecified unspecified unspecified unspecified unspecified  	O	null
22 גם גם גם conjunction unspecified unspecified unspecified unspecified unspecified  	O	null
23 ל ל לתהומות preposition unspecified unspecified unspecified unspecified unspecified 0 
23 תהומות תהום לתהומות noun feminine plural construct unspecified unspecified  	O	null
24 ה ה הייאוש definiteArticle unspecified unspecified unspecified unspecified unspecified 0 
24 הייאוש ייאוש הייאוש noun masculine singular absolute unspecified unspecified  	O	null
25 ו ו והניכור conjunction unspecified unspecified unspecified unspecified unspecified 0 
25 ה ה והניכור definiteArticle unspecified unspecified unspecified unspecified unspecified 0 
25 הניכור ניכור והניכור noun masculine singular absolute unspecified unspecified  	O	null
26 ה ה הרובצים definiteArticle unspecified unspecified unspecified unspecified unspecified 0 
26 הרובצים רבץ הרובצים participle masculine plural absolute any unspecified  	O	null
27 ל ל לפתחה preposition unspecified unspecified unspecified unspecified unspecified 0 
27 פתח פתח לפתחה noun masculine singular absolute unspecified unspecified  
27 ה ה לפתחה possessive feminine singular unspecified 3 unspecified 0 	O	null
28 " " " punctuation unspecified unspecified unspecified unspecified unspecified  	O	null
29 . . . punctuation unspecified unspecified unspecified unspecified unspecified  	O	null

0 שץ שץ שץ properName unspecified unspecified unspecified unspecified unspecified  	O	null
1 הוא הוא הוא pronoun masculine singular unspecified 3 unspecified  	O	null
2 גם גם גם conjunction unspecified unspecified unspecified unspecified unspecified  	O	null
3 מ מ מחלוצי preposition unspecified unspecified unspecified unspecified unspecified 0 
3 חלוצי חלוץ מחלוצי noun masculine plural construct unspecified unspecified  	O	null
4 ה ה הכתיבה definiteArticle unspecified unspecified unspecified unspecified unspecified 0 
4 הכתיבה כתיבה הכתיבה noun feminine singular absolute unspecified unspecified  	O	null
5 ה ה הספרותית definiteArticle unspecified unspecified unspecified unspecified unspecified 0 
5 הספרותית ספרותי הספרותית adjective feminine singular absolute unspecified unspecified  	O	null
6 ב ב ברשת preposition unspecified unspecified unspecified unspecified unspecified 0 
6 רשת רשת ברשת noun feminine singular construct unspecified unspecified  	O	null
7 ה ה האינטרנט definiteArticle unspecified unspecified unspecified unspecified unspecified 0 
7 האינטרנט אינטרנט האינטרנט noun masculine singular absolute unspecified unspecified  	O	null
8 . . . punctuation unspecified unspecified unspecified unspecified unspecified  	O	null

0 הוא הוא הוא pronoun masculine singular unspecified 3 unspecified  	O	null
1 למד למד למד verb masculine singular unspecified 3 past  	O	null
2 ו ו והשתכלל conjunction unspecified unspecified unspecified unspecified unspecified 0 
2 השתכלל השתכלל והשתכלל verb masculine singular unspecified 3 past  	O	null
3 ב ב בצדדים preposition unspecified unspecified unspecified unspecified unspecified 0 
3 ה ה בצדדים definiteArticle unspecified unspecified unspecified unspecified unspecified 0 
3 הצדדים צד בצדדים noun masculine plural absolute unspecified unspecified  	O	null
4 ה ה הטכניים definiteArticle unspecified unspecified unspecified unspecified unspecified 0 
4 הטכניים טכני הטכניים adjective masculine plural absolute unspecified unspecified  	O	null
5 של של של shel-preposition unspecified unspecified unspecified unspecified unspecified  	O	null
6 ה ה הפרסום definiteArticle unspecified unspecified unspecified unspecified unspecified 0 
6 הפרסום פרסום הפרסום noun masculine singular absolute unspecified unspecified  	O	null
7 ב ב ברשת preposition unspecified unspecified unspecified unspecified unspecified 0 
7 ה ה ברשת definiteArticle unspecified unspecified unspecified unspecified unspecified 0 
7 הרשת רשת ברשת noun feminine singular absolute unspecified unspecified  	O	null
8 , , , punctuation unspecified unspecified unspecified unspecified unspecified  	O	null
9 ו ו והקים conjunction unspecified unspecified unspecified unspecified unspecified 0 
9 הקים הקים והקים verb masculine singular unspecified 3 past  	O	null
10 אתר אתר אתר noun masculine singular absolute unspecified unspecified  	O	null
11 אישי אישי אישי adjective masculine singular absolute unspecified unspecified  	O	null
12 עצמאי עצמאי עצמאי adjective masculine singular absolute unspecified unspecified  	O	null
13 עוד עוד עוד adverb unspecified unspecified unspecified unspecified unspecified  	O	null
14 ב ב ב preposition unspecified unspecified unspecified unspecified unspecified 0 	O	null
15 - - - punctuation unspecified unspecified unspecified unspecified unspecified  	O	null
16 , , , punctuation unspecified unspecified unspecified unspecified unspecified  	O	null
17 ###NUMBER### ###NUMBER### ###NUMBER### numeral unspecified unspecified unspecified unspecified unspecified  	I_DATE	null
18 ו ו והוא conjunction unspecified unspecified unspecified unspecified unspecified 0 
18 הוא הוא והוא pronoun masculine singular unspecified 3 unspecified  	O	null
19 מ מ מראשוני preposition unspecified unspecified unspecified unspecified unspecified 0 
19 ראשוני ראשונים מראשוני noun masculine plural construct unspecified unspecified  	O	null
20 ה ה הסופרים definiteArticle unspecified unspecified unspecified unspecified unspecified 0 
20 הסופרים סופר הסופרים noun masculine plural absolute unspecified unspecified  	O	null
21 ב ב בארץ preposition unspecified unspecified unspecified unspecified unspecified 0 
21 ה ה בארץ definiteArticle unspecified unspecified unspecified unspecified unspecified 0 
21 הארץ ארץ בארץ noun feminine singular absolute unspecified unspecified  	O	null
22 ש ש שהחלו relativizer/subordinatingConjunction unspecified unspecified unspecified unspecified unspecified 0 
22 החלו החל שהחלו verb masculine-and-feminine plural unspecified 3 past  	O	null
23 לפרסם פרסם לפרסם verb unspecified unspecified unspecified unspecified infinitive  	O	null
24 בלוג בלוג בלוג noun masculine singular absolute unspecified unspecified  	O	null
25 , , , punctuation unspecified unspecified unspecified unspecified unspecified  	O	null
26 בעיקר בעיקר בעיקר adverb unspecified unspecified unspecified unspecified unspecified  	O	null
27 ב ב בנושאים preposition unspecified unspecified unspecified unspecified unspecified 0 
27 נושאים נושא בנושאים noun masculine plural absolute unspecified unspecified  	O	null
28 ספרותיים ספרותי ספרותיים adjective masculine plural absolute unspecified unspecified  	O	null
29 . . . punctuation unspecified unspecified unspecified unspecified unspecified  	O	null

0 כמה כמה כמה quantifier unspecified unspecified construct unspecified unspecified  	O	null
1 מ מ מסיפוריו preposition unspecified unspecified unspecified unspecified unspecified 0 
1 סיפורי סיפור מסיפוריו noun masculine plural absolute unspecified unspecified  
1 ו ו מסיפוריו possessive masculine singular unspecified 3 unspecified 0 	O	null
2 של של של shel-preposition unspecified unspecified unspecified unspecified unspecified  	O	null
3 שץ שץ שץ properName unspecified unspecified unspecified unspecified unspecified  	I_PERS	null
4 תורגמו תורגם תורגמו verb masculine-and-feminine plural unspecified 3 past  	O	null
5 ל ל לאנגלית preposition unspecified unspecified unspecified unspecified unspecified 0 
5 אנגלית אנגלית לאנגלית properName feminine singular unspecified unspecified unspecified  	I_PERS	null
6 , , , punctuation unspecified unspecified unspecified unspecified unspecified  	O	null
7 ל ל לסינית preposition unspecified unspecified unspecified unspecified unspecified 0 
7 סינית סיני לסינית noun feminine singular absolute unspecified unspecified  	O	null
8 ו ו וליפנית conjunction unspecified unspecified unspecified unspecified unspecified 0 
8 ל ל וליפנית preposition unspecified unspecified unspecified unspecified unspecified 0 
8 ה ה וליפנית definiteArticle unspecified unspecified unspecified unspecified unspecified 0 
8 היפנית יפני וליפנית adjective feminine singular absolute unspecified unspecified  	O	null
9 . . . punctuation unspecified unspecified unspecified unspecified unspecified  	O	null

0 References References References foreign unspecified unspecified unspecified unspecified unspecified  	O	null
1 : : : punctuation unspecified unspecified unspecified unspecified unspecified  	O	null
2 הולצמן הולצמן הולצמן properName unspecified unspecified unspecified unspecified unspecified  	I_ORG	null
3 , , , punctuation unspecified unspecified unspecified unspecified unspecified  	O	null
4 אבנר אבנר אבנר properName unspecified unspecified unspecified unspecified unspecified  	I_PERS	null
5 . . . punctuation unspecified unspecified unspecified unspecified unspecified  	O	null

0 " " " punctuation unspecified unspecified unspecified unspecified unspecified  	O	null
1 צעצוע צעצוע צעצוע noun masculine singular absolute unspecified unspecified  	O	null
2 בוהק בוהק בוהק adjective masculine singular absolute unspecified unspecified  	O	null
3 ו ו ומשוכלל conjunction unspecified unspecified unspecified unspecified unspecified 0 
3 משוכלל משוכלל ומשוכלל adjective masculine singular absolute unspecified unspecified  	O	null
4 " " " punctuation unspecified unspecified unspecified unspecified unspecified  	O	null
5 . . . punctuation unspecified unspecified unspecified unspecified unspecified  	O	null

0 מפת מפה מפת noun feminine singular construct unspecified unspecified  	O	null
1 דרכים דרך דרכים noun feminine plural absolute unspecified unspecified  	O	null
2 : : : punctuation unspecified unspecified unspecified unspecified unspecified  	O	null
3 סיפורת סיפורת סיפורת noun feminine singular absolute unspecified unspecified  	O	null
4 עברית עברי עברית adjective feminine singular absolute unspecified unspecified  	O	null
5 כיום כיום כיום adverb unspecified unspecified unspecified unspecified unspecified  	O	null
6 . . . punctuation unspecified unspecified unspecified unspecified unspecified  	O	null

0 תל תל תל properName unspecified unspecified unspecified unspecified unspecified  	I_LOC	null
1 אביב אביב אביב properName unspecified unspecified unspecified unspecified unspecified  	I_LOC	null
2 : : : punctuation unspecified unspecified unspecified unspecified unspecified  	O	null
3 ה ה הקיבוץ definiteArticle unspecified unspecified unspecified unspecified unspecified 0 
3 הקיבוץ קיבוץ הקיבוץ noun masculine singular absolute unspecified unspecified  	O	null
4 ה ה המאוחד definiteArticle unspecified unspecified unspecified unspecified unspecified 0 
4 המאוחד מאוחד המאוחד adjective masculine singular absolute unspecified unspecified  	O	null
5 . . . punctuation unspecified unspecified unspecified unspecified unspecified  	O	null

0 ###NUMBER### ###NUMBER### ###NUMBER### numeral unspecified unspecified unspecified unspecified unspecified  	I_DATE	null
1 . . . punctuation unspecified unspecified unspecified unspecified unspecified  	O	null

0 - - - punctuation unspecified unspecified unspecified unspecified unspecified  	O	null
1 ###NUMBER### ###NUMBER### ###NUMBER### numeral unspecified unspecified unspecified unspecified unspecified  	O	null
2 ; ; ; punctuation unspecified unspecified unspecified unspecified unspecified  	O	null
3 ###NUMBER### ###NUMBER### ###NUMBER### numeral unspecified unspecified unspecified unspecified unspecified  	O	null
4 הופמן הופמן הופמן properName unspecified unspecified unspecified unspecified unspecified  	O	null
5 , , , punctuation unspecified unspecified unspecified unspecified unspecified  	O	null
6 חיה חי חיה verb feminine singular unspecified 3 past  	O	null
7 . . . punctuation unspecified unspecified unspecified unspecified unspecified  	O	null

0 " " " punctuation unspecified unspecified unspecified unspecified unspecified  	O	null
1 למרוד מרד למרוד verb unspecified unspecified unspecified unspecified infinitive  	O	null
2 ב ב בכל preposition unspecified unspecified unspecified unspecified unspecified 0 
2 כל כול בכל quantifier unspecified unspecified construct unspecified unspecified  	O	null
3 " " " punctuation unspecified unspecified unspecified unspecified unspecified  	O	null
4 . . . punctuation unspecified unspecified unspecified unspecified unspecified  	O	null
5 ידיעות ידיעה ידיעות noun feminine plural absolute unspecified unspecified  	I_ORG	null
6 אחרונות אחרון אחרונות adjective feminine plural absolute unspecified unspecified  	I_ORG	null
7 ספרות ספרות ספרות noun feminine singular absolute unspecified unspecified  	O	null
8 . . . punctuation unspecified unspecified unspecified unspecified unspecified  	O	null

0 . . . punctuation unspecified unspecified unspecified unspecified unspecified  	O	null
1 ###NUMEXP### ###NUMEXP### ###NUMEXP### numberExpression unspecified unspecified unspecified unspecified unspecified  	I_DATE	null
2 ; ; ; punctuation unspecified unspecified unspecified unspecified unspecified  	O	null
3 ###NUMBER### ###NUMBER### ###NUMBER### numeral unspecified unspecified unspecified unspecified unspecified  	O	null
4 כץ כץ כץ properName unspecified unspecified unspecified unspecified unspecified  	I_PERS	null
5 , , , punctuation unspecified unspecified unspecified unspecified unspecified  	O	null
6 אבי אבי אבי properName unspecified unspecified unspecified unspecified unspecified  	I_PERS	null
7 . . . punctuation unspecified unspecified unspecified unspecified unspecified  	O	null

0 " " " punctuation unspecified unspecified unspecified unspecified unspecified  	O	null
1 מלים מילה מלים noun feminine plural absolute unspecified unspecified  	O	null
2 אינן הוא אינן copula feminine plural unspecified 3 beinoni  	O	null
3 יכולות יכולת יכולות noun feminine plural absolute unspecified unspecified  	O	null
4 " " " punctuation unspecified unspecified unspecified unspecified unspecified  	O	null
5 . . . punctuation unspecified unspecified unspecified unspecified unspecified  	O	null
6 ה ה הארץתרבות definiteArticle unspecified unspecified unspecified unspecified unspecified 0 
6 הארץתרבות הארץתרבות הארץתרבות adjective feminine plural absolute unspecified unspecified  	O	null
7 ו ו וספרות conjunction unspecified unspecified unspecified unspecified unspecified 0 
7 ספרות ספרות וספרות noun feminine singular absolute unspecified unspecified  	O	null
8 . . . punctuation unspecified unspecified unspecified unspecified unspecified  	O	null

0 . . . punctuation unspecified unspecified unspecified unspecified unspecified  	O	null
1 ###NUMEXP### ###NUMEXP### ###NUMEXP### numberExpression unspecified unspecified unspecified unspecified unspecified  	I_DATE	null
2 ב ב ב preposition unspecified unspecified unspecified unspecified unspecified 0 	I_ORG	null
3 ' ' ' punctuation unspecified unspecified unspecified unspecified unspecified  	I_ORG	null
4 ; ; ; punctuation unspecified unspecified unspecified unspecified unspecified  	O	null
5 ###NUMBER### ###NUMBER### ###NUMBER### numeral unspecified unspecified unspecified unspecified unspecified  	O	null
6 נגב נגב נגב properName unspecified unspecified unspecified unspecified unspecified  	I_LOC	null
7 , , , punctuation unspecified unspecified unspecified unspecified unspecified  	O	null
8 אילת אילת אילת properName unspecified unspecified unspecified unspecified unspecified  	I_LOC	null
9 . . . punctuation unspecified unspecified unspecified unspecified unspecified  	O	null

0 " " " punctuation unspecified unspecified unspecified unspecified unspecified  	O	null
1 עמוק עמוק עמוק adjective masculine singular absolute unspecified unspecified  	O	null
2 ב ב בפנים preposition unspecified unspecified unspecified unspecified unspecified 0 
2 ה ה בפנים definiteArticle unspecified unspecified unspecified unspecified unspecified 0 
2 הפנים פנים בפנים noun masculine singular absolute unspecified unspecified  	O	null
3 אני הוא אני pronoun masculine-and-feminine singular unspecified 1 unspecified  	I_ORG	null
4 חתרן חתרן חתרן adjective masculine singular absolute unspecified unspecified  	O	null
5 בלתי בלתי בלתי wPrefix unspecified unspecified unspecified unspecified unspecified  	O	null
6 נלאה נלאה נלאה adjective masculine singular absolute unspecified unspecified  	O	null
7 " " " punctuation unspecified unspecified unspecified unspecified unspecified  	O	null
8 . . . punctuation unspecified unspecified unspecified unspecified unspecified  	O	null
9 ידיעות ידיעה ידיעות noun feminine plural absolute unspecified unspecified  	I_ORG	null
10 אחרונות אחרון אחרונות adjective feminine plural absolute unspecified unspecified  	I_ORG	null
11 ספרות ספרות ספרות noun feminine singular absolute unspecified unspecified  	O	null
12 . . . punctuation unspecified unspecified unspecified unspecified unspecified  	O	null

0 . . . punctuation unspecified unspecified unspecified unspecified unspecified  	O	null
1 ###NUMEXP### ###NUMEXP### ###NUMEXP### numberExpression unspecified unspecified unspecified unspecified unspecified  	I_DATE	null
2 ; ; ; punctuation unspecified unspecified unspecified unspecified unspecified  	O	null
3 ###NUMBER### ###NUMBER### ###NUMBER### numeral unspecified unspecified unspecified unspecified unspecified  	O	null
4 צור צור צור properName unspecified unspecified unspecified unspecified unspecified  	I_PERS	null
5 , , , punctuation unspecified unspecified unspecified unspecified unspecified  	O	null
6 שי שי שי properName unspecified unspecified unspecified unspecified unspecified  	I_PERS	null
7 . . . punctuation unspecified unspecified unspecified unspecified unspecified  	O	null

0 " " " punctuation unspecified unspecified unspecified unspecified unspecified  	O	null
1 ה ה המסע definiteArticle unspecified unspecified unspecified unspecified unspecified 0 
1 המסע מסע המסע noun masculine singular absolute unspecified unspecified  	O	null
2 ה ה המעגלי definiteArticle unspecified unspecified unspecified unspecified unspecified 0 
2 המעגלי מעגלי המעגלי adjective masculine singular absolute unspecified unspecified  	O	null
3 " " " punctuation unspecified unspecified unspecified unspecified unspecified  	O	null
4 . . . punctuation unspecified unspecified unspecified unspecified unspecified  	O	null
5 מאזנייםע"ד מאזנייםע"ד מאזנייםע"ד properName unspecified unspecified unspecified unspecified unspecified  	I_PERS	null
6 ) ) ) punctuation unspecified unspecified unspecified unspecified unspecified  	O	null
7 . . . punctuation unspecified unspecified unspecified unspecified unspecified  	O	null
8 ###NUMBER### ###NUMBER### ###NUMBER### numeral unspecified unspecified unspecified unspecified unspecified  	O	null
9 ###NUMBER### ###NUMBER### ###NUMBER### numeral unspecified unspecified unspecified unspecified unspecified  	I_DATE	null
10 . . . punctuation unspecified unspecified unspecified unspecified unspecified  	O	null

0 ###NUMBER### ###NUMBER### ###NUMBER### numeral unspecified unspecified unspecified unspecified unspecified  	O	null
1 - - - punctuation unspecified unspecified unspecified unspecified unspecified  	O	null
2 ###NUMBER### ###NUMBER### ###NUMBER### numeral unspecified unspecified unspecified unspecified unspecified  	O	null
3 . . . punctuation unspecified unspecified unspecified unspecified unspecified  	O	null

