0 Name Name Name foreign unspecified unspecified unspecified unspecified unspecified  	O	null
1 : : : punctuation unspecified unspecified unspecified unspecified unspecified  	O	null
2 אמיר אמיר אמיר properName unspecified unspecified unspecified unspecified unspecified  	I_PERS	null
3 , , , punctuation unspecified unspecified unspecified unspecified unspecified  	O	null
4 גל גל גל noun masculine singular construct unspecified unspecified  	O	null
5 Birth Birth Birth foreign unspecified unspecified unspecified unspecified unspecified  	O	null
6 Year Year Year foreign unspecified unspecified unspecified unspecified unspecified  	O	null
7 : : : punctuation unspecified unspecified unspecified unspecified unspecified  	O	null
8 ###NUMBER### ###NUMBER### ###NUMBER### numeral unspecified unspecified unspecified unspecified unspecified  	I_DATE	null
9 Birth Birth Birth foreign unspecified unspecified unspecified unspecified unspecified  	O	null
10 Place Place Place foreign unspecified unspecified unspecified unspecified unspecified  	O	null
11 : : : punctuation unspecified unspecified unspecified unspecified unspecified  	O	null
12 עפולה עפולה עפולה properName feminine singular unspecified unspecified unspecified  	I_LOC	null
13 ל ל למשפחה preposition unspecified unspecified unspecified unspecified unspecified 0 
13 ה ה למשפחה definiteArticle unspecified unspecified unspecified unspecified unspecified 0 
13 המשפחה משפחה למשפחה noun feminine singular absolute unspecified unspecified  	O	null
14 ה ה המתגוררת definiteArticle unspecified unspecified unspecified unspecified unspecified 0 
14 המתגוררת התגורר המתגוררת participle feminine singular absolute any unspecified  	O	null
15 Occupation Occupation Occupation foreign unspecified unspecified unspecified unspecified unspecified  	O	null
16 : : : punctuation unspecified unspecified unspecified unspecified unspecified  	O	null
17 סופר סופר סופר noun masculine singular absolute unspecified unspecified  	O	null
18 Entry Entry Entry foreign unspecified unspecified unspecified unspecified unspecified  	O	null
19 writer writer writer foreign unspecified unspecified unspecified unspecified unspecified  	O	null
20 : : : punctuation unspecified unspecified unspecified unspecified unspecified  	O	null
21 אמנון אמנון אמנון properName unspecified unspecified unspecified unspecified unspecified  	I_PERS	null
22 ז'קונט ז'קונט ז'קונט properName unspecified unspecified unspecified unspecified unspecified  	I_PERS	null
23 Entry Entry Entry foreign unspecified unspecified unspecified unspecified unspecified  	O	null
24 Value Value Value foreign unspecified unspecified unspecified unspecified unspecified  	O	null
25 : : : punctuation unspecified unspecified unspecified unspecified unspecified  	O	null
26 נולד נולד נולד verb masculine singular unspecified 3 past  	O	null
27 ב ב בעפולה preposition unspecified unspecified unspecified unspecified unspecified 0 
27 עפולה עפולה בעפולה properName feminine singular unspecified unspecified unspecified  	I_LOC	null
28 ל ל למשפחה preposition unspecified unspecified unspecified unspecified unspecified 0 
28 ה ה למשפחה definiteArticle unspecified unspecified unspecified unspecified unspecified 0 
28 המשפחה משפחה למשפחה noun feminine singular absolute unspecified unspecified  	O	null
29 ה ה המתגוררת definiteArticle unspecified unspecified unspecified unspecified unspecified 0 
29 המתגוררת התגורר המתגוררת participle feminine singular absolute any unspecified  	O	null
30 ב ב בארץ preposition unspecified unspecified unspecified unspecified unspecified 0 
30 ארץ ארץ בארץ noun feminine singular construct unspecified unspecified  	O	null
31 שמונה CARD8 שמונה numeral masculine plural absolute unspecified unspecified  	O	null
32 דורות דור דורות noun masculine plural absolute unspecified unspecified  	O	null
33 . . . punctuation unspecified unspecified unspecified unspecified unspecified  	O	null

0 לאחר לאחר לאחר preposition unspecified unspecified unspecified unspecified unspecified  	O	null
1 סיום סיום סיום noun masculine singular construct unspecified unspecified  	O	null
2 שירות שירות שירותו noun masculine singular absolute unspecified unspecified  
2 ו ו שירותו possessive masculine singular unspecified 3 unspecified 0 	O	null
3 ה ה הצבאי definiteArticle unspecified unspecified unspecified unspecified unspecified 0 
3 הצבאי צבאי הצבאי adjective masculine singular absolute unspecified unspecified  	O	null
4 למד למד למד verb masculine singular unspecified 3 past  	O	null
5 משפטים משפט משפטים noun masculine plural absolute unspecified unspecified  	O	null
6 ב ב באוניברסיטה preposition unspecified unspecified unspecified unspecified unspecified 0 
6 ה ה באוניברסיטה definiteArticle unspecified unspecified unspecified unspecified unspecified 0 
6 האוניברסיטה אוניברסיטה באוניברסיטה noun feminine singular absolute unspecified unspecified  	O	null
7 ה ה העברית definiteArticle unspecified unspecified unspecified unspecified unspecified 0 
7 העברית עברי העברית adjective feminine singular absolute unspecified unspecified  	O	null
8 ב ב בירושלים preposition unspecified unspecified unspecified unspecified unspecified 0 
8 ירושלים ירושלים בירושלים properName unspecified unspecified unspecified unspecified unspecified  	I_LOC	null
9 , , , punctuation unspecified unspecified unspecified unspecified unspecified  	O	null
10 תוך תוך תוך preposition unspecified unspecified unspecified unspecified unspecified  	O	null
11 כדי כדי כדי conjunction unspecified unspecified unspecified unspecified unspecified  	O	null
12 עבודה עבודה עבודה noun feminine singular absolute unspecified unspecified  	O	null
13 כ כ כעוזר preposition unspecified unspecified unspecified unspecified unspecified 0 
13 עוזר עוזר כעוזר noun masculine singular absolute unspecified unspecified  	O	null
14 פרלמנטרי פרלמנטרי פרלמנטרי adjective masculine singular absolute unspecified unspecified  	O	null
15 ב ב בכנסת preposition unspecified unspecified unspecified unspecified unspecified 0 
15 ה ה בכנסת definiteArticle unspecified unspecified unspecified unspecified unspecified 0 
15 הכנסת כנסת בכנסת properName feminine singular unspecified unspecified unspecified  	I_ORG	null
16 . . . punctuation unspecified unspecified unspecified unspecified unspecified  	O	null

0 ב ב ב preposition unspecified unspecified unspecified unspecified unspecified 0 	O	null
1 - - - punctuation unspecified unspecified unspecified unspecified unspecified  	O	null
2 הוסמך הוסמך הוסמך verb masculine singular unspecified 3 past  	O	null
3 ###NUMBER### ###NUMBER### ###NUMBER### numeral unspecified unspecified unspecified unspecified unspecified  	I_DATE	null
4 לעסוק עסק לעסוק verb unspecified unspecified unspecified unspecified infinitive  	O	null
5 ב ב בעריכת preposition unspecified unspecified unspecified unspecified unspecified 0 
5 עריכת עריכה בעריכת noun feminine singular construct unspecified unspecified  	O	null
6 דין דין דין noun masculine singular absolute unspecified unspecified  	O	null
7 , , , punctuation unspecified unspecified unspecified unspecified unspecified  	O	null
8 ו ו ומאז conjunction unspecified unspecified unspecified unspecified unspecified 0 
8 מאז מאז ומאז adverb unspecified unspecified unspecified unspecified unspecified  	O	null
9 עוסק עסק עוסק verb masculine singular unspecified any beinoni  	O	null
10 ב ב במקצוע preposition unspecified unspecified unspecified unspecified unspecified 0 
10 מקצוע מקצוע במקצוע noun masculine singular absolute unspecified unspecified  	O	null
11 ב ב בעירו preposition unspecified unspecified unspecified unspecified unspecified 0 
11 עיר עיר בעירו noun feminine singular absolute unspecified unspecified  
11 ו ו בעירו possessive masculine singular unspecified 3 unspecified 0 	O	null
12 . . . punctuation unspecified unspecified unspecified unspecified unspecified  	O	null

0 ב ב ב preposition unspecified unspecified unspecified unspecified unspecified 0 	O	null
1 - - - punctuation unspecified unspecified unspecified unspecified unspecified  	O	null
2 ###NUMBER### ###NUMBER### ###NUMBER### numeral unspecified unspecified unspecified unspecified unspecified  	I_DATE	null
3 כתב כתב כתב verb masculine singular unspecified 3 past  	O	null
4 בתוך בתוך בתוך preposition unspecified unspecified unspecified unspecified unspecified  	O	null
5 כ כ כחודשיים preposition unspecified unspecified unspecified unspecified unspecified 0 
5 חודשיים חודש כחודשיים noun masculine dual absolute unspecified unspecified  	O	null
6 רומן רומן רומן properName unspecified unspecified unspecified unspecified unspecified  	I_PERS	null
7 מתח מתח מתח noun masculine singular absolute unspecified unspecified  	O	null
8 משפטי משפטי משפטי adjective masculine singular absolute unspecified unspecified  	O	null
9 : : : punctuation unspecified unspecified unspecified unspecified unspecified  	O	null
10 עפולה עפולה עפולה properName feminine singular unspecified unspecified unspecified  	I_LOC	null
11 , , , punctuation unspecified unspecified unspecified unspecified unspecified  	I_LOC	null
12 רח' רחוב רח' noun masculine singular absolute unspecified unspecified  	I_LOC	null
13 ה ה האופרה definiteArticle unspecified unspecified unspecified unspecified unspecified 0 
13 האופרה אופרה האופרה noun feminine singular absolute unspecified unspecified  	I_LOC	null
14 , , , punctuation unspecified unspecified unspecified unspecified unspecified  	O	null
15 ###NUMBER### ###NUMBER### ###NUMBER### numeral unspecified unspecified unspecified unspecified unspecified  	O	null
16 ש ש ששיקף relativizer/subordinatingConjunction unspecified unspecified unspecified unspecified unspecified 0 
16 שיקף שיקף ששיקף verb masculine singular unspecified 3 past  	O	null
17 את את את at-preposition unspecified unspecified unspecified unspecified unspecified  	O	null
18 ה ה ההווי definiteArticle unspecified unspecified unspecified unspecified unspecified 0 
18 ההווי ההווי ההווי noun masculine singular absolute unspecified unspecified  	O	null
19 ה ה הקרתני definiteArticle unspecified unspecified unspecified unspecified unspecified 0 
19 הקרתני קרתני הקרתני adjective masculine singular absolute unspecified unspecified  	O	null
20 - - - punctuation unspecified unspecified unspecified unspecified unspecified  	O	null
21 אכזרי אכזרי אכזרי adjective masculine singular absolute unspecified unspecified  	O	null
22 של של של shel-preposition unspecified unspecified unspecified unspecified unspecified  	O	null
23 עיר עיר עיר noun feminine singular absolute unspecified unspecified  	O	null
24 קטנה קטן קטנה adjective feminine singular absolute unspecified unspecified  	O	null
25 ב ב בעמק preposition unspecified unspecified unspecified unspecified unspecified 0 
25 ה ה בעמק definiteArticle unspecified unspecified unspecified unspecified unspecified 0 
25 העמק עמק בעמק noun masculine singular absolute unspecified unspecified  	O	null
26 . . . punctuation unspecified unspecified unspecified unspecified unspecified  	O	null

0 ה ה הרומן definiteArticle unspecified unspecified unspecified unspecified unspecified 0 
0 הרומן רומן הרומן noun masculine singular absolute unspecified unspecified  	O	null
1 התפרסם התפרסם התפרסם verb masculine singular unspecified 3 past  	O	null
2 ( ( ( punctuation unspecified unspecified unspecified unspecified unspecified  	O	null
3 זמורה זמורה זמורה noun feminine singular absolute unspecified unspecified  	O	null
4 - - - punctuation unspecified unspecified unspecified unspecified unspecified  	O	null
5 ביתן ביתן ביתן noun masculine singular absolute unspecified unspecified  	O	null
6 ) ) ) punctuation unspecified unspecified unspecified unspecified unspecified  	O	null
7 ו ו וזכה conjunction unspecified unspecified unspecified unspecified unspecified 0 
7 זכה זכה וזכה verb masculine singular unspecified 3 past  	O	null
8 ל ל להצלחה preposition unspecified unspecified unspecified unspecified unspecified 0 
8 הצלחה הצלחה להצלחה noun feminine singular absolute unspecified unspecified  	O	null
9 . . . punctuation unspecified unspecified unspecified unspecified unspecified  	O	null

0 בעקבות בעקבות בעקבותיה preposition unspecified unspecified unspecified unspecified unspecified  
0 ה ה בעקבותיה pronomial feminine singular unspecified 3 unspecified 0 	O	null
1 בחר בחר בחר verb masculine singular unspecified 3 past  	O	null
2 ה ה המחבר definiteArticle unspecified unspecified unspecified unspecified unspecified 0 
2 המחבר מחבר המחבר noun masculine singular absolute unspecified unspecified  	O	null
3 להתמודד התמודד להתמודד verb unspecified unspecified unspecified unspecified infinitive  	O	null
4 עם עם עם preposition unspecified unspecified unspecified unspecified unspecified  	O	null
5 כתיבה כתיבה כתיבה noun feminine singular absolute unspecified unspecified  	O	null
6 קנונית קנוניה קנונית noun feminine singular construct unspecified unspecified  	O	null
7 , , , punctuation unspecified unspecified unspecified unspecified unspecified  	O	null
8 ו ו וב conjunction unspecified unspecified unspecified unspecified unspecified 0 
8 ב ב וב preposition unspecified unspecified unspecified unspecified unspecified 0 	I_ORG	null
9 - - - punctuation unspecified unspecified unspecified unspecified unspecified  	I_ORG	null
10 ###NUMBER### ###NUMBER### ###NUMBER### numeral unspecified unspecified unspecified unspecified unspecified  	I_DATE	null
11 פירסם פרסם פירסם verb masculine singular unspecified 3 past  	O	null
12 את את את at-preposition unspecified unspecified unspecified unspecified unspecified  	O	null
13 ה ה הרומן definiteArticle unspecified unspecified unspecified unspecified unspecified 0 
13 הרומן רומן הרומן noun masculine singular absolute unspecified unspecified  	O	null
14 חיילי חייל חיילי noun masculine plural construct unspecified unspecified  	O	null
15 ה ה הבדיל definiteArticle unspecified unspecified unspecified unspecified unspecified 0 
15 הבדיל בדיל הבדיל noun masculine singular absolute unspecified unspecified  	O	null
16 צועדים צעד צועדים verb masculine plural unspecified any beinoni  	O	null
17 לאט לאט לאיטם adverb unspecified unspecified unspecified unspecified unspecified  
17 הם הם לאיטם pronomial masculine plural unspecified 3 unspecified 0 	O	null
18 , , , punctuation unspecified unspecified unspecified unspecified unspecified  	O	null
19 ה ה המתרחש definiteArticle unspecified unspecified unspecified unspecified unspecified 0 
19 המתרחש התרחש המתרחש participle masculine singular absolute any unspecified  	O	null
20 על על על preposition unspecified unspecified unspecified unspecified unspecified  	O	null
21 רקע רקע רקע noun masculine singular construct unspecified unspecified  	O	null
22 שירות שירות שירות noun masculine singular absolute unspecified unspecified  	O	null
23 צבאי צבאי צבאי adjective masculine singular absolute unspecified unspecified  	O	null
24 ב ב במהלך preposition unspecified unspecified unspecified unspecified unspecified 0 
24 מהלך מהלך במהלך noun masculine singular construct unspecified unspecified  	O	null
25 ה ה האינתיפאדה definiteArticle unspecified unspecified unspecified unspecified unspecified 0 
25 האינתיפאדה אינתיפאדה האינתיפאדה noun feminine singular absolute unspecified unspecified  	O	null
26 ה ה הראשונה definiteArticle unspecified unspecified unspecified unspecified unspecified 0 
26 הראשונה ORD1 הראשונה numeral feminine singular absolute unspecified unspecified  	O	null
27 . . . punctuation unspecified unspecified unspecified unspecified unspecified  	O	null

0 ה ה הספר definiteArticle unspecified unspecified unspecified unspecified unspecified 0 
0 הספר ספר הספר noun masculine singular absolute unspecified unspecified  	O	null
1 לא לא לא negation unspecified unspecified unspecified unspecified unspecified  	O	null
2 זכה זכה זכה verb masculine singular unspecified 3 past  	O	null
3 ל ל להצלחה preposition unspecified unspecified unspecified unspecified unspecified 0 
3 הצלחה הצלחה להצלחה noun feminine singular absolute unspecified unspecified  	O	null
4 ב ב בביקורת preposition unspecified unspecified unspecified unspecified unspecified 0 
4 ביקורת ביקורת בביקורת noun feminine singular absolute unspecified unspecified  	O	null
5 ו ו ובמכירות conjunction unspecified unspecified unspecified unspecified unspecified 0 
5 ב ב ובמכירות preposition unspecified unspecified unspecified unspecified unspecified 0 
5 מכירות מכירה ובמכירות noun feminine plural absolute unspecified unspecified  	O	null
6 כמו כמו כמו preposition unspecified unspecified unspecified unspecified unspecified  	O	null
7 קודם קודם קודמו noun masculine singular absolute unspecified unspecified  
7 ו ו קודמו possessive masculine singular unspecified 3 unspecified 0 	O	null
8 , , , punctuation unspecified unspecified unspecified unspecified unspecified  	O	null
9 ו ו ואמיר conjunction unspecified unspecified unspecified unspecified unspecified 0 
9 אמיר אמיר ואמיר properName unspecified unspecified unspecified unspecified unspecified  	I_PERS	null
10 הסיק הסיק הסיק verb masculine singular unspecified 3 past  	O	null
11 מ מ מכך preposition unspecified unspecified unspecified unspecified unspecified 0 
11 כך כך מכך pronoun unspecified unspecified unspecified unspecified unspecified  	O	null
12 ש ש שעיקר relativizer/subordinatingConjunction unspecified unspecified unspecified unspecified unspecified 0 
12 עיקר עיקר שעיקר noun masculine singular construct unspecified unspecified  	O	null
13 יכולת יכולת יכולתו noun feminine singular absolute unspecified unspecified  
13 ו ו יכולתו possessive masculine singular unspecified 3 unspecified 0 	O	null
14 ב ב בכתיבת preposition unspecified unspecified unspecified unspecified unspecified 0 
14 כתיבת כתיבה בכתיבת noun feminine singular construct unspecified unspecified  	O	null
15 ספרי ספר ספרי noun masculine plural construct unspecified unspecified  	O	null
16 מתח מתח מתח noun masculine singular absolute unspecified unspecified  	O	null
17 . . . punctuation unspecified unspecified unspecified unspecified unspecified  	O	null

0 נאמן נאמן נאמן adjective masculine singular absolute unspecified unspecified  	O	null
1 ל ל למסקנה preposition unspecified unspecified unspecified unspecified unspecified 0 
1 מסקנה מסקנה למסקנה noun feminine singular absolute unspecified unspecified  	O	null
2 זו זו זו pronoun feminine singular unspecified 3 unspecified  	O	null
3 כתב כתב כתב verb masculine singular unspecified 3 past  	O	null
4 את את את at-preposition unspecified unspecified unspecified unspecified unspecified  	O	null
5 ספר ספר ספרו noun masculine singular absolute unspecified unspecified  
5 ו ו ספרו possessive masculine singular unspecified 3 unspecified 0 	O	null
6 ה ה הבא definiteArticle unspecified unspecified unspecified unspecified unspecified 0 
6 הבא בא הבא adjective masculine singular absolute unspecified unspecified  	O	null
7 , , , punctuation unspecified unspecified unspecified unspecified unspecified  	O	null
8 לילה לילה לילה noun masculine singular absolute unspecified unspecified  	O	null
9 אדום אדום אדום properName unspecified unspecified unspecified unspecified unspecified  	I_LOC	null
10 , , , punctuation unspecified unspecified unspecified unspecified unspecified  	O	null
11 אגדה אגדה אגדה noun feminine singular absolute unspecified unspecified  	O	null
12 בעלת בעל בעלת noun feminine singular construct unspecified unspecified  	O	null
13 אופי אופי אופי noun masculine singular absolute unspecified unspecified  	O	null
14 ישראלי ישראלי ישראלי adjective masculine singular absolute unspecified unspecified  	O	null
15 - - - punctuation unspecified unspecified unspecified unspecified unspecified  	O	null
16 גותי גותי גותי properName unspecified unspecified unspecified unspecified unspecified  	I_ORG	null
17 ה ה המכילה definiteArticle unspecified unspecified unspecified unspecified unspecified 0 
17 המכילה הכיל המכילה participle feminine singular absolute any unspecified  	O	null
18 , , , punctuation unspecified unspecified unspecified unspecified unspecified  	O	null
19 בין בין בין preposition unspecified unspecified unspecified unspecified unspecified  	O	null
20 ה ה השאר definiteArticle unspecified unspecified unspecified unspecified unspecified 0 
20 השאר שאר השאר noun masculine singular absolute unspecified unspecified  	O	null
21 , , , punctuation unspecified unspecified unspecified unspecified unspecified  	O	null
22 גם גם גם conjunction unspecified unspecified unspecified unspecified unspecified  	O	null
23 ערפדים ערפד ערפדים noun masculine plural absolute unspecified unspecified  	O	null
24 יהודים יהודי יהודים adjective masculine plural absolute unspecified unspecified  	O	null
25 . . . punctuation unspecified unspecified unspecified unspecified unspecified  	O	null

0 ה ה הספר definiteArticle unspecified unspecified unspecified unspecified unspecified 0 
0 הספר ספר הספר noun masculine singular absolute unspecified unspecified  	O	null
1 הוכתר הוכתר הוכתר verb masculine singular unspecified 3 past  	O	null
2 על על על preposition unspecified unspecified unspecified unspecified unspecified  	O	null
3 ידי יד ידי noun feminine plural construct unspecified unspecified  	O	null
4 ה ה הביקורת definiteArticle unspecified unspecified unspecified unspecified unspecified 0 
4 הביקורת ביקורת הביקורת noun feminine singular absolute unspecified unspecified  	O	null
5 כ כ כ preposition unspecified unspecified unspecified unspecified unspecified 0 	O	null
6 " " " punctuation unspecified unspecified unspecified unspecified unspecified  	O	null
7 ספר ספר ספר noun masculine singular construct unspecified unspecified  	O	null
8 ה ה הערפדים definiteArticle unspecified unspecified unspecified unspecified unspecified 0 
8 הערפדים ערפד הערפדים noun masculine plural absolute unspecified unspecified  	O	null
9 ה ה הישראלי definiteArticle unspecified unspecified unspecified unspecified unspecified 0 
9 הישראלי ישראלי הישראלי adjective masculine singular absolute unspecified unspecified  	O	null
10 ה ה הראשון definiteArticle unspecified unspecified unspecified unspecified unspecified 0 
10 הראשון ORD1 הראשון numeral masculine singular absolute unspecified unspecified  	O	null
11 " " " punctuation unspecified unspecified unspecified unspecified unspecified  	O	null
12 ו ו והיה conjunction unspecified unspecified unspecified unspecified unspecified 0 
12 היה הוא והיה copula masculine singular unspecified 3 past  	O	null
13 גם גם גם conjunction unspecified unspecified unspecified unspecified unspecified  	O	null
14 ה ה הראשון definiteArticle unspecified unspecified unspecified unspecified unspecified 0 
14 הראשון ORD1 הראשון numeral masculine singular absolute unspecified unspecified  	O	null
15 ב ב בתולדות preposition unspecified unspecified unspecified unspecified unspecified 0 
15 תולדות תולדה בתולדות noun feminine plural construct unspecified unspecified  	O	null
16 המו המה המו verb masculine-and-feminine plural unspecified 3 past  	O	null
17 " " " punctuation unspecified unspecified unspecified unspecified unspecified  	O	null
18 לות לות לות noun feminine singular absolute unspecified unspecified  	O	null
19 ה ה העברית definiteArticle unspecified unspecified unspecified unspecified unspecified 0 
19 העברית עברי העברית adjective feminine singular absolute unspecified unspecified  	O	null
20 ש ש ששמו relativizer/subordinatingConjunction unspecified unspecified unspecified unspecified unspecified 0 
20 שם שם ששמו noun masculine singular absolute unspecified unspecified  
20 ו ו ששמו possessive masculine singular unspecified 3 unspecified 0 	O	null
21 נבחר נבחר נבחר verb masculine singular unspecified 3 past  	O	null
22 ב ב בתחרות preposition unspecified unspecified unspecified unspecified unspecified 0 
22 ה ה בתחרות definiteArticle unspecified unspecified unspecified unspecified unspecified 0 
22 התחרות תחרות בתחרות noun feminine singular absolute unspecified unspecified  	O	null
23 שבה שב שבה verb feminine singular unspecified 3 past  	O	null
24 הציעו הציע הציעו verb masculine-and-feminine plural unspecified 3 past  	O	null
25 גולשים גולש גולשים noun masculine plural absolute unspecified unspecified  	O	null
26 באתרynetשמות באתרynetשמות באתרynetשמות verb feminine singular unspecified 2 past  	O	null
27 ל ל לספר preposition unspecified unspecified unspecified unspecified unspecified 0 
27 ה ה לספר definiteArticle unspecified unspecified unspecified unspecified unspecified 0 
27 הספר ספר לספר noun masculine singular absolute unspecified unspecified  	O	null
28 , , , punctuation unspecified unspecified unspecified unspecified unspecified  	O	null
29 על על על preposition unspecified unspecified unspecified unspecified unspecified  	O	null
30 פי פה פי noun masculine singular construct unspecified unspecified  	O	null
31 תוכן תוכן תוכנו noun masculine singular absolute unspecified unspecified  
31 ו ו תוכנו possessive masculine singular unspecified 3 unspecified 0 	O	null
32 של של של shel-preposition unspecified unspecified unspecified unspecified unspecified  	O	null
33 פרק פארק פרק noun masculine singular absolute unspecified unspecified  	O	null
34 ש ש שפורסם relativizer/subordinatingConjunction unspecified unspecified unspecified unspecified unspecified 0 
34 פורסם פורסם שפורסם verb masculine singular unspecified 3 past  	O	null
35 ב ב באתר preposition unspecified unspecified unspecified unspecified unspecified 0 
35 ה ה באתר definiteArticle unspecified unspecified unspecified unspecified unspecified 0 
35 האתר אתר באתר noun masculine singular absolute unspecified unspecified  	O	null
36 . . . punctuation unspecified unspecified unspecified unspecified unspecified  	O	null

0 ב ב במרכז preposition unspecified unspecified unspecified unspecified unspecified 0 
0 מרכז מרכז במרכז noun masculine singular construct unspecified unspecified  	O	null
1 ה ה הספר definiteArticle unspecified unspecified unspecified unspecified unspecified 0 
1 הספר ספר הספר noun masculine singular absolute unspecified unspecified  	O	null
2 ה ה השלישית definiteArticle unspecified unspecified unspecified unspecified unspecified 0 
2 השלישית ORD3 השלישית numeral feminine singular absolute unspecified unspecified  	O	null
3 ב ב בשורה preposition unspecified unspecified unspecified unspecified unspecified 0 
3 ה ה בשורה definiteArticle unspecified unspecified unspecified unspecified unspecified 0 
3 השורה שורה בשורה noun feminine singular absolute unspecified unspecified  	O	null
4 ה ה השנייה definiteArticle unspecified unspecified unspecified unspecified unspecified 0 
4 השנייה ORD2 השנייה numeral feminine singular absolute unspecified unspecified  	O	null
5 ( ( ( punctuation unspecified unspecified unspecified unspecified unspecified  	O	null
6 ###NUMBER### ###NUMBER### ###NUMBER### numeral unspecified unspecified unspecified unspecified unspecified  	I_DATE	null
7 ) ) ) punctuation unspecified unspecified unspecified unspecified unspecified  	O	null
8 תעלומה תעלומה תעלומה noun feminine singular absolute unspecified unspecified  	O	null
9 בלשית בלשי בלשית adjective feminine singular absolute unspecified unspecified  	O	null
10 ה ה המתרחשת definiteArticle unspecified unspecified unspecified unspecified unspecified 0 
10 המתרחשת התרחש המתרחשת participle feminine singular absolute any unspecified  	O	null
11 על על על preposition unspecified unspecified unspecified unspecified unspecified  	O	null
12 רקע רקע רקע noun masculine singular construct unspecified unspecified  	O	null
13 פרשות פרשה פרשות noun feminine plural absolute unspecified unspecified  	O	null
14 של של של shel-preposition unspecified unspecified unspecified unspecified unspecified  	O	null
15 שחיתות שחיתות שחיתות noun feminine singular absolute unspecified unspecified  	O	null
16 ו ו ואלימות conjunction unspecified unspecified unspecified unspecified unspecified 0 
16 אלימות אלימות ואלימות noun feminine singular absolute unspecified unspecified  	O	null
17 ב ב בישראל preposition unspecified unspecified unspecified unspecified unspecified 0 
17 ישראל ישראל בישראל properName unspecified unspecified unspecified unspecified unspecified  	I_LOC	null
18 של של של shel-preposition unspecified unspecified unspecified unspecified unspecified  	O	null
19 ימין ימין ימינו noun masculine singular absolute unspecified unspecified  
19 ו ו ימינו possessive masculine singular unspecified 3 unspecified 0 	O	null
20 . . . punctuation unspecified unspecified unspecified unspecified unspecified  	O	null

0 ה ה הספר definiteArticle unspecified unspecified unspecified unspecified unspecified 0 
0 הספר ספר הספר noun masculine singular absolute unspecified unspecified  	O	null
1 ה ה המתמחה definiteArticle unspecified unspecified unspecified unspecified unspecified 0 
1 המתמחה התמחה המתמחה participle masculine singular absolute any unspecified  	O	null
2 ) ) ) punctuation unspecified unspecified unspecified unspecified unspecified  	O	null
3 , , , punctuation unspecified unspecified unspecified unspecified unspecified  	O	null
4 ###NUMBER### ###NUMBER### ###NUMBER### numeral unspecified unspecified unspecified unspecified unspecified  	I_DATE	null
5 רומן רומן רומן noun masculine singular absolute unspecified unspecified  	O	null
6 משפטי משפטי משפטי adjective masculine singular absolute unspecified unspecified  	O	null
7 - - - punctuation unspecified unspecified unspecified unspecified unspecified  	O	null
8 בלשי בלשי בלשי adjective masculine singular absolute unspecified unspecified  	O	null
9 נוסף נוסף נוסף adjective masculine singular absolute unspecified unspecified  	O	null
10 , , , punctuation unspecified unspecified unspecified unspecified unspecified  	O	null
11 מתרחש התרחש מתרחש verb masculine singular unspecified any beinoni  	O	null
12 אף אף אף conjunction unspecified unspecified unspecified unspecified unspecified  	O	null
13 הוא הוא הוא pronoun masculine singular unspecified 3 unspecified  	O	null
14 ב ב בעפולה preposition unspecified unspecified unspecified unspecified unspecified 0 
14 עפולה עפולה בעפולה properName unspecified unspecified unspecified unspecified unspecified  	I_LOC	null
15 , , , punctuation unspecified unspecified unspecified unspecified unspecified  	O	null
16 ו ו וכמה conjunction unspecified unspecified unspecified unspecified unspecified 0 
16 כמה כמה וכמה verb masculine singular unspecified 3 past  	O	null
17 מ מ מדמויותיו preposition unspecified unspecified unspecified unspecified unspecified 0 
17 דמויות דמות מדמויותיו noun feminine plural absolute unspecified unspecified  
17 ו ו מדמויותיו possessive masculine singular unspecified 3 unspecified 0 	O	null
18 הופיעו הופיע הופיעו verb masculine-and-feminine plural unspecified 3 past  	O	null
19 גם גם גם conjunction unspecified unspecified unspecified unspecified unspecified  	O	null
20 ב ב בספרו preposition unspecified unspecified unspecified unspecified unspecified 0 
20 ספר ספר בספרו noun masculine singular absolute unspecified unspecified  
20 ו ו בספרו possessive masculine singular unspecified 3 unspecified 0 	O	null
21 ה ה הראשון definiteArticle unspecified unspecified unspecified unspecified unspecified 0 
21 הראשון ORD1 הראשון numeral masculine singular absolute unspecified unspecified  	O	null
22 . . . punctuation unspecified unspecified unspecified unspecified unspecified  	O	null

0 כתיבת כתיבה כתיבתו noun feminine singular absolute unspecified unspecified  
0 ו ו כתיבתו possessive masculine singular unspecified 3 unspecified 0 	O	null
1 משקפת שיקף משקפת verb feminine singular unspecified any beinoni  	O	null
2 התבוננות התבוננות התבוננות noun feminine singular absolute unspecified unspecified  	O	null
3 חדהויכולת חדהויכולת חדהויכולת noun feminine singular construct unspecified unspecified  	O	null
4 להפוך הפך להפוך verb unspecified unspecified unspecified unspecified infinitive  	O	null
5 את את את at-preposition unspecified unspecified unspecified unspecified unspecified  	O	null
6 ה ה העולם definiteArticle unspecified unspecified unspecified unspecified unspecified 0 
6 העולם עולם העולם noun masculine singular absolute unspecified unspecified  	O	null
7 ה ה הסובב definiteArticle unspecified unspecified unspecified unspecified unspecified 0 
7 הסובב סבב הסובב participle masculine singular absolute any unspecified  	O	null
8 את את אותו at-preposition unspecified unspecified unspecified unspecified unspecified  
8 ו ו אותו pronomial masculine singular unspecified 3 unspecified 0 	O	null
9 ( ( ( punctuation unspecified unspecified unspecified unspecified unspecified  	O	null
10 ה ה ההווי definiteArticle unspecified unspecified unspecified unspecified unspecified 0 
10 ההווי ההווי ההווי noun masculine singular absolute unspecified unspecified  	O	null
11 ב ב בצבא preposition unspecified unspecified unspecified unspecified unspecified 0 
11 ה ה בצבא definiteArticle unspecified unspecified unspecified unspecified unspecified 0 
11 הצבא צבא בצבא noun masculine singular absolute unspecified unspecified  	O	null
12 , , , punctuation unspecified unspecified unspecified unspecified unspecified  	O	null
13 מערכת מערכה מערכת noun feminine singular construct unspecified unspecified  	O	null
14 ה ה המשפט definiteArticle unspecified unspecified unspecified unspecified unspecified 0 
14 המשפט משפט המשפט noun masculine singular absolute unspecified unspecified  	O	null
15 ו ו ועיר conjunction unspecified unspecified unspecified unspecified unspecified 0 
15 עיר עיר ועיר noun feminine singular construct unspecified unspecified  	O	null
16 הולדת הולדה הולדתו noun feminine singular absolute unspecified unspecified  
16 ו ו הולדתו possessive masculine singular unspecified 3 unspecified 0 	I_LOC	null
17 עפולה עפולה עפולה properName unspecified unspecified unspecified unspecified unspecified  	I_LOC	null
18 ) ) ) punctuation unspecified unspecified unspecified unspecified unspecified  	O	null
19 ל ל ל preposition unspecified unspecified unspecified unspecified unspecified 0 	O	null
20 " " " punctuation unspecified unspecified unspecified unspecified unspecified  	O	null
21 קומדיה קומדיה קומדיה noun feminine singular absolute unspecified unspecified  	O	null
22 של של של shel-preposition unspecified unspecified unspecified unspecified unspecified  	O	null
23 מנהגים מנהג מנהגים noun masculine plural absolute unspecified unspecified  	O	null
24 " " " punctuation unspecified unspecified unspecified unspecified unspecified  	O	null
25 – – – punctuation unspecified unspecified unspecified unspecified unspecified  	O	null
26 יצירה יצירה יצירה noun feminine singular absolute unspecified unspecified  	O	null
27 ספרותית ספרותי ספרותית adjective feminine singular absolute unspecified unspecified  	O	null
28 ה ה המתארת definiteArticle unspecified unspecified unspecified unspecified unspecified 0 
28 המתארת תיאר המתארת participle feminine singular absolute any unspecified  	O	null
29 ו ו ומבקרת conjunction unspecified unspecified unspecified unspecified unspecified 0 
29 מבקרת ביקר ומבקרת verb feminine singular unspecified any beinoni  	O	null
30 את את את at-preposition unspecified unspecified unspecified unspecified unspecified  	O	null
31 מנהגי מנהג מנהגיו noun masculine plural absolute unspecified unspecified  
31 ו ו מנהגיו possessive masculine singular unspecified 3 unspecified 0 	O	null
32 של של של shel-preposition unspecified unspecified unspecified unspecified unspecified  	O	null
33 חוג חוג חוג noun masculine singular absolute unspecified unspecified  	O	null
34 חברתי חברתי חברתי adjective masculine singular absolute unspecified unspecified  	O	null
35 מוגדר מוגדר מוגדר adjective masculine singular absolute unspecified unspecified  	O	null
36 . . . punctuation unspecified unspecified unspecified unspecified unspecified  	O	null

0 ה ה הספרים definiteArticle unspecified unspecified unspecified unspecified unspecified 0 
0 הספרים ספר הספרים noun masculine plural absolute unspecified unspecified  	O	null
1 ש ש שכתב relativizer/subordinatingConjunction unspecified unspecified unspecified unspecified unspecified 0 
1 כתב כתב שכתב verb masculine singular unspecified 3 past  	O	null
2 ב ב בז'אנר preposition unspecified unspecified unspecified unspecified unspecified 0 
2 ז'אנר ז'אנר בז'אנר noun masculine singular construct unspecified unspecified  	O	null
3 ה ה המתח definiteArticle unspecified unspecified unspecified unspecified unspecified 0 
3 המתח מתח המתח noun masculine singular absolute unspecified unspecified  	O	null
4 ו ו והפנטזיה conjunction unspecified unspecified unspecified unspecified unspecified 0 
4 ה ה והפנטזיה definiteArticle unspecified unspecified unspecified unspecified unspecified 0 
4 הפנטזיה פנטזיה והפנטזיה noun feminine singular absolute unspecified unspecified  	O	null
5 מתאפיינים התאפיין מתאפיינים verb masculine plural unspecified any beinoni  	O	null
6 גם גם גם conjunction unspecified unspecified unspecified unspecified unspecified  	O	null
7 ב ב בניסיון preposition unspecified unspecified unspecified unspecified unspecified 0 
7 ניסיון ניסיון בניסיון noun masculine singular absolute unspecified unspecified  	O	null
8 לפרוץ פרץ לפרוץ verb unspecified unspecified unspecified unspecified infinitive  	O	null
9 את את את at-preposition unspecified unspecified unspecified unspecified unspecified  	O	null
10 גבולות גבול גבולות noun masculine plural construct unspecified unspecified  	O	null
11 ה ה הז'אנר definiteArticle unspecified unspecified unspecified unspecified unspecified 0 
11 הז'אנר ז'אנר הז'אנר noun masculine singular absolute unspecified unspecified  	O	null
12 , , , punctuation unspecified unspecified unspecified unspecified unspecified  	O	null
13 ו ו ולהשתמש conjunction unspecified unspecified unspecified unspecified unspecified 0 
13 להשתמש השתמש ולהשתמש verb unspecified unspecified unspecified unspecified infinitive  	O	null
14 ב ב בו preposition unspecified unspecified unspecified unspecified unspecified  
14 ו ו בו pronomial masculine singular unspecified 3 unspecified 0 	O	null
15 כ כ כפלטפורמה preposition unspecified unspecified unspecified unspecified unspecified 0 
15 פלטפורמה פלטפורמה כפלטפורמה noun feminine singular absolute unspecified unspecified  	O	null
16 ל ל להצגת preposition unspecified unspecified unspecified unspecified unspecified 0 
16 הצגת הצגה להצגת noun feminine singular construct unspecified unspecified  	O	null
17 רעיונות רעיון רעיונות noun masculine plural absolute unspecified unspecified  	O	null
18 על על על preposition unspecified unspecified unspecified unspecified unspecified  	O	null
19 טבע טבע טבע noun masculine singular construct unspecified unspecified  	O	null
20 ה ה העולם definiteArticle unspecified unspecified unspecified unspecified unspecified 0 
20 העולם עולם העולם noun masculine singular absolute unspecified unspecified  	O	null
21 ו ו והאדם conjunction unspecified unspecified unspecified unspecified unspecified 0 
21 ה ה והאדם definiteArticle unspecified unspecified unspecified unspecified unspecified 0 
21 האדם אדם והאדם noun masculine singular absolute unspecified unspecified  	O	null
22 . . . punctuation unspecified unspecified unspecified unspecified unspecified  	O	null

0 References References References foreign unspecified unspecified unspecified unspecified unspecified  	O	null
1 : : : punctuation unspecified unspecified unspecified unspecified unspecified  	O	null
2 ז'קונט ז'קונט ז'קונט properName unspecified unspecified unspecified unspecified unspecified  	I_ORG	null
3 , , , punctuation unspecified unspecified unspecified unspecified unspecified  	O	null
4 אמנון אמנון אמנון properName unspecified unspecified unspecified unspecified unspecified  	I_PERS	null
5 . . . punctuation unspecified unspecified unspecified unspecified unspecified  	O	null

0 " " " punctuation unspecified unspecified unspecified unspecified unspecified  	O	null
1 טיול טיול טיול noun masculine singular absolute unspecified unspecified  	O	null
2 ב ב במחוזות preposition unspecified unspecified unspecified unspecified unspecified 0 
2 מחוזות מחוז במחוזות noun masculine plural construct unspecified unspecified  	O	null
3 ה ה השקר definiteArticle unspecified unspecified unspecified unspecified unspecified 0 
3 השקר שקר השקר noun masculine singular absolute unspecified unspecified  	O	null
4 ו ו והברוטליות conjunction unspecified unspecified unspecified unspecified unspecified 0 
4 ה ה והברוטליות definiteArticle unspecified unspecified unspecified unspecified unspecified 0 
4 הברוטליות ברוטליות והברוטליות noun feminine singular absolute unspecified unspecified  	O	null
5 של של של shel-preposition unspecified unspecified unspecified unspecified unspecified  	O	null
6 ה ה החברה definiteArticle unspecified unspecified unspecified unspecified unspecified 0 
6 החברה חבר החברה noun feminine singular absolute unspecified unspecified  	O	null
7 ה ה הישראלית definiteArticle unspecified unspecified unspecified unspecified unspecified 0 
7 הישראלית ישראלי הישראלית adjective feminine singular absolute unspecified unspecified  	O	null
8 " " " punctuation unspecified unspecified unspecified unspecified unspecified  	O	null
9 . . . punctuation unspecified unspecified unspecified unspecified unspecified  	O	null

0 ה ה הארץ definiteArticle unspecified unspecified unspecified unspecified unspecified 0 
0 הארץ ארץ הארץ noun feminine singular absolute unspecified unspecified  	O	null
1 ספרים ספר ספרים noun masculine plural absolute unspecified unspecified  	O	null
2 . . . punctuation unspecified unspecified unspecified unspecified unspecified  	O	null

0 . . . punctuation unspecified unspecified unspecified unspecified unspecified  	O	null
1 ###NUMEXP### ###NUMEXP### ###NUMEXP### numberExpression unspecified unspecified unspecified unspecified unspecified  	I_DATE	null
2 ; ; ; punctuation unspecified unspecified unspecified unspecified unspecified  	O	null
3 ###NUMBER### ###NUMBER### ###NUMBER### numeral unspecified unspecified unspecified unspecified unspecified  	O	null
4 פייט פייט פייט verb masculine singular unspecified 3 past  	O	null
5 , , , punctuation unspecified unspecified unspecified unspecified unspecified  	O	null
6 קרן קרן קרן verb masculine singular unspecified 3 past  	O	null
7 . . . punctuation unspecified unspecified unspecified unspecified unspecified  	O	null

0 " " " punctuation unspecified unspecified unspecified unspecified unspecified  	O	null
1 דרקולה דרקולה דרקולה properName unspecified unspecified unspecified unspecified unspecified  	O	null
2 הוא הוא הוא pronoun masculine singular unspecified 3 unspecified  	O	null
3 בחור בחור בחור noun masculine singular absolute unspecified unspecified  	O	null
4 ישיבה ישיבה ישיבה noun feminine singular absolute unspecified unspecified  	O	null
5 ה ה הזולל definiteArticle unspecified unspecified unspecified unspecified unspecified 0 
5 הזולל זלל הזולל participle masculine singular absolute any unspecified  	O	null
6 את את את at-preposition unspecified unspecified unspecified unspecified unspecified  	O	null
7 אנשי איש אנשי noun masculine plural construct unspecified unspecified  	O	null
8 ה ה הגליל definiteArticle unspecified unspecified unspecified unspecified unspecified 0 
8 הגליל גליל הגליל noun masculine singular absolute unspecified unspecified  	I_LOC	null
9 " " " punctuation unspecified unspecified unspecified unspecified unspecified  	O	null
10 . . . punctuation unspecified unspecified unspecified unspecified unspecified  	O	null

0 ה ה הארץ definiteArticle unspecified unspecified unspecified unspecified unspecified 0 
0 הארץ ארץ הארץ noun feminine singular absolute unspecified unspecified  	O	null
1 ספרים ספר ספרים noun masculine plural absolute unspecified unspecified  	O	null
2 . . . punctuation unspecified unspecified unspecified unspecified unspecified  	O	null

0 ###NUMEXP### ###NUMEXP### ###NUMEXP### numberExpression unspecified unspecified unspecified unspecified unspecified  	I_DATE	null
1 . . . punctuation unspecified unspecified unspecified unspecified unspecified  	O	null

0 ###NUMBER### ###NUMBER### ###NUMBER### numeral unspecified unspecified unspecified unspecified unspecified  	O	null
1 . . . punctuation unspecified unspecified unspecified unspecified unspecified  	O	null

