0 Name Name Name foreign unspecified unspecified unspecified unspecified unspecified  	O	null
1 : : : punctuation unspecified unspecified unspecified unspecified unspecified  	O	null
2 אס אס אס properName unspecified unspecified unspecified unspecified unspecified  	I_ORG	null
3 , , , punctuation unspecified unspecified unspecified unspecified unspecified  	O	null
4 ש ש שרון relativizer/subordinatingConjunction unspecified unspecified unspecified unspecified unspecified 0 
4 רון רון שרון properName unspecified unspecified unspecified unspecified unspecified  	I_LOC	null
5 Birth Birth Birth foreign unspecified unspecified unspecified unspecified unspecified  	O	null
6 Year Year Year foreign unspecified unspecified unspecified unspecified unspecified  	O	null
7 : : : punctuation unspecified unspecified unspecified unspecified unspecified  	O	null
8 ###NUMBER### ###NUMBER### ###NUMBER### numeral unspecified unspecified unspecified unspecified unspecified  	I_DATE	null
9 Birth Birth Birth foreign unspecified unspecified unspecified unspecified unspecified  	O	null
10 Place Place Place foreign unspecified unspecified unspecified unspecified unspecified  	O	null
11 : : : punctuation unspecified unspecified unspecified unspecified unspecified  	O	null
12 רמתגן רמתגן רמתגן properName unspecified unspecified unspecified unspecified unspecified  	I_ORG	null
13 , , , punctuation unspecified unspecified unspecified unspecified unspecified  	O	null
14 ו ו ובגיל conjunction unspecified unspecified unspecified unspecified unspecified 0 
14 ב ב ובגיל preposition unspecified unspecified unspecified unspecified unspecified 0 
14 גיל גיל ובגיל noun masculine singular construct unspecified unspecified  	O	null
15 תשע CARD9 תשע numeral feminine singular absolute unspecified unspecified  	O	null
16 Occupation Occupation Occupation foreign unspecified unspecified unspecified unspecified unspecified  	O	null
17 : : : punctuation unspecified unspecified unspecified unspecified unspecified  	O	null
18 משוררת משורר משוררת noun feminine singular absolute unspecified unspecified  	O	null
19 Entry Entry Entry foreign unspecified unspecified unspecified unspecified unspecified  	O	null
20 writer writer writer foreign unspecified unspecified unspecified unspecified unspecified  	O	null
21 : : : punctuation unspecified unspecified unspecified unspecified unspecified  	O	null
22 טל טל טל properName unspecified unspecified unspecified unspecified unspecified  	I_PERS	null
23 פרנקל פרנקל פרנקל properName unspecified unspecified unspecified unspecified unspecified  	I_PERS	null
24 Entry Entry Entry foreign unspecified unspecified unspecified unspecified unspecified  	O	null
25 Value Value Value foreign unspecified unspecified unspecified unspecified unspecified  	O	null
26 : : : punctuation unspecified unspecified unspecified unspecified unspecified  	O	null
27 נולדה נולד נולדה verb feminine singular unspecified 3 past  	O	null
28 ברמתגן ברמתגן ברמתגן properName unspecified unspecified unspecified unspecified unspecified  	I_PERS	null
29 , , , punctuation unspecified unspecified unspecified unspecified unspecified  	O	null
30 ו ו ובגיל conjunction unspecified unspecified unspecified unspecified unspecified 0 
30 ב ב ובגיל preposition unspecified unspecified unspecified unspecified unspecified 0 
30 גיל גיל ובגיל noun masculine singular construct unspecified unspecified  	O	null
31 תשע CARD9 תשע numeral feminine singular absolute unspecified unspecified  	O	null
32 עברה עבר עברה verb feminine singular unspecified 3 past  	O	null
33 עם עם עם preposition unspecified unspecified unspecified unspecified unspecified  	O	null
34 משפחת משפחה משפחתה noun feminine singular absolute unspecified unspecified  
34 ה ה משפחתה possessive feminine singular unspecified 3 unspecified 0 	O	null
35 ל ל לרמת preposition unspecified unspecified unspecified unspecified unspecified 0 
35 רמת רמה לרמת properName unspecified unspecified unspecified unspecified unspecified  	I_LOC	null
36 אפעל אפעל אפעל properName unspecified unspecified unspecified unspecified unspecified  	I_LOC	null
37 . . . punctuation unspecified unspecified unspecified unspecified unspecified  	O	null

0 ה ה החיים definiteArticle unspecified unspecified unspecified unspecified unspecified 0 
0 החיים חיים החיים noun masculine plural absolute unspecified unspecified  	O	null
1 ב ב בסמיכות preposition unspecified unspecified unspecified unspecified unspecified 0 
1 סמיכות סמיכות בסמיכות noun feminine singular absolute unspecified unspecified  	O	null
2 ל ל לפארק preposition unspecified unspecified unspecified unspecified unspecified 0 
2 פארק פארק לפארק noun masculine singular construct unspecified unspecified  	O	null
3 רמת רמה רמת properName unspecified unspecified unspecified unspecified unspecified  	I_LOC	null
4 גן גן גן properName unspecified unspecified unspecified unspecified unspecified  	I_LOC	null
5 ו ו והספארי conjunction unspecified unspecified unspecified unspecified unspecified 0 
5 ה ה והספארי definiteArticle unspecified unspecified unspecified unspecified unspecified 0 
5 הספארי הספארי והספארי noun masculine singular absolute unspecified unspecified  	O	null
6 נקשרו נקשר נקשרו verb masculine-and-feminine plural unspecified 3 past  	O	null
7 אצל אצל אצלה preposition unspecified unspecified unspecified unspecified unspecified  
7 ה ה אצלה pronomial feminine singular unspecified 3 unspecified 0 	O	null
8 ב ב בדימויי preposition unspecified unspecified unspecified unspecified unspecified 0 
8 דימויי דימוי בדימויי noun masculine plural construct unspecified unspecified  	O	null
9 טבע טבע טבע noun masculine singular absolute unspecified unspecified  	O	null
10 ו ו ואור conjunction unspecified unspecified unspecified unspecified unspecified 0 
10 אור אור ואור properName unspecified unspecified unspecified unspecified unspecified  	I_PERS	null
11 , , , punctuation unspecified unspecified unspecified unspecified unspecified  	O	null
12 ה ה הניכרים definiteArticle unspecified unspecified unspecified unspecified unspecified 0 
12 הניכרים ניכר הניכרים adjective masculine plural absolute unspecified unspecified  	O	null
13 היטב היטב היטב adverb unspecified unspecified unspecified unspecified unspecified  	O	null
14 ב ב בשיריה preposition unspecified unspecified unspecified unspecified unspecified 0 
14 שירי שיר בשיריה noun masculine plural absolute unspecified unspecified  
14 ה ה בשיריה possessive feminine singular unspecified 3 unspecified 0 	O	null
15 . . . punctuation unspecified unspecified unspecified unspecified unspecified  	O	null

0 למדה למד למדה verb feminine singular unspecified 3 past  	O	null
1 ב ב ב preposition unspecified unspecified unspecified unspecified unspecified 0 	O	null
2 " " " punctuation unspecified unspecified unspecified unspecified unspecified  	O	null
3 תיכון תיכון תיכון noun masculine singular absolute unspecified unspecified  	O	null
4 חדש חדש חדש adjective masculine singular absolute unspecified unspecified  	O	null
5 " " " punctuation unspecified unspecified unspecified unspecified unspecified  	O	null
6 בתלאביב בתלאביב בתלאביב properName unspecified unspecified unspecified unspecified unspecified  	O	null
7 , , , punctuation unspecified unspecified unspecified unspecified unspecified  	O	null
8 ו ו ובתקופה conjunction unspecified unspecified unspecified unspecified unspecified 0 
8 ב ב ובתקופה preposition unspecified unspecified unspecified unspecified unspecified 0 
8 תקופה תקופה ובתקופה noun feminine singular absolute unspecified unspecified  	O	null
9 זו זו זו pronoun feminine singular unspecified 3 unspecified  	O	null
10 התוודעה התוודע התוודעה verb feminine singular unspecified 3 past  	O	null
11 אל אל אל preposition unspecified unspecified unspecified unspecified unspecified  	O	null
12 ה ה המשוררת definiteArticle unspecified unspecified unspecified unspecified unspecified 0 
12 המשוררת משורר המשוררת noun feminine singular absolute unspecified unspecified  	O	null
13 נורית נורית נורית properName unspecified unspecified unspecified unspecified unspecified  	I_PERS	null
14 זרחי זרח זרחי verb feminine singular unspecified 2 imperative  	O	null
15 , , , punctuation unspecified unspecified unspecified unspecified unspecified  	O	null
16 ש ש שהידידות relativizer/subordinatingConjunction unspecified unspecified unspecified unspecified unspecified 0 
16 ה ה שהידידות definiteArticle unspecified unspecified unspecified unspecified unspecified 0 
16 הידידות ידידות שהידידות noun feminine singular absolute unspecified unspecified  	O	null
17 עם עם עמה preposition unspecified unspecified unspecified unspecified unspecified  
17 ה ה עמה pronomial feminine singular unspecified 3 unspecified 0 	O	null
18 פתחה פתח פתחה verb feminine singular unspecified 3 past  	O	null
19 ל ל לה preposition unspecified unspecified unspecified unspecified unspecified  
19 ה ה לה pronomial feminine singular unspecified 3 unspecified 0 	O	null
20 עולמות עולם עולמות noun masculine plural absolute unspecified unspecified  	O	null
21 של של של shel-preposition unspecified unspecified unspecified unspecified unspecified  	O	null
22 שיח שיח שיח noun masculine singular absolute unspecified unspecified  	O	null
23 ו ו ושירה conjunction unspecified unspecified unspecified unspecified unspecified 0 
23 שירה שירה ושירה noun feminine singular absolute unspecified unspecified  	O	null
24 . . . punctuation unspecified unspecified unspecified unspecified unspecified  	O	null

0 שירתה שירת שירתה verb feminine singular unspecified 3 past  	O	null
1 ב ב בצבא preposition unspecified unspecified unspecified unspecified unspecified 0 
1 ה ה בצבא definiteArticle unspecified unspecified unspecified unspecified unspecified 0 
1 הצבא צבא בצבא noun masculine singular absolute unspecified unspecified  	O	null
2 ב ב בתקופת preposition unspecified unspecified unspecified unspecified unspecified 0 
2 תקופת תקופה בתקופת noun feminine singular construct unspecified unspecified  	O	null
3 מלחמת מלחמה מלחמת noun feminine singular construct unspecified unspecified  	O	null
4 לבנון לבנון לבנון properName unspecified unspecified unspecified unspecified unspecified  	I_LOC	null
5 ה ה הראשונה definiteArticle unspecified unspecified unspecified unspecified unspecified 0 
5 הראשונה ORD1 הראשונה numeral feminine singular absolute unspecified unspecified  	O	null
6 . . . punctuation unspecified unspecified unspecified unspecified unspecified  	O	null

0 למדה למד למדה verb feminine singular unspecified 3 past  	O	null
1 ב ב באוניברסיטת preposition unspecified unspecified unspecified unspecified unspecified 0 
1 אוניברסיטת אוניברסיטה באוניברסיטת noun feminine singular construct unspecified unspecified  	I_ORG	null
2 תלאביב תלאביב תלאביב properName unspecified unspecified unspecified unspecified unspecified  	I_ORG	null
3 לימודים לימוד לימודים noun masculine plural absolute unspecified unspecified  	O	null
4 קלאסיים קלאסי קלאסיים adjective masculine plural absolute unspecified unspecified  	O	null
5 ו ו וספרות conjunction unspecified unspecified unspecified unspecified unspecified 0 
5 ספרות ספרות וספרות noun feminine singular absolute unspecified unspecified  	O	null
6 אנגלית אנגלי אנגלית adjective feminine singular absolute unspecified unspecified  	O	null
7 ל ל לתואר preposition unspecified unspecified unspecified unspecified unspecified 0 
7 תואר תואר לתואר noun masculine singular absolute unspecified unspecified  	O	null
8 ראשון ORD1 ראשון numeral masculine singular absolute unspecified unspecified  	O	null
9 , , , punctuation unspecified unspecified unspecified unspecified unspecified  	O	null
10 ו ו וסיימה conjunction unspecified unspecified unspecified unspecified unspecified 0 
10 סיימה סיים וסיימה verb feminine singular unspecified 3 past  	O	null
11 תואר תואר תואר noun masculine singular absolute unspecified unspecified  	O	null
12 שני שני שני noun masculine singular absolute unspecified unspecified  	O	null
13 ב ב במדעי preposition unspecified unspecified unspecified unspecified unspecified 0 
13 מדעי מדע במדעי noun masculine plural construct unspecified unspecified  	O	null
14 ה ה הדתות definiteArticle unspecified unspecified unspecified unspecified unspecified 0 
14 הדתות דת הדתות noun feminine plural absolute unspecified unspecified  	O	null
15 . . . punctuation unspecified unspecified unspecified unspecified unspecified  	O	null

0 ב ב ב preposition unspecified unspecified unspecified unspecified unspecified 0 	O	null
1 - - - punctuation unspecified unspecified unspecified unspecified unspecified  	O	null
2 ###NUMBER### ###NUMBER### ###NUMBER### numeral unspecified unspecified unspecified unspecified unspecified  	I_DATE	null
3 השתתפה השתתף השתתפה verb feminine singular unspecified 3 past  	O	null
4 ב ב בכיתת preposition unspecified unspecified unspecified unspecified unspecified 0 
4 כיתת כיתה בכיתת noun feminine singular construct unspecified unspecified  	O	null
5 ה ה השירה definiteArticle unspecified unspecified unspecified unspecified unspecified 0 
5 השירה שירה השירה noun feminine singular absolute unspecified unspecified  	O	null
6 ה ה הראשונה definiteArticle unspecified unspecified unspecified unspecified unspecified 0 
6 הראשונה ORD1 הראשונה numeral feminine singular absolute unspecified unspecified  	O	null
7 של של של shel-preposition unspecified unspecified unspecified unspecified unspecified  	O	null
8 " " " punctuation unspecified unspecified unspecified unspecified unspecified  	I_ORG	null
9 הליקון הליקון הליקון properName unspecified unspecified unspecified unspecified unspecified  	I_ORG	null
10 " " " punctuation unspecified unspecified unspecified unspecified unspecified  	O	null
11 , , , punctuation unspecified unspecified unspecified unspecified unspecified  	O	null
12 ולאחרמכן ולאחרמכן ולאחרמכן adjective masculine singular construct unspecified unspecified  	O	null
13 פירסמה פרסם פירסמה verb feminine singular unspecified 3 past  	O	null
14 שירים שיר שירים noun masculine plural absolute unspecified unspecified  	O	null
15 ב ב בכתבי preposition unspecified unspecified unspecified unspecified unspecified 0 
15 כתבי כתב בכתבי noun masculine plural construct unspecified unspecified  	O	null
16 ה ה העת definiteArticle unspecified unspecified unspecified unspecified unspecified 0 
16 העת עת העת noun feminine singular absolute unspecified unspecified  	O	null
17 הליקון הליקון הליקון properName unspecified unspecified unspecified unspecified unspecified  	I_PERS	null
18 , , , punctuation unspecified unspecified unspecified unspecified unspecified  	O	null
19 חדרים חדר חדרים noun masculine plural absolute unspecified unspecified  	O	null
20 , , , punctuation unspecified unspecified unspecified unspecified unspecified  	O	null
21 אפס אפס אפס conjunction unspecified unspecified unspecified unspecified unspecified  	O	null
22 שתיים CARD2 שתיים numeral feminine singular absolute unspecified unspecified  	I_ORG	null
23 , , , punctuation unspecified unspecified unspecified unspecified unspecified  	I_ORG	null
24 כרמל כרמל כרמל properName unspecified unspecified unspecified unspecified unspecified  	I_LOC	null
25 ו ו ובמוספי conjunction unspecified unspecified unspecified unspecified unspecified 0 
25 ב ב ובמוספי preposition unspecified unspecified unspecified unspecified unspecified 0 
25 מוספי מוסף ובמוספי noun masculine plural construct unspecified unspecified  	O	null
26 ה ה הספרות definiteArticle unspecified unspecified unspecified unspecified unspecified 0 
26 הספרות ספרות הספרות noun feminine singular absolute unspecified unspecified  	O	null
27 של של של shel-preposition unspecified unspecified unspecified unspecified unspecified  	O	null
28 ה ה העיתונים definiteArticle unspecified unspecified unspecified unspecified unspecified 0 
28 העיתונים עיתון העיתונים noun masculine plural absolute unspecified unspecified  	O	null
29 . . . punctuation unspecified unspecified unspecified unspecified unspecified  	O	null

0 הקימה הקים הקימה verb feminine singular unspecified 3 past  	O	null
1 עם עם עם preposition unspecified unspecified unspecified unspecified unspecified  	O	null
2 ליאת ליאת ליאת properName unspecified unspecified unspecified unspecified unspecified  	I_PERS	null
3 קפלן קפלן קפלן properName unspecified unspecified unspecified unspecified unspecified  	I_PERS	null
4 את את את at-preposition unspecified unspecified unspecified unspecified unspecified  	O	null
5 תחום תחום תחום noun masculine singular construct unspecified unspecified  	O	null
6 ה ה הכתיבה definiteArticle unspecified unspecified unspecified unspecified unspecified 0 
6 הכתיבה כתיבה הכתיבה noun feminine singular absolute unspecified unspecified  	O	null
7 במתא"ן במתא"ן במתא"ן properName unspecified unspecified unspecified unspecified unspecified  	I_ORG	null
8 ( ( ( punctuation unspecified unspecified unspecified unspecified unspecified  	O	null
9 מרכז מרכז מרכז noun masculine singular construct unspecified unspecified  	O	null
10 תרבות תרבות תרבות noun feminine singular absolute unspecified unspecified  	O	null
11 ו ו ואמנות conjunction unspecified unspecified unspecified unspecified unspecified 0 
11 אמנות אמנות ואמנות noun feminine singular absolute unspecified unspecified  	O	null
12 ל ל לנוער preposition unspecified unspecified unspecified unspecified unspecified 0 
12 נוער נוער לנוער noun masculine singular absolute unspecified unspecified  	O	null
13 ) ) ) punctuation unspecified unspecified unspecified unspecified unspecified  	O	null
14 ו ו והנחתה conjunction unspecified unspecified unspecified unspecified unspecified 0 
14 הנחתה הנחה והנחתה verb feminine singular unspecified 3 past  	O	null
15 שם שם שם adverb unspecified unspecified unspecified unspecified unspecified  	O	null
16 סדנאות סדנה סדנאות noun feminine plural absolute unspecified unspecified  	O	null
17 כתיבה כתיבה כתיבה noun feminine singular absolute unspecified unspecified  	O	null
18 ל ל לבני preposition unspecified unspecified unspecified unspecified unspecified 0 
18 בני בן לבני noun masculine plural construct unspecified unspecified  	O	null
19 נוער נוער נוער noun masculine singular absolute unspecified unspecified  	O	null
20 . . . punctuation unspecified unspecified unspecified unspecified unspecified  	O	null

0 מאז מאז מאז adverb unspecified unspecified unspecified unspecified unspecified  	O	null
1 הנחתה הנחה הנחתה verb feminine singular unspecified 3 past  	O	null
2 סדנאות סדנה סדנאות noun feminine plural absolute unspecified unspecified  	O	null
3 ל ל לכתיבת preposition unspecified unspecified unspecified unspecified unspecified 0 
3 כתיבת כתיבה לכתיבת noun feminine singular construct unspecified unspecified  	O	null
4 שירה שירה שירה noun feminine singular absolute unspecified unspecified  	O	null
5 ב ב באוניברסיטת preposition unspecified unspecified unspecified unspecified unspecified 0 
5 אוניברסיטת אוניברסיטה באוניברסיטת noun feminine singular construct unspecified unspecified  	I_ORG	null
6 בן בן בן properName unspecified unspecified unspecified unspecified unspecified  	I_ORG	null
7 - - - properName unspecified unspecified unspecified unspecified unspecified  	I_ORG	null
8 גוריון גוריון גוריון properName unspecified unspecified unspecified unspecified unspecified  	I_ORG	null
9 , , , punctuation unspecified unspecified unspecified unspecified unspecified  	O	null
10 ב ב באוניברסיטת preposition unspecified unspecified unspecified unspecified unspecified 0 
10 אוניברסיטת אוניברסיטה באוניברסיטת noun feminine singular construct unspecified unspecified  	I_ORG	null
11 תלאביב תלאביב תלאביב properName unspecified unspecified unspecified unspecified unspecified  	I_ORG	null
12 , , , punctuation unspecified unspecified unspecified unspecified unspecified  	O	null
13 ב ב באוניברסיטה preposition unspecified unspecified unspecified unspecified unspecified 0 
13 ה ה באוניברסיטה definiteArticle unspecified unspecified unspecified unspecified unspecified 0 
13 האוניברסיטה אוניברסיטה באוניברסיטה noun feminine singular absolute unspecified unspecified  	O	null
14 ה ה העברית definiteArticle unspecified unspecified unspecified unspecified unspecified 0 
14 העברית עברי העברית adjective feminine singular absolute unspecified unspecified  	O	null
15 ב ב בירושלים preposition unspecified unspecified unspecified unspecified unspecified 0 
15 ירושלים ירושלים בירושלים properName unspecified unspecified unspecified unspecified unspecified  	I_LOC	null
16 ו ו וב conjunction unspecified unspecified unspecified unspecified unspecified 0 
16 ב ב וב preposition unspecified unspecified unspecified unspecified unspecified 0 	O	null
17 " " " punctuation unspecified unspecified unspecified unspecified unspecified  	O	null
18 קמרה קימר קמרה verb feminine singular unspecified 3 past  	O	null
19 אובסקורה אובסקורה אובסקורה properName unspecified unspecified unspecified unspecified unspecified  	O	null
20 " " " punctuation unspecified unspecified unspecified unspecified unspecified  	O	null
21 . . . punctuation unspecified unspecified unspecified unspecified unspecified  	O	null

0 מלמדת לימד מלמדת verb feminine singular unspecified any beinoni  	O	null
1 ב ב במכון preposition unspecified unspecified unspecified unspecified unspecified 0 
1 ה ה במכון definiteArticle unspecified unspecified unspecified unspecified unspecified 0 
1 המכון מיכון במכון noun masculine singular absolute unspecified unspecified  	O	null
2 " " " punctuation unspecified unspecified unspecified unspecified unspecified  	O	null
3 כרם כרם כרם properName unspecified unspecified unspecified unspecified unspecified  	I_ORG	null
4 " " " punctuation unspecified unspecified unspecified unspecified unspecified  	O	null
5 ל ל להכשרת preposition unspecified unspecified unspecified unspecified unspecified 0 
5 הכשרת הכשרה להכשרת noun feminine singular construct unspecified unspecified  	O	null
6 מורים מורה מורים noun masculine plural absolute unspecified unspecified  	O	null
7 ב ב בירושלים preposition unspecified unspecified unspecified unspecified unspecified 0 
7 ירושלים ירושלים בירושלים properName unspecified unspecified unspecified unspecified unspecified  	I_LOC	null
8 . . . punctuation unspecified unspecified unspecified unspecified unspecified  	O	null

0 פירסמה פרסם פירסמה verb feminine singular unspecified 3 past  	O	null
1 ארבעה CARD4 ארבעה numeral masculine plural absolute unspecified unspecified  	O	null
2 ספרי ספר ספרי noun masculine plural construct unspecified unspecified  	O	null
3 שירה שירה שירה noun feminine singular absolute unspecified unspecified  	O	null
4 : : : punctuation unspecified unspecified unspecified unspecified unspecified  	O	null
5 אם אם אם conjunction unspecified unspecified unspecified unspecified unspecified  	O	null
6 ה ה ההר definiteArticle unspecified unspecified unspecified unspecified unspecified 0 
6 ההר הר ההר noun masculine singular absolute unspecified unspecified  	O	null
7 נעלמה נעלם נעלמה verb feminine singular unspecified 3 past  	O	null
8 ( ( ( punctuation unspecified unspecified unspecified unspecified unspecified  	O	null
9 תג תג תג noun masculine singular absolute unspecified unspecified  	O	null
10 : : : punctuation unspecified unspecified unspecified unspecified unspecified  	O	null
11 ספרי ספר ספרי noun masculine plural construct unspecified unspecified  	O	null
12 ה ה הליקון definiteArticle unspecified unspecified unspecified unspecified unspecified 0 
12 הליקון הליקון הליקון properName unspecified unspecified unspecified unspecified unspecified  	I_ORG	null
13 , , , punctuation unspecified unspecified unspecified unspecified unspecified  	O	null
14 ) ) ) punctuation unspecified unspecified unspecified unspecified unspecified  	O	null
15 ; ; ; punctuation unspecified unspecified unspecified unspecified unspecified  	O	null
16 ###NUMBER### ###NUMBER### ###NUMBER### numeral unspecified unspecified unspecified unspecified unspecified  	I_DATE	null
17 ה ה הזר definiteArticle unspecified unspecified unspecified unspecified unspecified 0 
17 הזר זר הזר noun masculine singular absolute unspecified unspecified  	O	null
18 ו ו ואשת conjunction unspecified unspecified unspecified unspecified unspecified 0 
18 אשת איש ואשת noun feminine singular construct unspecified unspecified  	O	null
19 חול חול חול noun masculine singular absolute unspecified unspecified  	O	null
20 ) ) ) punctuation unspecified unspecified unspecified unspecified unspecified  	O	null
21 ; ; ; punctuation unspecified unspecified unspecified unspecified unspecified  	O	null
22 נתיני נתין נתיני noun masculine plural construct unspecified unspecified  	O	null
23 ###NUMBER### ###NUMBER### ###NUMBER### numeral unspecified unspecified unspecified unspecified unspecified  	I_DATE	null
24 ה ה השמש definiteArticle unspecified unspecified unspecified unspecified unspecified 0 
24 השמש שמש השמש noun feminine singular absolute unspecified unspecified  	O	null
25 ) ) ) punctuation unspecified unspecified unspecified unspecified unspecified  	O	null
26 ; ; ; punctuation unspecified unspecified unspecified unspecified unspecified  	O	null
27 ###NUMBER### ###NUMBER### ###NUMBER### numeral unspecified unspecified unspecified unspecified unspecified  	I_DATE	null
28 ו ו והאוריום conjunction unspecified unspecified unspecified unspecified unspecified 0 
28 ה ה והאוריום definiteArticle unspecified unspecified unspecified unspecified unspecified 0 
28 האוריום האוריום והאוריום noun masculine singular absolute unspecified unspecified  	O	null
29 ) ) ) punctuation unspecified unspecified unspecified unspecified unspecified  	O	null
30 . . . punctuation unspecified unspecified unspecified unspecified unspecified  	O	null
31 ###NUMBER### ###NUMBER### ###NUMBER### numeral unspecified unspecified unspecified unspecified unspecified  	I_DATE	null
32 שירי שיר שיריה noun masculine plural absolute unspecified unspecified  
32 ה ה שיריה possessive feminine singular unspecified 3 unspecified 0 	O	null
33 הופיעו הופיע הופיעו verb masculine-and-feminine plural unspecified 3 past  	O	null
34 באנתולוגיות באנתולוגיות באנתולוגיות noun feminine plural absolute unspecified unspecified  	O	null
35 ב ב בארץ preposition unspecified unspecified unspecified unspecified unspecified 0 
35 ה ה בארץ definiteArticle unspecified unspecified unspecified unspecified unspecified 0 
35 הארץ ארץ בארץ noun feminine singular absolute unspecified unspecified  	O	null
36 ו ו ובארצות conjunction unspecified unspecified unspecified unspecified unspecified 0 
36 ב ב ובארצות preposition unspecified unspecified unspecified unspecified unspecified 0 
36 ארצות ארץ ובארצות properName unspecified unspecified unspecified unspecified unspecified  	I_LOC	null
37 הברית ברית הברית properName unspecified unspecified unspecified unspecified unspecified  	I_LOC	null
38 ו ו ותורגמו conjunction unspecified unspecified unspecified unspecified unspecified 0 
38 תורגמו תורגם ותורגמו verb masculine-and-feminine plural unspecified 3 past  	O	null
39 ל ל לכמה preposition unspecified unspecified unspecified unspecified unspecified 0 
39 כמה כמה לכמה quantifier unspecified unspecified construct unspecified unspecified  	O	null
40 שפות שפה שפות noun feminine plural absolute unspecified unspecified  	O	null
41 אירופיות אירופי אירופיות adjective feminine plural absolute unspecified unspecified  	O	null
42 . . . punctuation unspecified unspecified unspecified unspecified unspecified  	O	null

0 מתרגמת מתרגם מתרגמת noun feminine singular construct unspecified unspecified  	O	null
1 שירה שירה שירה noun feminine singular absolute unspecified unspecified  	O	null
2 מ מ מאנגלית preposition unspecified unspecified unspecified unspecified unspecified 0 
2 אנגלית אנגלית מאנגלית properName feminine singular unspecified unspecified unspecified  	I_PERS	null
3 ו ו ומצרפתית conjunction unspecified unspecified unspecified unspecified unspecified 0 
3 מ מ ומצרפתית preposition unspecified unspecified unspecified unspecified unspecified 0 
3 צרפתית צרפתית ומצרפתית properName feminine singular unspecified unspecified unspecified  	I_PERS	null
4 . . . punctuation unspecified unspecified unspecified unspecified unspecified  	O	null

0 בין בין בין preposition unspecified unspecified unspecified unspecified unspecified  	O	null
1 ה ה השאר definiteArticle unspecified unspecified unspecified unspecified unspecified 0 
1 השאר שאר השאר noun masculine singular absolute unspecified unspecified  	O	null
2 מ מ משיריהם preposition unspecified unspecified unspecified unspecified unspecified 0 
2 שירי שיר משיריהם noun masculine plural absolute unspecified unspecified  
2 הם הם משיריהם possessive masculine plural unspecified 3 unspecified 0 	O	null
3 של של של shel-preposition unspecified unspecified unspecified unspecified unspecified  	O	null
4 לואיס לואיס לואיס properName unspecified unspecified unspecified unspecified unspecified  	I_PERS	null
5 גלי גל גלי properName unspecified unspecified unspecified unspecified unspecified  	I_PERS	null
6 , , , punctuation unspecified unspecified unspecified unspecified unspecified  	O	null
7 ו ו וולאס conjunction unspecified unspecified unspecified unspecified unspecified 0 
7 ולא ולא וולאס punctuation masculine singular absolute unspecified unspecified  	O	null
8 סטיוונס סטיוונס סטיוונס properName unspecified unspecified unspecified unspecified unspecified  	I_PERS	null
9 , , , punctuation unspecified unspecified unspecified unspecified unspecified  	O	null
10 אן אן אן properName unspecified unspecified unspecified unspecified unspecified  	I_PERS	null
11 קארסון קארסון קארסון properName unspecified unspecified unspecified unspecified unspecified  	I_PERS	null
12 ו ו ופרנק conjunction unspecified unspecified unspecified unspecified unspecified 0 
12 פרנק פרנק ופרנק properName unspecified unspecified unspecified unspecified unspecified  	B_PERS	null
13 בידארט בידארט בידארט properName unspecified unspecified unspecified unspecified unspecified  	I_PERS	null
14 . . . punctuation unspecified unspecified unspecified unspecified unspecified  	O	null

0 כותבת כותב כותבת noun feminine singular construct unspecified unspecified  	O	null
1 מסות מסה מסות noun feminine plural absolute unspecified unspecified  	O	null
2 על על על preposition unspecified unspecified unspecified unspecified unspecified  	O	null
3 שירה שירה שירה noun feminine singular absolute unspecified unspecified  	O	null
4 ו ו וחוקרת conjunction unspecified unspecified unspecified unspecified unspecified 0 
4 חוקרת חקר וחוקרת verb feminine singular unspecified any beinoni  	O	null
5 את את את at-preposition unspecified unspecified unspecified unspecified unspecified  	O	null
6 ה ה המשורר definiteArticle unspecified unspecified unspecified unspecified unspecified 0 
6 המשורר משורר המשורר noun masculine singular absolute unspecified unspecified  	O	null
7 ה ה האיטלקי definiteArticle unspecified unspecified unspecified unspecified unspecified 0 
7 האיטלקי איטלקי האיטלקי adjective masculine singular absolute unspecified unspecified  	O	null
8 דנטה דנטה דנטה properName unspecified unspecified unspecified unspecified unspecified  	I_PERS	null
9 אליגיירי אליגיירי אליגיירי properName unspecified unspecified unspecified unspecified unspecified  	I_PERS	null
10 - - - punctuation unspecified unspecified unspecified unspecified unspecified  	O	null
11 ###NUMBER### ###NUMBER### ###NUMBER### numeral unspecified unspecified unspecified unspecified unspecified  	I_DATE	null
12 ) ) ) punctuation unspecified unspecified unspecified unspecified unspecified  	O	null
13 , , , punctuation unspecified unspecified unspecified unspecified unspecified  	O	null
14 ###NUMBER### ###NUMBER### ###NUMBER### numeral unspecified unspecified unspecified unspecified unspecified  	O	null
15 מ מ מחבר preposition unspecified unspecified unspecified unspecified unspecified 0 
15 חבר חבר מחבר noun masculine singular construct unspecified unspecified  	O	null
16 ה ה הקומדיה definiteArticle unspecified unspecified unspecified unspecified unspecified 0 
16 הקומדיה קומדיה הקומדיה noun feminine singular absolute unspecified unspecified  	O	null
17 ה ה האלוהית definiteArticle unspecified unspecified unspecified unspecified unspecified 0 
17 האלוהית אלוהי האלוהית adjective feminine singular absolute unspecified unspecified  	O	null
18 . . . punctuation unspecified unspecified unspecified unspecified unspecified  	O	null

0 שירת שירה שירתה noun feminine singular absolute unspecified unspecified  
0 ה ה שירתה possessive feminine singular unspecified 3 unspecified 0 	O	null
1 מאופיינת אופיין מאופיינת verb feminine singular unspecified any beinoni  	O	null
2 ב ב בשימוש preposition unspecified unspecified unspecified unspecified unspecified 0 
2 שימוש שימוש בשימוש noun masculine singular absolute unspecified unspecified  	O	null
3 אינטנסיבי אינטנסיבי אינטנסיבי adjective masculine singular absolute unspecified unspecified  	O	null
4 ב ב בחומרים preposition unspecified unspecified unspecified unspecified unspecified 0 
4 חומרים חומר בחומרים noun masculine plural absolute unspecified unspecified  	O	null
5 בעלי בעל בעלי noun masculine plural construct unspecified unspecified  	O	null
6 אופי אופי אופי noun masculine singular absolute unspecified unspecified  	O	null
7 מיתי מיתי מיתי adjective masculine singular absolute unspecified unspecified  	O	null
8 – – – punctuation unspecified unspecified unspecified unspecified unspecified  	O	null
9 מ מ מהמיתולוגיה preposition unspecified unspecified unspecified unspecified unspecified 0 
9 ה ה מהמיתולוגיה definiteArticle unspecified unspecified unspecified unspecified unspecified 0 
9 המיתולוגיה מיתולוגיה מהמיתולוגיה noun feminine singular absolute unspecified unspecified  	O	null
10 ה ה היוונית definiteArticle unspecified unspecified unspecified unspecified unspecified 0 
10 היוונית יווני היוונית adjective feminine singular absolute unspecified unspecified  	O	null
11 ו ו ומהקלאסיקה conjunction unspecified unspecified unspecified unspecified unspecified 0 
11 מ מ ומהקלאסיקה preposition unspecified unspecified unspecified unspecified unspecified 0 
11 ה ה ומהקלאסיקה definiteArticle unspecified unspecified unspecified unspecified unspecified 0 
11 הקלאסיקה קלאסיקה ומהקלאסיקה noun feminine singular absolute unspecified unspecified  	O	null
12 ה ה הנוצרית definiteArticle unspecified unspecified unspecified unspecified unspecified 0 
12 הנוצרית נוצרי הנוצרית adjective feminine singular absolute unspecified unspecified  	O	null
13 ו ו והמודרנית conjunction unspecified unspecified unspecified unspecified unspecified 0 
13 ה ה והמודרנית definiteArticle unspecified unspecified unspecified unspecified unspecified 0 
13 המודרנית מודרני והמודרנית adjective feminine singular absolute unspecified unspecified  	O	null
14 . . . punctuation unspecified unspecified unspecified unspecified unspecified  	O	null

0 יסודות יסוד יסודות noun masculine plural absolute unspecified unspecified  	O	null
1 מ מ מיצירותיהם preposition unspecified unspecified unspecified unspecified unspecified 0 
1 יצירות יצירה מיצירותיהם noun feminine plural absolute unspecified unspecified  
1 הם הם מיצירותיהם possessive masculine plural unspecified 3 unspecified 0 	O	null
2 של של של shel-preposition unspecified unspecified unspecified unspecified unspecified  	O	null
3 הומרוס הומרוס הומרוס properName unspecified unspecified unspecified unspecified unspecified  	I_PERS	null
4 , , , punctuation unspecified unspecified unspecified unspecified unspecified  	O	null
5 דנטה דנטה דנטה properName unspecified unspecified unspecified unspecified unspecified  	I_PERS	null
6 , , , punctuation unspecified unspecified unspecified unspecified unspecified  	O	null
7 ט"ס ט"ס ט"ס properName unspecified unspecified unspecified unspecified unspecified  	I_PERS	null
8 אליוט אליוט אליוט properName unspecified unspecified unspecified unspecified unspecified  	I_PERS	null
9 ו ו ועזרא conjunction unspecified unspecified unspecified unspecified unspecified 0 
9 עזרא עזרא ועזרא properName unspecified unspecified unspecified unspecified unspecified  	B_PERS	null
10 פאונד פאונד פאונד properName unspecified unspecified unspecified unspecified unspecified  	I_PERS	null
11 מעמידים העמיד מעמידים verb masculine plural unspecified any beinoni  	O	null
12 ב ב בשירתה preposition unspecified unspecified unspecified unspecified unspecified 0 
12 שירת שירה בשירתה noun feminine singular absolute unspecified unspecified  
12 ה ה בשירתה possessive feminine singular unspecified 3 unspecified 0 	O	null
13 עולם עולם עולם noun masculine singular absolute unspecified unspecified  	O	null
14 פואטי פואטי פואטי properName unspecified unspecified unspecified unspecified unspecified  	I_PERS	null
15 , , , punctuation unspecified unspecified unspecified unspecified unspecified  	O	null
16 מיתולוגי מיתולוגי מיתולוגי adjective masculine singular absolute unspecified unspecified  	O	null
17 ו ו ואלגי conjunction unspecified unspecified unspecified unspecified unspecified 0 
17 אלגי אלגי ואלגי properName unspecified unspecified unspecified unspecified unspecified  	I_PERS	null
18 , , , punctuation unspecified unspecified unspecified unspecified unspecified  	O	null
19 כ כ כעין preposition unspecified unspecified unspecified unspecified unspecified 0 
19 עין עין כעין noun feminine singular construct unspecified unspecified  	O	null
20 " " " punctuation unspecified unspecified unspecified unspecified unspecified  	O	null
21 תיאטרון תיאטרון תיאטרון properName unspecified unspecified unspecified unspecified unspecified  	I_ORG	null
22 תודעה תודעה תודעה noun feminine singular absolute unspecified unspecified  	O	null
23 " " " punctuation unspecified unspecified unspecified unspecified unspecified  	O	null
24 ב ב בלשונה preposition unspecified unspecified unspecified unspecified unspecified 0 
24 לשון לשון בלשונה noun feminine singular absolute unspecified unspecified  
24 ה ה בלשונה possessive feminine singular unspecified 3 unspecified 0 	O	null
25 . . . punctuation unspecified unspecified unspecified unspecified unspecified  	O	null

0 זהו זהו זהו pronoun masculine singular unspecified 3 unspecified  	O	null
1 עולם עולם עולם noun masculine singular absolute unspecified unspecified  	O	null
2 של של של shel-preposition unspecified unspecified unspecified unspecified unspecified  	O	null
3 טרנספורמציות טרנספורמציות טרנספורמציות verb masculine singular unspecified any beinoni  	O	null
4 , , , punctuation unspecified unspecified unspecified unspecified unspecified  	O	null
5 שבו ישב שבו verb masculine-and-feminine plural unspecified 2 imperative  	O	null
6 ה ה הזמן definiteArticle unspecified unspecified unspecified unspecified unspecified 0 
6 הזמן זמן הזמן noun masculine singular absolute unspecified unspecified  	O	null
7 שב שב שב verb masculine singular unspecified 3 past  	O	null
8 ו ו וסובב conjunction unspecified unspecified unspecified unspecified unspecified 0 
8 סובב סובב וסובב verb masculine singular unspecified 3 past  	O	null
9 ב ב בחלל preposition unspecified unspecified unspecified unspecified unspecified 0 
9 ה ה בחלל definiteArticle unspecified unspecified unspecified unspecified unspecified 0 
9 החלל חלל בחלל noun masculine singular absolute unspecified unspecified  	O	null
10 ; ; ; punctuation unspecified unspecified unspecified unspecified unspecified  	O	null
11 שבו ישב שבו verb masculine-and-feminine plural unspecified 2 imperative  	O	null
12 ה ה העבר definiteArticle unspecified unspecified unspecified unspecified unspecified 0 
12 העבר עבר העבר noun masculine singular absolute unspecified unspecified  	O	null
13 נוכח נכח נוכח verb masculine singular unspecified any beinoni  	O	null
14 תדיר תדיר תדיר adjective masculine singular absolute unspecified unspecified  	O	null
15 ב ב בהווה preposition unspecified unspecified unspecified unspecified unspecified 0 
15 ה ה בהווה definiteArticle unspecified unspecified unspecified unspecified unspecified 0 
15 ההווה הווה בהווה noun masculine singular absolute unspecified unspecified  	O	null
16 ו ו ומושלך conjunction unspecified unspecified unspecified unspecified unspecified 0 
16 מושלך הושלך ומושלך verb masculine singular unspecified any beinoni  	O	null
17 אל אל אל preposition unspecified unspecified unspecified unspecified unspecified  	O	null
18 ה ה העתיד definiteArticle unspecified unspecified unspecified unspecified unspecified 0 
18 העתיד עתיד העתיד noun masculine singular absolute unspecified unspecified  	O	null
19 ; ; ; punctuation unspecified unspecified unspecified unspecified unspecified  	O	null
20 שבו ישב שבו verb masculine-and-feminine plural unspecified 2 imperative  	O	null
21 מתמוססים התמוסס מתמוססים verb masculine plural unspecified any beinoni  	O	null
22 ה ה הגבולות definiteArticle unspecified unspecified unspecified unspecified unspecified 0 
22 הגבולות גבול הגבולות noun masculine plural absolute unspecified unspecified  	O	null
23 בין בין בין preposition unspecified unspecified unspecified unspecified unspecified  	O	null
24 סובייקטים סובייקטים סובייקטים noun masculine plural absolute unspecified unspecified  	O	null
25 . . . punctuation unspecified unspecified unspecified unspecified unspecified  	O	null

0 זהו זהו זהו pronoun masculine singular unspecified 3 unspecified  	O	null
1 עולם עולם עולם noun masculine singular absolute unspecified unspecified  	O	null
2 שבו שב שבו verb masculine-and-feminine plural unspecified 3 past  	O	null
3 ה ה המיתיזציה definiteArticle unspecified unspecified unspecified unspecified unspecified 0 
3 המיתיזציה המיתיזציה המיתיזציה participle masculine plural absolute any unspecified  	O	null
4 היא הוא היא pronoun feminine singular unspecified 3 unspecified  	O	null
5 תנאי תנאי תנאי noun masculine singular absolute unspecified unspecified  	O	null
6 ל ל לעוצמה preposition unspecified unspecified unspecified unspecified unspecified 0 
6 עוצמה עוצמה לעוצמה noun feminine singular absolute unspecified unspecified  	O	null
7 של של של shel-preposition unspecified unspecified unspecified unspecified unspecified  	O	null
8 ה ה הביוגרפי definiteArticle unspecified unspecified unspecified unspecified unspecified 0 
8 הביוגרפי ביוגראפי הביוגרפי adjective masculine singular absolute unspecified unspecified  	O	null
9 , , , punctuation unspecified unspecified unspecified unspecified unspecified  	O	null
10 ה ה הנסמך definiteArticle unspecified unspecified unspecified unspecified unspecified 0 
10 הנסמך נסמך הנסמך participle masculine singular absolute any unspecified  	O	null
11 על על על preposition unspecified unspecified unspecified unspecified unspecified  	O	null
12 דמויות דמות דמויות noun feminine plural absolute unspecified unspecified  	O	null
13 כגון כגון כגון preposition unspecified unspecified unspecified unspecified unspecified  	I_LOC	null
14 אודיסאוס אודיסאוס אודיסאוס properName unspecified unspecified unspecified unspecified unspecified  	I_PERS	null
15 , , , punctuation unspecified unspecified unspecified unspecified unspecified  	O	null
16 קרברוס קרברוס קרברוס properName unspecified unspecified unspecified unspecified unspecified  	I_PERS	null
17 , , , punctuation unspecified unspecified unspecified unspecified unspecified  	O	null
18 דמטריוס דמטריוס דמטריוס adjective feminine plural absolute unspecified unspecified  	O	null
19 , , , punctuation unspecified unspecified unspecified unspecified unspecified  	O	null
20 איקרוס איקרוס איקרוס noun masculine singular absolute unspecified unspecified  	O	null
21 ו ו ואחרים conjunction unspecified unspecified unspecified unspecified unspecified 0 
21 אחרים אחר ואחרים adjective masculine plural absolute unspecified unspecified  	O	null
22 . . . punctuation unspecified unspecified unspecified unspecified unspecified  	O	null

0 ש ש שלא relativizer/subordinatingConjunction unspecified unspecified unspecified unspecified unspecified 0 
0 לא לא שלא negation unspecified unspecified unspecified unspecified unspecified  	O	null
1 כ כ כמשוררים preposition unspecified unspecified unspecified unspecified unspecified 0 
1 משוררים משורר כמשוררים noun masculine plural absolute unspecified unspecified  	O	null
2 אחרים אחר אחרים adjective masculine plural absolute unspecified unspecified  	O	null
3 בני בן בני noun masculine plural construct unspecified unspecified  	O	null
4 תקופת תקופה תקופתה noun feminine singular absolute unspecified unspecified  
4 ה ה תקופתה possessive feminine singular unspecified 3 unspecified 0 	O	null
5 ( ( ( punctuation unspecified unspecified unspecified unspecified unspecified  	O	null
6 למשל למשל למשל conjunction unspecified unspecified unspecified unspecified unspecified  	O	null
7 , , , punctuation unspecified unspecified unspecified unspecified unspecified  	O	null
8 ליאת ליאת ליאת properName unspecified unspecified unspecified unspecified unspecified  	I_PERS	null
9 קפלן קפלן קפלן properName unspecified unspecified unspecified unspecified unspecified  	I_PERS	null
10 ו ו ותמיר conjunction unspecified unspecified unspecified unspecified unspecified 0 
10 תמיר תמיר ותמיר properName unspecified unspecified unspecified unspecified unspecified  	B_PERS	null
11 להב להב להב properName unspecified unspecified unspecified unspecified unspecified  	I_PERS	null
12 - - - punctuation unspecified unspecified unspecified unspecified unspecified  	O	null
13 רדלמסר רדלמסר רדלמסר properName unspecified unspecified unspecified unspecified unspecified  	I_ORG	null
14 ) ) ) punctuation unspecified unspecified unspecified unspecified unspecified  	O	null
15 , , , punctuation unspecified unspecified unspecified unspecified unspecified  	O	null
16 ה ה המשתמשים definiteArticle unspecified unspecified unspecified unspecified unspecified 0 
16 המשתמשים השתמש המשתמשים participle masculine plural absolute any unspecified  	O	null
17 ב ב ב preposition unspecified unspecified unspecified unspecified unspecified 0 	O	null
18 " " " punctuation unspecified unspecified unspecified unspecified unspecified  	O	null
19 דובר דובר דובר noun masculine singular absolute unspecified unspecified  	O	null
20 אוטוביוגרפי אוטוביוגרפי אוטוביוגרפי adjective masculine singular absolute unspecified unspecified  	O	null
21 " " " punctuation unspecified unspecified unspecified unspecified unspecified  	O	null
22 , , , punctuation unspecified unspecified unspecified unspecified unspecified  	O	null
23 אס אס אס properName unspecified unspecified unspecified unspecified unspecified  	I_ORG	null
24 מציגה הציג מציגה verb feminine singular unspecified any beinoni  	O	null
25 " " " punctuation unspecified unspecified unspecified unspecified unspecified  	O	null
26 אני הוא אני pronoun masculine-and-feminine singular unspecified 1 unspecified  	O	null
27 ל ל לירי preposition unspecified unspecified unspecified unspecified unspecified 0 
27 ירי ירי לירי noun masculine singular absolute unspecified unspecified  	O	null
28 " " " punctuation unspecified unspecified unspecified unspecified unspecified  	O	null
29 רב רב רב adjective masculine singular absolute unspecified unspecified  	O	null
30 - - - punctuation unspecified unspecified unspecified unspecified unspecified  	O	null
31 השתקפויות השתקפות השתקפויות noun feminine plural absolute unspecified unspecified  	O	null
32 , , , punctuation unspecified unspecified unspecified unspecified unspecified  	O	null
33 ה ה המועצם definiteArticle unspecified unspecified unspecified unspecified unspecified 0 
33 המועצם הועצם המועצם participle masculine singular absolute any unspecified  	O	null
34 ל ל לממדים preposition unspecified unspecified unspecified unspecified unspecified 0 
34 ממדים ממד לממדים noun masculine plural absolute unspecified unspecified  	O	null
35 קולוסאליים קולוסאליים קולוסאליים adjective masculine plural absolute unspecified unspecified  	O	null
36 . . . punctuation unspecified unspecified unspecified unspecified unspecified  	O	null

0 ב ב בשיריה preposition unspecified unspecified unspecified unspecified unspecified 0 
0 שירי שיר בשיריה noun masculine plural absolute unspecified unspecified  
0 ה ה בשיריה possessive feminine singular unspecified 3 unspecified 0 	O	null
1 מתגלמות התגלם מתגלמות verb feminine plural unspecified any beinoni  	O	null
2 , , , punctuation unspecified unspecified unspecified unspecified unspecified  	O	null
3 במקביל במקביל במקביל adverb unspecified unspecified unspecified unspecified unspecified  	O	null
4 , , , punctuation unspecified unspecified unspecified unspecified unspecified  	O	null
5 ה ה התשוקה definiteArticle unspecified unspecified unspecified unspecified unspecified 0 
5 התשוקה תשוקה התשוקה noun feminine singular absolute unspecified unspecified  	O	null
6 להחיות החיה להחיות verb unspecified unspecified unspecified unspecified infinitive  	O	null
7 עולם עולם עולם noun masculine singular absolute unspecified unspecified  	O	null
8 לאור לאור לאור preposition unspecified unspecified unspecified unspecified unspecified  	O	null
9 צללים צל צללים noun masculine plural absolute unspecified unspecified  	O	null
10 קדמוניים קדמוני קדמוניים adjective masculine plural absolute unspecified unspecified  	O	null
11 ו ו ושאלת conjunction unspecified unspecified unspecified unspecified unspecified 0 
11 שאלת שאלה ושאלת noun feminine singular construct unspecified unspecified  	O	null
12 ה ה המשמעות definiteArticle unspecified unspecified unspecified unspecified unspecified 0 
12 המשמעות משמעות המשמעות noun feminine singular absolute unspecified unspecified  	O	null
13 של של של shel-preposition unspecified unspecified unspecified unspecified unspecified  	O	null
14 מעשה מעשה מעשה noun masculine singular construct unspecified unspecified  	O	null
15 ה ה ההחייאה definiteArticle unspecified unspecified unspecified unspecified unspecified 0 
15 ההחייאה החייאה ההחייאה noun feminine singular absolute unspecified unspecified  	O	null
16 עצמו עצמו עצמו pronoun unspecified unspecified unspecified unspecified unspecified  
16 ו ו עצמו pronomial masculine singular unspecified 3 unspecified 0 	O	null
17 . . . punctuation unspecified unspecified unspecified unspecified unspecified  	O	null

0 פעולת פעולה פעולת noun feminine singular construct unspecified unspecified  	O	null
1 ה ה השיר definiteArticle unspecified unspecified unspecified unspecified unspecified 0 
1 השיר שיר השיר noun masculine singular absolute unspecified unspecified  	O	null
2 נתפשת נתפש נתפשת verb feminine singular unspecified any beinoni  	O	null
3 כ כ כמקום preposition unspecified unspecified unspecified unspecified unspecified 0 
3 מקום מקום כמקום noun masculine singular absolute unspecified unspecified  	O	null
4 של של של shel-preposition unspecified unspecified unspecified unspecified unspecified  	O	null
5 פתיחה פתיחה פתיחה noun feminine singular absolute unspecified unspecified  	O	null
6 , , , punctuation unspecified unspecified unspecified unspecified unspecified  	O	null
7 של של של shel-preposition unspecified unspecified unspecified unspecified unspecified  	O	null
8 היסוס היסוס היסוס noun feminine singular absolute unspecified unspecified  	O	null
9 ו ו ושל conjunction unspecified unspecified unspecified unspecified unspecified 0 
9 של של ושל shel-preposition unspecified unspecified unspecified unspecified unspecified  	O	null
10 גילוי גילוי גילוי noun masculine singular absolute unspecified unspecified  	O	null
11 , , , punctuation unspecified unspecified unspecified unspecified unspecified  	O	null
12 שבו ישב שבו verb masculine-and-feminine plural unspecified 2 imperative  	O	null
13 שולטים שלט שולטים verb masculine plural unspecified any beinoni  	O	null
14 ה ה העוצמה definiteArticle unspecified unspecified unspecified unspecified unspecified 0 
14 העוצמה עוצמה העוצמה noun feminine singular absolute unspecified unspecified  	O	null
15 של של של shel-preposition unspecified unspecified unspecified unspecified unspecified  	O	null
16 ה ה הדמיון definiteArticle unspecified unspecified unspecified unspecified unspecified 0 
16 הדמיון דמיון הדמיון noun masculine singular absolute unspecified unspecified  	O	null
17 ו ו והחירות conjunction unspecified unspecified unspecified unspecified unspecified 0 
17 ה ה והחירות definiteArticle unspecified unspecified unspecified unspecified unspecified 0 
17 החירות חירות והחירות noun feminine singular absolute unspecified unspecified  	O	null
18 להמציא המציא להמציא verb unspecified unspecified unspecified unspecified infinitive  	O	null
19 את את את at-preposition unspecified unspecified unspecified unspecified unspecified  	O	null
20 ה ה העולם definiteArticle unspecified unspecified unspecified unspecified unspecified 0 
20 העולם עולם העולם noun masculine singular absolute unspecified unspecified  	O	null
21 ו ו ולא conjunction unspecified unspecified unspecified unspecified unspecified 0 
21 לא לא ולא negation unspecified unspecified unspecified unspecified unspecified  	O	null
22 לחקות חיקה לחקותו verb unspecified unspecified unspecified unspecified infinitive  
22 ו ו לחקותו accusative-or-nominative masculine singular unspecified 3 unspecified 0 	O	null
23 . . . punctuation unspecified unspecified unspecified unspecified unspecified  	O	null

0 ה ה הטקסט definiteArticle unspecified unspecified unspecified unspecified unspecified 0 
0 הטקסט טקסט הטקסט noun masculine singular absolute unspecified unspecified  	O	null
1 ה ה השירי definiteArticle unspecified unspecified unspecified unspecified unspecified 0 
1 השירי שירי השירי adjective masculine singular absolute unspecified unspecified  	O	null
2 נבחן נבחן נבחן verb masculine singular unspecified 3 past  	O	null
3 ב ב בשיריה preposition unspecified unspecified unspecified unspecified unspecified 0 
3 שירי שיר בשיריה noun masculine plural absolute unspecified unspecified  
3 ה ה בשיריה possessive feminine singular unspecified 3 unspecified 0 	O	null
4 כ כ כמעשה preposition unspecified unspecified unspecified unspecified unspecified 0 
4 מעשה מעשה כמעשה noun masculine singular absolute unspecified unspecified  	O	null
5 של של של shel-preposition unspecified unspecified unspecified unspecified unspecified  	O	null
6 עדות עדות עדות noun feminine singular absolute unspecified unspecified  	O	null
7 , , , punctuation unspecified unspecified unspecified unspecified unspecified  	O	null
8 ו ו ובד conjunction unspecified unspecified unspecified unspecified unspecified 0 
8 בד בד ובד noun masculine singular absolute unspecified unspecified  	O	null
9 ב ב בבד preposition unspecified unspecified unspecified unspecified unspecified 0 
9 בד בד בבד noun masculine singular absolute unspecified unspecified  	O	null
10 כ כ כמעשה preposition unspecified unspecified unspecified unspecified unspecified 0 
10 מעשה מעשה כמעשה noun masculine singular construct unspecified unspecified  	O	null
11 בגידה בגידה בגידה noun feminine singular absolute unspecified unspecified  	O	null
12 , , , punctuation unspecified unspecified unspecified unspecified unspecified  	O	null
13 כ כ כפעולה preposition unspecified unspecified unspecified unspecified unspecified 0 
13 פעולה פעולה כפעולה noun feminine singular absolute unspecified unspecified  	O	null
14 לשונית לשוני לשונית adjective feminine singular absolute unspecified unspecified  	O	null
15 ש ש שמעצם relativizer/subordinatingConjunction unspecified unspecified unspecified unspecified unspecified 0 
15 מ מ שמעצם preposition unspecified unspecified unspecified unspecified unspecified 0 
15 עצם עצם שמעצם noun masculine singular construct unspecified unspecified  	O	null
16 טבע טבע טבעה noun masculine singular absolute unspecified unspecified  
16 ה ה טבעה possessive feminine singular unspecified 3 unspecified 0 	O	null
17 היא הוא היא pronoun feminine singular unspecified 3 unspecified  	O	null
18 שקר שקר שקר noun masculine singular absolute unspecified unspecified  	O	null
19 , , , punctuation unspecified unspecified unspecified unspecified unspecified  	O	null
20 אבל אבל אבל conjunction unspecified unspecified unspecified unspecified unspecified  	O	null
21 גם גם גם conjunction unspecified unspecified unspecified unspecified unspecified  	O	null
22 אמת אמת אמת noun feminine singular absolute unspecified unspecified  	O	null
23 . . . punctuation unspecified unspecified unspecified unspecified unspecified  	O	null

0 ב ב באופן preposition unspecified unspecified unspecified unspecified unspecified 0 
0 אופן אופן באופן noun masculine singular absolute unspecified unspecified  	O	null
1 זה זה זה pronoun masculine singular unspecified 3 unspecified  	O	null
2 גם גם גם conjunction unspecified unspecified unspecified unspecified unspecified  	O	null
3 קשורה קשור קשורה adjective feminine singular absolute unspecified unspecified  	O	null
4 ש ש שירתה relativizer/subordinatingConjunction unspecified unspecified unspecified unspecified unspecified 0 
4 ירתה ירה שירתה verb feminine singular unspecified 3 past  	O	null
5 ב ב בשירת preposition unspecified unspecified unspecified unspecified unspecified 0 
5 שירת שירה בשירת noun feminine singular construct unspecified unspecified  	O	null
6 נורית נורית נורית properName unspecified unspecified unspecified unspecified unspecified  	I_PERS	null
7 זרחי זרח זרחי verb feminine singular unspecified 2 imperative  	O	null
8 : : : punctuation unspecified unspecified unspecified unspecified unspecified  	O	null
9 ה ה הביוגרפי definiteArticle unspecified unspecified unspecified unspecified unspecified 0 
9 הביוגרפי ביוגראפי הביוגרפי adjective masculine singular absolute unspecified unspecified  	O	null
10 משמש משמש משמש verb masculine singular unspecified 3 past  	O	null
11 כ כ כעין preposition unspecified unspecified unspecified unspecified unspecified 0 
11 עין עין כעין noun feminine singular construct unspecified unspecified  	O	null
12 מקפצה מקפצה מקפצה noun feminine singular absolute unspecified unspecified  	O	null
13 אל אל אל preposition unspecified unspecified unspecified unspecified unspecified  	O	null
14 עולם עולם עולם noun masculine singular absolute unspecified unspecified  	O	null
15 אחר אחר אחר adjective masculine singular absolute unspecified unspecified  	O	null
16 , , , punctuation unspecified unspecified unspecified unspecified unspecified  	O	null
17 מורכב מורכב מורכב adjective masculine singular absolute unspecified unspecified  	O	null
18 , , , punctuation unspecified unspecified unspecified unspecified unspecified  	O	null
19 קסום קסום קסום adjective masculine singular absolute unspecified unspecified  	O	null
20 ו ו וטוטלי conjunction unspecified unspecified unspecified unspecified unspecified 0 
20 טוטלי טוטלי וטוטלי properName unspecified unspecified unspecified unspecified unspecified  	I_PERS	null
21 , , , punctuation unspecified unspecified unspecified unspecified unspecified  	O	null
22 ש ש שאין relativizer/subordinatingConjunction unspecified unspecified unspecified unspecified unspecified 0 
22 אין יש שאין existential unspecified unspecified unspecified unspecified unspecified  	O	null
23 לו לו לו conjunction unspecified unspecified unspecified unspecified unspecified  	O	null
24 דבר דבר דבר noun masculine singular absolute unspecified unspecified  	O	null
25 עם עם עם preposition unspecified unspecified unspecified unspecified unspecified  	O	null
26 ה ה היומיומי definiteArticle unspecified unspecified unspecified unspecified unspecified 0 
26 היומיומי יומיומי היומיומי adjective masculine singular absolute unspecified unspecified  	O	null
27 . . . punctuation unspecified unspecified unspecified unspecified unspecified  	O	null

0 על על על preposition unspecified unspecified unspecified unspecified unspecified  	O	null
1 ספר ספר ספרה noun masculine singular absolute unspecified unspecified  
1 ה ה ספרה possessive feminine singular unspecified 3 unspecified 0 	O	null
2 ה ה הראשון definiteArticle unspecified unspecified unspecified unspecified unspecified 0 
2 הראשון ORD1 הראשון numeral masculine singular absolute unspecified unspecified  	O	null
3 זכתה זכה זכתה verb feminine singular unspecified 3 past  	O	null
4 ב ב במלגת preposition unspecified unspecified unspecified unspecified unspecified 0 
4 מלגת מלגה במלגת noun feminine singular construct unspecified unspecified  	O	null
5 ה ה הליקון definiteArticle unspecified unspecified unspecified unspecified unspecified 0 
5 הליקון הליקון הליקון noun masculine singular absolute unspecified unspecified  	O	null
6 על על על preposition unspecified unspecified unspecified unspecified unspecified  	O	null
7 שם שם שם noun masculine singular construct unspecified unspecified  	O	null
8 חזי חזי חזי properName unspecified unspecified unspecified unspecified unspecified  	I_PERS	null
9 לסקלי לסקלי לסקלי properName unspecified unspecified unspecified unspecified unspecified  	I_PERS	null
10 ל ל לספר preposition unspecified unspecified unspecified unspecified unspecified 0 
10 ספר ספר לספר noun masculine singular construct unspecified unspecified  	O	null
11 ביכורים ביכורים ביכורים noun masculine singular absolute unspecified unspecified  	O	null
12 , , , punctuation unspecified unspecified unspecified unspecified unspecified  	O	null
13 ו ו ובמלגה conjunction unspecified unspecified unspecified unspecified unspecified 0 
13 ב ב ובמלגה preposition unspecified unspecified unspecified unspecified unspecified 0 
13 מלגה מלגה ובמלגה noun feminine singular absolute unspecified unspecified  	O	null
14 ל ל לעידוד preposition unspecified unspecified unspecified unspecified unspecified 0 
14 עידוד עידוד לעידוד noun masculine singular construct unspecified unspecified  	O	null
15 ספרי ספר ספרי noun masculine plural construct unspecified unspecified  	O	null
16 ביכורים ביכורים ביכורים noun masculine singular absolute unspecified unspecified  	O	null
17 מטעם מטעם מטעם preposition unspecified unspecified unspecified unspecified unspecified  	O	null
18 ה ה המועצה definiteArticle unspecified unspecified unspecified unspecified unspecified 0 
18 המועצה מועצה המועצה noun feminine singular absolute unspecified unspecified  	O	null
19 ל ל לתרבות preposition unspecified unspecified unspecified unspecified unspecified 0 
19 ה ה לתרבות definiteArticle unspecified unspecified unspecified unspecified unspecified 0 
19 התרבות תרבות לתרבות noun feminine singular absolute unspecified unspecified  	O	null
20 ו ו ואמנות conjunction unspecified unspecified unspecified unspecified unspecified 0 
20 אמנות אמנות ואמנות noun feminine singular absolute unspecified unspecified  	O	null
21 . . . punctuation unspecified unspecified unspecified unspecified unspecified  	O	null

0 כמו כמו כמו conjunction unspecified unspecified unspecified unspecified unspecified  	O	null
1 כן כן כן conjunction unspecified unspecified unspecified unspecified unspecified  	O	null
2 זכתה זכה זכתה verb feminine singular unspecified 3 past  	O	null
3 ב ב בפרס preposition unspecified unspecified unspecified unspecified unspecified 0 
3 פרס פרס בפרס noun masculine singular construct unspecified unspecified  	O	null
4 ה ה היצירה definiteArticle unspecified unspecified unspecified unspecified unspecified 0 
4 היצירה יצירה היצירה noun feminine singular absolute unspecified unspecified  	O	null
5 על על על preposition unspecified unspecified unspecified unspecified unspecified  	O	null
6 שם שם שם noun masculine singular construct unspecified unspecified  	O	null
7 ראש ראש ראש noun masculine singular construct unspecified unspecified  	O	null
8 ה ה הממשלה definiteArticle unspecified unspecified unspecified unspecified unspecified 0 
8 הממשלה ממשלה הממשלה noun feminine singular absolute unspecified unspecified  	O	null
9 לוי לוי לוי properName unspecified unspecified unspecified unspecified unspecified  	I_PERS	null
10 אשכול אשכול אשכול properName unspecified unspecified unspecified unspecified unspecified  	I_PERS	null
11 ) ) ) punctuation unspecified unspecified unspecified unspecified unspecified  	O	null
12 , , , punctuation unspecified unspecified unspecified unspecified unspecified  	O	null
13 ###NUMBER### ###NUMBER### ###NUMBER### numeral unspecified unspecified unspecified unspecified unspecified  	I_DATE	null
14 ב ב במלגת preposition unspecified unspecified unspecified unspecified unspecified 0 
14 מלגת מלגה במלגת noun feminine singular construct unspecified unspecified  	I_ORG	null
15 קרן קרן קרן noun feminine singular construct unspecified unspecified  	I_ORG	null
16 פולברייט פולברייט פולברייט properName unspecified unspecified unspecified unspecified unspecified  	I_ORG	null
17 ( ( ( punctuation unspecified unspecified unspecified unspecified unspecified  	O	null
18 ###NUMBER### ###NUMBER### ###NUMBER### numeral unspecified unspecified unspecified unspecified unspecified  	I_DATE	null
19 ) ) ) punctuation unspecified unspecified unspecified unspecified unspecified  	O	null
20 ו ו ובפרס conjunction unspecified unspecified unspecified unspecified unspecified 0 
20 ב ב ובפרס preposition unspecified unspecified unspecified unspecified unspecified 0 
20 פרס פרס ובפרס properName unspecified unspecified unspecified unspecified unspecified  	I_PERS	null
21 ביאליק ביאליק ביאליק properName unspecified unspecified unspecified unspecified unspecified  	I_PERS	null
22 ( ( ( punctuation unspecified unspecified unspecified unspecified unspecified  	O	null
23 ###NUMBER### ###NUMBER### ###NUMBER### numeral unspecified unspecified unspecified unspecified unspecified  	I_DATE	null
24 ) ) ) punctuation unspecified unspecified unspecified unspecified unspecified  	O	null
25 על על על preposition unspecified unspecified unspecified unspecified unspecified  	O	null
26 ספר ספר ספרה noun masculine singular absolute unspecified unspecified  
26 ה ה ספרה possessive feminine singular unspecified 3 unspecified 0 	O	null
27 ה ה האוריום definiteArticle unspecified unspecified unspecified unspecified unspecified 0 
27 האוריום האוריום האוריום participle feminine plural absolute any unspecified  	O	null
28 . . . punctuation unspecified unspecified unspecified unspecified unspecified  	O	null

0 References References References foreign unspecified unspecified unspecified unspecified unspecified  	O	null
1 : : : punctuation unspecified unspecified unspecified unspecified unspecified  	O	null
2 אופנהיימר אופנהיימר אופנהיימר properName unspecified unspecified unspecified unspecified unspecified  	I_PERS	null
3 , , , punctuation unspecified unspecified unspecified unspecified unspecified  	O	null
4 יוחאי יוחאי יוחאי properName unspecified unspecified unspecified unspecified unspecified  	I_PERS	null
5 . . . punctuation unspecified unspecified unspecified unspecified unspecified  	O	null

0 " " " punctuation unspecified unspecified unspecified unspecified unspecified  	O	null
1 לדבר דיבר לדבר verb unspecified unspecified unspecified unspecified infinitive  	O	null
2 ב ב בשפת preposition unspecified unspecified unspecified unspecified unspecified 0 
2 שפת שפה בשפת noun feminine singular construct unspecified unspecified  	O	null
3 ה ה המצולות definiteArticle unspecified unspecified unspecified unspecified unspecified 0 
3 המצולות מצולה המצולות noun feminine plural absolute unspecified unspecified  	O	null
4 " " " punctuation unspecified unspecified unspecified unspecified unspecified  	O	null
5 . . . punctuation unspecified unspecified unspecified unspecified unspecified  	O	null

0 מעריב מעריב מעריב properName unspecified unspecified unspecified unspecified unspecified  	I_ORG	null
1 ספרות ספרות ספרות noun feminine singular absolute unspecified unspecified  	O	null
2 . . . punctuation unspecified unspecified unspecified unspecified unspecified  	O	null

0 ###NUMEXP### ###NUMEXP### ###NUMEXP### numberExpression unspecified unspecified unspecified unspecified unspecified  	I_DATE	null
1 . . . punctuation unspecified unspecified unspecified unspecified unspecified  	O	null

0 ; ; ; punctuation unspecified unspecified unspecified unspecified unspecified  	O	null
1 ###NUMBER### ###NUMBER### ###NUMBER### numeral unspecified unspecified unspecified unspecified unspecified  	O	null
2 גלוזמן גלוזמן גלוזמן properName unspecified unspecified unspecified unspecified unspecified  	O	null
3 , , , punctuation unspecified unspecified unspecified unspecified unspecified  	O	null
4 מיכאל מיכאל מיכאל properName unspecified unspecified unspecified unspecified unspecified  	I_PERS	null
5 . . . punctuation unspecified unspecified unspecified unspecified unspecified  	O	null

0 " " " punctuation unspecified unspecified unspecified unspecified unspecified  	O	null
1 אי אי אי noun masculine singular construct unspecified unspecified  	O	null
2 ה ה הילדות definiteArticle unspecified unspecified unspecified unspecified unspecified 0 
2 הילדות ילדות הילדות noun feminine singular absolute unspecified unspecified  	O	null
3 ה ה השט definiteArticle unspecified unspecified unspecified unspecified unspecified 0 
3 השט שט השט participle masculine singular absolute any unspecified  	O	null
4 " " " punctuation unspecified unspecified unspecified unspecified unspecified  	O	null
5 . . . punctuation unspecified unspecified unspecified unspecified unspecified  	O	null

0 ה ה הארץ definiteArticle unspecified unspecified unspecified unspecified unspecified 0 
0 הארץ ארץ הארץ noun feminine singular absolute unspecified unspecified  	O	null
1 ספרים ספר ספרים noun masculine plural absolute unspecified unspecified  	O	null
2 . . . punctuation unspecified unspecified unspecified unspecified unspecified  	O	null

0 ###NUMEXP### ###NUMEXP### ###NUMEXP### numberExpression unspecified unspecified unspecified unspecified unspecified  	I_DATE	null
1 . . . punctuation unspecified unspecified unspecified unspecified unspecified  	O	null

0 , , , punctuation unspecified unspecified unspecified unspecified unspecified  	O	null
1 ###NUMBER### ###NUMBER### ###NUMBER### numeral unspecified unspecified unspecified unspecified unspecified  	O	null
2 ; ; ; punctuation unspecified unspecified unspecified unspecified unspecified  	O	null
3 ###NUMBER### ###NUMBER### ###NUMBER### numeral unspecified unspecified unspecified unspecified unspecified  	O	null
4 חדד חדד חדד properName unspecified unspecified unspecified unspecified unspecified  	I_PERS	null
5 , , , punctuation unspecified unspecified unspecified unspecified unspecified  	O	null
6 ש ש שירה relativizer/subordinatingConjunction unspecified unspecified unspecified unspecified unspecified 0 
6 ירה ירה שירה verb masculine singular unspecified 3 past  	O	null
7 . . . punctuation unspecified unspecified unspecified unspecified unspecified  	O	null

0 " " " punctuation unspecified unspecified unspecified unspecified unspecified  	O	null
1 ה ה הכתיבה definiteArticle unspecified unspecified unspecified unspecified unspecified 0 
1 הכתיבה כתיבה הכתיבה noun feminine singular absolute unspecified unspecified  	O	null
2 ב ב בעיני preposition unspecified unspecified unspecified unspecified unspecified 0 
2 עיני עין בעיני noun feminine plural construct unspecified unspecified  	O	null
3 , , , punctuation unspecified unspecified unspecified unspecified unspecified  	O	null
4 היא הוא היא pronoun feminine singular unspecified 3 unspecified  	O	null
5 מעשה מעשה מעשה noun masculine singular absolute unspecified unspecified  	O	null
6 של של של shel-preposition unspecified unspecified unspecified unspecified unspecified  	O	null
7 נדיבות נדיבות נדיבות noun feminine singular absolute unspecified unspecified  	O	null
8 עליונה עליון עליונה adjective feminine singular absolute unspecified unspecified  	O	null
9 " " " punctuation unspecified unspecified unspecified unspecified unspecified  	O	null
10 . . . punctuation unspecified unspecified unspecified unspecified unspecified  	O	null

0 מקום מקום מקום noun masculine singular absolute unspecified unspecified  	O	null
1 ל ל לשירה preposition unspecified unspecified unspecified unspecified unspecified 0 
1 ה ה לשירה definiteArticle unspecified unspecified unspecified unspecified unspecified 0 
1 השירה שירה לשירה noun feminine singular absolute unspecified unspecified  	O	null
2 . . . punctuation unspecified unspecified unspecified unspecified unspecified  	O	null

0 נובמבר נובמבר נובמבר properName unspecified unspecified unspecified unspecified unspecified  	I_DATE	null
1 ###NUMBER### ###NUMBER### ###NUMBER### numeral unspecified unspecified unspecified unspecified unspecified  	I_DATE	null
2 . . . punctuation unspecified unspecified unspecified unspecified unspecified  	O	null

0 ; ; ; punctuation unspecified unspecified unspecified unspecified unspecified  	O	null
1 ###NUMBER### ###NUMBER### ###NUMBER### numeral unspecified unspecified unspecified unspecified unspecified  	O	null
2 ש ש שמריז relativizer/subordinatingConjunction unspecified unspecified unspecified unspecified unspecified 0 
2 מ מ שמריז preposition unspecified unspecified unspecified unspecified unspecified 0 
2 ריז ריז שמריז noun masculine singular absolute unspecified unspecified  	O	null
3 , , , punctuation unspecified unspecified unspecified unspecified unspecified  	O	null
4 לירן לירן לירן properName unspecified unspecified unspecified unspecified unspecified  	I_PERS	null
5 . . . punctuation unspecified unspecified unspecified unspecified unspecified  	O	null

0 " " " punctuation unspecified unspecified unspecified unspecified unspecified  	O	null
1 ה ה האוריום definiteArticle unspecified unspecified unspecified unspecified unspecified 0 
1 האוריום האוריום האוריום participle feminine plural absolute any unspecified  	O	null
2 " " " punctuation unspecified unspecified unspecified unspecified unspecified  	O	null
3 . . . punctuation unspecified unspecified unspecified unspecified unspecified  	I_LOC	null
4 מאזנייםפ"ה מאזנייםפ"ה מאזנייםפ"ה properName unspecified unspecified unspecified unspecified unspecified  	I_ORG	null
5 ) ) ) punctuation unspecified unspecified unspecified unspecified unspecified  	O	null
6 . . . punctuation unspecified unspecified unspecified unspecified unspecified  	O	null
7 ###NUMBER### ###NUMBER### ###NUMBER### numeral unspecified unspecified unspecified unspecified unspecified  	I_ORG	null
8 ספטמבר ספטמבר ספטמבר properName unspecified unspecified unspecified unspecified unspecified  	I_DATE	null
9 ###NUMBER### ###NUMBER### ###NUMBER### numeral unspecified unspecified unspecified unspecified unspecified  	I_DATE	null
10 . . . punctuation unspecified unspecified unspecified unspecified unspecified  	O	null

0 ###NUMBER### ###NUMBER### ###NUMBER### numeral unspecified unspecified unspecified unspecified unspecified  	O	null
1 . . . punctuation unspecified unspecified unspecified unspecified unspecified  	O	null

