0 Name Name Name foreign unspecified unspecified unspecified unspecified unspecified  	O	null
1 : : : punctuation unspecified unspecified unspecified unspecified unspecified  	O	null
2 ארן ארן ארן properName unspecified unspecified unspecified unspecified unspecified  	I_PERS	null
3 , , , punctuation unspecified unspecified unspecified unspecified unspecified  	O	null
4 זלמן זלמן זלמן properName unspecified unspecified unspecified unspecified unspecified  	I_PERS	null
5 ( ( ( punctuation unspecified unspecified unspecified unspecified unspecified  	O	null
6 אהרונוביץ' אהרונוביץ' אהרונוביץ' properName unspecified unspecified unspecified unspecified unspecified  	I_PERS	null
7 , , , punctuation unspecified unspecified unspecified unspecified unspecified  	O	null
8 זיאמה זיאמה זיאמה properName unspecified unspecified unspecified unspecified unspecified  	O	null
9 ) ) ) punctuation unspecified unspecified unspecified unspecified unspecified  	O	null
10 Birth Birth Birth foreign unspecified unspecified unspecified unspecified unspecified  	O	null
11 Year Year Year foreign unspecified unspecified unspecified unspecified unspecified  	O	null
12 : : : punctuation unspecified unspecified unspecified unspecified unspecified  	O	null
13 ###NUMBER### ###NUMBER### ###NUMBER### numeral unspecified unspecified unspecified unspecified unspecified  	I_DATE	null
14 Death Death Death foreign unspecified unspecified unspecified unspecified unspecified  	O	null
15 Year Year Year foreign unspecified unspecified unspecified unspecified unspecified  	O	null
16 : : : punctuation unspecified unspecified unspecified unspecified unspecified  	O	null
17 ###NUMBER### ###NUMBER### ###NUMBER### numeral unspecified unspecified unspecified unspecified unspecified  	I_DATE	null
18 Birth Birth Birth foreign unspecified unspecified unspecified unspecified unspecified  	O	null
19 Place Place Place foreign unspecified unspecified unspecified unspecified unspecified  	O	null
20 : : : punctuation unspecified unspecified unspecified unspecified unspecified  	O	null
21 אוקראינה אוקראינה אוקראינה properName unspecified unspecified unspecified unspecified unspecified  	I_LOC	null
22 ו ו והתחנך conjunction unspecified unspecified unspecified unspecified unspecified 0 
22 התחנך התחנך והתחנך verb masculine singular unspecified 3 past  	O	null
23 חינוך חינוך חינוך noun masculine singular absolute unspecified unspecified  	O	null
24 Occupation Occupation Occupation foreign unspecified unspecified unspecified unspecified unspecified  	O	null
25 : : : punctuation unspecified unspecified unspecified unspecified unspecified  	O	null
26 איש איש איש noun masculine singular absolute unspecified unspecified  	O	null
27 ציבור ציבור ציבור noun masculine singular absolute unspecified unspecified  	O	null
28 ו ו ומשורר conjunction unspecified unspecified unspecified unspecified unspecified 0 
28 משורר משורר ומשורר noun masculine singular absolute unspecified unspecified  	O	null
29 Entry Entry Entry foreign unspecified unspecified unspecified unspecified unspecified  	O	null
30 writer writer writer foreign unspecified unspecified unspecified unspecified unspecified  	O	null
31 : : : punctuation unspecified unspecified unspecified unspecified unspecified  	O	null
32 רינה רינה רינה properName unspecified unspecified unspecified unspecified unspecified  	I_PERS	null
33 ז'אן ז'אן ז'אן properName unspecified unspecified unspecified unspecified unspecified  	I_PERS	null
34 ברוך ברוך ברוך properName unspecified unspecified unspecified unspecified unspecified  	I_PERS	null
35 ו ו ויעל conjunction unspecified unspecified unspecified unspecified unspecified 0 
35 יעל יעל ויעל properName unspecified unspecified unspecified unspecified unspecified  	B_PERS	null
36 חזן חזן חזן properName unspecified unspecified unspecified unspecified unspecified  	I_PERS	null
37 Entry Entry Entry foreign unspecified unspecified unspecified unspecified unspecified  	O	null
38 Value Value Value foreign unspecified unspecified unspecified unspecified unspecified  	O	null
39 : : : punctuation unspecified unspecified unspecified unspecified unspecified  	O	null
40 נולד נולד נולד verb masculine singular unspecified 3 past  	O	null
41 ב ב באוקראינה preposition unspecified unspecified unspecified unspecified unspecified 0 
41 אוקראינה אוקראינה באוקראינה properName unspecified unspecified unspecified unspecified unspecified  	I_LOC	null
42 ו ו והתחנך conjunction unspecified unspecified unspecified unspecified unspecified 0 
42 התחנך התחנך והתחנך verb masculine singular unspecified 3 past  	O	null
43 חינוך חינוך חינוך noun masculine singular absolute unspecified unspecified  	O	null
44 מסורתי מסורתי מסורתי adjective masculine singular absolute unspecified unspecified  	O	null
45 - - - punctuation unspecified unspecified unspecified unspecified unspecified  	O	null
46 דתי דתי דתי adjective masculine singular absolute unspecified unspecified  	O	null
47 . . . punctuation unspecified unspecified unspecified unspecified unspecified  	O	null

0 למד למד למד verb masculine singular unspecified 3 past  	O	null
1 ב ב בחדר preposition unspecified unspecified unspecified unspecified unspecified 0 
1 ה ה בחדר definiteArticle unspecified unspecified unspecified unspecified unspecified 0 
1 החדר חדר בחדר noun masculine singular absolute unspecified unspecified  	O	null
2 ו ו ובכמה conjunction unspecified unspecified unspecified unspecified unspecified 0 
2 ב ב ובכמה preposition unspecified unspecified unspecified unspecified unspecified 0 
2 כמה כמה ובכמה quantifier unspecified unspecified construct unspecified unspecified  	O	null
3 ישיבות ישיבה ישיבות noun feminine plural absolute unspecified unspecified  	O	null
4 , , , punctuation unspecified unspecified unspecified unspecified unspecified  	O	null
5 ב ב באקדמיה preposition unspecified unspecified unspecified unspecified unspecified 0 
5 ה ה באקדמיה definiteArticle unspecified unspecified unspecified unspecified unspecified 0 
5 האקדמיה אקדמיה באקדמיה noun feminine singular absolute unspecified unspecified  	O	null
6 ל ל למדעים preposition unspecified unspecified unspecified unspecified unspecified 0 
6 ה ה למדעים definiteArticle unspecified unspecified unspecified unspecified unspecified 0 
6 המדעים מדע למדעים noun masculine plural absolute unspecified unspecified  	O	null
7 ( ( ( punctuation unspecified unspecified unspecified unspecified unspecified  	O	null
8 ###NUMBER### ###NUMBER### ###NUMBER### numeral unspecified unspecified unspecified unspecified unspecified  	I_DATE	null
9 ) ) ) punctuation unspecified unspecified unspecified unspecified unspecified  	O	null
10 ו ו ובמכון conjunction unspecified unspecified unspecified unspecified unspecified 0 
10 ב ב ובמכון preposition unspecified unspecified unspecified unspecified unspecified 0 
10 ה ה ובמכון definiteArticle unspecified unspecified unspecified unspecified unspecified 0 
10 המכון מיכון ובמכון noun masculine singular absolute unspecified unspecified  	O	null
11 ל ל לחקלאות preposition unspecified unspecified unspecified unspecified unspecified 0 
11 ה ה לחקלאות definiteArticle unspecified unspecified unspecified unspecified unspecified 0 
11 החקלאות חקלאות לחקלאות noun feminine singular absolute unspecified unspecified  	O	null
12 בחרקוב בחרקוב בחרקוב properName unspecified unspecified unspecified unspecified unspecified  	I_LOC	null
13 - - - punctuation unspecified unspecified unspecified unspecified unspecified  	O	null
14 ###NUMBER### ###NUMBER### ###NUMBER### numeral unspecified unspecified unspecified unspecified unspecified  	I_DATE	null
15 ) ) ) punctuation unspecified unspecified unspecified unspecified unspecified  	O	null
16 . . . punctuation unspecified unspecified unspecified unspecified unspecified  	O	null

0 ###NUMBER### ###NUMBER### ###NUMBER### numeral unspecified unspecified unspecified unspecified unspecified  	I_DATE	null
1 עסק עסק עסק noun masculine singular absolute unspecified unspecified  	O	null
2 ב ב בהוראת preposition unspecified unspecified unspecified unspecified unspecified 0 
2 הוראת הוראה בהוראת noun feminine singular construct unspecified unspecified  	O	null
3 מדעי מדע מדעי noun masculine plural construct unspecified unspecified  	O	null
4 ה ה החברה definiteArticle unspecified unspecified unspecified unspecified unspecified 0 
4 החברה חבר החברה noun feminine singular absolute unspecified unspecified  	O	null
5 ( ( ( punctuation unspecified unspecified unspecified unspecified unspecified  	O	null
6 ###NUMBER### ###NUMBER### ###NUMBER### numeral unspecified unspecified unspecified unspecified unspecified  	I_DATE	null
7 - - - punctuation unspecified unspecified unspecified unspecified unspecified  	O	null
8 ###NUMBER### ###NUMBER### ###NUMBER### numeral unspecified unspecified unspecified unspecified unspecified  	I_DATE	null
9 ) ) ) punctuation unspecified unspecified unspecified unspecified unspecified  	O	null
10 ו ו והיה conjunction unspecified unspecified unspecified unspecified unspecified 0 
10 היה הוא והיה copula masculine singular unspecified 3 past  	O	null
11 פעיל פעיל פעיל adjective masculine singular absolute unspecified unspecified  	O	null
12 ב ב בענייני preposition unspecified unspecified unspecified unspecified unspecified 0 
12 ענייני עניין בענייני noun masculine plural construct unspecified unspecified  	O	null
13 ציבור ציבור ציבור noun masculine singular absolute unspecified unspecified  	O	null
14 יהודיים יהודי יהודיים adjective masculine plural absolute unspecified unspecified  	O	null
15 . . . punctuation unspecified unspecified unspecified unspecified unspecified  	O	null

0 עלה עלה עלה verb masculine singular unspecified 3 past  	O	null
1 ארצה ארצה ארצה adverb unspecified unspecified unspecified unspecified unspecified  	O	null
2 ( ( ( punctuation unspecified unspecified unspecified unspecified unspecified  	O	null
3 ###NUMBER### ###NUMBER### ###NUMBER### numeral unspecified unspecified unspecified unspecified unspecified  	I_DATE	null
4 ) ) ) punctuation unspecified unspecified unspecified unspecified unspecified  	O	null
5 לאחר לאחר לאחר conjunction unspecified unspecified unspecified unspecified unspecified  	O	null
6 ש ש שחצה relativizer/subordinatingConjunction unspecified unspecified unspecified unspecified unspecified 0 
6 חצה חצה שחצה verb masculine singular unspecified 3 past  	O	null
7 בחשאי בחשאי בחשאי adverb unspecified unspecified unspecified unspecified unspecified  	O	null
8 את את את at-preposition unspecified unspecified unspecified unspecified unspecified  	O	null
9 ה ה הגבול definiteArticle unspecified unspecified unspecified unspecified unspecified 0 
9 הגבול גבול הגבול noun masculine singular absolute unspecified unspecified  	O	null
10 בין בין בין preposition unspecified unspecified unspecified unspecified unspecified  	O	null
11 רוסיה רוסי רוסיה properName unspecified unspecified unspecified unspecified unspecified  	I_LOC	null
12 ל ל ללטביה preposition unspecified unspecified unspecified unspecified unspecified 0 
12 לטביה לטביה ללטביה properName unspecified unspecified unspecified unspecified unspecified  	I_LOC	null
13 . . . punctuation unspecified unspecified unspecified unspecified unspecified  	O	null

0 מילא מילא מילא verb masculine singular unspecified 3 past  	O	null
1 תפקידים תפקיד תפקידים noun masculine plural absolute unspecified unspecified  	O	null
2 שונים שונה שונים adjective masculine plural absolute unspecified unspecified  	O	null
3 ב ב במוסדות preposition unspecified unspecified unspecified unspecified unspecified 0 
3 מוסדות מוסד במוסדות noun masculine plural construct unspecified unspecified  	O	null
4 ה ה ההסתדרות definiteArticle unspecified unspecified unspecified unspecified unspecified 0 
4 ההסתדרות הסתדרות ההסתדרות noun feminine singular absolute unspecified unspecified  	O	null
5 . . . punctuation unspecified unspecified unspecified unspecified unspecified  	O	null

0 נבחר נבחר נבחר verb masculine singular unspecified 3 past  	O	null
1 ל ל לכנסת preposition unspecified unspecified unspecified unspecified unspecified 0 
1 ה ה לכנסת definiteArticle unspecified unspecified unspecified unspecified unspecified 0 
1 הכנסת כנסת לכנסת properName feminine singular unspecified unspecified unspecified  	I_ORG	null
2 ה ה הראשונה definiteArticle unspecified unspecified unspecified unspecified unspecified 0 
2 הראשונה ORD1 הראשונה numeral feminine singular absolute unspecified unspecified  	O	null
3 מטעם מטעם מטעם preposition unspecified unspecified unspecified unspecified unspecified  	O	null
4 מפא"י מפא"י מפא"י properName unspecified unspecified unspecified unspecified unspecified  	I_ORG	null
5 ו ו וכיהן conjunction unspecified unspecified unspecified unspecified unspecified 0 
5 כיהן כיהן וכיהן verb masculine singular unspecified 3 past  	O	null
6 ב ב בה preposition unspecified unspecified unspecified unspecified unspecified  
6 ה ה בה pronomial feminine singular unspecified 3 unspecified 0 	O	null
7 עד עד עד noun masculine singular absolute unspecified unspecified  	O	null
8 ל ל לפרישתו preposition unspecified unspecified unspecified unspecified unspecified 0 
8 פרישת פרישה לפרישתו noun feminine singular absolute unspecified unspecified  
8 ו ו לפרישתו possessive masculine singular unspecified 3 unspecified 0 	O	null
9 ) ) ) punctuation unspecified unspecified unspecified unspecified unspecified  	O	null
10 . . . punctuation unspecified unspecified unspecified unspecified unspecified  	O	null
11 ###NUMBER### ###NUMBER### ###NUMBER### numeral unspecified unspecified unspecified unspecified unspecified  	I_DATE	null
12 היה הוא היה copula masculine singular unspecified 3 past  	O	null
13 מזכיר מזכיר מזכיר noun masculine singular construct unspecified unspecified  	O	null
14 מפא"י מפא"י מפא"י properName masculine singular unspecified unspecified unspecified  	I_ORG	null
15 ( ( ( punctuation unspecified unspecified unspecified unspecified unspecified  	O	null
16 ###NUMBER### ###NUMBER### ###NUMBER### numeral unspecified unspecified unspecified unspecified unspecified  	I_DATE	null
17 - - - punctuation unspecified unspecified unspecified unspecified unspecified  	O	null
18 ###NUMBER### ###NUMBER### ###NUMBER### numeral unspecified unspecified unspecified unspecified unspecified  	I_DATE	null
19 ) ) ) punctuation unspecified unspecified unspecified unspecified unspecified  	O	null
20 ו ו ויו"ר conjunction unspecified unspecified unspecified unspecified unspecified 0 
20 יו"ר יו"ר ויו"ר noun masculine singular construct unspecified unspecified  	O	null
21 ועדת ועדה ועדת noun feminine singular construct unspecified unspecified  	I_ORG	null
22 ה ה החוץ definiteArticle unspecified unspecified unspecified unspecified unspecified 0 
22 החוץ חוץ החוץ noun masculine singular absolute unspecified unspecified  	I_ORG	null
23 ו ו והביטחון conjunction unspecified unspecified unspecified unspecified unspecified 0 
23 ה ה והביטחון definiteArticle unspecified unspecified unspecified unspecified unspecified 0 
23 הביטחון ביטחון והביטחון noun masculine singular absolute unspecified unspecified  	I_ORG	null
24 . . . punctuation unspecified unspecified unspecified unspecified unspecified  	O	null

0 מונה מונה מונה verb masculine singular unspecified 3 past  	O	null
1 ל ל לשר preposition unspecified unspecified unspecified unspecified unspecified 0 
1 שר שר לשר noun masculine singular construct unspecified unspecified  	O	null
2 ה ה החינוך definiteArticle unspecified unspecified unspecified unspecified unspecified 0 
2 החינוך חינוך החינוך noun masculine singular absolute unspecified unspecified  	I_DATE	null
3 ו ו והתרבות conjunction unspecified unspecified unspecified unspecified unspecified 0 
3 ה ה והתרבות definiteArticle unspecified unspecified unspecified unspecified unspecified 0 
3 התרבות תרבות והתרבות noun feminine singular absolute unspecified unspecified  	I_DATE	null
4 - - - punctuation unspecified unspecified unspecified unspecified unspecified  	O	null
5 ###NUMBER### ###NUMBER### ###NUMBER### numeral unspecified unspecified unspecified unspecified unspecified  	I_DATE	null
6 , , , punctuation unspecified unspecified unspecified unspecified unspecified  	O	null
7 ###NUMBER### ###NUMBER### ###NUMBER### numeral unspecified unspecified unspecified unspecified unspecified  	I_DATE	null
8 ###NUMBER### ###NUMBER### ###NUMBER### numeral unspecified unspecified unspecified unspecified unspecified  	I_DATE	null
9 - - - punctuation unspecified unspecified unspecified unspecified unspecified  	O	null
10 ###NUMBER### ###NUMBER### ###NUMBER### numeral unspecified unspecified unspecified unspecified unspecified  	I_DATE	null
11 ) ) ) punctuation unspecified unspecified unspecified unspecified unspecified  	O	null
12 . . . punctuation unspecified unspecified unspecified unspecified unspecified  	O	null

0 ראה ראה ראה verb masculine singular unspecified 3 past  	O	null
1 ב ב בתפקידו preposition unspecified unspecified unspecified unspecified unspecified 0 
1 תפקיד תפקיד בתפקידו noun masculine singular absolute unspecified unspecified  
1 ו ו בתפקידו possessive masculine singular unspecified 3 unspecified 0 	O	null
2 זה זה זה pronoun masculine singular unspecified 3 unspecified  	O	null
3 ה ה ההישג definiteArticle unspecified unspecified unspecified unspecified unspecified 0 
3 ההישג הישג ההישג noun masculine singular absolute unspecified unspecified  	O	null
4 ה ה החשוב definiteArticle unspecified unspecified unspecified unspecified unspecified 0 
4 החשוב חשוב החשוב adjective masculine singular absolute unspecified unspecified  	O	null
5 ביותר ביותר ביותר adverb unspecified unspecified unspecified unspecified unspecified  	O	null
6 של של של shel-preposition unspecified unspecified unspecified unspecified unspecified  	O	null
7 פעילות פעילות פעילותו noun feminine singular absolute unspecified unspecified  
7 ו ו פעילותו possessive masculine singular unspecified 3 unspecified 0 	O	null
8 ה ה הציבורית definiteArticle unspecified unspecified unspecified unspecified unspecified 0 
8 הציבורית ציבורי הציבורית adjective feminine singular absolute unspecified unspecified  	O	null
9 . . . punctuation unspecified unspecified unspecified unspecified unspecified  	O	null

0 הקים הקים הקים verb masculine singular unspecified 3 past  	O	null
1 מוסדות מוסד מוסדות noun masculine plural construct unspecified unspecified  	O	null
2 חינוך חינוך חינוך noun masculine singular absolute unspecified unspecified  	O	null
3 רבים רב רבים adjective masculine plural absolute unspecified unspecified  	O	null
4 : : : punctuation unspecified unspecified unspecified unspecified unspecified  	O	null
5 גני גן גני noun masculine plural construct unspecified unspecified  	O	null
6 ילדים ילד ילדים noun masculine plural absolute unspecified unspecified  	O	null
7 , , , punctuation unspecified unspecified unspecified unspecified unspecified  	O	null
8 פנימיות פנימייה פנימיות noun feminine plural absolute unspecified unspecified  	O	null
9 ו ו ומכללות conjunction unspecified unspecified unspecified unspecified unspecified 0 
9 מכללות מכללה ומכללות noun feminine plural absolute unspecified unspecified  	O	null
10 , , , punctuation unspecified unspecified unspecified unspecified unspecified  	O	null
11 ו ו וקבע conjunction unspecified unspecified unspecified unspecified unspecified 0 
11 קבע קבע וקבע verb masculine singular unspecified 3 past  	O	null
12 את את את at-preposition unspecified unspecified unspecified unspecified unspecified  	O	null
13 לימודי לימוד לימודי noun masculine plural construct unspecified unspecified  	O	null
14 " " " punctuation unspecified unspecified unspecified unspecified unspecified  	O	null
15 ה ה התודעה definiteArticle unspecified unspecified unspecified unspecified unspecified 0 
15 התודעה תודעה התודעה noun feminine singular absolute unspecified unspecified  	O	null
16 ה ה היהודית definiteArticle unspecified unspecified unspecified unspecified unspecified 0 
16 היהודית יהודי היהודית adjective feminine singular absolute unspecified unspecified  	O	null
17 " " " punctuation unspecified unspecified unspecified unspecified unspecified  	O	null
18 . . . punctuation unspecified unspecified unspecified unspecified unspecified  	O	null

0 יזם יזם יזם verb masculine singular unspecified 3 past  	O	null
1 את את את at-preposition unspecified unspecified unspecified unspecified unspecified  	O	null
2 הקמת הקמה הקמת noun feminine singular construct unspecified unspecified  	O	null
3 ה ה המתנ definiteArticle unspecified unspecified unspecified unspecified unspecified 0 
3 המתן המתן המתנ noun masculine singular absolute unspecified unspecified  	O	null
4 " " " punctuation unspecified unspecified unspecified unspecified unspecified  	O	null
5 סים סיים סים verb masculine singular unspecified 3 past  	O	null
6 ( ( ( punctuation unspecified unspecified unspecified unspecified unspecified  	O	null
7 ###NUMBER### ###NUMBER### ###NUMBER### numeral unspecified unspecified unspecified unspecified unspecified  	I_DATE	null
8 ) ) ) punctuation unspecified unspecified unspecified unspecified unspecified  	O	null
9 ו ו והנהיג conjunction unspecified unspecified unspecified unspecified unspecified 0 
9 הנהיג הנהיג והנהיג verb masculine singular unspecified 3 past  	O	null
10 רפורמות רפורמה רפורמות noun feminine plural absolute unspecified unspecified  	O	null
11 חשובות חשוב חשובות adjective feminine plural absolute unspecified unspecified  	O	null
12 ב ב במבנה preposition unspecified unspecified unspecified unspecified unspecified 0 
12 מבנה מבנה במבנה noun masculine singular construct unspecified unspecified  	O	null
13 ה ה החינוך definiteArticle unspecified unspecified unspecified unspecified unspecified 0 
13 החינוך חינוך החינוך noun masculine singular absolute unspecified unspecified  	O	null
14 – – – punctuation unspecified unspecified unspecified unspecified unspecified  	O	null
15 הקמת הקמה הקמת noun feminine singular construct unspecified unspecified  	O	null
16 חטיבות חטיבה חטיבות noun feminine plural construct unspecified unspecified  	O	null
17 ביניים ביניים ביניים noun masculine singular absolute unspecified unspecified  	O	null
18 ו ו והארכת conjunction unspecified unspecified unspecified unspecified unspecified 0 
18 הארכת הארכה והארכת noun feminine singular construct unspecified unspecified  	O	null
19 חינוך חינוך חינוך noun masculine singular construct unspecified unspecified  	O	null
20 ה ה החובה definiteArticle unspecified unspecified unspecified unspecified unspecified 0 
20 החובה חובה החובה noun feminine singular absolute unspecified unspecified  	O	null
21 . . . punctuation unspecified unspecified unspecified unspecified unspecified  	O	null

0 נחשב נחשב נחשב verb masculine singular unspecified 3 past  	O	null
1 ל ל לאחד preposition unspecified unspecified unspecified unspecified unspecified 0 
1 אחד CARD1 לאחד numeral masculine singular absolute unspecified unspecified  	O	null
2 מ מ משרי preposition unspecified unspecified unspecified unspecified unspecified 0 
2 שרי שר משרי noun masculine plural construct unspecified unspecified  	O	null
3 ה ה החינוך definiteArticle unspecified unspecified unspecified unspecified unspecified 0 
3 החינוך חינוך החינוך noun masculine singular absolute unspecified unspecified  	O	null
4 ה ה המשפיעים definiteArticle unspecified unspecified unspecified unspecified unspecified 0 
4 המשפיעים השפיע המשפיעים participle masculine plural absolute any unspecified  	O	null
5 ביותר ביותר ביותר adverb unspecified unspecified unspecified unspecified unspecified  	O	null
6 . . . punctuation unspecified unspecified unspecified unspecified unspecified  	O	null

0 ב ב בחייו preposition unspecified unspecified unspecified unspecified unspecified 0 
0 חיי חיים בחייו noun masculine plural absolute unspecified unspecified  
0 ו ו בחייו possessive masculine singular unspecified 3 unspecified 0 	O	null
1 פירסם פרסם פירסם verb masculine singular unspecified 3 past  	O	null
2 רק רק רק conjunction unspecified unspecified unspecified unspecified unspecified  	O	null
3 שירים שיר שירים noun masculine plural absolute unspecified unspecified  	O	null
4 אחדים אחדים אחדים adjective masculine plural absolute unspecified unspecified  	O	null
5 . . . punctuation unspecified unspecified unspecified unspecified unspecified  	O	null

0 לאחר לאחר לאחר preposition unspecified unspecified unspecified unspecified unspecified  	O	null
1 מות מוות מותו noun masculine singular absolute unspecified unspecified  
1 ו ו מותו possessive masculine singular unspecified 3 unspecified 0 	O	null
2 יצאו יצא יצאו verb masculine-and-feminine plural unspecified 3 past  	O	null
3 לאור לאור לאור preposition unspecified unspecified unspecified unspecified unspecified  	O	null
4 כתבי כתב כתביו noun masculine plural absolute unspecified unspecified  
4 ו ו כתביו possessive masculine singular unspecified 3 unspecified 0 	O	null
5 : : : punctuation unspecified unspecified unspecified unspecified unspecified  	O	null
6 ה ה הספר definiteArticle unspecified unspecified unspecified unspecified unspecified 0 
6 הספר ספר הספר noun masculine singular absolute unspecified unspecified  	O	null
7 אוטוביוגרפיה אוטוביוגרפיה אוטוביוגרפיה noun feminine singular absolute unspecified unspecified  	O	null
8 ( ( ( punctuation unspecified unspecified unspecified unspecified unspecified  	O	null
9 עם עם עם preposition unspecified unspecified unspecified unspecified unspecified  	O	null
10 עובד עובד עובד noun masculine singular absolute unspecified unspecified  	O	null
11 , , , punctuation unspecified unspecified unspecified unspecified unspecified  	O	null
12 ) ) ) punctuation unspecified unspecified unspecified unspecified unspecified  	O	null
13 ; ; ; punctuation unspecified unspecified unspecified unspecified unspecified  	O	null
14 ###NUMBER### ###NUMBER### ###NUMBER### numeral unspecified unspecified unspecified unspecified unspecified  	I_DATE	null
15 קובצי קבץ קובצי participle masculine plural construct any unspecified  	O	null
16 מאמרי מאמר מאמריו noun masculine plural absolute unspecified unspecified  
16 ו ו מאמריו possessive masculine singular unspecified 3 unspecified 0 	O	null
17 חבלי חבל חבלי noun masculine plural construct unspecified unspecified  	O	null
18 חינוך חינוך חינוך noun masculine singular absolute unspecified unspecified  	O	null
19 ) ) ) punctuation unspecified unspecified unspecified unspecified unspecified  	O	null
20 ; ; ; punctuation unspecified unspecified unspecified unspecified unspecified  	O	null
21 ###NUMBER### ###NUMBER### ###NUMBER### numeral unspecified unspecified unspecified unspecified unspecified  	I_DATE	null
22 חזית חזית חזית noun feminine singular absolute unspecified unspecified  	O	null
23 ו ו וחזות conjunction unspecified unspecified unspecified unspecified unspecified 0 
23 חזות חזות וחזות noun feminine singular absolute unspecified unspecified  	O	null
24 : : : punctuation unspecified unspecified unspecified unspecified unspecified  	O	null
25 דברים דבר דברים noun masculine plural absolute unspecified unspecified  	O	null
26 ב ב בכתב preposition unspecified unspecified unspecified unspecified unspecified 0 
26 כתב כתב בכתב noun masculine singular construct unspecified unspecified  	O	null
27 ו ו ובעל conjunction unspecified unspecified unspecified unspecified unspecified 0 
27 בעל בעל ובעל noun masculine singular construct unspecified unspecified  	O	null
28 פה פה פה noun masculine singular absolute unspecified unspecified  	O	null
29 ) ) ) punctuation unspecified unspecified unspecified unspecified unspecified  	O	null
30 ; ; ; punctuation unspecified unspecified unspecified unspecified unspecified  	O	null
31 ###NUMBER### ###NUMBER### ###NUMBER### numeral unspecified unspecified unspecified unspecified unspecified  	I_DATE	null
32 ו ו וקובץ conjunction unspecified unspecified unspecified unspecified unspecified 0 
32 קובץ קובץ וקובץ noun masculine singular construct unspecified unspecified  	O	null
33 שירי שיר שיריו noun masculine plural absolute unspecified unspecified  
33 ו ו שיריו possessive masculine singular unspecified 3 unspecified 0 	O	null
34 שורש שורש שורש noun masculine singular absolute unspecified unspecified  	O	null
35 ו ו וכוכב conjunction unspecified unspecified unspecified unspecified unspecified 0 
35 כוכב כוכב וכוכב noun masculine singular absolute unspecified unspecified  	O	null
36 ) ) ) punctuation unspecified unspecified unspecified unspecified unspecified  	O	null
37 . . . punctuation unspecified unspecified unspecified unspecified unspecified  	O	null
38 ###NUMBER### ###NUMBER### ###NUMBER### numeral unspecified unspecified unspecified unspecified unspecified  	I_DATE	null
39 שירי שיר שיריו noun masculine plural absolute unspecified unspecified  
39 ו ו שיריו possessive masculine singular unspecified 3 unspecified 0 	O	null
40 כתובים כתוב כתובים adjective masculine plural absolute unspecified unspecified  	O	null
41 מתוך מתוך מתוך preposition unspecified unspecified unspecified unspecified unspecified  	O	null
42 הלך הלך הלך noun masculine singular construct unspecified unspecified  	O	null
43 רוח רוח רוח noun feminine singular construct unspecified unspecified  	O	null
44 נוגה נוגה נוגה properName unspecified unspecified unspecified unspecified unspecified  	O	null
45 ו ו והם conjunction unspecified unspecified unspecified unspecified unspecified 0 
45 הם הוא והם pronoun masculine plural unspecified 3 unspecified  	O	null
46 ביטוי ביטוי ביטוי noun masculine singular absolute unspecified unspecified  	O	null
47 ל ל לתפישת preposition unspecified unspecified unspecified unspecified unspecified 0 
47 תפישת תפישה לתפישת noun feminine singular construct unspecified unspecified  	O	null
48 עולם עולם עולמו noun masculine singular absolute unspecified unspecified  
48 ו ו עולמו possessive masculine singular unspecified 3 unspecified 0 	O	null
49 ו ו ולגורל conjunction unspecified unspecified unspecified unspecified unspecified 0 
49 ל ל ולגורל preposition unspecified unspecified unspecified unspecified unspecified 0 
49 גורל גורל ולגורל noun masculine singular construct unspecified unspecified  	O	null
50 בני בן בני noun masculine plural construct unspecified unspecified  	O	null
51 דור דור דורו noun masculine singular absolute unspecified unspecified  
51 ו ו דורו possessive masculine singular unspecified 3 unspecified 0 	O	null
52 . . . punctuation unspecified unspecified unspecified unspecified unspecified  	O	null

0 כתב כתב כתב noun masculine singular construct unspecified unspecified  	O	null
1 שירים שיר שירים noun masculine plural absolute unspecified unspecified  	O	null
2 ליריים לירי ליריים adjective masculine plural absolute unspecified unspecified  	O	null
3 קצרים קצר קצרים adjective masculine plural absolute unspecified unspecified  	O	null
4 , , , punctuation unspecified unspecified unspecified unspecified unspecified  	O	null
5 ארבעה CARD4 ארבעה numeral masculine plural absolute unspecified unspecified  	O	null
6 או או או conjunction unspecified unspecified unspecified unspecified unspecified  	O	null
7 שישה CARD6 שישה numeral masculine plural absolute unspecified unspecified  	O	null
8 טורים טור טורים noun masculine plural absolute unspecified unspecified  	O	null
9 , , , punctuation unspecified unspecified unspecified unspecified unspecified  	O	null
10 ב ב בלשון preposition unspecified unspecified unspecified unspecified unspecified 0 
10 לשון לשון בלשון noun feminine singular absolute unspecified unspecified  	O	null
11 ציורית ציורי ציורית adjective feminine singular absolute unspecified unspecified  	O	null
12 ו ו ואסוציאטיבית conjunction unspecified unspecified unspecified unspecified unspecified 0 
12 אסוציאטיבית אסוציאטיבי ואסוציאטיבית adjective feminine singular absolute unspecified unspecified  	O	null
13 אך אך אך conjunction unspecified unspecified unspecified unspecified unspecified  	O	null
14 נקייה נקי נקייה adjective feminine singular absolute unspecified unspecified  	O	null
15 ממליצה המליץ ממליצה verb feminine singular unspecified any beinoni  	O	null
16 . . . punctuation unspecified unspecified unspecified unspecified unspecified  	O	null

0 גולדה גולדה גולדה properName unspecified unspecified unspecified unspecified unspecified  	I_PERS	null
1 מאיר מאיר מאיר properName unspecified unspecified unspecified unspecified unspecified  	I_PERS	null
2 , , , punctuation unspecified unspecified unspecified unspecified unspecified  	O	null
3 ראש ראש ראש noun masculine singular construct unspecified unspecified  	O	null
4 ה ה הממשלה definiteArticle unspecified unspecified unspecified unspecified unspecified 0 
4 הממשלה ממשלה הממשלה noun feminine singular absolute unspecified unspecified  	O	null
5 דאז דאז דאז adverb unspecified unspecified unspecified unspecified unspecified  	O	null
6 , , , punctuation unspecified unspecified unspecified unspecified unspecified  	O	null
7 אמרה אמר אמרה verb feminine singular unspecified 3 past  	O	null
8 על על עליו preposition unspecified unspecified unspecified unspecified unspecified  
8 ו ו עליו pronomial masculine singular unspecified 3 unspecified 0 	O	null
9 ב ב בהספדה preposition unspecified unspecified unspecified unspecified unspecified 0 
9 הספד הספד בהספדה noun masculine singular absolute unspecified unspecified  
9 ה ה בהספדה possessive feminine singular unspecified 3 unspecified 0 	O	null
10 : : : punctuation unspecified unspecified unspecified unspecified unspecified  	O	null
11 " " " punctuation unspecified unspecified unspecified unspecified unspecified  	O	null
12 משורר משורר משורר noun masculine singular absolute unspecified unspecified  	O	null
13 היה הוא היה copula masculine singular unspecified 3 past  	O	null
14 , , , punctuation unspecified unspecified unspecified unspecified unspecified  	O	null
15 ו ו ולא conjunction unspecified unspecified unspecified unspecified unspecified 0 
15 לא לא ולא negation unspecified unspecified unspecified unspecified unspecified  	O	null
16 רק רק רק conjunction unspecified unspecified unspecified unspecified unspecified  	O	null
17 מפני מפני מפני conjunction unspecified unspecified unspecified unspecified unspecified  	O	null
18 ש ש שכתב relativizer/subordinatingConjunction unspecified unspecified unspecified unspecified unspecified 0 
18 כתב כתב שכתב verb masculine singular unspecified 3 past  	O	null
19 שירים שיר שירים noun masculine plural absolute unspecified unspecified  	O	null
20 ; ; ; punctuation unspecified unspecified unspecified unspecified unspecified  	O	null
21 גם גם גם conjunction unspecified unspecified unspecified unspecified unspecified  	O	null
22 ב ב בנפשו preposition unspecified unspecified unspecified unspecified unspecified 0 
22 נפש נפש בנפשו noun feminine singular absolute unspecified unspecified  
22 ו ו בנפשו possessive masculine singular unspecified 3 unspecified 0 	O	null
23 היה הוא היה copula masculine singular unspecified 3 past  	O	null
24 משורר משורר משורר noun masculine singular absolute unspecified unspecified  	O	null
25 " " " punctuation unspecified unspecified unspecified unspecified unspecified  	O	null
26 ( ( ( punctuation unspecified unspecified unspecified unspecified unspecified  	O	null
27 חבלי חבל חבלי noun masculine plural construct unspecified unspecified  	O	null
28 חינוך חינוך חינוך noun masculine singular absolute unspecified unspecified  	O	null
29 , , , punctuation unspecified unspecified unspecified unspecified unspecified  	O	null
30 , , , punctuation unspecified unspecified unspecified unspecified unspecified  	O	null
31 ###NUMBER### ###NUMBER### ###NUMBER### numeral unspecified unspecified unspecified unspecified unspecified  	I_DATE	null
32 ###NUMBER### ###NUMBER### ###NUMBER### numeral unspecified unspecified unspecified unspecified unspecified  	O	null
33 ) ) ) punctuation unspecified unspecified unspecified unspecified unspecified  	O	null
34 . . . punctuation unspecified unspecified unspecified unspecified unspecified  	O	null

0 הזז הזיז הזז verb masculine singular unspecified 2 imperative  	O	null
1 , , , punctuation unspecified unspecified unspecified unspecified unspecified  	O	null
2 חיים חיים חיים noun masculine plural absolute unspecified unspecified  	O	null
3 . . . punctuation unspecified unspecified unspecified unspecified unspecified  	O	null

0 " " " punctuation unspecified unspecified unspecified unspecified unspecified  	O	null
1 זלמן זלמן זלמן properName unspecified unspecified unspecified unspecified unspecified  	I_PERS	null
2 ארן ארן ארן properName unspecified unspecified unspecified unspecified unspecified  	I_PERS	null
3 " " " punctuation unspecified unspecified unspecified unspecified unspecified  	O	null
4 . . . punctuation unspecified unspecified unspecified unspecified unspecified  	O	null

0 מאזניים מאזניים מאזניים noun masculine plural absolute unspecified unspecified  	O	null
1 ל ל ל"א preposition unspecified unspecified unspecified unspecified unspecified 0 
1 "א "א ל"א noun masculine singular construct unspecified unspecified  	O	null
2 - - - punctuation unspecified unspecified unspecified unspecified unspecified  	O	null
3 ###NUMBER### ###NUMBER### ###NUMBER### numeral unspecified unspecified unspecified unspecified unspecified  	O	null
4 ) ) ) punctuation unspecified unspecified unspecified unspecified unspecified  	O	null
5 . . . punctuation unspecified unspecified unspecified unspecified unspecified  	O	null

0 ###NUMBER### ###NUMBER### ###NUMBER### numeral unspecified unspecified unspecified unspecified unspecified  	O	null
1 ###NUMBER### ###NUMBER### ###NUMBER### numeral unspecified unspecified unspecified unspecified unspecified  	I_DATE	null
2 . . . punctuation unspecified unspecified unspecified unspecified unspecified  	O	null

0 - - - punctuation unspecified unspecified unspecified unspecified unspecified  	O	null
1 ###NUMBER### ###NUMBER### ###NUMBER### numeral unspecified unspecified unspecified unspecified unspecified  	O	null
2 ; ; ; punctuation unspecified unspecified unspecified unspecified unspecified  	O	null
3 ###NUMBER### ###NUMBER### ###NUMBER### numeral unspecified unspecified unspecified unspecified unspecified  	O	null
4 שמואלי שמואלי שמואלי properName unspecified unspecified unspecified unspecified unspecified  	I_PERS	null
5 , , , punctuation unspecified unspecified unspecified unspecified unspecified  	O	null
6 אליעזר אליעזר אליעזר properName unspecified unspecified unspecified unspecified unspecified  	I_PERS	null
7 . . . punctuation unspecified unspecified unspecified unspecified unspecified  	O	null

0 " " " punctuation unspecified unspecified unspecified unspecified unspecified  	O	null
1 זלמן זלמן זלמן properName unspecified unspecified unspecified unspecified unspecified  	I_PERS	null
2 ארן ארן ארן properName unspecified unspecified unspecified unspecified unspecified  	I_PERS	null
3 חולם חלם חולם verb masculine singular unspecified any beinoni  	O	null
4 ו ו ועושה conjunction unspecified unspecified unspecified unspecified unspecified 0 
4 עושה עשה ועושה verb masculine singular unspecified any beinoni  	O	null
5 " " " punctuation unspecified unspecified unspecified unspecified unspecified  	O	null
6 . . . punctuation unspecified unspecified unspecified unspecified unspecified  	O	null

0 הד הד הד noun masculine singular construct unspecified unspecified  	O	null
1 ה ה החינוך definiteArticle unspecified unspecified unspecified unspecified unspecified 0 
1 החינוך חינוך החינוך noun masculine singular absolute unspecified unspecified  	O	null
2 ###NUMBER### ###NUMBER### ###NUMBER### numeral unspecified unspecified unspecified unspecified unspecified  	O	null
3 ) ) ) punctuation unspecified unspecified unspecified unspecified unspecified  	O	null
4 . . . punctuation unspecified unspecified unspecified unspecified unspecified  	O	null
5 ###NUMBER### ###NUMBER### ###NUMBER### numeral unspecified unspecified unspecified unspecified unspecified  	O	null
6 ###NUMBER### ###NUMBER### ###NUMBER### numeral unspecified unspecified unspecified unspecified unspecified  	I_DATE	null
7 . . . punctuation unspecified unspecified unspecified unspecified unspecified  	O	null

0 ###NUMBER### ###NUMBER### ###NUMBER### numeral unspecified unspecified unspecified unspecified unspecified  	O	null
1 . . . punctuation unspecified unspecified unspecified unspecified unspecified  	O	null

0 References References References foreign unspecified unspecified unspecified unspecified unspecified  	O	null
1 : : : punctuation unspecified unspecified unspecified unspecified unspecified  	O	null

