0 Name Name Name foreign unspecified unspecified unspecified unspecified unspecified  	O	null
1 : : : punctuation unspecified unspecified unspecified unspecified unspecified  	O	null
2 בחור בחור בחור noun masculine singular absolute unspecified unspecified  	O	null
3 , , , punctuation unspecified unspecified unspecified unspecified unspecified  	O	null
4 יונה יון יונה properName unspecified unspecified unspecified unspecified unspecified  	I_PERS	null
5 Birth Birth Birth foreign unspecified unspecified unspecified unspecified unspecified  	O	null
6 Year Year Year foreign unspecified unspecified unspecified unspecified unspecified  	O	null
7 : : : punctuation unspecified unspecified unspecified unspecified unspecified  	O	null
8 ###NUMBER### ###NUMBER### ###NUMBER### numeral unspecified unspecified unspecified unspecified unspecified  	I_DATE	null
9 Death Death Death foreign unspecified unspecified unspecified unspecified unspecified  	O	null
10 Year Year Year foreign unspecified unspecified unspecified unspecified unspecified  	O	null
11 : : : punctuation unspecified unspecified unspecified unspecified unspecified  	O	null
12 ###NUMBER### ###NUMBER### ###NUMBER### numeral unspecified unspecified unspecified unspecified unspecified  	I_DATE	null
13 Birth Birth Birth foreign unspecified unspecified unspecified unspecified unspecified  	O	null
14 Place Place Place foreign unspecified unspecified unspecified unspecified unspecified  	O	null
15 : : : punctuation unspecified unspecified unspecified unspecified unspecified  	O	null
16 בת בת בת noun feminine singular construct unspecified unspecified  	O	null
17 יחידה יחידה יחידה noun feminine singular absolute unspecified unspecified  	O	null
18 ל ל להוריה preposition unspecified unspecified unspecified unspecified unspecified 0 
18 הוריה הוריה להוריה noun feminine singular absolute unspecified unspecified  	O	null
19 Occupation Occupation Occupation foreign unspecified unspecified unspecified unspecified unspecified  	O	null
20 : : : punctuation unspecified unspecified unspecified unspecified unspecified  	O	null
21 סופרת סופר סופרת noun feminine singular absolute unspecified unspecified  	O	null
22 ו ו ומבקרת conjunction unspecified unspecified unspecified unspecified unspecified 0 
22 מבקרת מבקר ומבקרת noun feminine singular construct unspecified unspecified  	O	null
23 Entry Entry Entry foreign unspecified unspecified unspecified unspecified unspecified  	O	null
24 writer writer writer foreign unspecified unspecified unspecified unspecified unspecified  	O	null
25 : : : punctuation unspecified unspecified unspecified unspecified unspecified  	O	null
26 ליאורה ליאורה ליאורה properName unspecified unspecified unspecified unspecified unspecified  	I_PERS	null
27 ריינגולד ריינגולד ריינגולד properName unspecified unspecified unspecified unspecified unspecified  	I_PERS	null
28 Entry Entry Entry foreign unspecified unspecified unspecified unspecified unspecified  	O	null
29 Value Value Value foreign unspecified unspecified unspecified unspecified unspecified  	O	null
30 : : : punctuation unspecified unspecified unspecified unspecified unspecified  	O	null
31 נולדה נולד נולדה verb feminine singular unspecified 3 past  	O	null
32 כ כ כבת preposition unspecified unspecified unspecified unspecified unspecified 0 
32 בת בת כבת noun feminine singular construct unspecified unspecified  	O	null
33 יחידה יחידה יחידה noun feminine singular absolute unspecified unspecified  	O	null
34 ל ל להוריה preposition unspecified unspecified unspecified unspecified unspecified 0 
34 הוריה הוריה להוריה noun feminine singular absolute unspecified unspecified  	O	null
35 ב ב בקריית preposition unspecified unspecified unspecified unspecified unspecified 0 
35 קריית קריה בקריית noun feminine singular construct unspecified unspecified  	O	null
36 מוצקין מוצקין מוצקין properName unspecified unspecified unspecified unspecified unspecified  	I_LOC	null
37 . . . punctuation unspecified unspecified unspecified unspecified unspecified  	O	null

0 ב ב בראשית preposition unspecified unspecified unspecified unspecified unspecified 0 
0 ראשית ראשית בראשית noun feminine singular construct unspecified unspecified  	O	null
1 שנות שנה שנות noun feminine plural construct unspecified unspecified  	I_DATE	null
2 ה ה השישים definiteArticle unspecified unspecified unspecified unspecified unspecified 0 
2 השישים ORD-CARD60 השישים numeral masculine-and-feminine plural absolute unspecified unspecified  	I_DATE	null
3 למדה למד למדה verb feminine singular unspecified 3 past  	O	null
4 ספרות ספרות ספרות noun feminine singular absolute unspecified unspecified  	O	null
5 ו ו ופילוסופיה conjunction unspecified unspecified unspecified unspecified unspecified 0 
5 פילוסופיה פילוסופיה ופילוסופיה noun feminine singular absolute unspecified unspecified  	O	null
6 ב ב באוניברסיטה preposition unspecified unspecified unspecified unspecified unspecified 0 
6 ה ה באוניברסיטה definiteArticle unspecified unspecified unspecified unspecified unspecified 0 
6 האוניברסיטה אוניברסיטה באוניברסיטה noun feminine singular absolute unspecified unspecified  	O	null
7 ה ה העברית definiteArticle unspecified unspecified unspecified unspecified unspecified 0 
7 העברית עברי העברית adjective feminine singular absolute unspecified unspecified  	O	null
8 ב ב בירושלים preposition unspecified unspecified unspecified unspecified unspecified 0 
8 ירושלים ירושלים בירושלים properName unspecified unspecified unspecified unspecified unspecified  	I_LOC	null
9 . . . punctuation unspecified unspecified unspecified unspecified unspecified  	O	null

0 עד עד עד preposition unspecified unspecified unspecified unspecified unspecified  	O	null
1 שנות שנה שנות noun feminine plural construct unspecified unspecified  	I_DATE	null
2 ה ה השישים definiteArticle unspecified unspecified unspecified unspecified unspecified 0 
2 השישים ORD-CARD60 השישים numeral masculine-and-feminine plural absolute unspecified unspecified  	I_DATE	null
3 היתה הוא היתה copula feminine singular unspecified 3 past  	O	null
4 מעורה מעורה מעורה adjective feminine singular absolute unspecified unspecified  	O	null
5 ב ב בחוגי preposition unspecified unspecified unspecified unspecified unspecified 0 
5 חוגי חוג בחוגי noun masculine plural construct unspecified unspecified  	O	null
6 ה ה האמנים definiteArticle unspecified unspecified unspecified unspecified unspecified 0 
6 האמנים אמן האמנים noun masculine plural absolute unspecified unspecified  	O	null
7 ו ו והבוהמה conjunction unspecified unspecified unspecified unspecified unspecified 0 
7 ה ה והבוהמה definiteArticle unspecified unspecified unspecified unspecified unspecified 0 
7 הבוהמה הבוהמה והבוהמה noun feminine singular absolute unspecified unspecified  	O	null
8 ו ו ומקורבת conjunction unspecified unspecified unspecified unspecified unspecified 0 
8 מקורבת קורב ומקורבת verb feminine singular unspecified any beinoni  	O	null
9 ל ל לחוגי preposition unspecified unspecified unspecified unspecified unspecified 0 
9 חוגי חוג לחוגי noun masculine plural construct unspecified unspecified  	O	null
10 ה ה השמאל definiteArticle unspecified unspecified unspecified unspecified unspecified 0 
10 השמאל שמאל השמאל noun masculine singular absolute unspecified unspecified  	O	null
11 . . . punctuation unspecified unspecified unspecified unspecified unspecified  	O	null

0 מ מ משנות preposition unspecified unspecified unspecified unspecified unspecified 0 
0 שנות שנה משנות noun feminine plural construct unspecified unspecified  	I_DATE	null
1 ה ה השישים definiteArticle unspecified unspecified unspecified unspecified unspecified 0 
1 השישים ORD-CARD60 השישים numeral masculine-and-feminine plural absolute unspecified unspecified  	I_DATE	null
2 החלה החל החלה verb feminine singular unspecified 3 past  	O	null
3 לפרסם פרסם לפרסם verb unspecified unspecified unspecified unspecified infinitive  	O	null
4 ביקורת ביקורת ביקורת noun feminine singular construct unspecified unspecified  	O	null
5 ספרים ספר ספרים noun masculine plural absolute unspecified unspecified  	O	null
6 , , , punctuation unspecified unspecified unspecified unspecified unspecified  	O	null
7 תרגומים תרגום תרגומים noun masculine plural absolute unspecified unspecified  	O	null
8 ו ו ודברי conjunction unspecified unspecified unspecified unspecified unspecified 0 
8 דברי דבר ודברי noun masculine plural construct unspecified unspecified  	O	null
9 ספרות ספרות ספרות noun feminine singular absolute unspecified unspecified  	O	null
10 קצרים קצר קצרים adjective masculine plural absolute unspecified unspecified  	O	null
11 משל משל משלה preposition unspecified unspecified unspecified unspecified unspecified  
11 ה ה משלה pronomial feminine singular unspecified 3 unspecified 0 	O	null
12 . . . punctuation unspecified unspecified unspecified unspecified unspecified  	O	null

0 לאחר לאחר לאחר conjunction unspecified unspecified unspecified unspecified unspecified  	O	null
1 מכן מיכן מכן verb masculine singular unspecified 2 imperative  	O	null
2 נעלמה נעלם נעלמה verb feminine singular unspecified 3 past  	O	null
3 מ מ מחיי preposition unspecified unspecified unspecified unspecified unspecified 0 
3 חיי חיים מחיי noun masculine plural construct unspecified unspecified  	O	null
4 ה ה הספרות definiteArticle unspecified unspecified unspecified unspecified unspecified 0 
4 הספרות ספרות הספרות noun feminine singular absolute unspecified unspecified  	O	null
5 ה ה הציבוריים definiteArticle unspecified unspecified unspecified unspecified unspecified 0 
5 הציבוריים ציבורי הציבוריים adjective masculine plural absolute unspecified unspecified  	O	null
6 ו ו וחיה conjunction unspecified unspecified unspecified unspecified unspecified 0 
6 חיה חי וחיה verb feminine singular unspecified 3 past  	O	null
7 חיי חיים חיי noun masculine plural construct unspecified unspecified  	O	null
8 בדידות בדידות בדידות noun feminine singular absolute unspecified unspecified  	O	null
9 קשים קשה קשים adjective masculine plural absolute unspecified unspecified  	O	null
10 . . . punctuation unspecified unspecified unspecified unspecified unspecified  	O	null

0 סמוך סמוך סמוך adjective masculine singular absolute unspecified unspecified  	O	null
1 ל ל למותה preposition unspecified unspecified unspecified unspecified unspecified 0 
1 מות מוות למותה noun masculine singular absolute unspecified unspecified  
1 ה ה למותה possessive feminine singular unspecified 3 unspecified 0 	O	null
2 הסתבר הסתבר הסתבר verb masculine singular unspecified 3 past  	O	null
3 ל ל למקורביה preposition unspecified unspecified unspecified unspecified unspecified 0 
3 מקורבי מקורב למקורביה noun masculine plural absolute unspecified unspecified  
3 ה ה למקורביה possessive feminine singular unspecified 3 unspecified 0 	O	null
4 ש ש שניהלה relativizer/subordinatingConjunction unspecified unspecified unspecified unspecified unspecified 0 
4 ניהלה ניהל שניהלה verb feminine singular unspecified 3 past  	O	null
5 יומנים יומן יומנים noun masculine plural absolute unspecified unspecified  	O	null
6 אישיים אישי אישיים adjective masculine plural absolute unspecified unspecified  	O	null
7 במשך במשך במשך preposition unspecified unspecified unspecified unspecified unspecified  	O	null
8 קרוב קרוב קרוב noun masculine singular absolute unspecified unspecified  	O	null
9 ל ל לשלושים preposition unspecified unspecified unspecified unspecified unspecified 0 
9 שלושים ORD-CARD30 לשלושים numeral masculine-and-feminine plural construct unspecified unspecified  	O	null
10 שנה ישן שנה verb feminine plural unspecified 2 imperative  	O	null
11 . . . punctuation unspecified unspecified unspecified unspecified unspecified  	O	null

0 סיפורי סיפור סיפוריה noun masculine plural absolute unspecified unspecified  
0 ה ה סיפוריה possessive feminine singular unspecified 3 unspecified 0 	O	null
1 מהווים היווה מהווים verb masculine plural unspecified any beinoni  	O	null
2 וריאציות וריאציה וריאציות noun feminine plural absolute unspecified unspecified  	O	null
3 על על על preposition unspecified unspecified unspecified unspecified unspecified  	O	null
4 נושא נושא נושא noun masculine singular construct unspecified unspecified  	O	null
5 ה ה הכמיהה definiteArticle unspecified unspecified unspecified unspecified unspecified 0 
5 הכמיהה כמיהה הכמיהה noun feminine singular absolute unspecified unspecified  	O	null
6 ו ו והפנטזיה conjunction unspecified unspecified unspecified unspecified unspecified 0 
6 ה ה והפנטזיה definiteArticle unspecified unspecified unspecified unspecified unspecified 0 
6 הפנטזיה פנטזיה והפנטזיה noun feminine singular absolute unspecified unspecified  	O	null
7 . . . punctuation unspecified unspecified unspecified unspecified unspecified  	O	null

0 חלק חלק חלקם noun masculine singular absolute unspecified unspecified  
0 ם ם חלקם possessive masculine plural unspecified 3 unspecified 0 	O	null
1 הופיעו הופיע הופיעו verb masculine-and-feminine plural unspecified 3 past  	O	null
2 ב ב בקובץ preposition unspecified unspecified unspecified unspecified unspecified 0 
2 קובץ קובץ בקובץ noun masculine singular construct unspecified unspecified  	O	null
3 ה ה הפרוזה definiteArticle unspecified unspecified unspecified unspecified unspecified 0 
3 הפרוזה פרוזה הפרוזה noun feminine singular absolute unspecified unspecified  	O	null
4 ה ה היחיד definiteArticle unspecified unspecified unspecified unspecified unspecified 0 
4 היחיד יחיד היחיד adjective masculine singular absolute unspecified unspecified  	O	null
5 ש ש שפירסמה relativizer/subordinatingConjunction unspecified unspecified unspecified unspecified unspecified 0 
5 פירסמה פרסם שפירסמה verb feminine singular unspecified 3 past  	O	null
6 ב ב בחייה preposition unspecified unspecified unspecified unspecified unspecified 0 
6 חיי חיים בחייה noun masculine plural absolute unspecified unspecified  
6 ה ה בחייה possessive feminine singular unspecified 3 unspecified 0 	O	null
7 : : : punctuation unspecified unspecified unspecified unspecified unspecified  	O	null
8 ה ה הבובה definiteArticle unspecified unspecified unspecified unspecified unspecified 0 
8 הבובה בובה הבובה noun feminine singular absolute unspecified unspecified  	O	null
9 ( ( ( punctuation unspecified unspecified unspecified unspecified unspecified  	O	null
10 עקד עקד עקד verb masculine singular unspecified 3 past  	O	null
11 , , , punctuation unspecified unspecified unspecified unspecified unspecified  	O	null
12 ###NUMBER### ###NUMBER### ###NUMBER### numeral unspecified unspecified unspecified unspecified unspecified  	I_DATE	null
13 ) ) ) punctuation unspecified unspecified unspecified unspecified unspecified  	O	null
14 . . . punctuation unspecified unspecified unspecified unspecified unspecified  	O	null

0 שאר שאר שאר noun masculine singular construct unspecified unspecified  	O	null
1 ה ה הסיפורים definiteArticle unspecified unspecified unspecified unspecified unspecified 0 
1 הסיפורים סיפור הסיפורים noun masculine plural absolute unspecified unspecified  	O	null
2 לוקטו לוקט לוקטו verb masculine-and-feminine plural unspecified 3 past  	O	null
3 לאחר לאחר לאחר conjunction unspecified unspecified unspecified unspecified unspecified  	O	null
4 מות מוות מותה noun masculine singular absolute unspecified unspecified  
4 ה ה מותה possessive feminine singular unspecified 3 unspecified 0 	O	null
5 על על על preposition unspecified unspecified unspecified unspecified unspecified  	O	null
6 פי פה פי noun masculine singular construct unspecified unspecified  	O	null
7 צוואת צוואה צוואתה noun feminine singular absolute unspecified unspecified  
7 ה ה צוואתה possessive feminine singular unspecified 3 unspecified 0 	O	null
8 . . . punctuation unspecified unspecified unspecified unspecified unspecified  	O	null

0 הם הוא הם pronoun masculine plural unspecified 3 unspecified  	O	null
1 ראו ראה ראו verb masculine-and-feminine plural unspecified 3 past  	O	null
2 אור אור אור noun masculine singular absolute unspecified unspecified  	O	null
3 ב ב בקובץ preposition unspecified unspecified unspecified unspecified unspecified 0 
3 קובץ קובץ בקובץ noun masculine singular construct unspecified unspecified  	O	null
4 סיפורים סיפור סיפורים noun masculine plural absolute unspecified unspecified  	O	null
5 קצרים קצר קצרים adjective masculine plural absolute unspecified unspecified  	O	null
6 ) ) ) punctuation unspecified unspecified unspecified unspecified unspecified  	O	null
7 . . . punctuation unspecified unspecified unspecified unspecified unspecified  	O	null
8 ###NUMBER### ###NUMBER### ###NUMBER### numeral unspecified unspecified unspecified unspecified unspecified  	I_DATE	null
9 סיפורי סיפור סיפוריה noun masculine plural absolute unspecified unspecified  
9 ה ה סיפוריה possessive feminine singular unspecified 3 unspecified 0 	O	null
10 עוסקים עסק עוסקים verb masculine plural unspecified any beinoni  	O	null
11 ב ב בבדידות preposition unspecified unspecified unspecified unspecified unspecified 0 
11 ה ה בבדידות definiteArticle unspecified unspecified unspecified unspecified unspecified 0 
11 הבדידות בדידות בבדידות noun feminine singular absolute unspecified unspecified  	O	null
12 ה ה האנושית definiteArticle unspecified unspecified unspecified unspecified unspecified 0 
12 האנושית אנושי האנושית adjective feminine singular absolute unspecified unspecified  	O	null
13 ב ב במרחב preposition unspecified unspecified unspecified unspecified unspecified 0 
13 ה ה במרחב definiteArticle unspecified unspecified unspecified unspecified unspecified 0 
13 המרחב מרחב במרחב noun masculine singular absolute unspecified unspecified  	O	null
14 ה ה האורבני definiteArticle unspecified unspecified unspecified unspecified unspecified 0 
14 האורבני אורבאני האורבני adjective masculine singular absolute unspecified unspecified  	O	null
15 ה ה התל definiteArticle unspecified unspecified unspecified unspecified unspecified 0 
15 התל תל התל noun masculine singular absolute unspecified unspecified  	O	null
16 - - - punctuation unspecified unspecified unspecified unspecified unspecified  	O	null
17 אביבי אביבי אביבי adjective masculine singular absolute unspecified unspecified  	O	null
18 של של של shel-preposition unspecified unspecified unspecified unspecified unspecified  	O	null
19 שנות שנה שנות noun feminine plural construct unspecified unspecified  	I_DATE	null
20 ה ה השישים definiteArticle unspecified unspecified unspecified unspecified unspecified 0 
20 השישים ORD-CARD60 השישים numeral masculine-and-feminine plural absolute unspecified unspecified  	I_DATE	null
21 ו ו והשבעים conjunction unspecified unspecified unspecified unspecified unspecified 0 
21 ה ה והשבעים definiteArticle unspecified unspecified unspecified unspecified unspecified 0 
21 השבעים ORD-CARD70 והשבעים numeral masculine-and-feminine plural absolute unspecified unspecified  	O	null
22 , , , punctuation unspecified unspecified unspecified unspecified unspecified  	O	null
23 כש כש כשעיקר temporalSubConj unspecified unspecified unspecified unspecified unspecified 0 
23 עיקר עיקר כשעיקר noun masculine singular construct unspecified unspecified  	O	null
24 ה ה ההתייחסות definiteArticle unspecified unspecified unspecified unspecified unspecified 0 
24 ההתייחסות התייחסות ההתייחסות noun feminine singular absolute unspecified unspecified  	O	null
25 ב ב בהם preposition unspecified unspecified unspecified unspecified unspecified  
25 הם הם בהם pronomial masculine plural unspecified 3 unspecified 0 	O	null
26 היא הוא היא pronoun feminine singular unspecified 3 unspecified  	O	null
27 לעולם לעולם לעולם adverb unspecified unspecified unspecified unspecified unspecified  	O	null
28 ב ב בשקיעה preposition unspecified unspecified unspecified unspecified unspecified 0 
28 ה ה בשקיעה definiteArticle unspecified unspecified unspecified unspecified unspecified 0 
28 השקיעה שקיעה בשקיעה noun feminine singular absolute unspecified unspecified  	O	null
29 . . . punctuation unspecified unspecified unspecified unspecified unspecified  	O	null

0 ב ב בשיריה preposition unspecified unspecified unspecified unspecified unspecified 0 
0 שירי שיר בשיריה noun masculine plural absolute unspecified unspecified  
0 ה ה בשיריה possessive feminine singular unspecified 3 unspecified 0 	O	null
1 בולט בלט בולט verb masculine singular unspecified any beinoni  	O	null
2 ה ה הפן definiteArticle unspecified unspecified unspecified unspecified unspecified 0 
2 הפן פן הפן noun masculine singular absolute unspecified unspecified  	O	null
3 ה ה הפמיניסטי definiteArticle unspecified unspecified unspecified unspecified unspecified 0 
3 הפמיניסטי הפמיניסטי הפמיניסטי adjective masculine singular absolute unspecified unspecified  	O	null
4 ה ה המתריס definiteArticle unspecified unspecified unspecified unspecified unspecified 0 
4 המתריס התריס המתריס participle masculine singular absolute any unspecified  	O	null
5 . . . punctuation unspecified unspecified unspecified unspecified unspecified  	O	null

0 בחור בחור בחור noun masculine singular absolute unspecified unspecified  	O	null
1 בונה בנה בונה verb masculine singular unspecified any beinoni  	O	null
2 דגם דגם דגם noun masculine singular absolute unspecified unspecified  	O	null
3 של של של shel-preposition unspecified unspecified unspecified unspecified unspecified  	O	null
4 אישה איש אישה noun feminine singular absolute unspecified unspecified  	O	null
5 מושלמת מושלם מושלמת adjective feminine singular absolute unspecified unspecified  	O	null
6 , , , punctuation unspecified unspecified unspecified unspecified unspecified  	O	null
7 ש ש שלמרות relativizer/subordinatingConjunction unspecified unspecified unspecified unspecified unspecified 0 
7 למרות למרות שלמרות conjunction unspecified unspecified unspecified unspecified unspecified  	O	null
8 זאת זאת זאת pronoun feminine singular unspecified 3 unspecified  	O	null
9 נשארת נשאר נשארת verb feminine singular unspecified any beinoni  	O	null
10 תמיד תמיד תמיד adverb unspecified unspecified unspecified unspecified unspecified  	O	null
11 ב ב בבדידותה preposition unspecified unspecified unspecified unspecified unspecified 0 
11 בדידות בדידות בבדידותה noun feminine singular absolute unspecified unspecified  
11 ה ה בבדידותה possessive feminine singular unspecified 3 unspecified 0 	O	null
12 . . . punctuation unspecified unspecified unspecified unspecified unspecified  	O	null

0 היא הוא היא pronoun feminine singular unspecified 3 unspecified  	O	null
1 חייבת חייב חייבת modal feminine singular unspecified any unspecified  	O	null
2 להיות הוא להיות copula unspecified unspecified unspecified unspecified infinitive  	O	null
3 תוססת תוסס תוססת adjective feminine singular absolute unspecified unspecified  	O	null
4 ו ו ופעלתנית conjunction unspecified unspecified unspecified unspecified unspecified 0 
4 פעלתנית פעלתן ופעלתנית adjective feminine singular absolute unspecified unspecified  	O	null
5 , , , punctuation unspecified unspecified unspecified unspecified unspecified  	O	null
6 משוחררת משוחרר משוחררת adjective feminine singular absolute unspecified unspecified  	O	null
7 מ מ מכל preposition unspecified unspecified unspecified unspecified unspecified 0 
7 כל כול מכל quantifier unspecified unspecified construct unspecified unspecified  	O	null
8 מוסכמה מוסכמה מוסכמה noun feminine singular absolute unspecified unspecified  	O	null
9 חברתית חברתי חברתית adjective feminine singular absolute unspecified unspecified  	O	null
10 נוקשה נוקשה נוקשה adjective feminine singular absolute unspecified unspecified  	O	null
11 . . . punctuation unspecified unspecified unspecified unspecified unspecified  	O	null

0 ה ה המחברת definiteArticle unspecified unspecified unspecified unspecified unspecified 0 
0 המחברת מחברת המחברת noun feminine singular absolute unspecified unspecified  	O	null
1 נמצאת נמצא נמצאת verb feminine singular unspecified any beinoni  	O	null
2 תמיד תמיד תמיד adverb unspecified unspecified unspecified unspecified unspecified  	O	null
3 ב ב ברקע preposition unspecified unspecified unspecified unspecified unspecified 0 
3 רקע רקע ברקע noun masculine singular construct unspecified unspecified  	O	null
4 של של של shel-preposition unspecified unspecified unspecified unspecified unspecified  	O	null
5 סיפורי סיפור סיפוריה noun masculine plural absolute unspecified unspecified  
5 ה ה סיפוריה possessive feminine singular unspecified 3 unspecified 0 	O	null
6 , , , punctuation unspecified unspecified unspecified unspecified unspecified  	O	null
7 בגלוי בגלוי בגלוי adverb unspecified unspecified unspecified unspecified unspecified  	O	null
8 או או או conjunction unspecified unspecified unspecified unspecified unspecified  	O	null
9 ב ב בסמוי preposition unspecified unspecified unspecified unspecified unspecified 0 
9 ה ה בסמוי definiteArticle unspecified unspecified unspecified unspecified unspecified 0 
9 הסמוי סמוי בסמוי adjective masculine singular absolute unspecified unspecified  	O	null
10 , , , punctuation unspecified unspecified unspecified unspecified unspecified  	O	null
11 ב ב בעילום preposition unspecified unspecified unspecified unspecified unspecified 0 
11 ה ה בעילום definiteArticle unspecified unspecified unspecified unspecified unspecified 0 
11 העילום עילום בעילום noun masculine singular absolute unspecified unspecified  	O	null
12 שם שם שם adverb unspecified unspecified unspecified unspecified unspecified  	O	null
13 או או או conjunction unspecified unspecified unspecified unspecified unspecified  	O	null
14 ב ב בשינוי preposition unspecified unspecified unspecified unspecified unspecified 0 
14 שינוי שינוי בשינוי noun masculine singular absolute unspecified unspecified  	O	null
15 תפאורה תפאורה תפאורה noun feminine singular absolute unspecified unspecified  	O	null
16 . . . punctuation unspecified unspecified unspecified unspecified unspecified  	O	null

0 מסקנות מסקנה מסקנותיה noun feminine plural absolute unspecified unspecified  
0 ה ה מסקנותיה possessive feminine singular unspecified 3 unspecified 0 	O	null
1 ו ו ודעותיה conjunction unspecified unspecified unspecified unspecified unspecified 0 
1 דעות דעה ודעותיה noun feminine plural absolute unspecified unspecified  
1 ה ה ודעותיה possessive feminine singular unspecified 3 unspecified 0 	O	null
2 מובעות הובע מובעות verb feminine plural unspecified any beinoni  	O	null
3 דרך דרך דרך preposition unspecified unspecified unspecified unspecified unspecified  	O	null
4 ה ה ההתרחשות definiteArticle unspecified unspecified unspecified unspecified unspecified 0 
4 ההתרחשות התרחשות ההתרחשות noun feminine singular absolute unspecified unspecified  	O	null
5 ה ה הסיפורית definiteArticle unspecified unspecified unspecified unspecified unspecified 0 
5 הסיפורית סיפורי הסיפורית adjective feminine singular absolute unspecified unspecified  	O	null
6 . . . punctuation unspecified unspecified unspecified unspecified unspecified  	O	null

0 היא הוא היא pronoun feminine singular unspecified 3 unspecified  	O	null
1 מבליטה הבליט מבליטה verb feminine singular unspecified any beinoni  	O	null
2 ב ב ביצירתה preposition unspecified unspecified unspecified unspecified unspecified 0 
2 יצירת יצירה ביצירתה noun feminine singular absolute unspecified unspecified  
2 ה ה ביצירתה possessive feminine singular unspecified 3 unspecified 0 	O	null
3 את את את at-preposition unspecified unspecified unspecified unspecified unspecified  	O	null
4 ה ה הצד definiteArticle unspecified unspecified unspecified unspecified unspecified 0 
4 הצד צד הצד noun masculine singular absolute unspecified unspecified  	O	null
5 ה ה החסוי definiteArticle unspecified unspecified unspecified unspecified unspecified 0 
5 החסוי חסוי החסוי adjective masculine singular absolute unspecified unspecified  	O	null
6 של של של shel-preposition unspecified unspecified unspecified unspecified unspecified  	O	null
7 ה ה הנפש definiteArticle unspecified unspecified unspecified unspecified unspecified 0 
7 הנפש נפש הנפש noun feminine singular absolute unspecified unspecified  	O	null
8 . . . punctuation unspecified unspecified unspecified unspecified unspecified  	O	null

0 לשון לשון לשונה noun feminine singular absolute unspecified unspecified  
0 ה ה לשונה possessive feminine singular unspecified 3 unspecified 0 	O	null
1 פיוטית פיוטי פיוטית adjective feminine singular absolute unspecified unspecified  	O	null
2 ו ו ועדינה conjunction unspecified unspecified unspecified unspecified unspecified 0 
2 עדינה עדין ועדינה adjective feminine singular absolute unspecified unspecified  	O	null
3 , , , punctuation unspecified unspecified unspecified unspecified unspecified  	O	null
4 מתובלת תובל מתובלת verb feminine singular unspecified any beinoni  	O	null
5 ב ב בפסוקים preposition unspecified unspecified unspecified unspecified unspecified 0 
5 פסוקים פסוק בפסוקים noun masculine plural absolute unspecified unspecified  	O	null
6 מקראיים מקראי מקראיים adjective masculine plural absolute unspecified unspecified  	O	null
7 . . . punctuation unspecified unspecified unspecified unspecified unspecified  	O	null

0 ב ב ביומנים preposition unspecified unspecified unspecified unspecified unspecified 0 
0 יומנים יומן ביומנים noun masculine plural absolute unspecified unspecified  	O	null
1 ש ש שהותירה relativizer/subordinatingConjunction unspecified unspecified unspecified unspecified unspecified 0 
1 הותירה הותיר שהותירה verb feminine singular unspecified 3 past  	O	null
2 אחרי אחרי אחריה preposition unspecified unspecified unspecified unspecified unspecified  
2 ה ה אחריה pronomial feminine singular unspecified 3 unspecified 0 	O	null
3 ו ו ושפורסמו conjunction unspecified unspecified unspecified unspecified unspecified 0 
3 ש ש ושפורסמו relativizer/subordinatingConjunction unspecified unspecified unspecified unspecified unspecified 0 
3 פורסמו פורסם ושפורסמו verb masculine-and-feminine plural unspecified 3 past  	O	null
4 לאחר לאחר לאחר preposition unspecified unspecified unspecified unspecified unspecified  	O	null
5 מות מוות מותה noun masculine singular absolute unspecified unspecified  
5 ה ה מותה possessive feminine singular unspecified 3 unspecified 0 	O	null
6 : : : punctuation unspecified unspecified unspecified unspecified unspecified  	O	null
7 ארבע CARD4 ארבע numeral feminine singular absolute unspecified unspecified  	O	null
8 מחברות מחברת מחברות noun feminine plural absolute unspecified unspecified  	O	null
9 יומן יומן יומן noun masculine singular absolute unspecified unspecified  	O	null
10 ( ( ( punctuation unspecified unspecified unspecified unspecified unspecified  	O	null
11 ###NUMBER### ###NUMBER### ###NUMBER### numeral unspecified unspecified unspecified unspecified unspecified  	I_DATE	null
12 ) ) ) punctuation unspecified unspecified unspecified unspecified unspecified  	O	null
13 ו ו וייסורי conjunction unspecified unspecified unspecified unspecified unspecified 0 
13 ייסורי ייסור וייסורי noun masculine plural construct unspecified unspecified  	O	null
14 יונה יון יונה properName unspecified unspecified unspecified unspecified unspecified  	I_PERS	null
15 ב ב בחור preposition unspecified unspecified unspecified unspecified unspecified 0 
15 חור חור בחור noun masculine singular absolute unspecified unspecified  	O	null
16 – – – punctuation unspecified unspecified unspecified unspecified unspecified  	O	null
17 ספר ספר ספר noun masculine singular absolute unspecified unspecified  	O	null
18 ה ה היומנים definiteArticle unspecified unspecified unspecified unspecified unspecified 0 
18 היומנים יומן היומנים noun masculine plural absolute unspecified unspecified  	O	null
19 - - - punctuation unspecified unspecified unspecified unspecified unspecified  	O	null
20 1991(1996 1991(1996 1991(1996 properName unspecified unspecified unspecified unspecified unspecified  	I_ORG	null
21 ) ) ) punctuation unspecified unspecified unspecified unspecified unspecified  	O	null
22 , , , punctuation unspecified unspecified unspecified unspecified unspecified  	O	null
23 ###NUMBER### ###NUMBER### ###NUMBER### numeral unspecified unspecified unspecified unspecified unspecified  	I_DATE	null
24 היא הוא היא pronoun feminine singular unspecified 3 unspecified  	O	null
25 מתעדת תיעד מתעדת verb feminine singular unspecified any beinoni  	O	null
26 את את את at-preposition unspecified unspecified unspecified unspecified unspecified  	O	null
27 ה ה ההוויה definiteArticle unspecified unspecified unspecified unspecified unspecified 0 
27 ההוויה הוויה ההוויה noun feminine singular absolute unspecified unspecified  	O	null
28 ה ה הישראלית definiteArticle unspecified unspecified unspecified unspecified unspecified 0 
28 הישראלית ישראלי הישראלית adjective feminine singular absolute unspecified unspecified  	O	null
29 . . . punctuation unspecified unspecified unspecified unspecified unspecified  	O	null

0 הקשבת הקשבה הקשבתה noun feminine singular absolute unspecified unspecified  
0 ה ה הקשבתה possessive feminine singular unspecified 3 unspecified 0 	O	null
1 ל ל לסביבה preposition unspecified unspecified unspecified unspecified unspecified 0 
1 ה ה לסביבה definiteArticle unspecified unspecified unspecified unspecified unspecified 0 
1 הסביבה סביבה לסביבה noun feminine singular absolute unspecified unspecified  	O	null
2 , , , punctuation unspecified unspecified unspecified unspecified unspecified  	O	null
3 ל ל לחדשות preposition unspecified unspecified unspecified unspecified unspecified 0 
3 ה ה לחדשות definiteArticle unspecified unspecified unspecified unspecified unspecified 0 
3 החדשות חדשה לחדשות noun feminine plural absolute unspecified unspecified  	O	null
4 , , , punctuation unspecified unspecified unspecified unspecified unspecified  	O	null
5 ל ל להוויה preposition unspecified unspecified unspecified unspecified unspecified 0 
5 ה ה להוויה definiteArticle unspecified unspecified unspecified unspecified unspecified 0 
5 ההוויה הוויה להוויה noun feminine singular absolute unspecified unspecified  	O	null
6 ה ה הפוליטית definiteArticle unspecified unspecified unspecified unspecified unspecified 0 
6 הפוליטית פוליטי הפוליטית adjective feminine singular absolute unspecified unspecified  	O	null
7 ו ו והאורבנית conjunction unspecified unspecified unspecified unspecified unspecified 0 
7 ה ה והאורבנית definiteArticle unspecified unspecified unspecified unspecified unspecified 0 
7 האורבנית אורבאני והאורבנית adjective feminine singular absolute unspecified unspecified  	O	null
8 , , , punctuation unspecified unspecified unspecified unspecified unspecified  	O	null
9 מתוארת תואר מתוארת verb feminine singular unspecified any beinoni  	O	null
10 ב ב בחדות preposition unspecified unspecified unspecified unspecified unspecified 0 
10 חדות חדות בחדות noun feminine singular absolute unspecified unspecified  	O	null
11 . . . punctuation unspecified unspecified unspecified unspecified unspecified  	O	null

0 היא הוא היא pronoun feminine singular unspecified 3 unspecified  	O	null
1 מיטיבה היטיב מיטיבה verb feminine singular unspecified any beinoni  	O	null
2 לחוש חש לחוש verb unspecified unspecified unspecified unspecified infinitive  	O	null
3 את את את at-preposition unspecified unspecified unspecified unspecified unspecified  	O	null
4 תת תת תת wPrefix unspecified unspecified unspecified unspecified unspecified  	O	null
5 - - - punctuation unspecified unspecified unspecified unspecified unspecified  	O	null
6 ה ה הזרמים definiteArticle unspecified unspecified unspecified unspecified unspecified 0 
6 הזרמים זרם הזרמים noun masculine plural absolute unspecified unspecified  	O	null
7 ה ה החולפים definiteArticle unspecified unspecified unspecified unspecified unspecified 0 
7 החולפים חולף החולפים adjective masculine plural absolute unspecified unspecified  	O	null
8 ב ב בשדרתה preposition unspecified unspecified unspecified unspecified unspecified 0 
8 שדרת שדרה בשדרתה noun feminine singular absolute unspecified unspecified  
8 ה ה בשדרתה possessive feminine singular unspecified 3 unspecified 0 	O	null
9 של של של shel-preposition unspecified unspecified unspecified unspecified unspecified  	O	null
10 ה ה החברה definiteArticle unspecified unspecified unspecified unspecified unspecified 0 
10 החברה חבר החברה noun feminine singular absolute unspecified unspecified  	O	null
11 ה ה הישראלית definiteArticle unspecified unspecified unspecified unspecified unspecified 0 
11 הישראלית ישראלי הישראלית adjective feminine singular absolute unspecified unspecified  	O	null
12 . . . punctuation unspecified unspecified unspecified unspecified unspecified  	O	null

0 גם גם גם conjunction unspecified unspecified unspecified unspecified unspecified  	O	null
1 כ כ כמבקרת preposition unspecified unspecified unspecified unspecified unspecified 0 
1 מבקרת מבקר כמבקרת noun feminine singular construct unspecified unspecified  	O	null
2 ספרות ספרות ספרות noun feminine singular absolute unspecified unspecified  	O	null
3 ( ( ( punctuation unspecified unspecified unspecified unspecified unspecified  	O	null
4 רשימות רשימה רשימות noun feminine plural absolute unspecified unspecified  	O	null
5 על על על preposition unspecified unspecified unspecified unspecified unspecified  	O	null
6 ספרות ספרות ספרות noun feminine singular absolute unspecified unspecified  	O	null
7 , , , punctuation unspecified unspecified unspecified unspecified unspecified  	O	null
8 ) ) ) punctuation unspecified unspecified unspecified unspecified unspecified  	O	null
9 ###NUMBER### ###NUMBER### ###NUMBER### numeral unspecified unspecified unspecified unspecified unspecified  	I_DATE	null
10 היא הוא היא pronoun feminine singular unspecified 3 unspecified  	O	null
11 מבטאת ביטא מבטאת verb feminine singular unspecified any beinoni  	O	null
12 רגישות רגישות רגישות noun feminine singular absolute unspecified unspecified  	O	null
13 ו ו ועין conjunction unspecified unspecified unspecified unspecified unspecified 0 
13 עין עין ועין noun feminine singular absolute unspecified unspecified  	O	null
14 חדה חד חדה adjective feminine singular absolute unspecified unspecified  	O	null
15 . . . punctuation unspecified unspecified unspecified unspecified unspecified  	O	null

0 References References References foreign unspecified unspecified unspecified unspecified unspecified  	O	null
1 : : : punctuation unspecified unspecified unspecified unspecified unspecified  	O	null
2 אלאלוף אלאלוף אלאלוף noun masculine singular absolute unspecified unspecified  	O	null
3 מימון מימון מימון noun masculine singular absolute unspecified unspecified  	O	null
4 , , , punctuation unspecified unspecified unspecified unspecified unspecified  	O	null
5 דלי דלי דליס noun masculine singular absolute unspecified unspecified  
5 ה ה דליס possessive feminine singular unspecified 3 unspecified 0 	O	null
6 . . . punctuation unspecified unspecified unspecified unspecified unspecified  	O	null

0 " " " punctuation unspecified unspecified unspecified unspecified unspecified  	O	null
1 ציפור ציפור ציפור noun masculine singular absolute unspecified unspecified  	O	null
2 נודדת נדד נודדת verb feminine singular unspecified any beinoni  	O	null
3 , , , punctuation unspecified unspecified unspecified unspecified unspecified  	O	null
4 תועה תעה תועה verb masculine singular unspecified any beinoni  	O	null
5 " " " punctuation unspecified unspecified unspecified unspecified unspecified  	O	null
6 . . . punctuation unspecified unspecified unspecified unspecified unspecified  	O	null

0 מאזנייםס"ט מאזנייםס"ט מאזנייםס"ט verb masculine plural unspecified any beinoni  	O	null
1 ־ ־ ־ punctuation unspecified unspecified unspecified unspecified unspecified  	O	null
2 ###NUMBER### ###NUMBER### ###NUMBER### numeral unspecified unspecified unspecified unspecified unspecified  	O	null
3 ) ) ) punctuation unspecified unspecified unspecified unspecified unspecified  	O	null
4 . . . punctuation unspecified unspecified unspecified unspecified unspecified  	O	null

0 ###NUMBER### ###NUMBER### ###NUMBER### numeral unspecified unspecified unspecified unspecified unspecified  	O	null
1 ###NUMBER### ###NUMBER### ###NUMBER### numeral unspecified unspecified unspecified unspecified unspecified  	I_DATE	null
2 . . . punctuation unspecified unspecified unspecified unspecified unspecified  	O	null

0 ־ ־ ־ punctuation unspecified unspecified unspecified unspecified unspecified  	O	null
1 ###NUMBER### ###NUMBER### ###NUMBER### numeral unspecified unspecified unspecified unspecified unspecified  	O	null
2 ; ; ; punctuation unspecified unspecified unspecified unspecified unspecified  	O	null
3 ###NUMBER### ###NUMBER### ###NUMBER### numeral unspecified unspecified unspecified unspecified unspecified  	O	null
4 וייכרט וייכרט וייכרט properName unspecified unspecified unspecified unspecified unspecified  	O	null
5 , , , punctuation unspecified unspecified unspecified unspecified unspecified  	O	null
6 רפי רפי רפי properName unspecified unspecified unspecified unspecified unspecified  	I_PERS	null
7 . . . punctuation unspecified unspecified unspecified unspecified unspecified  	O	null

0 " " " punctuation unspecified unspecified unspecified unspecified unspecified  	O	null
1 הזיות הזיה הזיות noun feminine plural absolute unspecified unspecified  	O	null
2 של של של shel-preposition unspecified unspecified unspecified unspecified unspecified  	O	null
3 אושר אושר אושר properName unspecified unspecified unspecified unspecified unspecified  	I_PERS	null
4 " " " punctuation unspecified unspecified unspecified unspecified unspecified  	O	null
5 . . . punctuation unspecified unspecified unspecified unspecified unspecified  	O	null

0 ידיעות ידיעה ידיעות noun feminine plural absolute unspecified unspecified  	I_ORG	null
1 אחרונות אחרון אחרונות adjective feminine plural absolute unspecified unspecified  	I_ORG	null
2 ל ל לשבת preposition unspecified unspecified unspecified unspecified unspecified 0 
2 ה ה לשבת definiteArticle unspecified unspecified unspecified unspecified unspecified 0 
2 השבת שבת לשבת noun feminine singular absolute unspecified unspecified  	O	null
3 . . . punctuation unspecified unspecified unspecified unspecified unspecified  	O	null

0 ###NUMEXP### ###NUMEXP### ###NUMEXP### numberExpression unspecified unspecified unspecified unspecified unspecified  	I_DATE	null
1 . . . punctuation unspecified unspecified unspecified unspecified unspecified  	O	null

0 ###NUMBER### ###NUMBER### ###NUMBER### numeral unspecified unspecified unspecified unspecified unspecified  	O	null
1 - - - punctuation unspecified unspecified unspecified unspecified unspecified  	O	null
2 ###NUMBER### ###NUMBER### ###NUMBER### numeral unspecified unspecified unspecified unspecified unspecified  	O	null
3 . . . punctuation unspecified unspecified unspecified unspecified unspecified  	O	null

