0 Name Name Name foreign unspecified unspecified unspecified unspecified unspecified  	O	null
1 : : : punctuation unspecified unspecified unspecified unspecified unspecified  	O	null
2 בטחיש בטחיש בטחיש noun masculine singular absolute unspecified unspecified  	O	null
3 , , , punctuation unspecified unspecified unspecified unspecified unspecified  	O	null
4 ראג'י ראג'י ראג'י properName unspecified unspecified unspecified unspecified unspecified  	O	null
5 Birth Birth Birth foreign unspecified unspecified unspecified unspecified unspecified  	O	null
6 Year Year Year foreign unspecified unspecified unspecified unspecified unspecified  	O	null
7 : : : punctuation unspecified unspecified unspecified unspecified unspecified  	O	null
8 ###NUMBER### ###NUMBER### ###NUMBER### numeral unspecified unspecified unspecified unspecified unspecified  	I_DATE	null
9 Birth Birth Birth foreign unspecified unspecified unspecified unspecified unspecified  	O	null
10 Place Place Place foreign unspecified unspecified unspecified unspecified unspecified  	O	null
11 : : : punctuation unspecified unspecified unspecified unspecified unspecified  	O	null
12 נצרת נצרת נצרת properName unspecified unspecified unspecified unspecified unspecified  	I_LOC	null
13 , , , punctuation unspecified unspecified unspecified unspecified unspecified  	O	null
14 ו ו ומתגורר conjunction unspecified unspecified unspecified unspecified unspecified 0 
14 מתגורר התגורר ומתגורר verb masculine singular unspecified any beinoni  	O	null
15 ב ב בנצרת preposition unspecified unspecified unspecified unspecified unspecified 0 
15 נצרת נצרת בנצרת properName unspecified unspecified unspecified unspecified unspecified  	I_LOC	null
16 ו ו ובתל conjunction unspecified unspecified unspecified unspecified unspecified 0 
16 ב ב ובתל preposition unspecified unspecified unspecified unspecified unspecified 0 
16 תל תל ובתל properName unspecified unspecified unspecified unspecified unspecified  	I_LOC	null
17 Occupation Occupation Occupation foreign unspecified unspecified unspecified unspecified unspecified  	O	null
18 : : : punctuation unspecified unspecified unspecified unspecified unspecified  	O	null
19 משורר משורר משורר noun masculine singular absolute unspecified unspecified  	O	null
20 , , , punctuation unspecified unspecified unspecified unspecified unspecified  	O	null
21 סופר סופר סופר noun masculine singular absolute unspecified unspecified  	O	null
22 ו ו ועורך conjunction unspecified unspecified unspecified unspecified unspecified 0 
22 עורך עורך ועורך noun masculine singular absolute unspecified unspecified  	O	null
23 ב ב בשפה preposition unspecified unspecified unspecified unspecified unspecified 0 
23 ה ה בשפה definiteArticle unspecified unspecified unspecified unspecified unspecified 0 
23 השפה שפה בשפה noun feminine singular absolute unspecified unspecified  	O	null
24 ה ה הערבית definiteArticle unspecified unspecified unspecified unspecified unspecified 0 
24 הערבית ערבי הערבית adjective feminine singular absolute unspecified unspecified  	O	null
25 Entry Entry Entry foreign unspecified unspecified unspecified unspecified unspecified  	O	null
26 writer writer writer foreign unspecified unspecified unspecified unspecified unspecified  	O	null
27 : : : punctuation unspecified unspecified unspecified unspecified unspecified  	O	null
28 אריאל אריאל אריאל properName unspecified unspecified unspecified unspecified unspecified  	I_ORG	null
29 שיטרית שיטרית שיטרית properName unspecified unspecified unspecified unspecified unspecified  	I_ORG	null
30 Entry Entry Entry foreign unspecified unspecified unspecified unspecified unspecified  	O	null
31 Value Value Value foreign unspecified unspecified unspecified unspecified unspecified  	O	null
32 : : : punctuation unspecified unspecified unspecified unspecified unspecified  	O	null
33 נולד נולד נולד verb masculine singular unspecified 3 past  	O	null
34 ב ב בנצרת preposition unspecified unspecified unspecified unspecified unspecified 0 
34 נצרת נצרת בנצרת properName unspecified unspecified unspecified unspecified unspecified  	I_LOC	null
35 , , , punctuation unspecified unspecified unspecified unspecified unspecified  	O	null
36 ו ו ומתגורר conjunction unspecified unspecified unspecified unspecified unspecified 0 
36 מתגורר התגורר ומתגורר verb masculine singular unspecified any beinoni  	O	null
37 ב ב בנצרת preposition unspecified unspecified unspecified unspecified unspecified 0 
37 נצרת נצרת בנצרת properName unspecified unspecified unspecified unspecified unspecified  	I_LOC	null
38 ו ו ובתל conjunction unspecified unspecified unspecified unspecified unspecified 0 
38 ב ב ובתל preposition unspecified unspecified unspecified unspecified unspecified 0 
38 תל תל ובתל properName unspecified unspecified unspecified unspecified unspecified  	B_LOC	null
39 אביב אביב אביב properName unspecified unspecified unspecified unspecified unspecified  	I_LOC	null
40 . . . punctuation unspecified unspecified unspecified unspecified unspecified  	O	null

0 בעל בעל בעל noun masculine singular construct unspecified unspecified  	O	null
1 תואר תואר תואר noun masculine singular absolute unspecified unspecified  	O	null
2 ראשון ORD1 ראשון numeral masculine singular absolute unspecified unspecified  	O	null
3 מ מ מהטכניון preposition unspecified unspecified unspecified unspecified unspecified 0 
3 ה ה מהטכניון definiteArticle unspecified unspecified unspecified unspecified unspecified 0 
3 הטכניון טכניון מהטכניון noun masculine singular absolute unspecified unspecified  	O	null
4 ב ב בהנדסה preposition unspecified unspecified unspecified unspecified unspecified 0 
4 הנדסה הנדסה בהנדסה noun feminine singular absolute unspecified unspecified  	O	null
5 ו ו וביוטכנולוגיה conjunction unspecified unspecified unspecified unspecified unspecified 0 
5 ביוטכנולוגיה ביוטכנולוגיה וביוטכנולוגיה properName unspecified unspecified unspecified unspecified unspecified  	I_ORG	null
6 ו ו ובוגר conjunction unspecified unspecified unspecified unspecified unspecified 0 
6 בוגר בוגר ובוגר noun masculine singular construct unspecified unspecified  	O	null
7 בית בית בית noun masculine singular construct unspecified unspecified  	O	null
8 ה ה הספר definiteArticle unspecified unspecified unspecified unspecified unspecified 0 
8 הספר ספר הספר noun masculine singular absolute unspecified unspecified  	O	null
9 לתסריטאות לתסריטאות לתסריטאות properName unspecified unspecified unspecified unspecified unspecified  	I_PERS	null
10 ב ב בתל preposition unspecified unspecified unspecified unspecified unspecified 0 
10 תל תל בתל properName unspecified unspecified unspecified unspecified unspecified  	I_LOC	null
11 אביב אביב אביב properName unspecified unspecified unspecified unspecified unspecified  	I_LOC	null
12 . . . punctuation unspecified unspecified unspecified unspecified unspecified  	O	null

0 כתב כתב כתב noun masculine singular construct unspecified unspecified  	O	null
1 שלושה CARD3 שלושה numeral masculine plural absolute unspecified unspecified  	O	null
2 ספרי ספר ספרי noun masculine plural construct unspecified unspecified  	O	null
3 שירה שירה שירה noun feminine singular absolute unspecified unspecified  	O	null
4 ב ב בערבית preposition unspecified unspecified unspecified unspecified unspecified 0 
4 ערבית ערבית בערבית properName feminine singular unspecified unspecified unspecified  	I_LOC	null
5 , , , punctuation unspecified unspecified unspecified unspecified unspecified  	O	null
6 ה ה הראשון definiteArticle unspecified unspecified unspecified unspecified unspecified 0 
6 הראשון ORD1 הראשון numeral masculine singular absolute unspecified unspecified  	I_DATE	null
7 ב ב בהם preposition unspecified unspecified unspecified unspecified unspecified  
7 הם הם בהם pronomial masculine plural unspecified 3 unspecified 0 	O	null
8 , , , punctuation unspecified unspecified unspecified unspecified unspecified  	O	null
9 ה ה הצל definiteArticle unspecified unspecified unspecified unspecified unspecified 0 
9 הצל צל הצל noun masculine singular absolute unspecified unspecified  	O	null
10 ו ו וההד conjunction unspecified unspecified unspecified unspecified unspecified 0 
10 ה ה וההד definiteArticle unspecified unspecified unspecified unspecified unspecified 0 
10 ההד הד וההד noun masculine singular absolute unspecified unspecified  	O	null
11 : : : punctuation unspecified unspecified unspecified unspecified unspecified  	O	null
12 שירה שירה שירה noun feminine singular absolute unspecified unspecified  	O	null
13 ( ( ( punctuation unspecified unspecified unspecified unspecified unspecified  	O	null
14 נצרת נצרת נצרת properName unspecified unspecified unspecified unspecified unspecified  	I_LOC	null
15 : : : punctuation unspecified unspecified unspecified unspecified unspecified  	O	null
16 אל אל אל properName unspecified unspecified unspecified unspecified unspecified  	I_LOC	null
17 - - - properName unspecified unspecified unspecified unspecified unspecified  	I_LOC	null
18 חכים חכים חכים properName unspecified unspecified unspecified unspecified unspecified  	I_LOC	null
19 , , , punctuation unspecified unspecified unspecified unspecified unspecified  	O	null
20 ###NUMBER### ###NUMBER### ###NUMBER### numeral unspecified unspecified unspecified unspecified unspecified  	I_DATE	null
21 ) ) ) punctuation unspecified unspecified unspecified unspecified unspecified  	O	null
22 . . . punctuation unspecified unspecified unspecified unspecified unspecified  	O	null

0 לאחר לאחר לאחר conjunction unspecified unspecified unspecified unspecified unspecified  	O	null
1 מכן מיכן מכן verb masculine singular unspecified 2 imperative  	O	null
2 עבר עבר עבר verb masculine singular unspecified 3 past  	O	null
3 ל ל לכתיבת preposition unspecified unspecified unspecified unspecified unspecified 0 
3 כתיבת כתיבה לכתיבת noun feminine singular construct unspecified unspecified  	O	null
4 פרוזה פרוזה פרוזה noun feminine singular absolute unspecified unspecified  	O	null
5 . . . punctuation unspecified unspecified unspecified unspecified unspecified  	O	null

0 קובץ קובץ קובץ noun masculine singular construct unspecified unspecified  	O	null
1 סיפורים סיפור סיפורים noun masculine plural absolute unspecified unspecified  	O	null
2 קצרים קצר קצרים adjective masculine plural absolute unspecified unspecified  	O	null
3 ראשון ראשון ראשון properName unspecified unspecified unspecified unspecified unspecified  	I_DATE	null
4 פרי פרי פרי properName unspecified unspecified unspecified unspecified unspecified  	I_PERS	null
5 עטו עט עטו verb masculine-and-feminine plural unspecified 3 past  	O	null
6 , , , punctuation unspecified unspecified unspecified unspecified unspecified  	O	null
7 תוספת תוספת תוספת noun feminine singular construct unspecified unspecified  	O	null
8 זמן זמן זמן noun masculine singular absolute unspecified unspecified  	O	null
9 , , , punctuation unspecified unspecified unspecified unspecified unspecified  	O	null
10 יצא יצא יצא verb masculine singular unspecified 3 past  	O	null
11 ב ב ב preposition unspecified unspecified unspecified unspecified unspecified 0 	O	null
12 - - - punctuation unspecified unspecified unspecified unspecified unspecified  	O	null
13 , , , punctuation unspecified unspecified unspecified unspecified unspecified  	O	null
14 ###NUMBER### ###NUMBER### ###NUMBER### numeral unspecified unspecified unspecified unspecified unspecified  	I_DATE	null
15 ו ו ואחריו conjunction unspecified unspecified unspecified unspecified unspecified 0 
15 אחרי אחרי ואחריו preposition unspecified unspecified unspecified unspecified unspecified  
15 ו ו ואחריו pronomial masculine singular unspecified 3 unspecified 0 	O	null
16 פורסם פורסם פורסם verb masculine singular unspecified 3 past  	O	null
17 הקובץחדר הקובץחדר הקובץחדר adjective masculine singular construct unspecified unspecified  	O	null
18 ב ב בתל preposition unspecified unspecified unspecified unspecified unspecified 0 
18 תל תל בתל properName unspecified unspecified unspecified unspecified unspecified  	I_LOC	null
19 אביב אביב אביב properName unspecified unspecified unspecified unspecified unspecified  	I_LOC	null
20 ( ( ( punctuation unspecified unspecified unspecified unspecified unspecified  	O	null
21 אל אל אל properName unspecified unspecified unspecified unspecified unspecified  	I_LOC	null
22 - - - punctuation unspecified unspecified unspecified unspecified unspecified  	O	null
23 מואססה מואססה מואססה properName unspecified unspecified unspecified unspecified unspecified  	I_LOC	null
24 אל אל אל properName unspecified unspecified unspecified unspecified unspecified  	I_LOC	null
25 - - - properName unspecified unspecified unspecified unspecified unspecified  	I_LOC	null
26 ערביה ערבי ערביה noun feminine singular absolute unspecified unspecified  	I_ORG	null
27 ל ל ללדראסאת preposition unspecified unspecified unspecified unspecified unspecified 0 
27 לדראסא לדראסא ללדראסאת noun masculine-and-feminine plural absolute unspecified unspecified  
27 י י ללדראסאת possessive masculine-and-feminine singular unspecified 1 unspecified 0 	I_ORG	null
28 ואל-נשר ואל-נשר ואל-נשר properName unspecified unspecified unspecified unspecified unspecified  	I_ORG	null
29 , , , punctuation unspecified unspecified unspecified unspecified unspecified  	O	null
30 ) ) ) punctuation unspecified unspecified unspecified unspecified unspecified  	O	null
31 . . . punctuation unspecified unspecified unspecified unspecified unspecified  	O	null
32 ###NUMBER### ###NUMBER### ###NUMBER### numeral unspecified unspecified unspecified unspecified unspecified  	I_DATE	null
33 מאז מאז מאז adverb unspecified unspecified unspecified unspecified unspecified  	O	null
34 פירסם פרסם פירסם verb masculine singular unspecified 3 past  	O	null
35 קובץ קובץ קובץ noun masculine singular construct unspecified unspecified  	O	null
36 סיפורים סיפור סיפורים noun masculine plural absolute unspecified unspecified  	O	null
37 קצרים קצר קצרים adjective masculine plural absolute unspecified unspecified  	O	null
38 ב ב ב preposition unspecified unspecified unspecified unspecified unspecified 0 	O	null
39 - - - punctuation unspecified unspecified unspecified unspecified unspecified  	O	null
40 ###NUMBER### ###NUMBER### ###NUMBER### numeral unspecified unspecified unspecified unspecified unspecified  	I_DATE	null
41 ו ו ורומן conjunction unspecified unspecified unspecified unspecified unspecified 0 
41 רומן רומן ורומן noun masculine singular absolute unspecified unspecified  	O	null
42 ב ב ב preposition unspecified unspecified unspecified unspecified unspecified 0 	I_ORG	null
43 - - - punctuation unspecified unspecified unspecified unspecified unspecified  	I_ORG	null
44 ###NUMBER### ###NUMBER### ###NUMBER### numeral unspecified unspecified unspecified unspecified unspecified  	I_DATE	null
45 . . . punctuation unspecified unspecified unspecified unspecified unspecified  	O	null

0 כתב כתב כתב noun masculine singular construct unspecified unspecified  	O	null
1 מחזה מחזה מחזה noun masculine singular absolute unspecified unspecified  	O	null
2 אחד CARD1 אחד numeral masculine singular absolute unspecified unspecified  	O	null
3 , , , punctuation unspecified unspecified unspecified unspecified unspecified  	O	null
4 אבדה אבדה אבדה noun feminine singular absolute unspecified unspecified  	O	null
5 ) ) ) punctuation unspecified unspecified unspecified unspecified unspecified  	O	null
6 , , , punctuation unspecified unspecified unspecified unspecified unspecified  	O	null
7 ה ה המשלב definiteArticle unspecified unspecified unspecified unspecified unspecified 0 
7 המשלב שילב המשלב participle masculine singular absolute any unspecified  	O	null
8 ###NUMBER### ###NUMBER### ###NUMBER### numeral unspecified unspecified unspecified unspecified unspecified  	I_DATE	null
9 בין בין בין preposition unspecified unspecified unspecified unspecified unspecified  	O	null
10 ריקוד ריקוד ריקוד noun masculine singular absolute unspecified unspecified  	O	null
11 מודרני מודרני מודרני adjective masculine singular absolute unspecified unspecified  	O	null
12 , , , punctuation unspecified unspecified unspecified unspecified unspecified  	O	null
13 שירה שירה שירה noun feminine singular absolute unspecified unspecified  	O	null
14 ווידיאו וידאו ווידיאו noun masculine unspecified absolute unspecified unspecified  	O	null
15 - - - punctuation unspecified unspecified unspecified unspecified unspecified  	O	null
16 ארט ארט ארט properName unspecified unspecified unspecified unspecified unspecified  	I_ORG	null
17 . . . punctuation unspecified unspecified unspecified unspecified unspecified  	O	null

0 היה הוא היה copula masculine singular unspecified 3 past  	O	null
1 מ מ מבוני preposition unspecified unspecified unspecified unspecified unspecified 0 
1 בוני בונה מבוני noun masculine plural construct unspecified unspecified  	O	null
2 ה ה האתר definiteArticle unspecified unspecified unspecified unspecified unspecified 0 
2 האתר אתר האתר noun masculine singular absolute unspecified unspecified  	O	null
3 ה ה המקוון definiteArticle unspecified unspecified unspecified unspecified unspecified 0 
3 המקוון מקוון המקוון adjective masculine singular absolute unspecified unspecified  	O	null
4 " " " punctuation unspecified unspecified unspecified unspecified unspecified  	O	null
5 קדיתא קדיתא קדיתא properName unspecified unspecified unspecified unspecified unspecified  	I_ORG	null
6 " " " punctuation unspecified unspecified unspecified unspecified unspecified  	O	null
7 ( ( ( punctuation unspecified unspecified unspecified unspecified unspecified  	O	null
8 ש ש שהקים relativizer/subordinatingConjunction unspecified unspecified unspecified unspecified unspecified 0 
8 הקים הקים שהקים verb masculine singular unspecified 3 past  	O	null
9 עלא עלא עלא properName unspecified unspecified unspecified unspecified unspecified  	I_PERS	null
10 חליחל חליחל חליחל properName unspecified unspecified unspecified unspecified unspecified  	I_PERS	null
11 ) ) ) punctuation unspecified unspecified unspecified unspecified unspecified  	O	null
12 ו ו ועורך conjunction unspecified unspecified unspecified unspecified unspecified 0 
12 עורך ערך ועורך verb masculine singular unspecified any beinoni  	O	null
13 את את את at-preposition unspecified unspecified unspecified unspecified unspecified  	O	null
14 ה ה הפינה definiteArticle unspecified unspecified unspecified unspecified unspecified 0 
14 הפינה פינה הפינה noun feminine singular absolute unspecified unspecified  	O	null
15 על על על preposition unspecified unspecified unspecified unspecified unspecified  	O	null
16 כתיבת כתיבה כתיבתם noun feminine singular absolute unspecified unspecified  
16 ם ם כתיבתם possessive masculine plural unspecified 3 unspecified 0 	O	null
17 של של של shel-preposition unspecified unspecified unspecified unspecified unspecified  	O	null
18 הומוסקסואלים הומוסקסואל הומוסקסואלים noun masculine plural absolute unspecified unspecified  	O	null
19 . . . punctuation unspecified unspecified unspecified unspecified unspecified  	O	null

0 ה ה החלק definiteArticle unspecified unspecified unspecified unspecified unspecified 0 
0 החלק חלק החלק noun masculine singular absolute unspecified unspecified  	O	null
1 ה ה העיקרי definiteArticle unspecified unspecified unspecified unspecified unspecified 0 
1 העיקרי עיקרי העיקרי adjective masculine singular absolute unspecified unspecified  	O	null
2 של של של shel-preposition unspecified unspecified unspecified unspecified unspecified  	O	null
3 הקובץחדר הקובץחדר הקובץחדר adjective masculine singular construct unspecified unspecified  	O	null
4 ב ב בתל preposition unspecified unspecified unspecified unspecified unspecified 0 
4 תל תל בתל properName unspecified unspecified unspecified unspecified unspecified  	I_LOC	null
5 אביב אביב אביב properName unspecified unspecified unspecified unspecified unspecified  	I_LOC	null
6 בנוי בנוי בנוי adjective masculine singular absolute unspecified unspecified  	O	null
7 כ כ כמחזור preposition unspecified unspecified unspecified unspecified unspecified 0 
7 מחזור מחזור כמחזור noun masculine singular construct unspecified unspecified  	O	null
8 סיפורים סיפור סיפורים noun masculine plural absolute unspecified unspecified  	O	null
9 . . . punctuation unspecified unspecified unspecified unspecified unspecified  	O	null

0 הוא הוא הוא pronoun masculine singular unspecified 3 unspecified  	O	null
1 כולל כלל כולל verb masculine singular unspecified any beinoni  	O	null
2 שבעה CARD7 שבעה numeral masculine plural absolute unspecified unspecified  	O	null
3 סיפורים סיפור סיפורים noun masculine plural absolute unspecified unspecified  	O	null
4 קצרים קצר קצרים adjective masculine plural absolute unspecified unspecified  	O	null
5 , , , punctuation unspecified unspecified unspecified unspecified unspecified  	O	null
6 ה ה המחוברים definiteArticle unspecified unspecified unspecified unspecified unspecified 0 
6 המחוברים חובר המחוברים participle masculine plural absolute any unspecified  	O	null
7 זה זה זה pronoun masculine singular unspecified 3 unspecified  	O	null
8 ל ל לזה preposition unspecified unspecified unspecified unspecified unspecified 0 
8 זה זה לזה pronoun masculine singular unspecified 3 unspecified  	O	null
9 באמצעות באמצעות באמצעות preposition unspecified unspecified unspecified unspecified unspecified  	O	null
10 זמן זמן זמן noun masculine singular construct unspecified unspecified  	O	null
11 - - - punctuation unspecified unspecified unspecified unspecified unspecified  	O	null
12 מרחב מרחב מרחב noun masculine singular absolute unspecified unspecified  	O	null
13 דומה דומה דומה adjective masculine singular absolute unspecified unspecified  	O	null
14 : : : punctuation unspecified unspecified unspecified unspecified unspecified  	O	null
15 שהייה שהייה שהייה noun feminine singular absolute unspecified unspecified  	O	null
16 ב ב בבית preposition unspecified unspecified unspecified unspecified unspecified 0 
16 בית בית בבית noun masculine singular construct unspecified unspecified  	O	null
17 מלון מלון מלון noun masculine singular absolute unspecified unspecified  	O	null
18 ב ב בעת preposition unspecified unspecified unspecified unspecified unspecified 0 
18 עת עת בעת noun feminine singular construct unspecified unspecified  	O	null
19 מלחמת מלחמה מלחמת noun feminine singular construct unspecified unspecified  	O	null
20 לבנון לבנון לבנון properName unspecified unspecified unspecified unspecified unspecified  	I_LOC	null
21 ה ה השנייה definiteArticle unspecified unspecified unspecified unspecified unspecified 0 
21 השנייה ORD2 השנייה numeral feminine singular absolute unspecified unspecified  	O	null
22 . . . punctuation unspecified unspecified unspecified unspecified unspecified  	O	null

0 כל כול כל quantifier unspecified unspecified construct unspecified unspecified  	O	null
1 סיפור סיפור סיפור noun masculine singular absolute unspecified unspecified  	O	null
2 מספר מספר מספר verb masculine singular unspecified 3 past  	O	null
3 על על על preposition unspecified unspecified unspecified unspecified unspecified  	O	null
4 אדםשנקלע אדםשנקלע אדםשנקלע preposition unspecified unspecified unspecified unspecified unspecified  	O	null
5 ב ב בחדר preposition unspecified unspecified unspecified unspecified unspecified 0 
5 חדר חדר בחדר noun masculine singular construct unspecified unspecified  	O	null
6 במלוןבעירכלשהי במלוןבעירכלשהי במלוןבעירכלשהי properName unspecified unspecified unspecified unspecified unspecified  	O	null
7 ב ב בעולם preposition unspecified unspecified unspecified unspecified unspecified 0 
7 ה ה בעולם definiteArticle unspecified unspecified unspecified unspecified unspecified 0 
7 העולם עולם בעולם noun masculine singular absolute unspecified unspecified  	O	null
8 , , , punctuation unspecified unspecified unspecified unspecified unspecified  	O	null
9 ל ל לרבות preposition unspecified unspecified unspecified unspecified unspecified 0 
9 רבות רב לרבות noun feminine plural construct unspecified unspecified  	O	null
10 תל תל תל properName unspecified unspecified unspecified unspecified unspecified  	I_LOC	null
11 אביב אביב אביב properName unspecified unspecified unspecified unspecified unspecified  	I_LOC	null
12 , , , punctuation unspecified unspecified unspecified unspecified unspecified  	O	null
13 עמאן עמאן עמאן properName unspecified unspecified unspecified unspecified unspecified  	I_LOC	null
14 , , , punctuation unspecified unspecified unspecified unspecified unspecified  	O	null
15 ירושלים ירושלים ירושלים properName unspecified unspecified unspecified unspecified unspecified  	I_LOC	null
16 , , , punctuation unspecified unspecified unspecified unspecified unspecified  	O	null
17 ו ו ועיר conjunction unspecified unspecified unspecified unspecified unspecified 0 
17 עיר עיר ועיר noun feminine singular absolute unspecified unspecified  	O	null
18 נידחת נידח נידחת adjective feminine singular absolute unspecified unspecified  	O	null
19 ב ב במדינת preposition unspecified unspecified unspecified unspecified unspecified 0 
19 מדינת מדינה במדינת noun feminine singular construct unspecified unspecified  	O	null
20 יוטה יוטה יוטה noun feminine singular absolute unspecified unspecified  	O	null
21 ב ב בארצות preposition unspecified unspecified unspecified unspecified unspecified 0 
21 ארצות ארץ בארצות properName unspecified unspecified unspecified unspecified unspecified  	I_LOC	null
22 הברית ברית הברית properName unspecified unspecified unspecified unspecified unspecified  	I_LOC	null
23 . . . punctuation unspecified unspecified unspecified unspecified unspecified  	O	null

0 שני CARD2 שני numeral masculine dual construct unspecified unspecified  	O	null
1 פרקים פארק פרקים noun masculine plural absolute unspecified unspecified  	O	null
2 מתוך מתוך מתוך preposition unspecified unspecified unspecified unspecified unspecified  	O	null
3 חדר חדר חדר noun masculine singular absolute unspecified unspecified  	O	null
4 ב ב בתל preposition unspecified unspecified unspecified unspecified unspecified 0 
4 תל תל בתל properName unspecified unspecified unspecified unspecified unspecified  	I_LOC	null
5 אביבתורגמו אביבתורגמו אביבתורגמו properName unspecified unspecified unspecified unspecified unspecified  	I_LOC	null
6 ל ל לעברית preposition unspecified unspecified unspecified unspecified unspecified 0 
6 עברית עברית לעברית properName feminine singular unspecified unspecified unspecified  	I_LOC	null
7 כאילו כאילו כאילו conjunction unspecified unspecified unspecified unspecified unspecified  	O	null
8 היו הוא היו copula masculine plural unspecified 2 imperative  	O	null
9 סיפורים סיפור סיפורים noun masculine plural absolute unspecified unspecified  	O	null
10 קצרים קצר קצרים adjective masculine plural absolute unspecified unspecified  	O	null
11 עצמאיים עצמאי עצמאיים adjective masculine plural absolute unspecified unspecified  	O	null
12 ; ; ; punctuation unspecified unspecified unspecified unspecified unspecified  	O	null
13 כלומר כלומר כלומר conjunction unspecified unspecified unspecified unspecified unspecified  	O	null
14 , , , punctuation unspecified unspecified unspecified unspecified unspecified  	O	null
15 ללא ללא ללא preposition unspecified unspecified unspecified unspecified unspecified  	O	null
16 ה ה ההקשר definiteArticle unspecified unspecified unspecified unspecified unspecified 0 
16 ההקשר הקשר ההקשר noun masculine singular absolute unspecified unspecified  	O	null
17 ה ה הסיפורי definiteArticle unspecified unspecified unspecified unspecified unspecified 0 
17 הסיפורי סיפורי הסיפורי adjective masculine singular absolute unspecified unspecified  	O	null
18 - - - punctuation unspecified unspecified unspecified unspecified unspecified  	O	null
19 מחזורי מחזורי מחזורי adjective masculine singular absolute unspecified unspecified  	O	null
20 . . . punctuation unspecified unspecified unspecified unspecified unspecified  	O	null

0 ה ה הראשון definiteArticle unspecified unspecified unspecified unspecified unspecified 0 
0 הראשון ORD1 הראשון numeral masculine singular absolute unspecified unspecified  	O	null
1 הוא הוא הוא pronoun masculine singular unspecified 3 unspecified  	O	null
2 ה ה הסיפור definiteArticle unspecified unspecified unspecified unspecified unspecified 0 
2 הסיפור סיפור הסיפור noun masculine singular absolute unspecified unspecified  	O	null
3 " " " punctuation unspecified unspecified unspecified unspecified unspecified  	O	null
4 כאילו כאילו כאילו conjunction unspecified unspecified unspecified unspecified unspecified  	O	null
5 מדינה מדינה מדינה noun feminine singular absolute unspecified unspecified  	O	null
6 אחרת אחר אחרת adjective feminine singular absolute unspecified unspecified  	O	null
7 " " " punctuation unspecified unspecified unspecified unspecified unspecified  	O	null
8 . . . punctuation unspecified unspecified unspecified unspecified unspecified  	O	null

0 גיבור גיבור גיבורו noun masculine singular absolute unspecified unspecified  
0 ו ו גיבורו possessive masculine singular unspecified 3 unspecified 0 	O	null
1 , , , punctuation unspecified unspecified unspecified unspecified unspecified  	O	null
2 ש ש ששמו relativizer/subordinatingConjunction unspecified unspecified unspecified unspecified unspecified 0 
2 שמו שם ששמו verb masculine-and-feminine plural unspecified 3 past  	O	null
3 ג'אד ג'אד ג'אד properName unspecified unspecified unspecified unspecified unspecified  	I_PERS	null
4 , , , punctuation unspecified unspecified unspecified unspecified unspecified  	O	null
5 מחליט החליט מחליט verb masculine singular unspecified any beinoni  	O	null
6 ש ש שירושלים relativizer/subordinatingConjunction unspecified unspecified unspecified unspecified unspecified 0 
6 ירושלים ירושלים שירושלים properName unspecified unspecified unspecified unspecified unspecified  	I_LOC	null
7 היא הוא היא pronoun feminine singular unspecified 3 unspecified  	O	null
8 ה ה המקום definiteArticle unspecified unspecified unspecified unspecified unspecified 0 
8 המקום מקום המקום noun masculine singular absolute unspecified unspecified  	O	null
9 ה ה הראוי definiteArticle unspecified unspecified unspecified unspecified unspecified 0 
9 הראוי ראוי הראוי adjective masculine singular absolute unspecified unspecified  	O	null
10 לבצע ביצע לבצע verb unspecified unspecified unspecified unspecified infinitive  	O	null
11 ב ב בו preposition unspecified unspecified unspecified unspecified unspecified  
11 ו ו בו pronomial masculine singular unspecified 3 unspecified 0 	O	null
12 את את את at-preposition unspecified unspecified unspecified unspecified unspecified  	O	null
13 תוכנית תוכנייה תוכניתו noun feminine singular absolute unspecified unspecified  
13 ו ו תוכניתו possessive masculine singular unspecified 3 unspecified 0 	O	null
14 : : : punctuation unspecified unspecified unspecified unspecified unspecified  	O	null
15 להתאבד התאבד להתאבד verb unspecified unspecified unspecified unspecified infinitive  	O	null
16 . . . punctuation unspecified unspecified unspecified unspecified unspecified  	O	null

0 ו ו ואולם conjunction unspecified unspecified unspecified unspecified unspecified 0 
0 אולם אולם ואולם conjunction unspecified unspecified unspecified unspecified unspecified  	O	null
1 , , , punctuation unspecified unspecified unspecified unspecified unspecified  	O	null
2 למרות למרות למרות conjunction unspecified unspecified unspecified unspecified unspecified  	O	null
3 ה ה הגרעין definiteArticle unspecified unspecified unspecified unspecified unspecified 0 
3 הגרעין גרעין הגרעין noun masculine singular absolute unspecified unspecified  	O	null
4 ה ה הדרמטי definiteArticle unspecified unspecified unspecified unspecified unspecified 0 
4 הדרמטי דרמטי הדרמטי adjective masculine singular absolute unspecified unspecified  	O	null
5 , , , punctuation unspecified unspecified unspecified unspecified unspecified  	O	null
6 ה ה העלילה definiteArticle unspecified unspecified unspecified unspecified unspecified 0 
6 העלילה עלילה העלילה noun feminine singular absolute unspecified unspecified  	O	null
7 אינה הוא אינה copula feminine singular unspecified 3 beinoni  	O	null
8 מתמקדת התמקד מתמקדת verb feminine singular unspecified any beinoni  	O	null
9 ב ב בגורלו preposition unspecified unspecified unspecified unspecified unspecified 0 
9 גורל גורל בגורלו noun masculine singular absolute unspecified unspecified  
9 ו ו בגורלו possessive masculine singular unspecified 3 unspecified 0 	O	null
10 של של של shel-preposition unspecified unspecified unspecified unspecified unspecified  	O	null
11 ה ה הגיבור definiteArticle unspecified unspecified unspecified unspecified unspecified 0 
11 הגיבור גיבור הגיבור noun masculine singular absolute unspecified unspecified  	O	null
12 אלא אלא אלא conjunction unspecified unspecified unspecified unspecified unspecified  	O	null
13 ב ב בדרמה preposition unspecified unspecified unspecified unspecified unspecified 0 
13 ה ה בדרמה definiteArticle unspecified unspecified unspecified unspecified unspecified 0 
13 הדרמה דרמה בדרמה noun feminine singular absolute unspecified unspecified  	O	null
14 של של של shel-preposition unspecified unspecified unspecified unspecified unspecified  	O	null
15 ה ה המקום definiteArticle unspecified unspecified unspecified unspecified unspecified 0 
15 המקום מקום המקום noun masculine singular absolute unspecified unspecified  	O	null
16 , , , punctuation unspecified unspecified unspecified unspecified unspecified  	O	null
17 ה ה הנתפש definiteArticle unspecified unspecified unspecified unspecified unspecified 0 
17 הנתפש נתפש הנתפש participle masculine singular absolute any unspecified  	O	null
18 כ כ כגיבור preposition unspecified unspecified unspecified unspecified unspecified 0 
18 גיבור גיבור כגיבור properName masculine singular unspecified unspecified unspecified  	I_PERS	null
19 ה ה האמיתי definiteArticle unspecified unspecified unspecified unspecified unspecified 0 
19 האמיתי אמיתי האמיתי adjective masculine singular absolute unspecified unspecified  	O	null
20 של של של shel-preposition unspecified unspecified unspecified unspecified unspecified  	O	null
21 ה ה הסיפור definiteArticle unspecified unspecified unspecified unspecified unspecified 0 
21 הסיפור סיפור הסיפור noun masculine singular absolute unspecified unspecified  	O	null
22 : : : punctuation unspecified unspecified unspecified unspecified unspecified  	O	null
23 " " " punctuation unspecified unspecified unspecified unspecified unspecified  	I_LOC	null
24 כביש כביש כביש noun masculine singular construct unspecified unspecified  	I_LOC	null
25 תל תל תל properName unspecified unspecified unspecified unspecified unspecified  	I_LOC	null
26 אביב אביב אביב properName unspecified unspecified unspecified unspecified unspecified  	I_LOC	null
27 - - - properName unspecified unspecified unspecified unspecified unspecified  	I_LOC	null
28 ירושלים ירושלים ירושלים properName unspecified unspecified unspecified unspecified unspecified  	I_LOC	null
29 השתנה השתנה השתנה verb masculine singular unspecified 3 past  	O	null
30 ככל ככל ככל conjunction unspecified unspecified unspecified unspecified unspecified  	O	null
31 ש ש שהרחיק relativizer/subordinatingConjunction unspecified unspecified unspecified unspecified unspecified 0 
31 הרחיק הרחיק שהרחיק verb masculine singular unspecified 3 past  	O	null
32 מזרחה מזרחה מזרחה adverb unspecified unspecified unspecified unspecified unspecified  	O	null
33 , , , punctuation unspecified unspecified unspecified unspecified unspecified  	O	null
34 במיוחד במיוחד במיוחד adverb unspecified unspecified unspecified unspecified unspecified  	O	null
35 בבאב בבאב בבאב properName unspecified unspecified unspecified unspecified unspecified  	I_PERS	null
36 אל אל אל properName unspecified unspecified unspecified unspecified unspecified  	I_PERS	null
37 - - - properName unspecified unspecified unspecified unspecified unspecified  	I_PERS	null
38 אד אד ואד properName unspecified unspecified unspecified unspecified unspecified  	I_PERS	null
39 ה ה המפורסם definiteArticle unspecified unspecified unspecified unspecified unspecified 0 
39 המפורסם פורסם המפורסם participle masculine singular absolute any unspecified  	I_ORG	null
40 , , , punctuation unspecified unspecified unspecified unspecified unspecified  	O	null
41 שם שם שם adverb unspecified unspecified unspecified unspecified unspecified  	O	null
42 הופך הפך הופך verb masculine singular unspecified any beinoni  	I_LOC	null
43 ה ה הכביש definiteArticle unspecified unspecified unspecified unspecified unspecified 0 
43 הכביש כביש הכביש noun masculine singular absolute unspecified unspecified  	I_LOC	null
44 ה ה הישר definiteArticle unspecified unspecified unspecified unspecified unspecified 0 
44 הישר ישר הישר noun masculine singular absolute unspecified unspecified  	I_LOC	null
45 , , , punctuation unspecified unspecified unspecified unspecified unspecified  	O	null
46 ה ה הצחיח definiteArticle unspecified unspecified unspecified unspecified unspecified 0 
46 הצחיח צחיח הצחיח adjective masculine singular absolute unspecified unspecified  	O	null
47 , , , punctuation unspecified unspecified unspecified unspecified unspecified  	O	null
48 ו ו והתלוש conjunction unspecified unspecified unspecified unspecified unspecified 0 
48 ה ה והתלוש definiteArticle unspecified unspecified unspecified unspecified unspecified 0 
48 התלוש תלוש והתלוש noun masculine singular absolute unspecified unspecified  	O	null
49 מ מ מכל preposition unspecified unspecified unspecified unspecified unspecified 0 
49 כל כול מכל quantifier unspecified unspecified construct unspecified unspecified  	O	null
50 משמעות משמעות משמעות noun feminine singular construct unspecified unspecified  	O	null
51 , , , punctuation unspecified unspecified unspecified unspecified unspecified  	O	null
52 ל ל לאוסף preposition unspecified unspecified unspecified unspecified unspecified 0 
52 אוסף אוסף לאוסף noun masculine singular construct unspecified unspecified  	O	null
53 גדול גדול גדול adjective masculine singular absolute unspecified unspecified  	O	null
54 של של של shel-preposition unspecified unspecified unspecified unspecified unspecified  	O	null
55 הרים הר הרים noun masculine plural absolute unspecified unspecified  	O	null
56 , , , punctuation unspecified unspecified unspecified unspecified unspecified  	O	null
57 של של של shel-preposition unspecified unspecified unspecified unspecified unspecified  	O	null
58 סודות סוד סודות noun masculine plural construct unspecified unspecified  	O	null
59 , , , punctuation unspecified unspecified unspecified unspecified unspecified  	O	null
60 של של של shel-preposition unspecified unspecified unspecified unspecified unspecified  	O	null
61 סמלים סמל סמלים noun masculine plural absolute unspecified unspecified  	O	null
62 , , , punctuation unspecified unspecified unspecified unspecified unspecified  	O	null
63 של של של shel-preposition unspecified unspecified unspecified unspecified unspecified  	O	null
64 חרדה חרד חרדה adjective feminine singular absolute unspecified unspecified  	O	null
65 , , , punctuation unspecified unspecified unspecified unspecified unspecified  	O	null
66 ו ו ושל conjunction unspecified unspecified unspecified unspecified unspecified 0 
66 של של ושל shel-preposition unspecified unspecified unspecified unspecified unspecified  	O	null
67 ציפייה ציפייה ציפייה noun feminine singular absolute unspecified unspecified  	O	null
68 – – – punctuation unspecified unspecified unspecified unspecified unspecified  	O	null
69 תולדה תולדה תולדה noun feminine singular absolute unspecified unspecified  	O	null
70 בת בת בת noun feminine singular construct unspecified unspecified  	O	null
71 שנים שנה שנים noun feminine plural absolute unspecified unspecified  	O	null
72 , , , punctuation unspecified unspecified unspecified unspecified unspecified  	O	null
73 אלפי אילף אלפי verb feminine singular unspecified 2 imperative  	O	null
74 ש ש שנים..."(מערבית: relativizer/subordinatingConjunction unspecified unspecified unspecified unspecified unspecified 0 
74 נים..."(מערבית: נים..."(מערבית: שנים..."(מערבית: noun masculine singular absolute unspecified unspecified  	O	null
75 עלא עלא עלא properName unspecified unspecified unspecified unspecified unspecified  	I_PERS	null
76 חליחל חליחל חליחל properName unspecified unspecified unspecified unspecified unspecified  	I_PERS	null
77 , , , punctuation unspecified unspecified unspecified unspecified unspecified  	O	null
78 מטעם מטעם מטעם preposition unspecified unspecified unspecified unspecified unspecified  	O	null
79 , , , punctuation unspecified unspecified unspecified unspecified unspecified  	O	null
80 ###NUMBER### ###NUMBER### ###NUMBER### numeral unspecified unspecified unspecified unspecified unspecified  	O	null
81 ###NUMBER### ###NUMBER### ###NUMBER### numeral unspecified unspecified unspecified unspecified unspecified  	O	null
82 - - - punctuation unspecified unspecified unspecified unspecified unspecified  	O	null
83 ###NUMBER### ###NUMBER### ###NUMBER### numeral unspecified unspecified unspecified unspecified unspecified  	O	null
84 ) ) ) punctuation unspecified unspecified unspecified unspecified unspecified  	O	null
85 . . . punctuation unspecified unspecified unspecified unspecified unspecified  	O	null

0 לבסוף לבסוף לבסוף adverb unspecified unspecified unspecified unspecified unspecified  	O	null
1 נדמה נדמה נדמה verb masculine singular unspecified 3 past  	O	null
2 ש ש שזהו relativizer/subordinatingConjunction unspecified unspecified unspecified unspecified unspecified 0 
2 זהו זהו שזהו pronoun masculine singular unspecified 3 unspecified  	O	null
3 ה ה המקום definiteArticle unspecified unspecified unspecified unspecified unspecified 0 
3 המקום מקום המקום noun masculine singular absolute unspecified unspecified  	O	null
4 עצמו עצם עצמו verb masculine-and-feminine plural unspecified 3 past  	O	null
5 ש ש שמציל relativizer/subordinatingConjunction unspecified unspecified unspecified unspecified unspecified 0 
5 מציל הציל שמציל verb masculine singular unspecified any beinoni  	O	null
6 את את את at-preposition unspecified unspecified unspecified unspecified unspecified  	O	null
7 ג'אד ג'אד ג'אד properName unspecified unspecified unspecified unspecified unspecified  	I_PERS	null
8 מ מ מלהגשים preposition unspecified unspecified unspecified unspecified unspecified 0 
8 להגשים הגשים מלהגשים verb unspecified unspecified unspecified unspecified infinitive  	O	null
9 את את את at-preposition unspecified unspecified unspecified unspecified unspecified  	O	null
10 תוכנית תוכנייה תוכניתו noun feminine singular absolute unspecified unspecified  
10 ו ו תוכניתו possessive masculine singular unspecified 3 unspecified 0 	O	null
11 , , , punctuation unspecified unspecified unspecified unspecified unspecified  	O	null
12 כאשר כאשר כאשר conjunction unspecified unspecified unspecified unspecified unspecified  	O	null
13 ב ב במדרגות preposition unspecified unspecified unspecified unspecified unspecified 0 
13 ה ה במדרגות definiteArticle unspecified unspecified unspecified unspecified unspecified 0 
13 המדרגות מדרגה במדרגות noun feminine plural absolute unspecified unspecified  	O	null
14 ב ב ברובע preposition unspecified unspecified unspecified unspecified unspecified 0 
14 ה ה ברובע definiteArticle unspecified unspecified unspecified unspecified unspecified 0 
14 הרובע רובע ברובע noun masculine singular absolute unspecified unspecified  	O	null
15 ה ה הנוצרי definiteArticle unspecified unspecified unspecified unspecified unspecified 0 
15 הנוצרי נוצרי הנוצרי adjective masculine singular absolute unspecified unspecified  	O	null
16 ב ב בכיוון preposition unspecified unspecified unspecified unspecified unspecified 0 
16 ה ה בכיוון definiteArticle unspecified unspecified unspecified unspecified unspecified 0 
16 הכיוון כיוון בכיוון noun masculine singular absolute unspecified unspecified  	O	null
17 ב ב באב preposition unspecified unspecified unspecified unspecified unspecified 0 
17 ה ה באב definiteArticle unspecified unspecified unspecified unspecified unspecified 0 
17 האב אב באב noun masculine singular absolute unspecified unspecified  	O	null
18 אל אל אל properName unspecified unspecified unspecified unspecified unspecified  	I_PERS	null
19 - - - properName unspecified unspecified unspecified unspecified unspecified  	I_PERS	null
20 סאהרה סאהרה סאהרה properName unspecified unspecified unspecified unspecified unspecified  	I_PERS	null
21 , , , punctuation unspecified unspecified unspecified unspecified unspecified  	O	null
22 על על על preposition unspecified unspecified unspecified unspecified unspecified  	O	null
23 רקע רקע רקע noun masculine singular construct unspecified unspecified  	O	null
24 חדשות חדשה חדשות noun feminine plural absolute unspecified unspecified  	O	null
25 ב ב בטלוויזיה preposition unspecified unspecified unspecified unspecified unspecified 0 
25 ה ה בטלוויזיה definiteArticle unspecified unspecified unspecified unspecified unspecified 0 
25 הטלוויזיה טלוויזיה בטלוויזיה noun feminine singular absolute unspecified unspecified  	O	null
26 ה ה המבשרות definiteArticle unspecified unspecified unspecified unspecified unspecified 0 
26 המבשרות בישר המבשרות participle feminine plural absolute any unspecified  	O	null
27 על על על preposition unspecified unspecified unspecified unspecified unspecified  	O	null
28 מלחמה מלחמה מלחמה noun feminine singular absolute unspecified unspecified  	O	null
29 ה ה הממשמשת definiteArticle unspecified unspecified unspecified unspecified unspecified 0 
29 הממשמשת משמש הממשמשת participle feminine singular absolute any unspecified  	O	null
30 ו ו ובאה conjunction unspecified unspecified unspecified unspecified unspecified 0 
30 באה בא ובאה verb feminine singular unspecified any beinoni  	O	null
31 ב ב בגבול preposition unspecified unspecified unspecified unspecified unspecified 0 
31 גבול גבול בגבול noun masculine singular construct unspecified unspecified  	O	null
32 ישראל ישראל ישראל properName unspecified unspecified unspecified unspecified unspecified  	I_LOC	null
33 - - - properName unspecified unspecified unspecified unspecified unspecified  	I_LOC	null
34 לבנון לבנון לבנון properName unspecified unspecified unspecified unspecified unspecified  	I_LOC	null
35 , , , punctuation unspecified unspecified unspecified unspecified unspecified  	O	null
36 נבעט נבעט נבעט verb masculine singular unspecified 3 past  	O	null
37 כדור כדור כדור noun masculine singular absolute unspecified unspecified  	O	null
38 לעבר לעבר לעברו preposition unspecified unspecified unspecified unspecified unspecified  
38 ו ו לעברו pronomial masculine singular unspecified 3 unspecified 0 	O	null
39 , , , punctuation unspecified unspecified unspecified unspecified unspecified  	O	null
40 פוגע פגע פוגע verb masculine singular unspecified any beinoni  	O	null
41 ב ב בבקבוק preposition unspecified unspecified unspecified unspecified unspecified 0 
41 בקבוק בקבוק בבקבוק noun masculine singular construct unspecified unspecified  	O	null
42 ה ה התרופות definiteArticle unspecified unspecified unspecified unspecified unspecified 0 
42 התרופות תרופה התרופות noun feminine plural absolute unspecified unspecified  	O	null
43 ש ש שתיכנן relativizer/subordinatingConjunction unspecified unspecified unspecified unspecified unspecified 0 
43 תיכנן תכנן שתיכנן verb masculine singular unspecified 3 past  	O	null
44 לבלוע בלע לבלוע verb unspecified unspecified unspecified unspecified infinitive  	O	null
45 , , , punctuation unspecified unspecified unspecified unspecified unspecified  	O	null
46 ו ו ומנפץ conjunction unspecified unspecified unspecified unspecified unspecified 0 
46 מנפץ ניפץ ומנפץ verb masculine singular unspecified any beinoni  	O	null
47 את את אותו at-preposition unspecified unspecified unspecified unspecified unspecified  
47 ו ו אותו pronomial masculine singular unspecified 3 unspecified 0 	O	null
48 . . . punctuation unspecified unspecified unspecified unspecified unspecified  	O	null

0 ה ה הסיפור definiteArticle unspecified unspecified unspecified unspecified unspecified 0 
0 הסיפור סיפור הסיפור noun masculine singular absolute unspecified unspecified  	O	null
1 ה ה השני definiteArticle unspecified unspecified unspecified unspecified unspecified 0 
1 השני ORD2 השני numeral masculine singular absolute unspecified unspecified  	O	null
2 , , , punctuation unspecified unspecified unspecified unspecified unspecified  	O	null
3 " " " punctuation unspecified unspecified unspecified unspecified unspecified  	O	null
4 עולא עולא עולא noun masculine singular absolute unspecified unspecified  	O	null
5 " " " punctuation unspecified unspecified unspecified unspecified unspecified  	O	null
6 , , , punctuation unspecified unspecified unspecified unspecified unspecified  	O	null
7 גם גם גם conjunction unspecified unspecified unspecified unspecified unspecified  	O	null
8 הוא הוא הוא pronoun masculine singular unspecified 3 unspecified  	O	null
9 פרק פרק פרק verb masculine singular unspecified 3 past  	O	null
10 מ מ מאותו preposition unspecified unspecified unspecified unspecified unspecified 0 
10 אותו אותו מאותו quantifier unspecified unspecified construct unspecified unspecified  	O	null
11 ה ה הספר definiteArticle unspecified unspecified unspecified unspecified unspecified 0 
11 הספר ספר הספר noun masculine singular absolute unspecified unspecified  	O	null
12 , , , punctuation unspecified unspecified unspecified unspecified unspecified  	O	null
13 ו ו ובו conjunction unspecified unspecified unspecified unspecified unspecified 0 
13 ב ב ובו preposition unspecified unspecified unspecified unspecified unspecified  
13 ו ו ובו pronomial masculine singular unspecified 3 unspecified 0 	O	null
14 נפרשת נפרש נפרשת verb feminine singular unspecified any beinoni  	O	null
15 סצנה סצנה סצנה noun feminine singular absolute unspecified unspecified  	O	null
16 שבה שב שבה verb feminine singular unspecified 3 past  	O	null
17 אישה איש אישה noun feminine singular absolute unspecified unspecified  	O	null
18 ב ב בשם preposition unspecified unspecified unspecified unspecified unspecified 0 
18 שם שם בשם noun masculine singular construct unspecified unspecified  	O	null
19 עולא עולא עולא noun masculine singular absolute unspecified unspecified  	O	null
20 מחכה חיכה מחכה verb masculine singular unspecified any beinoni  	O	null
21 ל ל למאהבה preposition unspecified unspecified unspecified unspecified unspecified 0 
21 מאהב מאהב למאהבה noun masculine singular absolute unspecified unspecified  
21 ה ה למאהבה possessive feminine singular unspecified 3 unspecified 0 	O	null
22 ב ב במלון preposition unspecified unspecified unspecified unspecified unspecified 0 
22 מלון מלון במלון noun masculine singular absolute unspecified unspecified  	O	null
23 ב ב ברמאללה preposition unspecified unspecified unspecified unspecified unspecified 0 
23 רמאללה רמאללה ברמאללה properName unspecified unspecified unspecified unspecified unspecified  	I_LOC	null
24 . . . punctuation unspecified unspecified unspecified unspecified unspecified  	O	null

0 גם גם גם conjunction unspecified unspecified unspecified unspecified unspecified  	O	null
1 ב ב בסיפור preposition unspecified unspecified unspecified unspecified unspecified 0 
1 סיפור סיפור בסיפור noun masculine singular absolute unspecified unspecified  	O	null
2 זה זה זה pronoun masculine singular unspecified 3 unspecified  	O	null
3 ה ה המקום definiteArticle unspecified unspecified unspecified unspecified unspecified 0 
3 המקום מקום המקום noun masculine singular absolute unspecified unspecified  	O	null
4 , , , punctuation unspecified unspecified unspecified unspecified unspecified  	O	null
5 כאן כאן כאן adverb unspecified unspecified unspecified unspecified unspecified  	O	null
6 ה ה המלון definiteArticle unspecified unspecified unspecified unspecified unspecified 0 
6 המלון מלון המלון noun masculine singular absolute unspecified unspecified  	O	null
7 ה ה המסוים definiteArticle unspecified unspecified unspecified unspecified unspecified 0 
7 המסוים מסוים המסוים adjective masculine singular absolute unspecified unspecified  	O	null
8 , , , punctuation unspecified unspecified unspecified unspecified unspecified  	O	null
9 מבטא ביטא מבטא verb masculine singular unspecified any beinoni  	O	null
10 את את את at-preposition unspecified unspecified unspecified unspecified unspecified  	O	null
11 ה ה התחושה definiteArticle unspecified unspecified unspecified unspecified unspecified 0 
11 התחושה תחושה התחושה noun feminine singular absolute unspecified unspecified  	O	null
12 ה ה הכללית definiteArticle unspecified unspecified unspecified unspecified unspecified 0 
12 הכללית כללי הכללית adjective feminine singular absolute unspecified unspecified  	O	null
13 של של של shel-preposition unspecified unspecified unspecified unspecified unspecified  	O	null
14 ה ה הסיפור definiteArticle unspecified unspecified unspecified unspecified unspecified 0 
14 הסיפור סיפור הסיפור noun masculine singular absolute unspecified unspecified  	O	null
15 . . . punctuation unspecified unspecified unspecified unspecified unspecified  	O	null

0 ה ה המלון definiteArticle unspecified unspecified unspecified unspecified unspecified 0 
0 המלון מלון המלון noun masculine singular absolute unspecified unspecified  	O	null
1 מתואר תואר מתואר verb masculine singular unspecified any beinoni  	O	null
2 כ כ כמקום preposition unspecified unspecified unspecified unspecified unspecified 0 
2 מקום מקום כמקום noun masculine singular absolute unspecified unspecified  	O	null
3 ש ש ש relativizer/subordinatingConjunction unspecified unspecified unspecified unspecified unspecified 0 	O	null
4 " " " punctuation unspecified unspecified unspecified unspecified unspecified  	O	null
5 כול כול כולו quantifier unspecified unspecified unspecified unspecified unspecified  
5 ו ו כולו pronomial masculine singular unspecified 3 unspecified 0 	O	null
6 התנצלות התנצלות התנצלות noun feminine singular absolute unspecified unspecified  	O	null
7 ו ו וחרטה conjunction unspecified unspecified unspecified unspecified unspecified 0 
7 חרטה חרטה וחרטה noun feminine singular absolute unspecified unspecified  	O	null
8 על על על preposition unspecified unspecified unspecified unspecified unspecified  	O	null
9 ה ה הרגעים definiteArticle unspecified unspecified unspecified unspecified unspecified 0 
9 הרגעים רגע הרגעים noun masculine plural absolute unspecified unspecified  	O	null
10 ב ב בהם preposition unspecified unspecified unspecified unspecified unspecified  
10 הם הם בהם pronomial masculine plural unspecified 3 unspecified 0 	O	null
11 ניסה ניסה ניסה verb masculine singular unspecified 3 past  	O	null
12 להתבלט התבלט להתבלט verb unspecified unspecified unspecified unspecified infinitive  	O	null
13 ו ו ולזהור conjunction unspecified unspecified unspecified unspecified unspecified 0 
13 לזהור זהר ולזהור verb unspecified unspecified unspecified unspecified infinitive  	O	null
14 " " " punctuation unspecified unspecified unspecified unspecified unspecified  	O	null
15 ( ( ( punctuation unspecified unspecified unspecified unspecified unspecified  	O	null
16 מערבית מערבי מערבית noun feminine singular absolute unspecified unspecified  	O	null
17 : : : punctuation unspecified unspecified unspecified unspecified unspecified  	O	null
18 עלא עלא עלא properName unspecified unspecified unspecified unspecified unspecified  	I_PERS	null
19 חליחל חליחל חליחל properName unspecified unspecified unspecified unspecified unspecified  	I_PERS	null
20 , , , punctuation unspecified unspecified unspecified unspecified unspecified  	O	null
21 מטעם מטעם מטעם preposition unspecified unspecified unspecified unspecified unspecified  	O	null
22 , , , punctuation unspecified unspecified unspecified unspecified unspecified  	O	null
23 ###NUMBER### ###NUMBER### ###NUMBER### numeral unspecified unspecified unspecified unspecified unspecified  	O	null
24 ###NUMBER### ###NUMBER### ###NUMBER### numeral unspecified unspecified unspecified unspecified unspecified  	O	null
25 - - - punctuation unspecified unspecified unspecified unspecified unspecified  	O	null
26 ###NUMBER### ###NUMBER### ###NUMBER### numeral unspecified unspecified unspecified unspecified unspecified  	O	null
27 ) ) ) punctuation unspecified unspecified unspecified unspecified unspecified  	O	null
28 . . . punctuation unspecified unspecified unspecified unspecified unspecified  	O	null

0 ב ב בזמן preposition unspecified unspecified unspecified unspecified unspecified 0 
0 זמן זמן בזמן noun masculine singular absolute unspecified unspecified  	O	null
1 ש ש שעולא relativizer/subordinatingConjunction unspecified unspecified unspecified unspecified unspecified 0 
1 עולא עולא שעולא noun masculine singular absolute unspecified unspecified  	O	null
2 מחכה חיכה מחכה verb masculine singular unspecified any beinoni  	O	null
3 ל ל למאהבה preposition unspecified unspecified unspecified unspecified unspecified 0 
3 מאהב מאהב למאהבה noun masculine singular absolute unspecified unspecified  
3 ה ה למאהבה possessive feminine singular unspecified 3 unspecified 0 	O	null
4 , , , punctuation unspecified unspecified unspecified unspecified unspecified  	O	null
5 היא הוא היא pronoun feminine singular unspecified 3 unspecified  	O	null
6 מדברת דיבר מדברת verb feminine singular unspecified any beinoni  	O	null
7 עם עם עם preposition unspecified unspecified unspecified unspecified unspecified  	O	null
8 חברת חבר חברתה noun feminine singular absolute unspecified unspecified  
8 ה ה חברתה possessive feminine singular unspecified 3 unspecified 0 	O	null
9 ב ב בפלאפון preposition unspecified unspecified unspecified unspecified unspecified 0 
9 פלאפון פלאפון בפלאפון properName unspecified unspecified unspecified unspecified unspecified  	I_ORG	null
10 ו ו ומגלה conjunction unspecified unspecified unspecified unspecified unspecified 0 
10 מגלה הגלה ומגלה verb masculine singular unspecified any beinoni  	O	null
11 ש ש שהיא relativizer/subordinatingConjunction unspecified unspecified unspecified unspecified unspecified 0 
11 היא הוא שהיא pronoun feminine singular unspecified 3 unspecified  	O	null
12 מנהלת ניהל מנהלת verb feminine singular unspecified any beinoni  	O	null
13 רומן רומן רומן noun masculine singular absolute unspecified unspecified  	O	null
14 עם עם עם preposition unspecified unspecified unspecified unspecified unspecified  	O	null
15 אותו אותו אותו quantifier unspecified unspecified construct unspecified unspecified  	O	null
16 ה ה המאהב definiteArticle unspecified unspecified unspecified unspecified unspecified 0 
16 המאהב מאהב המאהב noun masculine singular absolute unspecified unspecified  	O	null
17 – – – punctuation unspecified unspecified unspecified unspecified unspecified  	O	null
18 ו ו ובשל conjunction unspecified unspecified unspecified unspecified unspecified 0 
18 בשל בשל ובשל preposition unspecified unspecified unspecified unspecified unspecified  	O	null
19 כך כך כך pronoun unspecified unspecified unspecified unspecified unspecified  	O	null
20 הוא הוא הוא pronoun masculine singular unspecified 3 unspecified  	O	null
21 מאחר איחר מאחר verb masculine singular unspecified any beinoni  	O	null
22 . . . punctuation unspecified unspecified unspecified unspecified unspecified  	O	null

0 ב ב בזמן preposition unspecified unspecified unspecified unspecified unspecified 0 
0 זמן זמן בזמן noun masculine singular absolute unspecified unspecified  	O	null
1 ש ש שהיא relativizer/subordinatingConjunction unspecified unspecified unspecified unspecified unspecified 0 
1 היא הוא שהיא pronoun feminine singular unspecified 3 unspecified  	O	null
2 ממתינה המתין ממתינה verb feminine singular unspecified any beinoni  	O	null
3 ל ל למאהב preposition unspecified unspecified unspecified unspecified unspecified 0 
3 ה ה למאהב definiteArticle unspecified unspecified unspecified unspecified unspecified 0 
3 המאהב מאהב למאהב noun masculine singular absolute unspecified unspecified  	O	null
4 ה ה הבוגדני definiteArticle unspecified unspecified unspecified unspecified unspecified 0 
4 הבוגדני בוגדני הבוגדני adjective masculine singular absolute unspecified unspecified  	O	null
5 מופיעים הופיע מופיעים verb masculine plural unspecified any beinoni  	O	null
6 על על על preposition unspecified unspecified unspecified unspecified unspecified  	O	null
7 צג צג צג noun masculine singular construct unspecified unspecified  	O	null
8 ה ה הטלוויזיה definiteArticle unspecified unspecified unspecified unspecified unspecified 0 
8 הטלוויזיה טלוויזיה הטלוויזיה noun feminine singular absolute unspecified unspecified  	O	null
9 דמויות דמות דמויות noun feminine plural absolute unspecified unspecified  	O	null
10 ו ו והבזקים conjunction unspecified unspecified unspecified unspecified unspecified 0 
10 הבזקים הבזק והבזקים noun masculine plural absolute unspecified unspecified  	O	null
11 על על על preposition unspecified unspecified unspecified unspecified unspecified  	O	null
12 ה ה ההרג definiteArticle unspecified unspecified unspecified unspecified unspecified 0 
12 ההרג הרג ההרג noun masculine singular absolute unspecified unspecified  	O	null
13 ב ב במלחמת preposition unspecified unspecified unspecified unspecified unspecified 0 
13 מלחמת מלחמה במלחמת noun feminine singular construct unspecified unspecified  	O	null
14 לבנון לבנון לבנון properName unspecified unspecified unspecified unspecified unspecified  	I_LOC	null
15 ה ה השנייה definiteArticle unspecified unspecified unspecified unspecified unspecified 0 
15 השנייה ORD2 השנייה numeral feminine singular absolute unspecified unspecified  	O	null
16 , , , punctuation unspecified unspecified unspecified unspecified unspecified  	O	null
17 ו ו והם conjunction unspecified unspecified unspecified unspecified unspecified 0 
17 הם הוא והם pronoun masculine plural unspecified 3 unspecified  	O	null
18 מבטאים ביטא מבטאים verb masculine plural unspecified any beinoni  	O	null
19 , , , punctuation unspecified unspecified unspecified unspecified unspecified  	O	null
20 ב ב בדרך preposition unspecified unspecified unspecified unspecified unspecified 0 
20 דרך דרך בדרך noun feminine singular absolute unspecified unspecified  	O	null
21 עקיפה עקיף עקיפה adjective feminine singular absolute unspecified unspecified  	O	null
22 ו ו ומעוותת conjunction unspecified unspecified unspecified unspecified unspecified 0 
22 מעוותת מעוות ומעוותת adjective feminine singular absolute unspecified unspecified  	O	null
23 , , , punctuation unspecified unspecified unspecified unspecified unspecified  	O	null
24 את את את at-preposition unspecified unspecified unspecified unspecified unspecified  	O	null
25 ה ה המשבר definiteArticle unspecified unspecified unspecified unspecified unspecified 0 
25 המשבר משבר המשבר noun masculine singular absolute unspecified unspecified  	O	null
26 ש ש שהיא relativizer/subordinatingConjunction unspecified unspecified unspecified unspecified unspecified 0 
26 היא הוא שהיא pronoun feminine singular unspecified 3 unspecified  	O	null
27 חווה חווה חווה verb feminine singular unspecified any beinoni  	O	null
28 , , , punctuation unspecified unspecified unspecified unspecified unspecified  	O	null
29 או או או conjunction unspecified unspecified unspecified unspecified unspecified  	O	null
30 לחלופין לחלופין לחלופין adverb unspecified unspecified unspecified unspecified unspecified  	O	null
31 , , , punctuation unspecified unspecified unspecified unspecified unspecified  	O	null
32 מצבה מצבה מצבה noun feminine singular absolute unspecified unspecified  	O	null
33 , , , punctuation unspecified unspecified unspecified unspecified unspecified  	O	null
34 כ כ כמי preposition unspecified unspecified unspecified unspecified unspecified 0 
34 מי מי כמי interrogative unspecified unspecified unspecified unspecified unspecified  	O	null
35 ש ש שחשה relativizer/subordinatingConjunction unspecified unspecified unspecified unspecified unspecified 0 
35 חשה חש שחשה verb feminine singular unspecified any beinoni  	O	null
36 ש ש שפג relativizer/subordinatingConjunction unspecified unspecified unspecified unspecified unspecified 0 
36 פג פג שפג verb masculine singular unspecified 3 past  	O	null
37 ו ו ונעלם conjunction unspecified unspecified unspecified unspecified unspecified 0 
37 נעלם נעלם ונעלם verb masculine singular unspecified 3 past  	O	null
38 ה ה האמון definiteArticle unspecified unspecified unspecified unspecified unspecified 0 
38 האמון אמון האמון noun masculine singular absolute unspecified unspecified  	O	null
39 ש ש שהיה relativizer/subordinatingConjunction unspecified unspecified unspecified unspecified unspecified 0 
39 היה הוא שהיה copula masculine singular unspecified 3 past  	O	null
40 ל ל לה preposition unspecified unspecified unspecified unspecified unspecified  
40 ה ה לה pronomial feminine singular unspecified 3 unspecified 0 	O	null
41 ב ב בסובבים preposition unspecified unspecified unspecified unspecified unspecified 0 
41 ה ה בסובבים definiteArticle unspecified unspecified unspecified unspecified unspecified 0 
41 הסובבים סבב בסובבים participle masculine plural absolute any unspecified  	O	null
42 את את אותה at-preposition unspecified unspecified unspecified unspecified unspecified  
42 ה ה אותה pronomial feminine singular unspecified 3 unspecified 0 	O	null
43 , , , punctuation unspecified unspecified unspecified unspecified unspecified  	O	null
44 מבטא ביטא מבטא verb masculine singular unspecified any beinoni  	O	null
45 , , , punctuation unspecified unspecified unspecified unspecified unspecified  	O	null
46 בעקיפין בעקיפין בעקיפין adverb unspecified unspecified unspecified unspecified unspecified  	O	null
47 , , , punctuation unspecified unspecified unspecified unspecified unspecified  	O	null
48 את את את at-preposition unspecified unspecified unspecified unspecified unspecified  	O	null
49 ה ה ההרס definiteArticle unspecified unspecified unspecified unspecified unspecified 0 
49 ההרס הרס ההרס noun masculine singular absolute unspecified unspecified  	O	null
50 ו ו והחורבן conjunction unspecified unspecified unspecified unspecified unspecified 0 
50 ה ה והחורבן definiteArticle unspecified unspecified unspecified unspecified unspecified 0 
50 החורבן חורבן והחורבן noun masculine singular absolute unspecified unspecified  	O	null
51 ש ש שמתרחשים relativizer/subordinatingConjunction unspecified unspecified unspecified unspecified unspecified 0 
51 מתרחשים התרחש שמתרחשים verb masculine plural unspecified any beinoni  	O	null
52 מעבר מעבר מעבר noun masculine singular absolute unspecified unspecified  	O	null
53 ל ל לגבול preposition unspecified unspecified unspecified unspecified unspecified 0 
53 ה ה לגבול definiteArticle unspecified unspecified unspecified unspecified unspecified 0 
53 הגבול גבול לגבול noun masculine singular absolute unspecified unspecified  	O	null
54 . . . punctuation unspecified unspecified unspecified unspecified unspecified  	O	null

0 חדר חדר חדר noun masculine singular absolute unspecified unspecified  	O	null
1 ב ב בתל preposition unspecified unspecified unspecified unspecified unspecified 0 
1 תל תל בתל properName unspecified unspecified unspecified unspecified unspecified  	I_LOC	null
2 אביב אביב אביב properName unspecified unspecified unspecified unspecified unspecified  	I_LOC	null
3 הוא הוא הוא pronoun masculine singular unspecified 3 unspecified  	O	null
4 גם גם גם conjunction unspecified unspecified unspecified unspecified unspecified  	O	null
5 שם שם שמו noun masculine singular absolute unspecified unspecified  
5 ו ו שמו possessive masculine singular unspecified 3 unspecified 0 	O	null
6 של של של shel-preposition unspecified unspecified unspecified unspecified unspecified  	O	null
7 סרט סרט סרט noun masculine singular absolute unspecified unspecified  	O	null
8 תיעודי תיעודי תיעודי adjective masculine singular absolute unspecified unspecified  	O	null
9 ב ב בבימוי preposition unspecified unspecified unspecified unspecified unspecified 0 
9 בימוי בימוי בבימוי noun masculine singular construct unspecified unspecified  	O	null
10 אבתיסאם אבתיסאם אבתיסאם properName unspecified unspecified unspecified unspecified unspecified  	I_ORG	null
11 מראענה מראענה מראענה properName unspecified unspecified unspecified unspecified unspecified  	I_ORG	null
12 ) ) ) punctuation unspecified unspecified unspecified unspecified unspecified  	O	null
13 . . . punctuation unspecified unspecified unspecified unspecified unspecified  	O	null
14 ###NUMBER### ###NUMBER### ###NUMBER### numeral unspecified unspecified unspecified unspecified unspecified  	I_DATE	null
15 מראענה מראענה מראענה properName unspecified unspecified unspecified unspecified unspecified  	I_ORG	null
16 התלווה התלווה התלווה verb masculine singular unspecified 3 past  	O	null
17 ל ל לבטחיש preposition unspecified unspecified unspecified unspecified unspecified 0 
17 בטחיש בטחיש לבטחיש noun masculine singular absolute unspecified unspecified  	O	null
18 ב ב במסעותיו preposition unspecified unspecified unspecified unspecified unspecified 0 
18 מסעותי מסע במסעותיו noun masculine plural absolute unspecified unspecified  
18 ו ו במסעותיו possessive masculine singular unspecified 3 unspecified 0 	O	null
19 ב ב ברמאללה preposition unspecified unspecified unspecified unspecified unspecified 0 
19 רמאללה רמאללה ברמאללה properName unspecified unspecified unspecified unspecified unspecified  	I_LOC	null
20 , , , punctuation unspecified unspecified unspecified unspecified unspecified  	O	null
21 ירדן ירדן ירדן properName unspecified unspecified unspecified unspecified unspecified  	I_LOC	null
22 , , , punctuation unspecified unspecified unspecified unspecified unspecified  	O	null
23 נצרת נצרת נצרת properName unspecified unspecified unspecified unspecified unspecified  	I_LOC	null
24 , , , punctuation unspecified unspecified unspecified unspecified unspecified  	O	null
25 חיפה חיפה חיפה properName unspecified unspecified unspecified unspecified unspecified  	I_LOC	null
26 ו ו ותל conjunction unspecified unspecified unspecified unspecified unspecified 0 
26 תל תל ותל properName unspecified unspecified unspecified unspecified unspecified  	B_LOC	null
27 אביב אביב אביב properName unspecified unspecified unspecified unspecified unspecified  	I_LOC	null
28 ו ו ובמפגשים conjunction unspecified unspecified unspecified unspecified unspecified 0 
28 ב ב ובמפגשים preposition unspecified unspecified unspecified unspecified unspecified 0 
28 מפגשים מפגש ובמפגשים noun masculine plural absolute unspecified unspecified  	O	null
29 עם עם עם preposition unspecified unspecified unspecified unspecified unspecified  	O	null
30 סופרים סופר סופרים noun masculine plural absolute unspecified unspecified  	O	null
31 פלסטינים פלסטיני פלסטינים adjective masculine plural absolute unspecified unspecified  	O	null
32 . . . punctuation unspecified unspecified unspecified unspecified unspecified  	O	null

0 ה ה הסרט definiteArticle unspecified unspecified unspecified unspecified unspecified 0 
0 הסרט סרט הסרט noun masculine singular absolute unspecified unspecified  	O	null
1 עוסק עסק עוסק verb masculine singular unspecified any beinoni  	O	null
2 ב ב בסוגיות preposition unspecified unspecified unspecified unspecified unspecified 0 
2 סוגיות סוגיה בסוגיות noun feminine plural absolute unspecified unspecified  	O	null
3 אישיות אישי אישיות adjective feminine plural absolute unspecified unspecified  	O	null
4 : : : punctuation unspecified unspecified unspecified unspecified unspecified  	O	null
5 זהות זהות זהות noun feminine singular absolute unspecified unspecified  	O	null
6 מינית מיני מינית adjective feminine singular absolute unspecified unspecified  	O	null
7 , , , punctuation unspecified unspecified unspecified unspecified unspecified  	O	null
8 תשוקה תשוקה תשוקה noun feminine singular absolute unspecified unspecified  	O	null
9 ו ו וכו' conjunction unspecified unspecified unspecified unspecified unspecified 0 
9 כ כ וכו' preposition unspecified unspecified unspecified unspecified unspecified 0 
9 ו' ו' וכו' noun masculine singular absolute unspecified unspecified  	O	null
10 ב ב בזיקה preposition unspecified unspecified unspecified unspecified unspecified 0 
10 זיקה זיקה בזיקה noun feminine singular absolute unspecified unspecified  	O	null
11 ל ל למאבקים preposition unspecified unspecified unspecified unspecified unspecified 0 
11 מאבקים מאבק למאבקים noun masculine plural absolute unspecified unspecified  	O	null
12 פוליטיים פוליטי פוליטיים adjective masculine plural absolute unspecified unspecified  	O	null
13 . . . punctuation unspecified unspecified unspecified unspecified unspecified  	O	null

0 ב ב בכתיבתו preposition unspecified unspecified unspecified unspecified unspecified 0 
0 כתיבת כתיבה בכתיבתו noun feminine singular absolute unspecified unspecified  
0 ו ו בכתיבתו possessive masculine singular unspecified 3 unspecified 0 	O	null
1 נשברים נשבר נשברים verb masculine plural unspecified any beinoni  	O	null
2 מוסכמות מוסכמה מוסכמות noun feminine plural absolute unspecified unspecified  	O	null
3 חברתיות חברתי חברתיות adjective feminine plural absolute unspecified unspecified  	O	null
4 ו ו וסטריאוטיפים conjunction unspecified unspecified unspecified unspecified unspecified 0 
4 סטריאוטיפים סטריאוטיפ וסטריאוטיפים noun masculine plural absolute unspecified unspecified  	O	null
5 , , , punctuation unspecified unspecified unspecified unspecified unspecified  	O	null
6 שכן שכן שכן conjunction unspecified unspecified unspecified unspecified unspecified  	O	null
7 הוא הוא הוא pronoun masculine singular unspecified 3 unspecified  	O	null
8 מציג הציג מציג verb masculine singular unspecified any beinoni  	O	null
9 מציאות מציאות מציאות noun feminine singular absolute unspecified unspecified  	O	null
10 מורכבת מורכב מורכבת adjective feminine singular absolute unspecified unspecified  	O	null
11 של של של shel-preposition unspecified unspecified unspecified unspecified unspecified  	O	null
12 ה ה החיים definiteArticle unspecified unspecified unspecified unspecified unspecified 0 
12 החיים חיים החיים noun masculine plural absolute unspecified unspecified  	I_ORG	null
13 ב ב במדינת preposition unspecified unspecified unspecified unspecified unspecified 0 
13 מדינת מדינה במדינת noun feminine singular construct unspecified unspecified  	I_ORG	null
14 ישראל ישראל ישראל properName unspecified unspecified unspecified unspecified unspecified  	I_ORG	null
15 . . . punctuation unspecified unspecified unspecified unspecified unspecified  	O	null

0 דוגמה דוגמה דוגמה noun feminine singular absolute unspecified unspecified  	O	null
1 בולטת בולט בולטת adjective feminine singular absolute unspecified unspecified  	O	null
2 ל ל לכך preposition unspecified unspecified unspecified unspecified unspecified 0 
2 כך כך לכך pronoun unspecified unspecified unspecified unspecified unspecified  	O	null
3 היא הוא היא copula feminine singular unspecified 3 beinoni  	O	null
4 , , , punctuation unspecified unspecified unspecified unspecified unspecified  	O	null
5 למשל למשל למשל conjunction unspecified unspecified unspecified unspecified unspecified  	O	null
6 , , , punctuation unspecified unspecified unspecified unspecified unspecified  	O	null
7 ה ה המציאות definiteArticle unspecified unspecified unspecified unspecified unspecified 0 
7 המציאות מציאות המציאות noun feminine singular absolute unspecified unspecified  	O	null
8 ה ה המעוצבת definiteArticle unspecified unspecified unspecified unspecified unspecified 0 
8 המעוצבת עוצב המעוצבת participle feminine singular absolute any unspecified  	O	null
9 ב ב בסיפור preposition unspecified unspecified unspecified unspecified unspecified 0 
9 ה ה בסיפור definiteArticle unspecified unspecified unspecified unspecified unspecified 0 
9 הסיפור סיפור בסיפור noun masculine singular absolute unspecified unspecified  	O	null
10 ה ה הקצר definiteArticle unspecified unspecified unspecified unspecified unspecified 0 
10 הקצר קצר הקצר adjective masculine singular absolute unspecified unspecified  	O	null
11 ה ה הפותח definiteArticle unspecified unspecified unspecified unspecified unspecified 0 
11 הפותח פתח הפותח participle masculine singular absolute any unspecified  	O	null
12 את את את at-preposition unspecified unspecified unspecified unspecified unspecified  	O	null
13 קובץ קובץ קובץ noun masculine singular construct unspecified unspecified  	O	null
14 ה ה הסיפוריםהרבהמלח... definiteArticle unspecified unspecified unspecified unspecified unspecified 0 
14 הסיפוריםהרבהמלח... הסיפוריםהרבהמלח... הסיפוריםהרבהמלח... noun feminine plural absolute unspecified unspecified  	O	null
15 פחותארץ פחותארץ פחותארץ noun masculine-and-feminine singular absolute unspecified unspecified  	O	null
16 ) ) ) punctuation unspecified unspecified unspecified unspecified unspecified  	O	null
17 , , , punctuation unspecified unspecified unspecified unspecified unspecified  	O	null
18 ###NUMBER### ###NUMBER### ###NUMBER### numeral unspecified unspecified unspecified unspecified unspecified  	I_DATE	null
19 " " " punctuation unspecified unspecified unspecified unspecified unspecified  	O	null
20 ה ה החיים definiteArticle unspecified unspecified unspecified unspecified unspecified 0 
20 החיים חיים החיים noun masculine plural absolute unspecified unspecified  	O	null
21 בלעדי בלעדי בלעדי preposition unspecified unspecified unspecified unspecified unspecified  	O	null
22 " " " punctuation unspecified unspecified unspecified unspecified unspecified  	O	null
23 . . . punctuation unspecified unspecified unspecified unspecified unspecified  	O	null

0 ה ה הגיבור definiteArticle unspecified unspecified unspecified unspecified unspecified 0 
0 הגיבור גיבור הגיבור noun masculine singular absolute unspecified unspecified  	O	null
1 ב ב בסיפור preposition unspecified unspecified unspecified unspecified unspecified 0 
1 ה ה בסיפור definiteArticle unspecified unspecified unspecified unspecified unspecified 0 
1 הסיפור סיפור בסיפור noun masculine singular absolute unspecified unspecified  	O	null
2 ה ה הזה definiteArticle unspecified unspecified unspecified unspecified unspecified 0 
2 הזה זה הזה pronoun masculine singular unspecified 3 unspecified  	O	null
3 , , , punctuation unspecified unspecified unspecified unspecified unspecified  	O	null
4 ו ו וולאא conjunction unspecified unspecified unspecified unspecified unspecified 0 
4 ולא ולא וולאא noun masculine singular absolute unspecified unspecified  
4 ה ה וולאא possessive feminine singular unspecified 3 unspecified 0 	O	null
5 , , , punctuation unspecified unspecified unspecified unspecified unspecified  	O	null
6 מקבל קיבל מקבל verb masculine singular unspecified any beinoni  	O	null
7 את את את at-preposition unspecified unspecified unspecified unspecified unspecified  	O	null
8 ה ה הידיעה definiteArticle unspecified unspecified unspecified unspecified unspecified 0 
8 הידיעה ידיעה הידיעה noun feminine singular absolute unspecified unspecified  	O	null
9 ש ש שהוא relativizer/subordinatingConjunction unspecified unspecified unspecified unspecified unspecified 0 
9 הוא הוא שהוא pronoun masculine singular unspecified 3 unspecified  	O	null
10 גוסס גסס גוסס verb masculine singular unspecified any beinoni  	O	null
11 מ מ מסרטן preposition unspecified unspecified unspecified unspecified unspecified 0 
11 סרטן סרטן מסרטן noun masculine singular absolute unspecified unspecified  	O	null
12 . . . punctuation unspecified unspecified unspecified unspecified unspecified  	O	null

0 הוא הוא הוא pronoun masculine singular unspecified 3 unspecified  	O	null
1 מהרהר הרהר מהרהר verb masculine singular unspecified any beinoni  	O	null
2 ב ב בציפיות preposition unspecified unspecified unspecified unspecified unspecified 0 
2 ה ה בציפיות definiteArticle unspecified unspecified unspecified unspecified unspecified 0 
2 הציפיות ציפייה בציפיות noun feminine plural absolute unspecified unspecified  	O	null
3 ש ש שהציב relativizer/subordinatingConjunction unspecified unspecified unspecified unspecified unspecified 0 
3 הציב הציב שהציב verb masculine singular unspecified 3 past  	O	null
4 ל ל לעצמו preposition unspecified unspecified unspecified unspecified unspecified 0 
4 עצמו עצמו לעצמו pronoun unspecified unspecified unspecified unspecified unspecified  
4 ו ו לעצמו pronomial masculine singular unspecified 3 unspecified 0 	O	null
5 , , , punctuation unspecified unspecified unspecified unspecified unspecified  	O	null
6 ו ו ושלא conjunction unspecified unspecified unspecified unspecified unspecified 0 
6 ש ש ושלא relativizer/subordinatingConjunction unspecified unspecified unspecified unspecified unspecified 0 
6 לא לא ושלא negation unspecified unspecified unspecified unspecified unspecified  	O	null
7 הגשים הגשים הגשים verb masculine singular unspecified 3 past  	O	null
8 – – – punctuation unspecified unspecified unspecified unspecified unspecified  	O	null
9 להקים הקים להקים verb unspecified unspecified unspecified unspecified infinitive  	O	null
10 משפחה משפחה משפחה noun feminine singular absolute unspecified unspecified  	O	null
11 , , , punctuation unspecified unspecified unspecified unspecified unspecified  	O	null
12 להיות הוא להיות copula unspecified unspecified unspecified unspecified infinitive  	O	null
13 ל ל לרופא preposition unspecified unspecified unspecified unspecified unspecified 0 
13 רופא רופא לרופא noun masculine singular construct unspecified unspecified  	O	null
14 שיניים שן שיניים noun feminine plural absolute unspecified unspecified  	O	null
15 , , , punctuation unspecified unspecified unspecified unspecified unspecified  	O	null
16 להתעניין התעניין להתעניין verb unspecified unspecified unspecified unspecified infinitive  	O	null
17 ב ב בדברים preposition unspecified unspecified unspecified unspecified unspecified 0 
17 ה ה בדברים definiteArticle unspecified unspecified unspecified unspecified unspecified 0 
17 הדברים דבר בדברים noun masculine plural absolute unspecified unspecified  	O	null
18 " " " punctuation unspecified unspecified unspecified unspecified unspecified  	O	null
19 גבריים גברי גבריים adjective masculine plural absolute unspecified unspecified  	O	null
20 " " " punctuation unspecified unspecified unspecified unspecified unspecified  	O	null
21 – – – punctuation unspecified unspecified unspecified unspecified unspecified  	O	null
22 ו ו ומתנחם conjunction unspecified unspecified unspecified unspecified unspecified 0 
22 מתנחם התנחם ומתנחם verb masculine singular unspecified any beinoni  	O	null
23 ב ב בכך preposition unspecified unspecified unspecified unspecified unspecified 0 
23 כך כך בכך pronoun unspecified unspecified unspecified unspecified unspecified  	O	null
24 ש ש שלאחר relativizer/subordinatingConjunction unspecified unspecified unspecified unspecified unspecified 0 
24 לאחר לאחר שלאחר preposition unspecified unspecified unspecified unspecified unspecified  	O	null
25 מות מוות מותו noun masculine singular absolute unspecified unspecified  
25 ו ו מותו possessive masculine singular unspecified 3 unspecified 0 	O	null
26 הקרב הקריב הקרב verb masculine singular unspecified 2 imperative  	O	null
27 יוכלו יכול יוכלו modal masculine-and-feminine plural unspecified 3 future  	O	null
28 הורי הורה הוריו noun masculine plural absolute unspecified unspecified  
28 ו ו הוריו possessive masculine singular unspecified 3 unspecified 0 	O	null
29 לטוות טווה לטוות verb unspecified unspecified unspecified unspecified infinitive  	O	null
30 סיפור סיפור סיפור noun masculine singular absolute unspecified unspecified  	O	null
31 אחר אחר אחר adjective masculine singular absolute unspecified unspecified  	O	null
32 , , , punctuation unspecified unspecified unspecified unspecified unspecified  	O	null
33 כ כ כרצונם preposition unspecified unspecified unspecified unspecified unspecified 0 
33 רצון רצון כרצונם noun masculine singular absolute unspecified unspecified  
33 ם ם כרצונם possessive masculine plural unspecified 3 unspecified 0 	O	null
34 . . . punctuation unspecified unspecified unspecified unspecified unspecified  	O	null

0 שם שם שם noun masculine singular construct unspecified unspecified  	O	null
1 ה ה הדמות definiteArticle unspecified unspecified unspecified unspecified unspecified 0 
1 הדמות דמות הדמות noun feminine singular absolute unspecified unspecified  	O	null
2 , , , punctuation unspecified unspecified unspecified unspecified unspecified  	O	null
3 ו ו וולאא conjunction unspecified unspecified unspecified unspecified unspecified 0 
3 ולא ולא וולאא noun masculine singular absolute unspecified unspecified  
3 ה ה וולאא possessive feminine singular unspecified 3 unspecified 0 	O	null
4 ( ( ( punctuation unspecified unspecified unspecified unspecified unspecified  	O	null
5 " " " punctuation unspecified unspecified unspecified unspecified unspecified  	O	null
6 נאמנות נאמנות נאמנות noun feminine singular absolute unspecified unspecified  	O	null
7 " " " punctuation unspecified unspecified unspecified unspecified unspecified  	O	null
8 ב ב בערבית preposition unspecified unspecified unspecified unspecified unspecified 0 
8 ערבית ערבית בערבית properName unspecified unspecified unspecified unspecified unspecified  	I_ORG	null
9 ) ) ) punctuation unspecified unspecified unspecified unspecified unspecified  	O	null
10 , , , punctuation unspecified unspecified unspecified unspecified unspecified  	O	null
11 מזכיר הזכיר מזכיר verb masculine singular unspecified any beinoni  	O	null
12 את את את at-preposition unspecified unspecified unspecified unspecified unspecified  	O	null
13 בן בן בנו noun masculine singular absolute unspecified unspecified  
13 ו ו בנו possessive masculine singular unspecified 3 unspecified 0 	O	null
14 של של של shel-preposition unspecified unspecified unspecified unspecified unspecified  	O	null
15 גיבור גיבור גיבור properName unspecified unspecified unspecified unspecified unspecified  	I_PERS	null
16 ה ה הרומן definiteArticle unspecified unspecified unspecified unspecified unspecified 0 
16 הרומן רומן הרומן noun masculine singular absolute unspecified unspecified  	O	null
17 האופסימיסט האופסימיסט האופסימיסט noun masculine-and-feminine singular absolute unspecified unspecified  	O	null
18 מאת מאת מאת preposition unspecified unspecified unspecified unspecified unspecified  	O	null
19 אמיל אמיל אמיל properName unspecified unspecified unspecified unspecified unspecified  	I_PERS	null
20 חביבי חביב חביבי adjective masculine plural construct unspecified unspecified  	O	null
21 ) ) ) punctuation unspecified unspecified unspecified unspecified unspecified  	O	null
22 ; ; ; punctuation unspecified unspecified unspecified unspecified unspecified  	O	null
23 ###NUMBER### ###NUMBER### ###NUMBER### numeral unspecified unspecified unspecified unspecified unspecified  	I_DATE	null
24 אלא אלא אלא conjunction unspecified unspecified unspecified unspecified unspecified  	O	null
25 ש ש שכאן relativizer/subordinatingConjunction unspecified unspecified unspecified unspecified unspecified 0 
25 כאן כאן שכאן adverb unspecified unspecified unspecified unspecified unspecified  	O	null
26 ה ה הנאמנות definiteArticle unspecified unspecified unspecified unspecified unspecified 0 
26 הנאמנות נאמנות הנאמנות noun feminine singular absolute unspecified unspecified  	O	null
27 מופנית הופנה מופנית verb feminine singular unspecified any beinoni  	O	null
28 פנימה פנימה פנימה adverb unspecified unspecified unspecified unspecified unspecified  	O	null
29 , , , punctuation unspecified unspecified unspecified unspecified unspecified  	O	null
30 כלפי כלפי כלפי preposition unspecified unspecified unspecified unspecified unspecified  	O	null
31 עצמו עצמו עצמו pronoun unspecified unspecified unspecified unspecified unspecified  
31 ו ו עצמו pronomial masculine singular unspecified 3 unspecified 0 	O	null
32 , , , punctuation unspecified unspecified unspecified unspecified unspecified  	O	null
33 ו ו ולא conjunction unspecified unspecified unspecified unspecified unspecified 0 
33 לא לא ולא negation unspecified unspecified unspecified unspecified unspecified  	O	null
34 כלפי כלפי כלפי preposition unspecified unspecified unspecified unspecified unspecified  	O	null
35 ה ה הדרישות definiteArticle unspecified unspecified unspecified unspecified unspecified 0 
35 הדרישות דרישה הדרישות noun feminine plural absolute unspecified unspecified  	O	null
36 ה ה הלאומיות definiteArticle unspecified unspecified unspecified unspecified unspecified 0 
36 הלאומיות לאומי הלאומיות adjective feminine plural absolute unspecified unspecified  	O	null
37 . . . punctuation unspecified unspecified unspecified unspecified unspecified  	O	null

0 ה ה המתח definiteArticle unspecified unspecified unspecified unspecified unspecified 0 
0 המתח מתח המתח noun masculine singular absolute unspecified unspecified  	O	null
1 בין בין בין preposition unspecified unspecified unspecified unspecified unspecified  	O	null
2 שתי CARD2 שתי numeral feminine dual construct unspecified unspecified  	O	null
3 ה ה הנאמנויות definiteArticle unspecified unspecified unspecified unspecified unspecified 0 
3 הנאמנויות נאמנות הנאמנויות noun feminine plural absolute unspecified unspecified  	O	null
4 – – – punctuation unspecified unspecified unspecified unspecified unspecified  	O	null
5 בין בין בין preposition unspecified unspecified unspecified unspecified unspecified  	O	null
6 זהות זהות זהותו noun feminine singular absolute unspecified unspecified  
6 ו ו זהותו possessive masculine singular unspecified 3 unspecified 0 	O	null
7 ה ה הפלסטינית definiteArticle unspecified unspecified unspecified unspecified unspecified 0 
7 הפלסטינית פלסטיני הפלסטינית adjective feminine singular absolute unspecified unspecified  	O	null
8 ה ה הקולקטיבית definiteArticle unspecified unspecified unspecified unspecified unspecified 0 
8 הקולקטיבית קולקטיבי הקולקטיבית adjective feminine singular absolute unspecified unspecified  	O	null
9 לבין לבין לבין preposition unspecified unspecified unspecified unspecified unspecified  	O	null
10 מאווייו מאווייו מאווייו noun masculine plural construct unspecified unspecified  	O	null
11 ה ה האישיים definiteArticle unspecified unspecified unspecified unspecified unspecified 0 
11 האישיים אישי האישיים adjective masculine plural absolute unspecified unspecified  	O	null
12 ו ו והרצון conjunction unspecified unspecified unspecified unspecified unspecified 0 
12 ה ה והרצון definiteArticle unspecified unspecified unspecified unspecified unspecified 0 
12 הרצון רצון והרצון noun masculine singular absolute unspecified unspecified  	O	null
13 להישאר נשאר להישאר verb unspecified unspecified unspecified unspecified infinitive  	O	null
14 נאמן נאמן נאמן noun masculine singular absolute unspecified unspecified  	O	null
15 ל ל לעצמו preposition unspecified unspecified unspecified unspecified unspecified 0 
15 עצמו עצמו לעצמו pronoun unspecified unspecified unspecified unspecified unspecified  
15 ו ו לעצמו pronomial masculine singular unspecified 3 unspecified 0 	O	null
16 – – – punctuation unspecified unspecified unspecified unspecified unspecified  	O	null
17 עובר עבר עובר verb masculine singular unspecified any beinoni  	O	null
18 כ כ כחוט preposition unspecified unspecified unspecified unspecified unspecified 0 
18 חוט חוט כחוט noun masculine singular construct unspecified unspecified  	O	null
19 ה ה השני definiteArticle unspecified unspecified unspecified unspecified unspecified 0 
19 השני שני השני noun masculine singular absolute unspecified unspecified  	O	null
20 ב ב ביצירותיו preposition unspecified unspecified unspecified unspecified unspecified 0 
20 יצירות יצירה ביצירותיו noun feminine plural absolute unspecified unspecified  
20 ו ו ביצירותיו possessive masculine singular unspecified 3 unspecified 0 	O	null
21 של של של shel-preposition unspecified unspecified unspecified unspecified unspecified  	O	null
22 בטחיש בטחיש בטחיש noun masculine singular absolute unspecified unspecified  	O	null
23 ו ו ומייחד conjunction unspecified unspecified unspecified unspecified unspecified 0 
23 מייחד ייחד ומייחד verb masculine singular unspecified any beinoni  	O	null
24 את את אותו at-preposition unspecified unspecified unspecified unspecified unspecified  
24 ו ו אותו pronomial masculine singular unspecified 3 unspecified 0 	O	null
25 כ כ כסופר preposition unspecified unspecified unspecified unspecified unspecified 0 
25 סופר סופר כסופר noun masculine singular absolute unspecified unspecified  	O	null
26 ב ב ביחס preposition unspecified unspecified unspecified unspecified unspecified 0 
26 יחס יחס ביחס noun masculine singular absolute unspecified unspecified  	O	null
27 ל ל לסופרים preposition unspecified unspecified unspecified unspecified unspecified 0 
27 סופרים סופר לסופרים noun masculine plural absolute unspecified unspecified  	O	null
28 ש ש שקדמו relativizer/subordinatingConjunction unspecified unspecified unspecified unspecified unspecified 0 
28 קדמו קדם שקדמו verb masculine-and-feminine plural unspecified 3 past  	O	null
29 ל ל לו preposition unspecified unspecified unspecified unspecified unspecified  
29 ו ו לו pronomial masculine singular unspecified 3 unspecified 0 	O	null
30 . . . punctuation unspecified unspecified unspecified unspecified unspecified  	O	null

0 ספרי ספר ספריו noun masculine plural absolute unspecified unspecified  
0 ו ו ספריו possessive masculine singular unspecified 3 unspecified 0 	O	null
1 לא לא לא negation unspecified unspecified unspecified unspecified unspecified  	O	null
2 תורגמו תורגם תורגמו verb masculine-and-feminine plural unspecified 3 past  	O	null
3 ל ל לעברית preposition unspecified unspecified unspecified unspecified unspecified 0 
3 עברית עברית לעברית properName feminine singular unspecified unspecified unspecified  	I_LOC	null
4 . . . punctuation unspecified unspecified unspecified unspecified unspecified  	O	null

0 תורגמו תורגם תורגמו verb masculine-and-feminine plural unspecified 3 past  	O	null
1 שירים שיר שירים noun masculine plural absolute unspecified unspecified  	O	null
2 בודדים בודד בודדים adjective masculine plural absolute unspecified unspecified  	O	null
3 ו ו וסיפורים conjunction unspecified unspecified unspecified unspecified unspecified 0 
3 סיפורים סיפור וסיפורים noun masculine plural absolute unspecified unspecified  	O	null
4 ב ב בכתבי preposition unspecified unspecified unspecified unspecified unspecified 0 
4 כתבי כתב בכתבי noun masculine plural construct unspecified unspecified  	O	null
5 עת עת עת noun feminine singular absolute unspecified unspecified  	O	null
6 ו ו ובעיתונים conjunction unspecified unspecified unspecified unspecified unspecified 0 
6 ב ב ובעיתונים preposition unspecified unspecified unspecified unspecified unspecified 0 
6 ה ה ובעיתונים definiteArticle unspecified unspecified unspecified unspecified unspecified 0 
6 העיתונים עיתון ובעיתונים noun masculine plural absolute unspecified unspecified  	O	null
7 . . . punctuation unspecified unspecified unspecified unspecified unspecified  	O	null

0 ה ה היצירה definiteArticle unspecified unspecified unspecified unspecified unspecified 0 
0 היצירה יצירה היצירה noun feminine singular absolute unspecified unspecified  	O	null
1 " " " punctuation unspecified unspecified unspecified unspecified unspecified  	O	null
2 יבשה יבשה יבשה noun feminine singular absolute unspecified unspecified  	O	null
3 - - - punctuation unspecified unspecified unspecified unspecified unspecified  	O	null
4 ים ים ים noun masculine singular absolute unspecified unspecified  	O	null
5 " " " punctuation unspecified unspecified unspecified unspecified unspecified  	O	null
6 , , , punctuation unspecified unspecified unspecified unspecified unspecified  	O	null
7 ה ה המופיעה definiteArticle unspecified unspecified unspecified unspecified unspecified 0 
7 המופיעה הופיע המופיעה participle feminine singular absolute any unspecified  	I_ORG	null
8 ב ב בערבית preposition unspecified unspecified unspecified unspecified unspecified 0 
8 ערבית ערבית בערבית properName feminine singular unspecified unspecified unspecified  	I_ORG	null
9 ו ו ובתרגום conjunction unspecified unspecified unspecified unspecified unspecified 0 
9 ב ב ובתרגום preposition unspecified unspecified unspecified unspecified unspecified 0 
9 תרגום תרגום ובתרגום noun masculine singular absolute unspecified unspecified  	O	null
10 מקוצר קוצר מקוצר verb masculine singular unspecified any beinoni  	O	null
11 ל ל לעברית preposition unspecified unspecified unspecified unspecified unspecified 0 
11 עברית עברית לעברית properName feminine singular unspecified unspecified unspecified  	O	null
12 ב ב באוסף preposition unspecified unspecified unspecified unspecified unspecified 0 
12 אוסף אוסף באוסף noun masculine singular absolute unspecified unspecified  	O	null
13 ש ש שירה relativizer/subordinatingConjunction unspecified unspecified unspecified unspecified unspecified 0 
13 ירה ירה שירה verb masculine singular unspecified 3 past  	O	null
14 מפרקת מפרקת מפרקת noun feminine singular construct unspecified unspecified  	O	null
15 חומה חומה חומה noun feminine singular absolute unspecified unspecified  	O	null
16 : : : punctuation unspecified unspecified unspecified unspecified unspecified  	O	null
17 גרילה גרילה גרילה noun feminine singular absolute unspecified unspecified  	O	null
18 תרבות תרבות תרבות noun feminine singular absolute unspecified unspecified  	O	null
19 ב ב באבו preposition unspecified unspecified unspecified unspecified unspecified 0 
19 אבו אבו באבו properName unspecified unspecified unspecified unspecified unspecified  	I_PERS	null
20 דיס דיס דיס properName unspecified unspecified unspecified unspecified unspecified  	I_PERS	null
21 , , , punctuation unspecified unspecified unspecified unspecified unspecified  	O	null
22 מתארת תיאר מתארת verb feminine singular unspecified any beinoni  	O	null
23 את את את at-preposition unspecified unspecified unspecified unspecified unspecified  	O	null
24 ה ה הקשר definiteArticle unspecified unspecified unspecified unspecified unspecified 0 
24 הקשר קשר הקשר noun masculine singular absolute unspecified unspecified  	O	null
25 בין בין בינו preposition unspecified unspecified unspecified unspecified unspecified  
25 ו ו בינו pronomial masculine singular unspecified 3 unspecified 0 	O	null
26 כ כ כפלסטיני preposition unspecified unspecified unspecified unspecified unspecified 0 
26 פלסטיני פלשתינאי כפלסטיני noun masculine singular absolute unspecified unspecified  	O	null
27 ל ל לנוף preposition unspecified unspecified unspecified unspecified unspecified 0 
27 ה ה לנוף definiteArticle unspecified unspecified unspecified unspecified unspecified 0 
27 הנוף נוף לנוף noun masculine singular absolute unspecified unspecified  	O	null
28 ה ה הסובב definiteArticle unspecified unspecified unspecified unspecified unspecified 0 
28 הסובב סבב הסובב participle masculine singular absolute any unspecified  	O	null
29 את את אותו at-preposition unspecified unspecified unspecified unspecified unspecified  
29 ו ו אותו pronomial masculine singular unspecified 3 unspecified 0 	O	null
30 : : : punctuation unspecified unspecified unspecified unspecified unspecified  	O	null
31 " " " punctuation unspecified unspecified unspecified unspecified unspecified  	O	null
32 מֵהָרֶגַעשֶׁנִּגְנַבהַיָּםמֵאֲבִי מֵהָרֶגַעשֶׁנִּגְנַבהַיָּםמֵאֲבִי מֵהָרֶגַעשֶׁנִּגְנַבהַיָּםמֵאֲבִי properName unspecified unspecified unspecified unspecified unspecified  	I_ORG	null
33 , , , punctuation unspecified unspecified unspecified unspecified unspecified  	O	null
34 ה ה הוּאלִימֵּדאוֹתִילֹאלִשְׁאוֹלעָלָיו definiteArticle unspecified unspecified unspecified unspecified unspecified 0 
34 הוּאלִימֵּדאוֹתִילֹאלִשְׁאוֹלעָלָיו הוּאלִימֵּדאוֹתִילֹאלִשְׁאוֹלעָלָיו הוּאלִימֵּדאוֹתִילֹאלִשְׁאוֹלעָלָיו adjective feminine singular absolute unspecified unspecified  	O	null
35 – – – punctuation unspecified unspecified unspecified unspecified unspecified  	O	null
36 הַיָּם הַיָּם הַיָּם verb feminine singular unspecified 2 imperative  	O	null
37 – – – punctuation unspecified unspecified unspecified unspecified unspecified  	O	null
38 הוּאלֹאשֶׁלָּנו הוּאלֹאשֶׁלָּנו הוּאלֹאשֶׁלָּנו properName unspecified unspecified unspecified unspecified unspecified  	I_PERS	null
39 ּ ּ ּ punctuation unspecified unspecified unspecified unspecified unspecified  	O	null
40 , , , punctuation unspecified unspecified unspecified unspecified unspecified  	O	null
41 בְּנִי בְּנִי בְּנִי properName unspecified unspecified unspecified unspecified unspecified  	I_PERS	null
42 . . . punctuation unspecified unspecified unspecified unspecified unspecified  	O	null

0 גַּםהַחוֹלהַזֶּהאֵיןבּוֹמַמָּש גַּםהַחוֹלהַזֶּהאֵיןבּוֹמַמָּש גַּםהַחוֹלהַזֶּהאֵיןבּוֹמַמָּש properName unspecified unspecified unspecified unspecified unspecified  	I_PERS	null
1 ׁ ׁ ׁ punctuation unspecified unspecified unspecified unspecified unspecified  	O	null
2 . . . punctuation unspecified unspecified unspecified unspecified unspecified  	O	null

0 וְגַםלֹאהַסַּרְטָןהַזּוֹחֵללִקְרָאתֵנו וְגַםלֹאהַסַּרְטָןהַזּוֹחֵללִקְרָאתֵנו וְגַםלֹאהַסַּרְטָןהַזּוֹחֵללִקְרָאתֵנו properName unspecified unspecified unspecified unspecified unspecified  	I_PERS	null
1 ּ ּ ּ punctuation unspecified unspecified unspecified unspecified unspecified  	O	null
2 . . . punctuation unspecified unspecified unspecified unspecified unspecified  	O	null

0 הוּאאֵינוֹמְבַקֵּשׁאוֹתָנו הוּאאֵינוֹמְבַקֵּשׁאוֹתָנו הוּאאֵינוֹמְבַקֵּשׁאוֹתָנו verb masculine-and-feminine plural unspecified 2 imperative  	O	null
1 ּ ּ ּ punctuation unspecified unspecified unspecified unspecified unspecified  	O	null
2 " " " punctuation unspecified unspecified unspecified unspecified unspecified  	O	null
3 ( ( ( punctuation unspecified unspecified unspecified unspecified unspecified  	O	null
4 מערבית מערבי מערבית noun feminine singular absolute unspecified unspecified  	O	null
5 : : : punctuation unspecified unspecified unspecified unspecified unspecified  	O	null
6 תאמר אמר תאמר verb feminine singular unspecified 3 future  	O	null
7 מצאלחה מצאלחה מצאלחה properName unspecified unspecified unspecified unspecified unspecified  	I_PERS	null
8 , , , punctuation unspecified unspecified unspecified unspecified unspecified  	O	null
9 , , , punctuation unspecified unspecified unspecified unspecified unspecified  	O	null
10 ###NUMBER### ###NUMBER### ###NUMBER### numeral unspecified unspecified unspecified unspecified unspecified  	I_DATE	null
11 ###NUMBER### ###NUMBER### ###NUMBER### numeral unspecified unspecified unspecified unspecified unspecified  	O	null
12 - - - punctuation unspecified unspecified unspecified unspecified unspecified  	O	null
13 ###NUMBER### ###NUMBER### ###NUMBER### numeral unspecified unspecified unspecified unspecified unspecified  	O	null
14 ) ) ) punctuation unspecified unspecified unspecified unspecified unspecified  	O	null
15 . . . punctuation unspecified unspecified unspecified unspecified unspecified  	O	null

0 ב ב ב preposition unspecified unspecified unspecified unspecified unspecified 0 	I_ORG	null
1 - - - punctuation unspecified unspecified unspecified unspecified unspecified  	I_ORG	null
2 ###NUMBER### ###NUMBER### ###NUMBER### numeral unspecified unspecified unspecified unspecified unspecified  	I_DATE	null
3 תורגמה תורגם תורגמה verb feminine singular unspecified 3 past  	O	null
4 יצירה יצירה יצירה noun feminine singular absolute unspecified unspecified  	O	null
5 קצרה קצר קצרה adjective feminine singular absolute unspecified unspecified  	O	null
6 פרי פרי פרי properName unspecified unspecified unspecified unspecified unspecified  	I_PERS	null
7 עטו עט עטו verb masculine-and-feminine plural unspecified 3 past  	O	null
8 מ מ מ preposition unspecified unspecified unspecified unspecified unspecified 0 	O	null
9 - - - punctuation unspecified unspecified unspecified unspecified unspecified  	O	null
10 , , , punctuation unspecified unspecified unspecified unspecified unspecified  	O	null
11 ###NUMBER### ###NUMBER### ###NUMBER### numeral unspecified unspecified unspecified unspecified unspecified  	I_DATE	null
12 " " " punctuation unspecified unspecified unspecified unspecified unspecified  	O	null
13 מ מ משני preposition unspecified unspecified unspecified unspecified unspecified 0 
13 שני שני משני noun masculine singular construct unspecified unspecified  	O	null
14 עד עד עד noun masculine singular absolute unspecified unspecified  	O	null
15 חמישי ORD5 חמישי numeral masculine singular absolute unspecified unspecified  	I_DATE	null
16 , , , punctuation unspecified unspecified unspecified unspecified unspecified  	O	null
17 אני הוא אני pronoun masculine-and-feminine singular unspecified 1 unspecified  	O	null
18 דורך דרך דורך verb masculine singular unspecified any beinoni  	O	null
19 על על על preposition unspecified unspecified unspecified unspecified unspecified  	O	null
20 עפרה עפרה עפרה noun feminine singular absolute unspecified unspecified  	O	null
21 של של של shel-preposition unspecified unspecified unspecified unspecified unspecified  	O	null
22 סלמה סלמה סלמה properName unspecified unspecified unspecified unspecified unspecified  	I_ORG	null
23 " " " punctuation unspecified unspecified unspecified unspecified unspecified  	O	null
24 ( ( ( punctuation unspecified unspecified unspecified unspecified unspecified  	O	null
25 מערבית מערבי מערבית noun feminine singular absolute unspecified unspecified  	O	null
26 : : : punctuation unspecified unspecified unspecified unspecified unspecified  	O	null
27 גיא גיא גיא properName unspecified unspecified unspecified unspecified unspecified  	I_PERS	null
28 רון רון רון properName unspecified unspecified unspecified unspecified unspecified  	I_PERS	null
29 גלבוע גלבוע גלבוע properName unspecified unspecified unspecified unspecified unspecified  	I_PERS	null
30 ) ) ) punctuation unspecified unspecified unspecified unspecified unspecified  	O	null
31 , , , punctuation unspecified unspecified unspecified unspecified unspecified  	O	null
32 בתוך בתוך בתוך preposition unspecified unspecified unspecified unspecified unspecified  	O	null
33 כתב כתב כתב noun masculine singular construct unspecified unspecified  	O	null
34 ה ה העת definiteArticle unspecified unspecified unspecified unspecified unspecified 0 
34 העת עת העת noun feminine singular absolute unspecified unspecified  	O	null
35 ל ל לרוחב preposition unspecified unspecified unspecified unspecified unspecified 0 
35 ה ה לרוחב definiteArticle unspecified unspecified unspecified unspecified unspecified 0 
35 הרוחב רוחב לרוחב noun masculine singular absolute unspecified unspecified  	O	null
36 : : : punctuation unspecified unspecified unspecified unspecified unspecified  	O	null
37 מגזין מגזין מגזין noun masculine singular construct unspecified unspecified  	O	null
38 גרילה גרילה גרילה noun feminine singular absolute unspecified unspecified  	O	null
39 תרבות תרבות תרבות noun feminine singular absolute unspecified unspecified  	O	null
40 . . . punctuation unspecified unspecified unspecified unspecified unspecified  	O	null

0 גם גם גם conjunction unspecified unspecified unspecified unspecified unspecified  	O	null
1 יצירה יצירה יצירה noun feminine singular absolute unspecified unspecified  	O	null
2 זו זו זו pronoun feminine singular unspecified 3 unspecified  	O	null
3 עוסקת עסק עוסקת verb feminine singular unspecified any beinoni  	O	null
4 ב ב בבעייתיות preposition unspecified unspecified unspecified unspecified unspecified 0 
4 ה ה בבעייתיות definiteArticle unspecified unspecified unspecified unspecified unspecified 0 
4 הבעייתיות בעייתי בבעייתיות adjective feminine plural absolute unspecified unspecified  	O	null
5 של של של shel-preposition unspecified unspecified unspecified unspecified unspecified  	O	null
6 סוגיית סוגיה סוגיית noun feminine singular construct unspecified unspecified  	O	null
7 ה ה הזהות definiteArticle unspecified unspecified unspecified unspecified unspecified 0 
7 הזהות זהות הזהות noun feminine singular absolute unspecified unspecified  	O	null
8 , , , punctuation unspecified unspecified unspecified unspecified unspecified  	O	null
9 כפי כפי כפי conjunction unspecified unspecified unspecified unspecified unspecified  	O	null
10 ש ש שהיא relativizer/subordinatingConjunction unspecified unspecified unspecified unspecified unspecified 0 
10 היא הוא שהיא pronoun feminine singular unspecified 3 unspecified  	O	null
11 משתמעת השתמע משתמעת verb feminine singular unspecified any beinoni  	O	null
12 מ מ משמותיו preposition unspecified unspecified unspecified unspecified unspecified 0 
12 שמותי שם משמותיו noun masculine plural absolute unspecified unspecified  
12 ו ו משמותיו possessive masculine singular unspecified 3 unspecified 0 	O	null
13 ה ה המשתנים definiteArticle unspecified unspecified unspecified unspecified unspecified 0 
13 המשתנים משתנה המשתנים adjective masculine plural absolute unspecified unspecified  	O	null
14 של של של shel-preposition unspecified unspecified unspecified unspecified unspecified  	O	null
15 מקום מקום מקום noun masculine singular absolute unspecified unspecified  	O	null
16 : : : punctuation unspecified unspecified unspecified unspecified unspecified  	I_LOC	null
17 רחוב רחוב רחוב noun masculine singular absolute unspecified unspecified  	I_LOC	null
18 ו ו ושמו conjunction unspecified unspecified unspecified unspecified unspecified 0 
18 שמו שם ושמו verb masculine-and-feminine plural unspecified 3 past  	O	null
19 דרך דרך דרך noun feminine singular absolute unspecified unspecified  	O	null
20 שלמה שלם שלמה adjective feminine singular absolute unspecified unspecified  	O	null
21 ב ב ביפו preposition unspecified unspecified unspecified unspecified unspecified 0 
21 יפו יפו ביפו properName unspecified unspecified unspecified unspecified unspecified  	I_LOC	null
22 , , , punctuation unspecified unspecified unspecified unspecified unspecified  	O	null
23 ש ש שהיה relativizer/subordinatingConjunction unspecified unspecified unspecified unspecified unspecified 0 
23 היה הוא שהיה copula masculine singular unspecified 3 past  	O	null
24 פעם פעם פעם adverb unspecified unspecified unspecified unspecified unspecified  	O	null
25 " " " punctuation unspecified unspecified unspecified unspecified unspecified  	O	null
26 אדמת אדמה אדמת noun feminine singular construct unspecified unspecified  	O	null
27 כפר כפר כפר properName unspecified unspecified unspecified unspecified unspecified  	I_ORG	null
28 סלמה סלמה סלמה properName unspecified unspecified unspecified unspecified unspecified  	I_ORG	null
29 " " " punctuation unspecified unspecified unspecified unspecified unspecified  	O	null
30 . . . punctuation unspecified unspecified unspecified unspecified unspecified  	O	null

0 References References References foreign unspecified unspecified unspecified unspecified unspecified  	O	null
1 : : : punctuation unspecified unspecified unspecified unspecified unspecified  	O	null
2 ناشف ناشف ناشف properName unspecified unspecified unspecified unspecified unspecified  	I_ORG	null
3 , , , punctuation unspecified unspecified unspecified unspecified unspecified  	O	null
4 إسماعيل إسماعيل إسماعيل properName unspecified unspecified unspecified unspecified unspecified  	I_PERS	null
5 . . . punctuation unspecified unspecified unspecified unspecified unspecified  	O	null

0 " " " punctuation unspecified unspecified unspecified unspecified unspecified  	I_ORG	null
1 في في في properName unspecified unspecified unspecified unspecified unspecified  	I_ORG	null
2 بحث بحث بحث adjective masculine singular construct unspecified unspecified  	O	null
3 عن عن عن adjective masculine singular construct unspecified unspecified  	O	null
4 راجي راجي راجي adjective masculine singular construct unspecified unspecified  	O	null
5 بطحيش بطحيش بطحيش adjective masculine singular construct unspecified unspecified  	O	null
6 " " " punctuation unspecified unspecified unspecified unspecified unspecified  	O	null
7 . . . punctuation unspecified unspecified unspecified unspecified unspecified  	O	null

0 قديتا قديتا قديتا properName unspecified unspecified unspecified unspecified unspecified  	I_PERS	null
1 . . . punctuation unspecified unspecified unspecified unspecified unspecified  	O	null

0 ###NUMEXP### ###NUMEXP### ###NUMEXP### numberExpression unspecified unspecified unspecified unspecified unspecified  	I_DATE	null
1 . . . punctuation unspecified unspecified unspecified unspecified unspecified  	O	null

