0 Name Name Name foreign unspecified unspecified unspecified unspecified unspecified  	O	null
1 : : : punctuation unspecified unspecified unspecified unspecified unspecified  	O	null
2 בן בן בן properName unspecified unspecified unspecified unspecified unspecified  	I_ORG	null
3 - - - properName unspecified unspecified unspecified unspecified unspecified  	I_ORG	null
4 יהודה יהודה יהודה properName unspecified unspecified unspecified unspecified unspecified  	I_ORG	null
5 , , , punctuation unspecified unspecified unspecified unspecified unspecified  	O	null
6 נתיב נתיב נתיבה noun masculine singular absolute unspecified unspecified  
6 ה ה נתיבה possessive feminine singular unspecified 3 unspecified 0 	O	null
7 Birth Birth Birth foreign unspecified unspecified unspecified unspecified unspecified  	O	null
8 Year Year Year foreign unspecified unspecified unspecified unspecified unspecified  	O	null
9 : : : punctuation unspecified unspecified unspecified unspecified unspecified  	O	null
10 ###NUMBER### ###NUMBER### ###NUMBER### numeral unspecified unspecified unspecified unspecified unspecified  	I_DATE	null
11 Death Death Death foreign unspecified unspecified unspecified unspecified unspecified  	O	null
12 Year Year Year foreign unspecified unspecified unspecified unspecified unspecified  	O	null
13 : : : punctuation unspecified unspecified unspecified unspecified unspecified  	O	null
14 ###NUMBER### ###NUMBER### ###NUMBER### numeral unspecified unspecified unspecified unspecified unspecified  	I_DATE	null
15 Birth Birth Birth foreign unspecified unspecified unspecified unspecified unspecified  	O	null
16 Place Place Place foreign unspecified unspecified unspecified unspecified unspecified  	O	null
17 : : : punctuation unspecified unspecified unspecified unspecified unspecified  	O	null
18 תלאביב תלאביב תלאביב noun masculine singular absolute unspecified unspecified  	O	null
19 ל ל להורים preposition unspecified unspecified unspecified unspecified unspecified 0 
19 ה ה להורים definiteArticle unspecified unspecified unspecified unspecified unspecified 0 
19 ההורים הורה להורים noun masculine plural absolute unspecified unspecified  	O	null
20 מ מ מאנשי preposition unspecified unspecified unspecified unspecified unspecified 0 
20 אנשי איש מאנשי noun masculine plural construct unspecified unspecified  	O	null
21 Occupation Occupation Occupation foreign unspecified unspecified unspecified unspecified unspecified  	O	null
22 : : : punctuation unspecified unspecified unspecified unspecified unspecified  	O	null
23 סופרת סופר סופרת noun feminine singular absolute unspecified unspecified  	O	null
24 ו ו ומילונאית conjunction unspecified unspecified unspecified unspecified unspecified 0 
24 מילונאי מילונאי ומילונאית noun masculine singular absolute unspecified unspecified  
24 ו ו ומילונאית possessive masculine singular unspecified 3 unspecified 0 	O	null
25 Entry Entry Entry foreign unspecified unspecified unspecified unspecified unspecified  	O	null
26 writer writer writer foreign unspecified unspecified unspecified unspecified unspecified  	O	null
27 : : : punctuation unspecified unspecified unspecified unspecified unspecified  	O	null
28 ישראל ישראל ישראל properName unspecified unspecified unspecified unspecified unspecified  	I_LOC	null
29 ל ל לנדרס preposition unspecified unspecified unspecified unspecified unspecified 0 
29 נדרס נדרס לנדרס participle masculine singular construct any unspecified  	O	null
30 Entry Entry Entry foreign unspecified unspecified unspecified unspecified unspecified  	O	null
31 Value Value Value foreign unspecified unspecified unspecified unspecified unspecified  	O	null
32 : : : punctuation unspecified unspecified unspecified unspecified unspecified  	O	null
33 נולדה נולד נולדה verb feminine singular unspecified 3 past  	O	null
34 בתלאביב בתלאביב בתלאביב noun feminine singular absolute unspecified unspecified  	O	null
35 ל ל להורים preposition unspecified unspecified unspecified unspecified unspecified 0 
35 ה ה להורים definiteArticle unspecified unspecified unspecified unspecified unspecified 0 
35 ההורים הורה להורים noun masculine plural absolute unspecified unspecified  	O	null
36 מ מ מאנשי preposition unspecified unspecified unspecified unspecified unspecified 0 
36 אנשי איש מאנשי noun masculine plural construct unspecified unspecified  	O	null
37 ה ה העלייה definiteArticle unspecified unspecified unspecified unspecified unspecified 0 
37 העלייה עלייה העלייה noun feminine singular absolute unspecified unspecified  	O	null
38 ה ה השנייה definiteArticle unspecified unspecified unspecified unspecified unspecified 0 
38 השנייה ORD2 השנייה numeral feminine singular absolute unspecified unspecified  	O	null
39 . . . punctuation unspecified unspecified unspecified unspecified unspecified  	O	null

0 אביה אביה אביה properName unspecified unspecified unspecified unspecified unspecified  	I_PERS	null
1 , , , punctuation unspecified unspecified unspecified unspecified unspecified  	O	null
2 ד"ר ד"ר ד"ר title unspecified singular unspecified unspecified unspecified  	O	null
3 ברוך ברוך ברוך properName unspecified unspecified unspecified unspecified unspecified  	I_PERS	null
4 בן בן בן properName unspecified unspecified unspecified unspecified unspecified  	I_PERS	null
5 - - - properName unspecified unspecified unspecified unspecified unspecified  	I_PERS	null
6 יהודה יהודה יהודה properName unspecified unspecified unspecified unspecified unspecified  	I_PERS	null
7 , , , punctuation unspecified unspecified unspecified unspecified unspecified  	O	null
8 בוגר בוגר בוגר noun masculine singular construct unspecified unspecified  	O	null
9 ה ה המחזור definiteArticle unspecified unspecified unspecified unspecified unspecified 0 
9 המחזור מחזור המחזור noun masculine singular absolute unspecified unspecified  	O	null
10 ה ה השני definiteArticle unspecified unspecified unspecified unspecified unspecified 0 
10 השני ORD2 השני numeral masculine singular absolute unspecified unspecified  	O	null
11 ב ב בגימנסיה preposition unspecified unspecified unspecified unspecified unspecified 0 
11 ה ה בגימנסיה definiteArticle unspecified unspecified unspecified unspecified unspecified 0 
11 הגימנסיה הגימנסיה בגימנסיה noun feminine singular absolute unspecified unspecified  	O	null
12 " " " punctuation unspecified unspecified unspecified unspecified unspecified  	O	null
13 הרצליה הרצליה הרצליה properName unspecified unspecified unspecified unspecified unspecified  	I_ORG	null
14 " " " punctuation unspecified unspecified unspecified unspecified unspecified  	O	null
15 , , , punctuation unspecified unspecified unspecified unspecified unspecified  	O	null
16 היה הוא היה copula masculine singular unspecified 3 past  	O	null
17 לימים לימים לימים adverb unspecified unspecified unspecified unspecified unspecified  	O	null
18 מנהל מנהל מנהלה noun masculine singular absolute unspecified unspecified  
18 ה ה מנהלה possessive feminine singular unspecified 3 unspecified 0 	O	null
19 ו ו ונשיאה conjunction unspecified unspecified unspecified unspecified unspecified 0 
19 נשיא נשיא ונשיאה noun masculine singular absolute unspecified unspecified  
19 ה ה ונשיאה possessive feminine singular unspecified 3 unspecified 0 	O	null
20 . . . punctuation unspecified unspecified unspecified unspecified unspecified  	O	null

0 כמו כמו כמו conjunction unspecified unspecified unspecified unspecified unspecified  	O	null
1 כן כן כן conjunction unspecified unspecified unspecified unspecified unspecified  	O	null
2 היה הוא היה copula masculine singular unspecified 3 past  	O	null
3 מנהל מנהל מנהל noun masculine singular construct unspecified unspecified  	O	null
4 מחלקת מחלק מחלקת noun feminine singular construct unspecified unspecified  	O	null
5 ה ה החינוך definiteArticle unspecified unspecified unspecified unspecified unspecified 0 
5 החינוך חינוך החינוך noun masculine singular absolute unspecified unspecified  	O	null
6 של של של shel-preposition unspecified unspecified unspecified unspecified unspecified  	O	null
7 ה ה הוועד definiteArticle unspecified unspecified unspecified unspecified unspecified 0 
7 הוועד ועד הוועד noun masculine singular absolute unspecified unspecified  	O	null
8 ה ה הלאומי definiteArticle unspecified unspecified unspecified unspecified unspecified 0 
8 הלאומי לאומי הלאומי adjective masculine singular absolute unspecified unspecified  	O	null
9 ו ו ומנכ"ל conjunction unspecified unspecified unspecified unspecified unspecified 0 
9 מנכ"ל מנכ"ל ומנכ"ל noun masculine singular construct unspecified unspecified  	O	null
10 ראשון ORD1 ראשון numeral masculine singular absolute unspecified unspecified  	O	null
11 של של של shel-preposition unspecified unspecified unspecified unspecified unspecified  	O	null
12 משרד משרד משרד noun masculine singular construct unspecified unspecified  	I_ORG	null
13 ה ה החינוך definiteArticle unspecified unspecified unspecified unspecified unspecified 0 
13 החינוך חינוך החינוך noun masculine singular absolute unspecified unspecified  	I_ORG	null
14 ו ו והתרבות conjunction unspecified unspecified unspecified unspecified unspecified 0 
14 ה ה והתרבות definiteArticle unspecified unspecified unspecified unspecified unspecified 0 
14 התרבות תרבות והתרבות noun feminine singular absolute unspecified unspecified  	I_ORG	null
15 . . . punctuation unspecified unspecified unspecified unspecified unspecified  	O	null

0 למדה למד למדה verb feminine singular unspecified 3 past  	O	null
1 ב ב בביתהספר preposition unspecified unspecified unspecified unspecified unspecified 0 
1 ביתהסף ביתהסף בביתהספר noun masculine-and-feminine plural absolute unspecified unspecified  
1 י י בביתהספר possessive masculine-and-feminine singular unspecified 1 unspecified 0 	O	null
2 ה ה החקלאי definiteArticle unspecified unspecified unspecified unspecified unspecified 0 
2 החקלאי חקלאי החקלאי adjective masculine singular absolute unspecified unspecified  	O	null
3 " " " punctuation unspecified unspecified unspecified unspecified unspecified  	O	null
4 מקווה מקווה מקווה properName unspecified unspecified unspecified unspecified unspecified  	I_ORG	null
5 ישראל ישראל ישראל properName unspecified unspecified unspecified unspecified unspecified  	I_ORG	null
6 " " " punctuation unspecified unspecified unspecified unspecified unspecified  	O	null
7 ובגימנסיה ובגימנסיה ובגימנסיה properName unspecified unspecified unspecified unspecified unspecified  	I_ORG	null
8 " " " punctuation unspecified unspecified unspecified unspecified unspecified  	O	null
9 הרצליה הרצליה הרצליה properName unspecified unspecified unspecified unspecified unspecified  	I_ORG	null
10 " " " punctuation unspecified unspecified unspecified unspecified unspecified  	O	null
11 . . . punctuation unspecified unspecified unspecified unspecified unspecified  	O	null

0 ב ב בנעוריה preposition unspecified unspecified unspecified unspecified unspecified 0 
0 נעורי נעורים בנעוריה noun masculine plural absolute unspecified unspecified  
0 ה ה בנעוריה possessive feminine singular unspecified 3 unspecified 0 	O	null
1 היתה הוא היתה copula feminine singular unspecified 3 past  	O	null
2 אתלטית אתלט אתלטית noun feminine singular absolute unspecified unspecified  	O	null
3 מוכשרת מוכשר מוכשרת adjective feminine singular absolute unspecified unspecified  	O	null
4 ו ו ובעלת conjunction unspecified unspecified unspecified unspecified unspecified 0 
4 בעלת בעל ובעלת noun feminine singular construct unspecified unspecified  	O	null
5 סיכויים סיכוי סיכויים noun masculine plural absolute unspecified unspecified  	O	null
6 להתחרות התחרה להתחרות verb unspecified unspecified unspecified unspecified infinitive  	O	null
7 ב ב בהדיפת preposition unspecified unspecified unspecified unspecified unspecified 0 
7 הדיפת הדיפה בהדיפת noun feminine singular construct unspecified unspecified  	O	null
8 כדור כדור כדור noun masculine singular construct unspecified unspecified  	O	null
9 - - - punctuation unspecified unspecified unspecified unspecified unspecified  	O	null
10 ברזל ברזל ברזל noun masculine singular absolute unspecified unspecified  	O	null
11 ב ב באולימפיאדה preposition unspecified unspecified unspecified unspecified unspecified 0 
11 ה ה באולימפיאדה definiteArticle unspecified unspecified unspecified unspecified unspecified 0 
11 האולימפיאדה אולימפיאדה באולימפיאדה noun feminine singular absolute unspecified unspecified  	O	null
12 של של של shel-preposition unspecified unspecified unspecified unspecified unspecified  	O	null
13 , , , punctuation unspecified unspecified unspecified unspecified unspecified  	O	null
14 ###NUMBER### ###NUMBER### ###NUMBER### numeral unspecified unspecified unspecified unspecified unspecified  	I_DATE	null
15 אבל אבל אבל conjunction unspecified unspecified unspecified unspecified unspecified  	O	null
16 כדור כדור כדור noun masculine singular construct unspecified unspecified  	O	null
17 אקדח אקדח אקדח noun masculine singular absolute unspecified unspecified  	O	null
18 שירה שירה שירה noun feminine singular absolute unspecified unspecified  	O	null
19 אנגלי אנגלי אנגלי adjective masculine singular absolute unspecified unspecified  	O	null
20 ב ב ברחוב preposition unspecified unspecified unspecified unspecified unspecified 0 
20 רחוב רחוב ברחוב noun masculine singular construct unspecified unspecified  	I_LOC	null
21 תל תל תל properName unspecified unspecified unspecified unspecified unspecified  	I_LOC	null
22 - - - punctuation unspecified unspecified unspecified unspecified unspecified  	O	null
23 אביבי אביבי אביבי adjective masculine singular absolute unspecified unspecified  	O	null
24 פגע פגע פגע verb masculine singular unspecified 3 past  	O	null
25 ב ב בזרועה preposition unspecified unspecified unspecified unspecified unspecified 0 
25 זרוע זרוע בזרועה noun feminine singular absolute unspecified unspecified  
25 ה ה בזרועה possessive feminine singular unspecified 3 unspecified 0 	O	null
26 ו ו ומנע conjunction unspecified unspecified unspecified unspecified unspecified 0 
26 מנע מנע ומנע verb masculine singular unspecified 3 past  	O	null
27 מן מן ממנה preposition unspecified unspecified unspecified unspecified unspecified  
27 ה ה ממנה pronomial feminine singular unspecified 3 unspecified 0 	O	null
28 את את את at-preposition unspecified unspecified unspecified unspecified unspecified  	O	null
29 ה ה ההשתתפות definiteArticle unspecified unspecified unspecified unspecified unspecified 0 
29 ההשתתפות השתתפות ההשתתפות noun feminine singular absolute unspecified unspecified  	O	null
30 ב ב בתחרות preposition unspecified unspecified unspecified unspecified unspecified 0 
30 ה ה בתחרות definiteArticle unspecified unspecified unspecified unspecified unspecified 0 
30 התחרות תחרות בתחרות noun feminine singular absolute unspecified unspecified  	O	null
31 . . . punctuation unspecified unspecified unspecified unspecified unspecified  	O	null

0 ב ב בתום preposition unspecified unspecified unspecified unspecified unspecified 0 
0 תום תום בתום noun masculine singular construct unspecified unspecified  	O	null
1 לימודי לימוד לימודיה noun masculine plural absolute unspecified unspecified  
1 ה ה לימודיה possessive feminine singular unspecified 3 unspecified 0 	O	null
2 ה ה התיכוניים definiteArticle unspecified unspecified unspecified unspecified unspecified 0 
2 התיכוניים תיכוני התיכוניים adjective masculine plural absolute unspecified unspecified  	O	null
3 ( ( ( punctuation unspecified unspecified unspecified unspecified unspecified  	O	null
4 ###NUMBER### ###NUMBER### ###NUMBER### numeral unspecified unspecified unspecified unspecified unspecified  	I_DATE	null
5 ) ) ) punctuation unspecified unspecified unspecified unspecified unspecified  	O	null
6 הצטרפה הצטרף הצטרפה verb feminine singular unspecified 3 past  	O	null
7 ל ל לפלמ"ח preposition unspecified unspecified unspecified unspecified unspecified 0 
7 פלמ"ח פלמ"ח לפלמ"ח properName unspecified unspecified unspecified unspecified unspecified  	I_ORG	null
8 ו ו ועברה conjunction unspecified unspecified unspecified unspecified unspecified 0 
8 עברה עבר ועברה verb feminine singular unspecified 3 past  	O	null
9 ב ב בהצטיינות preposition unspecified unspecified unspecified unspecified unspecified 0 
9 הצטיינות הצטיינות בהצטיינות noun feminine singular construct unspecified unspecified  	O	null
10 קורס קורס קורס noun masculine singular construct unspecified unspecified  	O	null
11 סיירות סיירת סיירות noun feminine plural absolute unspecified unspecified  	O	null
12 ו ו וטופוגרפיה conjunction unspecified unspecified unspecified unspecified unspecified 0 
12 טופוגרפיה טופוגרפיה וטופוגרפיה noun feminine singular absolute unspecified unspecified  	O	null
13 , , , punctuation unspecified unspecified unspecified unspecified unspecified  	O	null
14 קורס קורס קורס noun masculine singular absolute unspecified unspecified  	O	null
15 מ מ מ preposition unspecified unspecified unspecified unspecified unspecified 0 	O	null
16 " " " punctuation unspecified unspecified unspecified unspecified unspecified  	O	null
17 כ כ כים preposition unspecified unspecified unspecified unspecified unspecified 0 
17 ה ה כים definiteArticle unspecified unspecified unspecified unspecified unspecified 0 
17 הים ים כים noun masculine singular absolute unspecified unspecified  	O	null
18 ו ו וקורס conjunction unspecified unspecified unspecified unspecified unspecified 0 
18 קורס קורס וקורס noun masculine singular construct unspecified unspecified  	O	null
19 קציני קצין קציני noun masculine plural construct unspecified unspecified  	O	null
20 חבלה חבלה חבלה noun feminine singular absolute unspecified unspecified  	O	null
21 . . . punctuation unspecified unspecified unspecified unspecified unspecified  	O	null

0 ב ב בפרוץ preposition unspecified unspecified unspecified unspecified unspecified 0 
0 פרוץ פרץ בפרוץ participle masculine singular construct any unspecified  	O	null
1 מלחמת מלחמה מלחמת noun feminine singular construct unspecified unspecified  	O	null
2 ה ה העצמאות definiteArticle unspecified unspecified unspecified unspecified unspecified 0 
2 העצמאות עצמאות העצמאות noun feminine singular absolute unspecified unspecified  	O	null
3 גילתה גילה גילתה verb feminine singular unspecified 3 past  	O	null
4 אומץ אומץ אומץ noun masculine singular absolute unspecified unspecified  	O	null
5 לב לב לב noun masculine singular absolute unspecified unspecified  	O	null
6 כ כ כחבלנית preposition unspecified unspecified unspecified unspecified unspecified 0 
6 חבלנית חבלן כחבלנית noun feminine singular absolute unspecified unspecified  	O	null
7 ו ו וכמפקדת conjunction unspecified unspecified unspecified unspecified unspecified 0 
7 כ כ וכמפקדת preposition unspecified unspecified unspecified unspecified unspecified 0 
7 מפקדת מפקד וכמפקדת noun feminine singular construct unspecified unspecified  	O	null
8 ב ב בקרבות preposition unspecified unspecified unspecified unspecified unspecified 0 
8 קרבות קרב בקרבות noun masculine plural construct unspecified unspecified  	O	null
9 ה ה הגליל definiteArticle unspecified unspecified unspecified unspecified unspecified 0 
9 הגליל גליל הגליל properName unspecified unspecified unspecified unspecified unspecified  	I_LOC	null
10 , , , punctuation unspecified unspecified unspecified unspecified unspecified  	O	null
11 ו ו והתפרסמה conjunction unspecified unspecified unspecified unspecified unspecified 0 
11 התפרסמה התפרסם והתפרסמה verb feminine singular unspecified 3 past  	O	null
12 בקרב בקרב בקרב preposition unspecified unspecified unspecified unspecified unspecified  	O	null
13 ה ה הערבים definiteArticle unspecified unspecified unspecified unspecified unspecified 0 
13 הערבים ערב הערבים noun masculine plural absolute unspecified unspecified  	O	null
14 ב ב בכינוי preposition unspecified unspecified unspecified unspecified unspecified 0 
14 ה ה בכינוי definiteArticle unspecified unspecified unspecified unspecified unspecified 0 
14 הכינוי כינוי בכינוי noun masculine singular absolute unspecified unspecified  	O	null
15 " " " punctuation unspecified unspecified unspecified unspecified unspecified  	O	null
16 ה ה השֵדה definiteArticle unspecified unspecified unspecified unspecified unspecified 0 
16 השֵדה השֵדה השֵדה participle feminine singular absolute any unspecified  	O	null
17 ה ה הצהובה definiteArticle unspecified unspecified unspecified unspecified unspecified 0 
17 הצהובה צהוב הצהובה adjective feminine singular absolute unspecified unspecified  	O	null
18 " " " punctuation unspecified unspecified unspecified unspecified unspecified  	O	null
19 בשל בשל בשל preposition unspecified unspecified unspecified unspecified unspecified  	O	null
20 צבע צבע צבע noun masculine singular construct unspecified unspecified  	O	null
21 שערה שערה שערה noun feminine singular absolute unspecified unspecified  	O	null
22 , , , punctuation unspecified unspecified unspecified unspecified unspecified  	O	null
23 ו ו ואף conjunction unspecified unspecified unspecified unspecified unspecified 0 
23 אף אף ואף conjunction unspecified unspecified unspecified unspecified unspecified  	O	null
24 נקבע נקבע נקבע verb masculine singular unspecified 3 past  	O	null
25 פרס פרס פרס noun masculine singular absolute unspecified unspecified  	O	null
26 בסך בסך בסך adverb unspecified unspecified unspecified unspecified unspecified  	O	null
27 אלף ORD-CARD1000 אלף numeral masculine plural absolute unspecified unspecified  	O	null
28 לירות לירה לירות noun feminine plural absolute unspecified unspecified  	O	null
29 על על על preposition unspecified unspecified unspecified unspecified unspecified  	O	null
30 ראש ראש ראשה noun masculine singular absolute unspecified unspecified  
30 ה ה ראשה possessive feminine singular unspecified 3 unspecified 0 	O	null
31 . . . punctuation unspecified unspecified unspecified unspecified unspecified  	O	null

0 בעקבות בעקבות בעקבות preposition unspecified unspecified unspecified unspecified unspecified  	O	null
1 חוויות חוויה חוויות noun feminine plural construct unspecified unspecified  	O	null
2 לחימה לחימה לחימה noun feminine singular absolute unspecified unspecified  	O	null
3 קשות קשה קשות adjective feminine plural absolute unspecified unspecified  	O	null
4 ו ו ונזיפה conjunction unspecified unspecified unspecified unspecified unspecified 0 
4 נזיפה נזיפה ונזיפה noun feminine singular absolute unspecified unspecified  	O	null
5 לא לא לא negation unspecified unspecified unspecified unspecified unspecified  	O	null
6 מוצדקת הוצדק מוצדקת participle feminine singular absolute any unspecified  	O	null
7 של של של shel-preposition unspecified unspecified unspecified unspecified unspecified  	O	null
8 מפקדה מפקדה מפקדה noun feminine singular absolute unspecified unspecified  	O	null
9 ב ב בעניין preposition unspecified unspecified unspecified unspecified unspecified 0 
9 עניין עניין בעניין noun masculine singular construct unspecified unspecified  	O	null
10 תפקוד תפקוד תפקודה noun masculine singular absolute unspecified unspecified  
10 ה ה תפקודה possessive feminine singular unspecified 3 unspecified 0 	O	null
11 , , , punctuation unspecified unspecified unspecified unspecified unspecified  	O	null
12 סבלה סבל סבלה verb feminine singular unspecified 3 past  	O	null
13 מ מ מהלם preposition unspecified unspecified unspecified unspecified unspecified 0 
13 הלם הלם מהלם noun masculine singular construct unspecified unspecified  	O	null
14 קרב קרב קרב noun masculine singular absolute unspecified unspecified  	O	null
15 . . . punctuation unspecified unspecified unspecified unspecified unspecified  	O	null

0 אחרי אחרי אחרי preposition unspecified unspecified unspecified unspecified unspecified  	O	null
1 ששת CARD6 ששת numeral masculine plural construct unspecified unspecified  	O	null
2 חודשי חודש חודשי noun masculine plural construct unspecified unspecified  	O	null
3 ה ה המלחמה definiteArticle unspecified unspecified unspecified unspecified unspecified 0 
3 המלחמה מלחמה המלחמה noun feminine singular absolute unspecified unspecified  	O	null
4 ה ה הראשונים definiteArticle unspecified unspecified unspecified unspecified unspecified 0 
4 הראשונים ORD1 הראשונים numeral masculine plural absolute unspecified unspecified  	O	null
5 מילאה מילא מילאה verb feminine singular unspecified 3 past  	O	null
6 תפקיד תפקיד תפקידי noun masculine singular absolute unspecified unspecified  
6 י י תפקידי possessive masculine-and-feminine singular unspecified 1 unspecified 0 	O	null
7 מנהלה מנהלה מנהלה noun feminine singular absolute unspecified unspecified  	O	null
8 , , , punctuation unspecified unspecified unspecified unspecified unspecified  	O	null
9 הדרכה הדרכה הדרכה noun feminine singular absolute unspecified unspecified  	O	null
10 ו ו וחבלה conjunction unspecified unspecified unspecified unspecified unspecified 0 
10 חבלה חבלה וחבלה noun feminine singular absolute unspecified unspecified  	O	null
11 עד עד עד preposition unspecified unspecified unspecified unspecified unspecified  	O	null
12 גמר גמר גמר noun masculine singular construct unspecified unspecified  	O	null
13 שירות שירות שירותה noun masculine singular absolute unspecified unspecified  
13 ה ה שירותה possessive feminine singular unspecified 3 unspecified 0 	O	null
14 ה ה הצבאי definiteArticle unspecified unspecified unspecified unspecified unspecified 0 
14 הצבאי צבאי הצבאי adjective masculine singular absolute unspecified unspecified  	O	null
15 ) ) ) punctuation unspecified unspecified unspecified unspecified unspecified  	O	null
16 . . . punctuation unspecified unspecified unspecified unspecified unspecified  	O	null
17 ###NUMBER### ###NUMBER### ###NUMBER### numeral unspecified unspecified unspecified unspecified unspecified  	I_DATE	null
18 ב ב בשנות preposition unspecified unspecified unspecified unspecified unspecified 0 
18 שנות שנה בשנות noun feminine plural construct unspecified unspecified  	I_DATE	null
19 ה ה החמישים definiteArticle unspecified unspecified unspecified unspecified unspecified 0 
19 החמישים ORD-CARD50 החמישים numeral masculine plural absolute unspecified unspecified  	I_DATE	null
20 למדה למד למדה verb feminine singular unspecified 3 past  	O	null
21 פיסול פיסול פיסול noun masculine singular absolute unspecified unspecified  	O	null
22 ב ב בארץ preposition unspecified unspecified unspecified unspecified unspecified 0 
22 ה ה בארץ definiteArticle unspecified unspecified unspecified unspecified unspecified 0 
22 הארץ ארץ בארץ noun feminine singular absolute unspecified unspecified  	O	null
23 ו ו ובאנגליה conjunction unspecified unspecified unspecified unspecified unspecified 0 
23 ב ב ובאנגליה preposition unspecified unspecified unspecified unspecified unspecified 0 
23 אנגליה אנגלי ובאנגליה properName unspecified unspecified unspecified unspecified unspecified  	I_LOC	null
24 , , , punctuation unspecified unspecified unspecified unspecified unspecified  	O	null
25 ו ו ובשובה conjunction unspecified unspecified unspecified unspecified unspecified 0 
25 ב ב ובשובה preposition unspecified unspecified unspecified unspecified unspecified 0 
25 שובה שובה ובשובה noun masculine singular absolute unspecified unspecified  	O	null
26 מ מ מחו"ל preposition unspecified unspecified unspecified unspecified unspecified 0 
26 חו"ל חו"ל מחו"ל noun masculine singular absolute unspecified unspecified  	O	null
27 למדה למד למדה verb feminine singular unspecified 3 past  	O	null
28 בלשנות בלשנות בלשנות noun feminine singular absolute unspecified unspecified  	O	null
29 , , , punctuation unspecified unspecified unspecified unspecified unspecified  	O	null
30 לשון לשון לשון noun feminine singular construct unspecified unspecified  	O	null
31 עברית עברית עברית properName feminine singular unspecified unspecified unspecified  	O	null
32 ו ו ופילוסופיה conjunction unspecified unspecified unspecified unspecified unspecified 0 
32 פילוסופיה פילוסופיה ופילוסופיה noun feminine singular absolute unspecified unspecified  	O	null
33 ב ב באוניברסיטה preposition unspecified unspecified unspecified unspecified unspecified 0 
33 ה ה באוניברסיטה definiteArticle unspecified unspecified unspecified unspecified unspecified 0 
33 האוניברסיטה אוניברסיטה באוניברסיטה noun feminine singular absolute unspecified unspecified  	O	null
34 ה ה העברית definiteArticle unspecified unspecified unspecified unspecified unspecified 0 
34 העברית עברי העברית adjective feminine singular absolute unspecified unspecified  	O	null
35 ב ב בירושלים preposition unspecified unspecified unspecified unspecified unspecified 0 
35 ירושלים ירושלים בירושלים properName unspecified unspecified unspecified unspecified unspecified  	I_LOC	null
36 . . . punctuation unspecified unspecified unspecified unspecified unspecified  	O	null

0 ב ב ב preposition unspecified unspecified unspecified unspecified unspecified 0 	O	null
1 - - - punctuation unspecified unspecified unspecified unspecified unspecified  	O	null
2 ###NUMBER### ###NUMBER### ###NUMBER### numeral unspecified unspecified unspecified unspecified unspecified  	I_DATE	null
3 מונתה מונה מונתה verb feminine singular unspecified 3 past  	O	null
4 ל ל לדוברת preposition unspecified unspecified unspecified unspecified unspecified 0 
4 דוברת דובר לדוברת noun feminine singular construct unspecified unspecified  	O	null
5 משרד משרד משרד noun masculine singular construct unspecified unspecified  	I_ORG	null
6 ה ה העבודה definiteArticle unspecified unspecified unspecified unspecified unspecified 0 
6 העבודה עבודה העבודה noun feminine singular absolute unspecified unspecified  	I_ORG	null
7 , , , punctuation unspecified unspecified unspecified unspecified unspecified  	O	null
8 ו ו ובאותו conjunction unspecified unspecified unspecified unspecified unspecified 0 
8 ב ב ובאותו preposition unspecified unspecified unspecified unspecified unspecified 0 
8 אותו אותו ובאותו quantifier unspecified unspecified construct unspecified unspecified  	O	null
9 זמן זמן זמן noun masculine singular absolute unspecified unspecified  	O	null
10 החלה החל החלה verb feminine singular unspecified 3 past  	O	null
11 ב ב במימוש preposition unspecified unspecified unspecified unspecified unspecified 0 
11 מימוש מימוש במימוש noun masculine singular construct unspecified unspecified  	O	null
12 יוזמת יוזמה יוזמתה noun feminine singular absolute unspecified unspecified  
12 ה ה יוזמתה possessive feminine singular unspecified 3 unspecified 0 	O	null
13 ל ל להוצאת preposition unspecified unspecified unspecified unspecified unspecified 0 
13 הוצאת הוצאה להוצאת noun feminine singular construct unspecified unspecified  	O	null
14 מילון מילון מילון noun masculine singular absolute unspecified unspecified  	O	null
15 ל ל לעברית preposition unspecified unspecified unspecified unspecified unspecified 0 
15 עברית עברית לעברית properName feminine singular unspecified unspecified unspecified  	O	null
16 מדוברת מדובר מדוברת adjective feminine singular absolute unspecified unspecified  	O	null
17 , , , punctuation unspecified unspecified unspecified unspecified unspecified  	O	null
18 ו ו ולצורך conjunction unspecified unspecified unspecified unspecified unspecified 0 
18 ל ל ולצורך preposition unspecified unspecified unspecified unspecified unspecified 0 
18 צורך צורך ולצורך noun masculine singular absolute unspecified unspecified  	O	null
19 זה זה זה pronoun masculine singular unspecified 3 unspecified  	O	null
20 שיתפה שיתף שיתפה verb feminine singular unspecified 3 past  	O	null
21 פעולה פעולה פעולה noun feminine singular absolute unspecified unspecified  	O	null
22 עם עם עם preposition unspecified unspecified unspecified unspecified unspecified  	O	null
23 דן דן דן properName unspecified unspecified unspecified unspecified unspecified  	I_PERS	null
24 בן בן בן properName unspecified unspecified unspecified unspecified unspecified  	I_PERS	null
25 - - - properName unspecified unspecified unspecified unspecified unspecified  	I_PERS	null
26 אמוץ אמוץ אמוץ properName unspecified unspecified unspecified unspecified unspecified  	I_PERS	null
27 . . . punctuation unspecified unspecified unspecified unspecified unspecified  	O	null

0 היא הוא היא pronoun feminine singular unspecified 3 unspecified  	O	null
1 היתה הוא היתה copula feminine singular unspecified 3 past  	O	null
2 אחראית אחראי אחראית adjective feminine singular absolute unspecified unspecified  	O	null
3 ל ל לתחום preposition unspecified unspecified unspecified unspecified unspecified 0 
3 ה ה לתחום definiteArticle unspecified unspecified unspecified unspecified unspecified 0 
3 התחום תחום לתחום noun masculine singular absolute unspecified unspecified  	O	null
4 ה ה הלשוני definiteArticle unspecified unspecified unspecified unspecified unspecified 0 
4 הלשוני לשוני הלשוני adjective masculine singular absolute unspecified unspecified  	O	null
5 – – – punctuation unspecified unspecified unspecified unspecified unspecified  	O	null
6 איסוף איסוף איסוף noun masculine singular construct unspecified unspecified  	O	null
7 ה ה המילים definiteArticle unspecified unspecified unspecified unspecified unspecified 0 
7 המילים מילה המילים noun feminine plural absolute unspecified unspecified  	O	null
8 , , , punctuation unspecified unspecified unspecified unspecified unspecified  	O	null
9 ניקוד ניקוד ניקודן noun masculine singular absolute unspecified unspecified  
9 ן ן ניקודן possessive feminine plural unspecified 3 unspecified 0 	O	null
10 ו ו והגדרתן conjunction unspecified unspecified unspecified unspecified unspecified 0 
10 הגדרת הגדרה והגדרתן noun feminine singular absolute unspecified unspecified  
10 ן ן והגדרתן possessive feminine plural unspecified 3 unspecified 0 	O	null
11 – – – punctuation unspecified unspecified unspecified unspecified unspecified  	O	null
12 ו ו והוא conjunction unspecified unspecified unspecified unspecified unspecified 0 
12 הוא הוא והוא pronoun masculine singular unspecified 3 unspecified  	O	null
13 כתב כתב כתב verb masculine singular unspecified 3 past  	O	null
14 ב ב בנימה preposition unspecified unspecified unspecified unspecified unspecified 0 
14 נימה נימה בנימה noun feminine singular absolute unspecified unspecified  	O	null
15 הומוריסטית הומוריסטי הומוריסטית adjective feminine singular absolute unspecified unspecified  	O	null
16 את את את at-preposition unspecified unspecified unspecified unspecified unspecified  	O	null
17 ה ה המובאות definiteArticle unspecified unspecified unspecified unspecified unspecified 0 
17 המובאות מובאה המובאות noun feminine plural absolute unspecified unspecified  	O	null
18 , , , punctuation unspecified unspecified unspecified unspecified unspecified  	O	null
19 ה ה המדגימות definiteArticle unspecified unspecified unspecified unspecified unspecified 0 
19 המדגימות הדגים המדגימות participle feminine plural absolute any unspecified  	O	null
20 את את את at-preposition unspecified unspecified unspecified unspecified unspecified  	O	null
21 ה ה השימוש definiteArticle unspecified unspecified unspecified unspecified unspecified 0 
21 השימוש שימוש השימוש noun masculine singular absolute unspecified unspecified  	O	null
22 ב ב במילות preposition unspecified unspecified unspecified unspecified unspecified 0 
22 מילות מילה במילות noun feminine plural construct unspecified unspecified  	O	null
23 ה ה העגה definiteArticle unspecified unspecified unspecified unspecified unspecified 0 
23 העגה עגה העגה noun feminine singular absolute unspecified unspecified  	O	null
24 . . . punctuation unspecified unspecified unspecified unspecified unspecified  	O	null

0 ה ה המילון definiteArticle unspecified unspecified unspecified unspecified unspecified 0 
0 המילון מילון המילון noun masculine singular absolute unspecified unspecified  	O	null
1 יצא יצא יצא verb masculine singular unspecified 3 past  	O	null
2 לאור לאור לאור preposition unspecified unspecified unspecified unspecified unspecified  	O	null
3 ב ב בשני preposition unspecified unspecified unspecified unspecified unspecified 0 
3 שני שני בשני noun masculine singular construct unspecified unspecified  	O	null
4 חלקים חלק חלקים noun masculine plural absolute unspecified unspecified  	O	null
5 ( ( ( punctuation unspecified unspecified unspecified unspecified unspecified  	O	null
6 מילון מילון מילון noun masculine singular absolute unspecified unspecified  	O	null
7 עולמי עולמי עולמי adjective masculine singular absolute unspecified unspecified  	O	null
8 ל ל לעברית preposition unspecified unspecified unspecified unspecified unspecified 0 
8 עברית עברית לעברית properName feminine singular unspecified unspecified unspecified  	I_DATE	null
9 מדוברת מדובר מדוברת adjective feminine singular absolute unspecified unspecified  	O	null
10 , , , punctuation unspecified unspecified unspecified unspecified unspecified  	O	null
11 ; ; ; punctuation unspecified unspecified unspecified unspecified unspecified  	O	null
12 מילון מילון מילון noun masculine singular construct unspecified unspecified  	O	null
13 ###NUMBER### ###NUMBER### ###NUMBER### numeral unspecified unspecified unspecified unspecified unspecified  	I_DATE	null
14 אחול חל אחול verb masculine-and-feminine singular unspecified 1 future  	O	null
15 - - - punctuation unspecified unspecified unspecified unspecified unspecified  	O	null
16 מ מ מניוקי preposition unspecified unspecified unspecified unspecified unspecified 0 
16 ניוקי ניוקי מניוקי noun masculine singular absolute unspecified unspecified  	O	null
17 ל ל לעברית preposition unspecified unspecified unspecified unspecified unspecified 0 
17 עברית עברית לעברית properName feminine singular unspecified unspecified unspecified  	O	null
18 מדוברת מדובר מדוברת adjective feminine singular absolute unspecified unspecified  	O	null
19 , , , punctuation unspecified unspecified unspecified unspecified unspecified  	O	null
20 , , , punctuation unspecified unspecified unspecified unspecified unspecified  	O	null
21 ###NUMBER### ###NUMBER### ###NUMBER### numeral unspecified unspecified unspecified unspecified unspecified  	I_DATE	null
22 זמורה זמורה זמורה noun feminine singular absolute unspecified unspecified  	O	null
23 - - - punctuation unspecified unspecified unspecified unspecified unspecified  	O	null
24 ביתן ביתן ביתן noun masculine singular absolute unspecified unspecified  	O	null
25 ) ) ) punctuation unspecified unspecified unspecified unspecified unspecified  	O	null
26 , , , punctuation unspecified unspecified unspecified unspecified unspecified  	O	null
27 ו ו ואת conjunction unspecified unspecified unspecified unspecified unspecified 0 
27 את את ואת at-preposition unspecified unspecified unspecified unspecified unspecified  	O	null
28 רוב רוב רוב noun masculine singular construct unspecified unspecified  	O	null
29 ה ה החלק definiteArticle unspecified unspecified unspecified unspecified unspecified 0 
29 החלק חלק החלק noun masculine singular absolute unspecified unspecified  	O	null
30 ה ה השני definiteArticle unspecified unspecified unspecified unspecified unspecified 0 
30 השני ORD2 השני numeral masculine singular absolute unspecified unspecified  	O	null
31 הכינה הכין הכינה verb feminine singular unspecified 3 past  	O	null
32 בן בן בן properName unspecified unspecified unspecified unspecified unspecified  	I_PERS	null
33 - - - properName unspecified unspecified unspecified unspecified unspecified  	I_PERS	null
34 יהודה יהודה יהודה properName unspecified unspecified unspecified unspecified unspecified  	I_PERS	null
35 . . . punctuation unspecified unspecified unspecified unspecified unspecified  	O	null

0 ה ה המילון definiteArticle unspecified unspecified unspecified unspecified unspecified 0 
0 המילון מילון המילון noun masculine singular absolute unspecified unspecified  	O	null
1 כלל כלל כלל adverb unspecified unspecified unspecified unspecified unspecified  	O	null
2 בזמנו בזמנו בזמנו adverb unspecified unspecified unspecified unspecified unspecified  	O	null
3 את את את at-preposition unspecified unspecified unspecified unspecified unspecified  	O	null
4 ה ה האוסף definiteArticle unspecified unspecified unspecified unspecified unspecified 0 
4 האוסף אוסף האוסף noun masculine singular absolute unspecified unspecified  	O	null
5 ה ה הגדול definiteArticle unspecified unspecified unspecified unspecified unspecified 0 
5 הגדול גדול הגדול adjective masculine singular absolute unspecified unspecified  	O	null
6 ביותר ביותר ביותר adverb unspecified unspecified unspecified unspecified unspecified  	O	null
7 של של של shel-preposition unspecified unspecified unspecified unspecified unspecified  	O	null
8 מילות מילה מילות noun feminine plural construct unspecified unspecified  	O	null
9 סלנג סלנג סלנג properName unspecified unspecified unspecified unspecified unspecified  	I_PERS	null
10 ב ב בעברית preposition unspecified unspecified unspecified unspecified unspecified 0 
10 עברית עברית בעברית properName feminine singular unspecified unspecified unspecified  	I_PERS	null
11 . . . punctuation unspecified unspecified unspecified unspecified unspecified  	O	null

0 הוא הוא הוא pronoun masculine singular unspecified 3 unspecified  	O	null
1 נפוץ נפוץ נפוץ verb masculine singular unspecified 3 past  	O	null
2 ב ב במהדורות preposition unspecified unspecified unspecified unspecified unspecified 0 
2 מהדורות מהדורה במהדורות noun feminine plural absolute unspecified unspecified  	O	null
3 רבות רב רבות adjective feminine plural absolute unspecified unspecified  	O	null
4 ו ו וסייע conjunction unspecified unspecified unspecified unspecified unspecified 0 
4 סייע סייע וסייע verb masculine singular unspecified 3 past  	O	null
5 ל ל לקידום preposition unspecified unspecified unspecified unspecified unspecified 0 
5 קידום קידום לקידום noun masculine singular construct unspecified unspecified  	O	null
6 תפישת תפישה תפישתה noun feminine singular absolute unspecified unspecified  
6 ה ה תפישתה possessive feminine singular unspecified 3 unspecified 0 	O	null
7 , , , punctuation unspecified unspecified unspecified unspecified unspecified  	O	null
8 ש ש שהעגה relativizer/subordinatingConjunction unspecified unspecified unspecified unspecified unspecified 0 
8 ה ה שהעגה definiteArticle unspecified unspecified unspecified unspecified unspecified 0 
8 העגה עגה שהעגה noun feminine singular absolute unspecified unspecified  	O	null
9 היא הוא היא copula feminine singular unspecified 3 beinoni  	O	null
10 חלק חלק חלק noun masculine singular absolute unspecified unspecified  	O	null
11 טבעי טבעי טבעי adjective masculine singular absolute unspecified unspecified  	O	null
12 מ מ מלשון preposition unspecified unspecified unspecified unspecified unspecified 0 
12 לשון לשון מלשון noun feminine singular absolute unspecified unspecified  	O	null
13 מתפתחת התפתח מתפתחת verb feminine singular unspecified any beinoni  	O	null
14 ו ו וראוי conjunction unspecified unspecified unspecified unspecified unspecified 0 
14 ראוי ראוי וראוי modal masculine singular unspecified any unspecified  	O	null
15 לאמץ אימץ לאמץ verb unspecified unspecified unspecified unspecified infinitive  	O	null
16 את את אותה at-preposition unspecified unspecified unspecified unspecified unspecified  
16 ה ה אותה pronomial feminine singular unspecified 3 unspecified 0 	O	null
17 ב ב במקום preposition unspecified unspecified unspecified unspecified unspecified 0 
17 מקום מקום במקום noun masculine singular absolute unspecified unspecified  	O	null
18 להתכחש התכחש להתכחש verb unspecified unspecified unspecified unspecified infinitive  	O	null
19 ל ל לה preposition unspecified unspecified unspecified unspecified unspecified  
19 ה ה לה pronomial feminine singular unspecified 3 unspecified 0 	O	null
20 ב ב בנימוק preposition unspecified unspecified unspecified unspecified unspecified 0 
20 ה ה בנימוק definiteArticle unspecified unspecified unspecified unspecified unspecified 0 
20 הנימוק נימוק בנימוק noun masculine singular absolute unspecified unspecified  	O	null
21 ש ש שאינה relativizer/subordinatingConjunction unspecified unspecified unspecified unspecified unspecified 0 
21 אינה הוא שאינה copula feminine singular unspecified 3 beinoni  	O	null
22 תקנית תקני תקנית adjective feminine singular absolute unspecified unspecified  	O	null
23 . . . punctuation unspecified unspecified unspecified unspecified unspecified  	O	null

0 ב ב בראשית preposition unspecified unspecified unspecified unspecified unspecified 0 
0 ראשית ראשית בראשית noun feminine singular construct unspecified unspecified  	O	null
1 שנות שנה שנות noun feminine plural construct unspecified unspecified  	I_DATE	null
2 ה ה השמונים definiteArticle unspecified unspecified unspecified unspecified unspecified 0 
2 השמונים ORD-CARD80 השמונים numeral masculine-and-feminine plural absolute unspecified unspecified  	I_DATE	null
3 לקתה לקה לקתה verb feminine singular unspecified 3 past  	O	null
4 ב ב במחלה preposition unspecified unspecified unspecified unspecified unspecified 0 
4 מחלה מחלה במחלה noun feminine singular absolute unspecified unspecified  	O	null
5 ממארת ממאיר ממארת adjective feminine singular absolute unspecified unspecified  	O	null
6 ו ו ולפי conjunction unspecified unspecified unspecified unspecified unspecified 0 
6 לפי לפי ולפי preposition unspecified unspecified unspecified unspecified unspecified  	O	null
7 הערכת הערכה הערכת noun feminine singular construct unspecified unspecified  	O	null
8 רופאי רופא רופאיה noun masculine plural absolute unspecified unspecified  
8 ה ה רופאיה possessive feminine singular unspecified 3 unspecified 0 	O	null
9 נותרה נותר נותרה verb feminine singular unspecified 3 past  	O	null
10 ל ל לה preposition unspecified unspecified unspecified unspecified unspecified  
10 ה ה לה pronomial feminine singular unspecified 3 unspecified 0 	O	null
11 שנת שינה שנת noun feminine singular construct unspecified unspecified  	O	null
12 חיים חיים חיים noun masculine plural absolute unspecified unspecified  	O	null
13 אחת CARD1 אחת numeral feminine singular absolute unspecified unspecified  	O	null
14 . . . punctuation unspecified unspecified unspecified unspecified unspecified  	O	null

0 היא הוא היא pronoun feminine singular unspecified 3 unspecified  	O	null
1 התפטרה התפטר התפטרה verb feminine singular unspecified 3 past  	O	null
2 מ מ מעבודתה preposition unspecified unspecified unspecified unspecified unspecified 0 
2 עבודת עבודה מעבודתה noun feminine singular absolute unspecified unspecified  
2 ה ה מעבודתה possessive feminine singular unspecified 3 unspecified 0 	O	null
3 לשם לשם לשם preposition unspecified unspecified unspecified unspecified unspecified  	O	null
4 כתיבת כתיבה כתיבת noun feminine singular construct unspecified unspecified  	O	null
5 דין דין דין noun masculine singular absolute unspecified unspecified  	O	null
6 ו ו וחשבון conjunction unspecified unspecified unspecified unspecified unspecified 0 
6 חשבון חשבון וחשבון noun masculine singular absolute unspecified unspecified  	O	null
7 אישי אישי אישי adjective masculine singular absolute unspecified unspecified  	O	null
8 על על על preposition unspecified unspecified unspecified unspecified unspecified  	O	null
9 קורות קורה קורותיה noun feminine plural absolute unspecified unspecified  
9 ה ה קורותיה possessive feminine singular unspecified 3 unspecified 0 	O	null
10 כ כ כלוחמת preposition unspecified unspecified unspecified unspecified unspecified 0 
10 לוחמת לוחם כלוחמת noun feminine singular absolute unspecified unspecified  	O	null
11 ב ב בפלמ"ח preposition unspecified unspecified unspecified unspecified unspecified 0 
11 פלמ"ח פלמ"ח בפלמ"ח properName unspecified unspecified unspecified unspecified unspecified  	I_ORG	null
12 . . . punctuation unspecified unspecified unspecified unspecified unspecified  	O	null

0 לאחר לאחר לאחר preposition unspecified unspecified unspecified unspecified unspecified  	O	null
1 זמן זמן זמן noun masculine singular absolute unspecified unspecified  	O	null
2 התבדתה התבדה התבדתה verb feminine singular unspecified 3 past  	O	null
3 ה ה התחזית definiteArticle unspecified unspecified unspecified unspecified unspecified 0 
3 התחזית תחזית התחזית noun feminine singular absolute unspecified unspecified  	O	null
4 על על על preposition unspecified unspecified unspecified unspecified unspecified  	O	null
5 תוחלת תוחלת תוחלת noun feminine singular construct unspecified unspecified  	O	null
6 חיי חיים חייה noun masculine plural absolute unspecified unspecified  
6 ה ה חייה possessive feminine singular unspecified 3 unspecified 0 	O	null
7 , , , punctuation unspecified unspecified unspecified unspecified unspecified  	O	null
8 ו ו ובמשך conjunction unspecified unspecified unspecified unspecified unspecified 0 
8 במשך במשך ובמשך preposition unspecified unspecified unspecified unspecified unspecified  	O	null
9 כ כ כעשר preposition unspecified unspecified unspecified unspecified unspecified 0 
9 עשר CARD10 כעשר numeral feminine singular absolute unspecified unspecified  	O	null
10 שנים שנה שנים noun feminine plural absolute unspecified unspecified  	O	null
11 תיעדה תיעד תיעדה verb feminine singular unspecified 3 past  	O	null
12 את את את at-preposition unspecified unspecified unspecified unspecified unspecified  	O	null
13 זיכרונותי זיכרון זיכרונותיה noun masculine plural absolute unspecified unspecified  
13 ה ה זיכרונותיה possessive feminine singular unspecified 3 unspecified 0 	O	null
14 ו ו ואת conjunction unspecified unspecified unspecified unspecified unspecified 0 
14 את את ואת at-preposition unspecified unspecified unspecified unspecified unspecified  	O	null
15 חוויות חוויה חוויותיה noun feminine plural absolute unspecified unspecified  
15 ה ה חוויותיה possessive feminine singular unspecified 3 unspecified 0 	O	null
16 ב ב בשלושה preposition unspecified unspecified unspecified unspecified unspecified 0 
16 שלושה CARD3 בשלושה numeral masculine plural absolute unspecified unspecified  	O	null
17 ספרים ספר ספרים noun masculine plural absolute unspecified unspecified  	O	null
18 , , , punctuation unspecified unspecified unspecified unspecified unspecified  	O	null
19 ש ש שכינתה relativizer/subordinatingConjunction unspecified unspecified unspecified unspecified unspecified 0 
19 כינתה כינה שכינתה verb feminine singular unspecified 3 past  	O	null
20 רומנים רומן רומנים noun masculine plural absolute unspecified unspecified  	O	null
21 דוקומנטריים דוקומנטרי דוקומנטריים adjective masculine plural absolute unspecified unspecified  	O	null
22 : : : punctuation unspecified unspecified unspecified unspecified unspecified  	O	null
23 – – – punctuation unspecified unspecified unspecified unspecified unspecified  	O	null
24 בין בין בין preposition unspecified unspecified unspecified unspecified unspecified  	O	null
25 ה ה הספירות definiteArticle unspecified unspecified unspecified unspecified unspecified 0 
25 הספירות ספירה הספירות noun feminine plural absolute unspecified unspecified  	O	null
26 ( ( ( punctuation unspecified unspecified unspecified unspecified unspecified  	O	null
27 ) ) ) punctuation unspecified unspecified unspecified unspecified unspecified  	O	null
28 ; ; ; punctuation unspecified unspecified unspecified unspecified unspecified  	O	null
29 מבעד מבעד מבעד preposition unspecified unspecified unspecified unspecified unspecified  	O	null
30 ###NUMBER### ###NUMBER### ###NUMBER### numeral unspecified unspecified unspecified unspecified unspecified  	I_DATE	null
31 ל ל לעבותות preposition unspecified unspecified unspecified unspecified unspecified 0 
31 ה ה לעבותות definiteArticle unspecified unspecified unspecified unspecified unspecified 0 
31 העבותות עבותות לעבותות noun masculine plural absolute unspecified unspecified  	O	null
32 ) ) ) punctuation unspecified unspecified unspecified unspecified unspecified  	O	null
33 ; ; ; punctuation unspecified unspecified unspecified unspecified unspecified  	O	null
34 ###NUMBER### ###NUMBER### ###NUMBER### numeral unspecified unspecified unspecified unspecified unspecified  	I_DATE	null
35 ו ו וכשפרצה conjunction unspecified unspecified unspecified unspecified unspecified 0 
35 כש כש וכשפרצה temporalSubConj unspecified unspecified unspecified unspecified unspecified 0 
35 פרצה פרץ וכשפרצה verb feminine singular unspecified 3 past  	O	null
36 ה ה המדינה definiteArticle unspecified unspecified unspecified unspecified unspecified 0 
36 המדינה מדינה המדינה noun feminine singular absolute unspecified unspecified  	O	null
37 ) ) ) punctuation unspecified unspecified unspecified unspecified unspecified  	O	null
38 . . . punctuation unspecified unspecified unspecified unspecified unspecified  	O	null
39 ###NUMBER### ###NUMBER### ###NUMBER### numeral unspecified unspecified unspecified unspecified unspecified  	I_DATE	null
40 טרילוגיה טרילוגיה טרילוגיה properName unspecified unspecified unspecified unspecified unspecified  	I_ORG	null
41 זאת זאת זאת pronoun feminine singular unspecified 3 unspecified  	O	null
42 , , , punctuation unspecified unspecified unspecified unspecified unspecified  	O	null
43 ש ש שהיא relativizer/subordinatingConjunction unspecified unspecified unspecified unspecified unspecified 0 
43 היא הוא שהיא pronoun feminine singular unspecified 3 unspecified  	O	null
44 יצירת יצירה יצירתה noun feminine singular absolute unspecified unspecified  
44 ה ה יצירתה possessive feminine singular unspecified 3 unspecified 0 	O	null
45 ה ה החשובה definiteArticle unspecified unspecified unspecified unspecified unspecified 0 
45 החשובה חשוב החשובה adjective feminine singular absolute unspecified unspecified  	O	null
46 ביותר ביותר ביותר adverb unspecified unspecified unspecified unspecified unspecified  	O	null
47 , , , punctuation unspecified unspecified unspecified unspecified unspecified  	O	null
48 עוסקת עסק עוסקת verb feminine singular unspecified any beinoni  	O	null
49 ב ב בשבעת preposition unspecified unspecified unspecified unspecified unspecified 0 
49 שבעת שבעה בשבעת noun feminine singular construct unspecified unspecified  	O	null
50 ה ה החודשים definiteArticle unspecified unspecified unspecified unspecified unspecified 0 
50 החודשים חודש החודשים noun masculine plural absolute unspecified unspecified  	O	null
51 ה ה הראשונים definiteArticle unspecified unspecified unspecified unspecified unspecified 0 
51 הראשונים ORD1 הראשונים numeral masculine plural absolute unspecified unspecified  	O	null
52 של של של shel-preposition unspecified unspecified unspecified unspecified unspecified  	O	null
53 מלחמת מלחמה מלחמת noun feminine singular construct unspecified unspecified  	O	null
54 ה ה העצמאות definiteArticle unspecified unspecified unspecified unspecified unspecified 0 
54 העצמאות עצמאות העצמאות noun feminine singular absolute unspecified unspecified  	O	null
55 . . . punctuation unspecified unspecified unspecified unspecified unspecified  	O	null

0 כל כול כל quantifier unspecified unspecified construct unspecified unspecified  	O	null
1 אחד CARD1 אחד numeral masculine singular absolute unspecified unspecified  	O	null
2 מ מ משלושת preposition unspecified unspecified unspecified unspecified unspecified 0 
2 שלושת CARD3 משלושת numeral masculine plural construct unspecified unspecified  	O	null
3 ה ה הספרים definiteArticle unspecified unspecified unspecified unspecified unspecified 0 
3 הספרים ספר הספרים noun masculine plural absolute unspecified unspecified  	O	null
4 הוא הוא הוא pronoun masculine singular unspecified 3 unspecified  	O	null
5 מונולוג מונולוג מונולוג noun masculine singular absolute unspecified unspecified  	O	null
6 של של של shel-preposition unspecified unspecified unspecified unspecified unspecified  	O	null
7 ה ה הכותבת definiteArticle unspecified unspecified unspecified unspecified unspecified 0 
7 הכותבת כותב הכותבת noun feminine singular absolute unspecified unspecified  	O	null
8 , , , punctuation unspecified unspecified unspecified unspecified unspecified  	O	null
9 ה ה המתארת definiteArticle unspecified unspecified unspecified unspecified unspecified 0 
9 המתארת תיאר המתארת participle feminine singular absolute any unspecified  	O	null
10 את את את at-preposition unspecified unspecified unspecified unspecified unspecified  	O	null
11 ה ה האירועים definiteArticle unspecified unspecified unspecified unspecified unspecified 0 
11 האירועים אירוע האירועים noun masculine plural absolute unspecified unspecified  	O	null
12 כ כ כצופה preposition unspecified unspecified unspecified unspecified unspecified 0 
12 ה ה כצופה definiteArticle unspecified unspecified unspecified unspecified unspecified 0 
12 הצופה צופה כצופה noun masculine singular absolute unspecified unspecified  	O	null
13 מן מן מן preposition unspecified unspecified unspecified unspecified unspecified  	O	null
14 ה ה הצד definiteArticle unspecified unspecified unspecified unspecified unspecified 0 
14 הצד צד הצד noun masculine singular absolute unspecified unspecified  	O	null
15 , , , punctuation unspecified unspecified unspecified unspecified unspecified  	O	null
16 ו ו ועם conjunction unspecified unspecified unspecified unspecified unspecified 0 
16 עם עם ועם preposition unspecified unspecified unspecified unspecified unspecified  	O	null
17 זאת זאת זאת pronoun feminine singular unspecified 3 unspecified  	O	null
18 חושפת חשף חושפת verb feminine singular unspecified any beinoni  	O	null
19 את את את at-preposition unspecified unspecified unspecified unspecified unspecified  	O	null
20 השפעת השפעה השפעת noun feminine singular construct unspecified unspecified  	O	null
21 ה ה הלחימה definiteArticle unspecified unspecified unspecified unspecified unspecified 0 
21 הלחימה לחימה הלחימה noun feminine singular absolute unspecified unspecified  	O	null
22 על על על preposition unspecified unspecified unspecified unspecified unspecified  	O	null
23 נפש נפש נפשם noun feminine singular absolute unspecified unspecified  
23 ם ם נפשם possessive masculine plural unspecified 3 unspecified 0 	O	null
24 של של של shel-preposition unspecified unspecified unspecified unspecified unspecified  	O	null
25 ה ה הלוחמים definiteArticle unspecified unspecified unspecified unspecified unspecified 0 
25 הלוחמים לוחם הלוחמים noun masculine plural absolute unspecified unspecified  	O	null
26 . . . punctuation unspecified unspecified unspecified unspecified unspecified  	O	null

0 ה ה הדברים definiteArticle unspecified unspecified unspecified unspecified unspecified 0 
0 הדברים דבר הדברים noun masculine plural absolute unspecified unspecified  	O	null
1 כתובים כתוב כתובים adjective masculine plural absolute unspecified unspecified  	O	null
2 ב ב בלשון preposition unspecified unspecified unspecified unspecified unspecified 0 
2 לשון לשון בלשון noun feminine singular construct unspecified unspecified  	O	null
3 ה ה הדיבור definiteArticle unspecified unspecified unspecified unspecified unspecified 0 
3 הדיבור דיבור הדיבור noun masculine singular absolute unspecified unspecified  	O	null
4 , , , punctuation unspecified unspecified unspecified unspecified unspecified  	O	null
5 ש ש שהמחברת relativizer/subordinatingConjunction unspecified unspecified unspecified unspecified unspecified 0 
5 ה ה שהמחברת definiteArticle unspecified unspecified unspecified unspecified unspecified 0 
5 המחברת מחברת שהמחברת noun feminine singular absolute unspecified unspecified  	O	null
6 לשה לש לשה verb feminine singular unspecified 3 past  	O	null
7 מן מן ממנה preposition unspecified unspecified unspecified unspecified unspecified  
7 ה ה ממנה pronomial feminine singular unspecified 3 unspecified 0 	O	null
8 סגנון סגנון סגנון noun masculine singular absolute unspecified unspecified  	O	null
9 ייחודי ייחודי ייחודי adjective masculine singular absolute unspecified unspecified  	O	null
10 ו ו ואופייני conjunction unspecified unspecified unspecified unspecified unspecified 0 
10 אופייני אופייני ואופייני adjective masculine singular absolute unspecified unspecified  	O	null
11 ל ל לה preposition unspecified unspecified unspecified unspecified unspecified  
11 ה ה לה pronomial feminine singular unspecified 3 unspecified 0 	O	null
12 . . . punctuation unspecified unspecified unspecified unspecified unspecified  	O	null

0 אמנם אמנם אמנם adverb unspecified unspecified unspecified unspecified unspecified  	O	null
1 ל ל לדעתה preposition unspecified unspecified unspecified unspecified unspecified 0 
1 דעת דעה לדעתה noun feminine singular absolute unspecified unspecified  
1 ה ה לדעתה possessive feminine singular unspecified 3 unspecified 0 	O	null
2 ה ה הטרילוגיה definiteArticle unspecified unspecified unspecified unspecified unspecified 0 
2 הטרילוגיה הטרילוגיה הטרילוגיה adjective masculine singular absolute unspecified unspecified  	O	null
3 אינה אינה אינה verb masculine singular unspecified 3 past  	O	null
4 ב ב בגדר preposition unspecified unspecified unspecified unspecified unspecified 0 
4 גדר גדר בגדר noun feminine singular construct unspecified unspecified  	O	null
5 ספרות ספרות ספרות noun feminine singular absolute unspecified unspecified  	O	null
6 , , , punctuation unspecified unspecified unspecified unspecified unspecified  	O	null
7 אבל אבל אבל conjunction unspecified unspecified unspecified unspecified unspecified  	O	null
8 רוב רוב רוב noun masculine singular construct unspecified unspecified  	O	null
9 ה ה המבקרים definiteArticle unspecified unspecified unspecified unspecified unspecified 0 
9 המבקרים מבקר המבקרים noun masculine plural absolute unspecified unspecified  	O	null
10 חלקו חלק חלקו verb masculine-and-feminine plural unspecified 3 past  	O	null
11 על על עליה preposition unspecified unspecified unspecified unspecified unspecified  
11 ה ה עליה pronomial feminine singular unspecified 3 unspecified 0 	O	null
12 ו ו ושיבחו conjunction unspecified unspecified unspecified unspecified unspecified 0 
12 שיבחו שיבח ושיבחו verb masculine-and-feminine plural unspecified 3 past  	O	null
13 את את את at-preposition unspecified unspecified unspecified unspecified unspecified  	O	null
14 כתיבת כתיבה כתיבתה noun feminine singular absolute unspecified unspecified  
14 ה ה כתיבתה possessive feminine singular unspecified 3 unspecified 0 	O	null
15 , , , punctuation unspecified unspecified unspecified unspecified unspecified  	O	null
16 ש ש שמשולבים relativizer/subordinatingConjunction unspecified unspecified unspecified unspecified unspecified 0 
16 משולבים שולב שמשולבים verb masculine plural unspecified any beinoni  	O	null
17 ב ב בה preposition unspecified unspecified unspecified unspecified unspecified  
17 ה ה בה pronomial feminine singular unspecified 3 unspecified 0 	O	null
18 כישרון כישרון כישרון noun masculine singular construct unspecified unspecified  	O	null
19 תיאור תיאור תיאור noun masculine singular absolute unspecified unspecified  	O	null
20 , , , punctuation unspecified unspecified unspecified unspecified unspecified  	O	null
21 דימויים דימוי דימויים noun masculine plural absolute unspecified unspecified  	O	null
22 מקוריים מקורי מקוריים adjective masculine plural absolute unspecified unspecified  	O	null
23 ו ו והומור conjunction unspecified unspecified unspecified unspecified unspecified 0 
23 הומור הומור והומור noun masculine singular absolute unspecified unspecified  	O	null
24 . . . punctuation unspecified unspecified unspecified unspecified unspecified  	O	null

0 ה ה הטרילוגיה definiteArticle unspecified unspecified unspecified unspecified unspecified 0 
0 הטרילוגיה הטרילוגיה הטרילוגיה noun feminine singular absolute unspecified unspecified  	O	null
1 היא הוא היא copula feminine singular unspecified 3 beinoni  	O	null
2 גם גם גם conjunction unspecified unspecified unspecified unspecified unspecified  	O	null
3 מקור מקור מקור noun masculine singular absolute unspecified unspecified  	O	null
4 היסטורי היסטורי היסטורי adjective masculine singular absolute unspecified unspecified  	O	null
5 , , , punctuation unspecified unspecified unspecified unspecified unspecified  	O	null
6 ה ה המאיר definiteArticle unspecified unspecified unspecified unspecified unspecified 0 
6 המאיר האיר המאיר participle masculine singular absolute any unspecified  	O	null
7 את את את at-preposition unspecified unspecified unspecified unspecified unspecified  	O	null
8 ה ה האווירה definiteArticle unspecified unspecified unspecified unspecified unspecified 0 
8 האווירה אווירה האווירה noun feminine singular absolute unspecified unspecified  	O	null
9 ב ב ביישוב preposition unspecified unspecified unspecified unspecified unspecified 0 
9 ה ה ביישוב definiteArticle unspecified unspecified unspecified unspecified unspecified 0 
9 היישוב יישוב ביישוב noun masculine singular absolute unspecified unspecified  	O	null
10 ה ה העברי definiteArticle unspecified unspecified unspecified unspecified unspecified 0 
10 העברי עברי העברי adjective masculine singular absolute unspecified unspecified  	O	null
11 ב ב באותו preposition unspecified unspecified unspecified unspecified unspecified 0 
11 אותו אותו באותו quantifier unspecified unspecified construct unspecified unspecified  	O	null
12 זמן זמן זמן noun masculine singular absolute unspecified unspecified  	O	null
13 ו ו ואת conjunction unspecified unspecified unspecified unspecified unspecified 0 
13 את את ואת at-preposition unspecified unspecified unspecified unspecified unspecified  	O	null
14 אופי אופה אופיו noun masculine plural absolute unspecified unspecified  
14 ו ו אופיו possessive masculine singular unspecified 3 unspecified 0 	O	null
15 של של של shel-preposition unspecified unspecified unspecified unspecified unspecified  	O	null
16 הפלמ"ח פלמ"ח הפלמ"ח properName unspecified unspecified unspecified unspecified unspecified  	I_ORG	null
17 . . . punctuation unspecified unspecified unspecified unspecified unspecified  	O	null

0 למרות למרות למרות conjunction unspecified unspecified unspecified unspecified unspecified  	O	null
1 הערכת הערכה הערכתה noun feminine singular absolute unspecified unspecified  
1 ה ה הערכתה possessive feminine singular unspecified 3 unspecified 0 	O	null
2 ל ל לתפקידו preposition unspecified unspecified unspecified unspecified unspecified 0 
2 תפקיד תפקיד לתפקידו noun masculine singular absolute unspecified unspecified  
2 ו ו לתפקידו possessive masculine singular unspecified 3 unspecified 0 	O	null
3 ה ה החיוני definiteArticle unspecified unspecified unspecified unspecified unspecified 0 
3 החיוני חיוני החיוני adjective masculine singular absolute unspecified unspecified  	O	null
4 ב ב במלחמה preposition unspecified unspecified unspecified unspecified unspecified 0 
4 ה ה במלחמה definiteArticle unspecified unspecified unspecified unspecified unspecified 0 
4 המלחמה מלחמה במלחמה noun feminine singular absolute unspecified unspecified  	O	null
5 , , , punctuation unspecified unspecified unspecified unspecified unspecified  	O	null
6 היא הוא היא pronoun feminine singular unspecified 3 unspecified  	O	null
7 מצביעה הצביע מצביעה verb feminine singular unspecified any beinoni  	O	null
8 גם גם גם conjunction unspecified unspecified unspecified unspecified unspecified  	O	null
9 על על על preposition unspecified unspecified unspecified unspecified unspecified  	O	null
10 מגבלות מגבלה מגבלותיו noun feminine plural absolute unspecified unspecified  
10 ו ו מגבלותיו possessive masculine singular unspecified 3 unspecified 0 	O	null
11 , , , punctuation unspecified unspecified unspecified unspecified unspecified  	O	null
12 ו ו ובהן conjunction unspecified unspecified unspecified unspecified unspecified 0 
12 ב ב ובהן preposition unspecified unspecified unspecified unspecified unspecified 0 
12 הן הוא ובהן pronoun feminine plural unspecified 3 unspecified  	O	null
13 אפליה אפליה אפליה noun feminine singular absolute unspecified unspecified  	O	null
14 לרעה לרעה לרעה adverb unspecified unspecified unspecified unspecified unspecified  	O	null
15 של של של shel-preposition unspecified unspecified unspecified unspecified unspecified  	O	null
16 ה ה הנשים definiteArticle unspecified unspecified unspecified unspecified unspecified 0 
16 הנשים איש הנשים noun feminine plural absolute unspecified unspecified  	O	null
17 ו ו ודחיקת conjunction unspecified unspecified unspecified unspecified unspecified 0 
17 דחיקת דחיקה ודחיקת noun feminine singular construct unspecified unspecified  	O	null
18 רוב רוב רובן noun masculine singular absolute unspecified unspecified  
18 ן ן רובן possessive feminine plural unspecified 3 unspecified 0 	O	null
19 ל ל לתפקידי preposition unspecified unspecified unspecified unspecified unspecified 0 
19 תפקידי תפקיד לתפקידי noun masculine plural construct unspecified unspecified  	O	null
20 שירותים שירות שירותים noun masculine plural absolute unspecified unspecified  	O	null
21 . . . punctuation unspecified unspecified unspecified unspecified unspecified  	O	null

0 בכך בכך בכך adverb unspecified unspecified unspecified unspecified unspecified  	I_ORG	null
1 תרמה תרם תרמה verb feminine singular unspecified 3 past  	O	null
2 ל ל להגברת preposition unspecified unspecified unspecified unspecified unspecified 0 
2 הגברת הגברה להגברת noun feminine singular construct unspecified unspecified  	O	null
3 ה ה המודעות definiteArticle unspecified unspecified unspecified unspecified unspecified 0 
3 המודעות מודעות המודעות noun feminine singular absolute unspecified unspecified  	O	null
4 ה ה הפמיניסטית definiteArticle unspecified unspecified unspecified unspecified unspecified 0 
4 הפמיניסטית פמיניסט הפמיניסטית adjective feminine singular absolute unspecified unspecified  	O	null
5 ב ב בשיח preposition unspecified unspecified unspecified unspecified unspecified 0 
5 ה ה בשיח definiteArticle unspecified unspecified unspecified unspecified unspecified 0 
5 השיח שיח בשיח noun masculine singular absolute unspecified unspecified  	O	null
6 ה ה הציבורי definiteArticle unspecified unspecified unspecified unspecified unspecified 0 
6 הציבורי ציבורי הציבורי adjective masculine singular absolute unspecified unspecified  	O	null
7 . . . punctuation unspecified unspecified unspecified unspecified unspecified  	O	null

0 מ מ מ preposition unspecified unspecified unspecified unspecified unspecified 0 	O	null
1 - - - punctuation unspecified unspecified unspecified unspecified unspecified  	O	null
2 ###NUMBER### ###NUMBER### ###NUMBER### numeral unspecified unspecified unspecified unspecified unspecified  	I_DATE	null
3 ו ו ועד conjunction unspecified unspecified unspecified unspecified unspecified 0 
3 עד עד ועד preposition unspecified unspecified unspecified unspecified unspecified  	O	null
4 מות מוות מותה noun masculine singular absolute unspecified unspecified  
4 ה ה מותה possessive feminine singular unspecified 3 unspecified 0 	O	null
5 הגישה הגיש הגישה verb feminine singular unspecified 3 past  	O	null
6 ב ב ב preposition unspecified unspecified unspecified unspecified unspecified 0 	I_ORG	null
7 " " " punctuation unspecified unspecified unspecified unspecified unspecified  	I_ORG	null
8 קול קול קול properName unspecified unspecified unspecified unspecified unspecified  	I_ORG	null
9 ישראל ישראל ישראל properName unspecified unspecified unspecified unspecified unspecified  	I_ORG	null
10 " " " punctuation unspecified unspecified unspecified unspecified unspecified  	O	null
11 תוכנית תוכנית תוכנית noun feminine singular absolute unspecified unspecified  	O	null
12 שבועית שבועי שבועית adjective feminine singular absolute unspecified unspecified  	O	null
13 אישית אישי אישית adjective feminine singular absolute unspecified unspecified  	O	null
14 ב ב בשם preposition unspecified unspecified unspecified unspecified unspecified 0 
14 שם שם בשם noun masculine singular construct unspecified unspecified  	O	null
15 נתיבה נתיבה נתיבה properName unspecified unspecified unspecified unspecified unspecified  	I_PERS	null
16 מדברת דיבר מדברת verb feminine singular unspecified any beinoni  	O	null
17 ו ו ומקשיבה conjunction unspecified unspecified unspecified unspecified unspecified 0 
17 מקשיבה הקשיב ומקשיבה verb feminine singular unspecified any beinoni  	O	null
18 , , , punctuation unspecified unspecified unspecified unspecified unspecified  	O	null
19 ו ו ובה conjunction unspecified unspecified unspecified unspecified unspecified 0 
19 ב ב ובה preposition unspecified unspecified unspecified unspecified unspecified  
19 ה ה ובה pronomial feminine singular unspecified 3 unspecified 0 	O	null
20 שירים שיר שירים noun masculine plural absolute unspecified unspecified  	O	null
21 מלפני מלפני מלפני adverb unspecified unspecified unspecified unspecified unspecified  	O	null
22 קום קם קום verb masculine singular unspecified 2 imperative  	O	null
23 ה ה המדינה definiteArticle unspecified unspecified unspecified unspecified unspecified 0 
23 המדינה מדינה המדינה noun feminine singular absolute unspecified unspecified  	O	null
24 ו ו ושיחות conjunction unspecified unspecified unspecified unspecified unspecified 0 
24 שיחות שיחה ושיחות noun feminine plural absolute unspecified unspecified  	O	null
25 טלפוניות טלפוני טלפוניות adjective feminine plural absolute unspecified unspecified  	O	null
26 עם עם עם preposition unspecified unspecified unspecified unspecified unspecified  	O	null
27 מאזינים מאזין מאזינים noun masculine plural absolute unspecified unspecified  	O	null
28 . . . punctuation unspecified unspecified unspecified unspecified unspecified  	O	null

0 עוד עוד עוד adverb unspecified unspecified unspecified unspecified unspecified  	O	null
1 מ מ מספריה preposition unspecified unspecified unspecified unspecified unspecified 0 
1 ספרי ספר מספריה noun masculine plural absolute unspecified unspecified  
1 ה ה מספריה possessive feminine singular unspecified 3 unspecified 0 	O	null
2 : : : punctuation unspecified unspecified unspecified unspecified unspecified  	O	null
3 ברכות בריכה ברכות noun feminine plural absolute unspecified unspecified  	O	null
4 ו ו וקללות conjunction unspecified unspecified unspecified unspecified unspecified 0 
4 קללות קללה וקללות noun feminine plural absolute unspecified unspecified  	O	null
5 , , , punctuation unspecified unspecified unspecified unspecified unspecified  	O	null
6 אוסף אוסף אוסף noun masculine singular absolute unspecified unspecified  	O	null
7 פרטי פרטי פרטי adjective masculine singular absolute unspecified unspecified  	O	null
8 ( ( ( punctuation unspecified unspecified unspecified unspecified unspecified  	O	null
9 ) ) ) punctuation unspecified unspecified unspecified unspecified unspecified  	O	null
10 ; ; ; punctuation unspecified unspecified unspecified unspecified unspecified  	O	null
11 ###NUMBER### ###NUMBER### ###NUMBER### numeral unspecified unspecified unspecified unspecified unspecified  	I_DATE	null
12 ירושלים ירושלים ירושלים properName unspecified unspecified unspecified unspecified unspecified  	B_LOC	null
13 מבפנוכו מבפנוכו מבפנוכו participle feminine plural construct any unspecified  	O	null
14 : : : punctuation unspecified unspecified unspecified unspecified unspecified  	O	null
15 לחיות חי לחיות verb unspecified unspecified unspecified unspecified infinitive  	O	null
16 ב ב בירושלים preposition unspecified unspecified unspecified unspecified unspecified 0 
16 ירושלים ירושלים בירושלים properName unspecified unspecified unspecified unspecified unspecified  	I_LOC	null
17 ו ו ולמות conjunction unspecified unspecified unspecified unspecified unspecified 0 
17 למות מת ולמות verb unspecified unspecified unspecified unspecified infinitive  	O	null
18 ב ב בה preposition unspecified unspecified unspecified unspecified unspecified  
18 ה ה בה pronomial feminine singular unspecified 3 unspecified 0 	O	null
19 – – – punctuation unspecified unspecified unspecified unspecified unspecified  	O	null
20 מ מ מצחוק preposition unspecified unspecified unspecified unspecified unspecified 0 
20 צחוק צחוק מצחוק noun masculine singular absolute unspecified unspecified  	O	null
21 ( ( ( punctuation unspecified unspecified unspecified unspecified unspecified  	O	null
22 ) ) ) punctuation unspecified unspecified unspecified unspecified unspecified  	O	null
23 ; ; ; punctuation unspecified unspecified unspecified unspecified unspecified  	O	null
24 ###NUMBER### ###NUMBER### ###NUMBER### numeral unspecified unspecified unspecified unspecified unspecified  	I_DATE	null
25 אוטוביוגרפיה אוטוביוגרפיה אוטוביוגרפיה noun feminine singular absolute unspecified unspecified  	O	null
26 ב ב בשיר preposition unspecified unspecified unspecified unspecified unspecified 0 
26 ה ה בשיר definiteArticle unspecified unspecified unspecified unspecified unspecified 0 
26 השיר שיר בשיר noun masculine singular absolute unspecified unspecified  	O	null
27 ו ו וזמר conjunction unspecified unspecified unspecified unspecified unspecified 0 
27 זמר זמר וזמר noun masculine singular absolute unspecified unspecified  	O	null
28 ( ( ( punctuation unspecified unspecified unspecified unspecified unspecified  	O	null
29 ) ) ) punctuation unspecified unspecified unspecified unspecified unspecified  	O	null
30 . . . punctuation unspecified unspecified unspecified unspecified unspecified  	O	null
31 ###NUMBER### ###NUMBER### ###NUMBER### numeral unspecified unspecified unspecified unspecified unspecified  	I_DATE	null
32 References References References foreign unspecified unspecified unspecified unspecified unspecified  	O	null
33 : : : punctuation unspecified unspecified unspecified unspecified unspecified  	O	null
34 בר בר בר properName unspecified unspecified unspecified unspecified unspecified  	I_ORG	null
35 - - - properName unspecified unspecified unspecified unspecified unspecified  	I_ORG	null
36 יוסף יוסף יוסף properName unspecified unspecified unspecified unspecified unspecified  	I_ORG	null
37 , , , punctuation unspecified unspecified unspecified unspecified unspecified  	O	null
38 חמוטל חמוטל חמוטל properName unspecified unspecified unspecified unspecified unspecified  	I_PERS	null
39 . . . punctuation unspecified unspecified unspecified unspecified unspecified  	O	null

0 " " " punctuation unspecified unspecified unspecified unspecified unspecified  	O	null
1 ' ' ' punctuation unspecified unspecified unspecified unspecified unspecified  	O	null
2 מבעד מבעד מבעד preposition unspecified unspecified unspecified unspecified unspecified  	O	null
3 לעבותות' לעבותות' לעבותות' noun masculine-and-feminine singular absolute unspecified unspecified  	O	null
4 של של של shel-preposition unspecified unspecified unspecified unspecified unspecified  	O	null
5 נתיבה נתיבה נתיבה properName unspecified unspecified unspecified unspecified unspecified  	I_PERS	null
6 בן בן בן properName unspecified unspecified unspecified unspecified unspecified  	I_PERS	null
7 - - - properName unspecified unspecified unspecified unspecified unspecified  	I_PERS	null
8 יהודה יהודה יהודה properName unspecified unspecified unspecified unspecified unspecified  	I_PERS	null
9 ״ ״ ״ punctuation unspecified unspecified unspecified unspecified unspecified  	O	null
10 . . . punctuation unspecified unspecified unspecified unspecified unspecified  	O	null

0 טעמי טעם טעמי noun masculine plural construct unspecified unspecified  	O	null
1 ה ה הקריאה definiteArticle unspecified unspecified unspecified unspecified unspecified 0 
1 הקריאה קריאה הקריאה noun feminine singular absolute unspecified unspecified  	O	null
2 : : : punctuation unspecified unspecified unspecified unspecified unspecified  	O	null
3 רשימות רשימה רשימות noun feminine plural absolute unspecified unspecified  	O	null
4 ביקורתספרותית ביקורתספרותית ביקורתספרותית adjective feminine singular construct unspecified unspecified  	O	null
5 . . . punctuation unspecified unspecified unspecified unspecified unspecified  	O	null

0 מבשרת בישר מבשרת verb feminine singular unspecified any beinoni  	I_LOC	null
1 ציון ציון ציון properName unspecified unspecified unspecified unspecified unspecified  	I_LOC	null
2 : : : punctuation unspecified unspecified unspecified unspecified unspecified  	O	null
3 צבעונים צבעוני צבעונים noun masculine plural absolute unspecified unspecified  	O	null
4 . . . punctuation unspecified unspecified unspecified unspecified unspecified  	O	null

0 ###NUMBER### ###NUMBER### ###NUMBER### numeral unspecified unspecified unspecified unspecified unspecified  	I_DATE	null
1 . . . punctuation unspecified unspecified unspecified unspecified unspecified  	O	null

0 - - - punctuation unspecified unspecified unspecified unspecified unspecified  	O	null
1 ###NUMBER### ###NUMBER### ###NUMBER### numeral unspecified unspecified unspecified unspecified unspecified  	O	null
2 ; ; ; punctuation unspecified unspecified unspecified unspecified unspecified  	O	null
3 ###NUMBER### ###NUMBER### ###NUMBER### numeral unspecified unspecified unspecified unspecified unspecified  	O	null
4 מ מ מירון preposition unspecified unspecified unspecified unspecified unspecified 0 
4 ירון ירון מירון properName unspecified unspecified unspecified unspecified unspecified  	I_PERS	null
5 , , , punctuation unspecified unspecified unspecified unspecified unspecified  	O	null
6 דן דן דן properName unspecified unspecified unspecified unspecified unspecified  	I_PERS	null
7 . . . punctuation unspecified unspecified unspecified unspecified unspecified  	O	null

0 " " " punctuation unspecified unspecified unspecified unspecified unspecified  	O	null
1 אילו אילו אילו conjunction unspecified unspecified unspecified unspecified unspecified  	O	null
2 נכתב נכתב נכתב verb masculine singular unspecified 3 past  	O	null
3 בזמנו בזמנו בזמנו adverb unspecified unspecified unspecified unspecified unspecified  	I_ORG	null
4 " " " punctuation unspecified unspecified unspecified unspecified unspecified  	O	null
5 . . . punctuation unspecified unspecified unspecified unspecified unspecified  	O	null

0 סימן סימן סימן noun masculine singular construct unspecified unspecified  	O	null
1 קריאה קריאה קריאה noun feminine singular absolute unspecified unspecified  	O	null
2 ###NUMBER### ###NUMBER### ###NUMBER### numeral unspecified unspecified unspecified unspecified unspecified  	O	null
3 - - - punctuation unspecified unspecified unspecified unspecified unspecified  	O	null
4 ###NUMBER### ###NUMBER### ###NUMBER### numeral unspecified unspecified unspecified unspecified unspecified  	O	null
5 . . . punctuation unspecified unspecified unspecified unspecified unspecified  	O	null

0 אפריל אפריל אפריל properName unspecified unspecified unspecified unspecified unspecified  	I_DATE	null
1 ###NUMBER### ###NUMBER### ###NUMBER### numeral unspecified unspecified unspecified unspecified unspecified  	I_DATE	null
2 . . . punctuation unspecified unspecified unspecified unspecified unspecified  	O	null

0 - - - punctuation unspecified unspecified unspecified unspecified unspecified  	O	null
1 ###NUMBER### ###NUMBER### ###NUMBER### numeral unspecified unspecified unspecified unspecified unspecified  	O	null
2 ; ; ; punctuation unspecified unspecified unspecified unspecified unspecified  	O	null
3 ###NUMBER### ###NUMBER### ###NUMBER### numeral unspecified unspecified unspecified unspecified unspecified  	O	null
4 משמר משמר משמר noun masculine singular absolute unspecified unspecified  	O	null
5 , , , punctuation unspecified unspecified unspecified unspecified unspecified  	O	null
6 תמר תמר תמר properName feminine singular unspecified unspecified unspecified  	I_LOC	null
7 . . . punctuation unspecified unspecified unspecified unspecified unspecified  	O	null

0 " " " punctuation unspecified unspecified unspecified unspecified unspecified  	O	null
1 נתיבה נתיבה נתיבה properName unspecified unspecified unspecified unspecified unspecified  	I_PERS	null
2 בן בן בן properName unspecified unspecified unspecified unspecified unspecified  	I_PERS	null
3 - - - properName unspecified unspecified unspecified unspecified unspecified  	I_PERS	null
4 יהודה יהודה יהודה properName unspecified unspecified unspecified unspecified unspecified  	I_PERS	null
5 ו ו ומילון conjunction unspecified unspecified unspecified unspecified unspecified 0 
5 מילון מילון ומילון noun masculine singular absolute unspecified unspecified  	O	null
6 עולמי עולמי עולמי adjective masculine singular absolute unspecified unspecified  	O	null
7 ל ל לעברית preposition unspecified unspecified unspecified unspecified unspecified 0 
7 עברית עברית לעברית properName feminine singular unspecified unspecified unspecified  	I_ORG	null
8 מדוברת מדובר מדוברת adjective feminine singular absolute unspecified unspecified  	O	null
9 " " " punctuation unspecified unspecified unspecified unspecified unspecified  	O	null
10 . . . punctuation unspecified unspecified unspecified unspecified unspecified  	O	null

0 תיאוריה תיאוריה תיאוריה noun feminine singular absolute unspecified unspecified  	O	null
1 ו ו וביקורת conjunction unspecified unspecified unspecified unspecified unspecified 0 
1 ביקורת ביקורת וביקורת noun feminine singular absolute unspecified unspecified  	O	null
2 ###NUMBER### ###NUMBER### ###NUMBER### numeral unspecified unspecified unspecified unspecified unspecified  	O	null
3 - - - punctuation unspecified unspecified unspecified unspecified unspecified  	O	null
4 ###NUMBER### ###NUMBER### ###NUMBER### numeral unspecified unspecified unspecified unspecified unspecified  	O	null
5 . . . punctuation unspecified unspecified unspecified unspecified unspecified  	O	null

0 ###NUMBER### ###NUMBER### ###NUMBER### numeral unspecified unspecified unspecified unspecified unspecified  	I_DATE	null
1 . . . punctuation unspecified unspecified unspecified unspecified unspecified  	O	null

0 - - - punctuation unspecified unspecified unspecified unspecified unspecified  	O	null
1 ###NUMBER### ###NUMBER### ###NUMBER### numeral unspecified unspecified unspecified unspecified unspecified  	O	null
2 ; ; ; punctuation unspecified unspecified unspecified unspecified unspecified  	O	null
3 ###NUMBER### ###NUMBER### ###NUMBER### numeral unspecified unspecified unspecified unspecified unspecified  	O	null
4 פורת פורת פורת properName unspecified unspecified unspecified unspecified unspecified  	I_PERS	null
5 , , , punctuation unspecified unspecified unspecified unspecified unspecified  	O	null
6 אמציה אמציה אמציה properName unspecified unspecified unspecified unspecified unspecified  	I_PERS	null
7 . . . punctuation unspecified unspecified unspecified unspecified unspecified  	O	null

0 " " " punctuation unspecified unspecified unspecified unspecified unspecified  	I_ORG	null
1 כיפאק כיפאק כיפאק properName unspecified unspecified unspecified unspecified unspecified  	I_ORG	null
2 ל ל לנתיבה preposition unspecified unspecified unspecified unspecified unspecified 0 
2 נתיבה נתיבה לנתיבה noun feminine singular absolute unspecified unspecified  	O	null
3 " " " punctuation unspecified unspecified unspecified unspecified unspecified  	O	null
4 . . . punctuation unspecified unspecified unspecified unspecified unspecified  	O	null

0 ידיעות ידיעה ידיעות noun feminine plural absolute unspecified unspecified  	I_ORG	null
1 אחרונות אחרון אחרונות adjective feminine plural absolute unspecified unspecified  	I_ORG	null
2 ספרות ספרות ספרות noun feminine singular absolute unspecified unspecified  	O	null
3 . . . punctuation unspecified unspecified unspecified unspecified unspecified  	O	null

0 ###NUMEXP### ###NUMEXP### ###NUMEXP### numberExpression unspecified unspecified unspecified unspecified unspecified  	I_DATE	null
1 . . . punctuation unspecified unspecified unspecified unspecified unspecified  	O	null

0 ; ; ; punctuation unspecified unspecified unspecified unspecified unspecified  	O	null
1 ###NUMBER### ###NUMBER### ###NUMBER### numeral unspecified unspecified unspecified unspecified unspecified  	O	null
2 פלדמן פלדמן פלדמן properName unspecified unspecified unspecified unspecified unspecified  	I_PERS	null
3 , , , punctuation unspecified unspecified unspecified unspecified unspecified  	O	null
4 יעל יעל יעל properName unspecified unspecified unspecified unspecified unspecified  	I_PERS	null
5 . . . punctuation unspecified unspecified unspecified unspecified unspecified  	O	null

0 – – – punctuation unspecified unspecified unspecified unspecified unspecified  	O	null
1 ###NUMBER### ###NUMBER### ###NUMBER### numeral unspecified unspecified unspecified unspecified unspecified  	I_DATE	null
2 ' ' ' punctuation unspecified unspecified unspecified unspecified unspecified  	O	null
3 מגדר מגדר מגדר noun masculine singular absolute unspecified unspecified  	O	null
4 ' ' ' punctuation unspecified unspecified unspecified unspecified unspecified  	O	null
5 עברי עברי עברי adjective masculine singular absolute unspecified unspecified  	O	null
6 ו ו ואידיאולוגיה conjunction unspecified unspecified unspecified unspecified unspecified 0 
6 אידיאולוגיה אידיאולוגיה ואידיאולוגיה noun feminine singular absolute unspecified unspecified  	O	null
7 ציונית ציוני ציונית adjective feminine singular absolute unspecified unspecified  	O	null
8 : : : punctuation unspecified unspecified unspecified unspecified unspecified  	O	null
9 טרילוגיית טרילוגיית טרילוגיית noun feminine singular construct unspecified unspecified  	O	null
10 הפלמ"ח פלמ"ח הפלמ"ח properName unspecified unspecified unspecified unspecified unspecified  	I_ORG	null
11 של של של shel-preposition unspecified unspecified unspecified unspecified unspecified  	O	null
12 נתיבה נתיבה נתיבה properName unspecified unspecified unspecified unspecified unspecified  	I_PERS	null
13 בן בן בן properName unspecified unspecified unspecified unspecified unspecified  	I_PERS	null
14 - - - properName unspecified unspecified unspecified unspecified unspecified  	I_PERS	null
15 יהודה יהודה יהודה properName unspecified unspecified unspecified unspecified unspecified  	I_PERS	null
16 " " " punctuation unspecified unspecified unspecified unspecified unspecified  	O	null
17 . . . punctuation unspecified unspecified unspecified unspecified unspecified  	O	null
18 ללא ללא ללא preposition unspecified unspecified unspecified unspecified unspecified  	O	null
19 חדר חדר חדר noun masculine singular absolute unspecified unspecified  	O	null
20 משל משל משלהן preposition unspecified unspecified unspecified unspecified unspecified  
20 הן הן משלהן pronomial feminine plural unspecified 3 unspecified 0 	O	null
21 : : : punctuation unspecified unspecified unspecified unspecified unspecified  	O	null
22 מ מ מגדר preposition unspecified unspecified unspecified unspecified unspecified 0 
22 גדר גדר מגדר noun feminine singular absolute unspecified unspecified  	O	null
23 ו ו ולאומיות conjunction unspecified unspecified unspecified unspecified unspecified 0 
23 לאומיות לאומיות ולאומיות noun feminine singular absolute unspecified unspecified  	O	null
24 ב ב ביצירתן preposition unspecified unspecified unspecified unspecified unspecified 0 
24 יצירת יצירה ביצירתן noun feminine singular absolute unspecified unspecified  
24 ן ן ביצירתן possessive feminine plural unspecified 3 unspecified 0 	O	null
25 של של של shel-preposition unspecified unspecified unspecified unspecified unspecified  	O	null
26 סופרות סופר סופרות noun feminine plural absolute unspecified unspecified  	O	null
27 ישראליות ישראלי ישראליות adjective feminine plural absolute unspecified unspecified  	O	null
28 . . . punctuation unspecified unspecified unspecified unspecified unspecified  	O	null

0 תל תל תל properName unspecified unspecified unspecified unspecified unspecified  	I_LOC	null
1 אביב אביב אביב properName unspecified unspecified unspecified unspecified unspecified  	I_LOC	null
2 : : : punctuation unspecified unspecified unspecified unspecified unspecified  	O	null
3 הקיבוץהמאוחד הקיבוץהמאוחד הקיבוץהמאוחד adjective masculine singular construct unspecified unspecified  	O	null
4 . . . punctuation unspecified unspecified unspecified unspecified unspecified  	O	null

0 ###NUMBER### ###NUMBER### ###NUMBER### numeral unspecified unspecified unspecified unspecified unspecified  	I_DATE	null
1 . . . punctuation unspecified unspecified unspecified unspecified unspecified  	O	null

0 - - - punctuation unspecified unspecified unspecified unspecified unspecified  	O	null
1 ###NUMBER### ###NUMBER### ###NUMBER### numeral unspecified unspecified unspecified unspecified unspecified  	O	null
2 ; ; ; punctuation unspecified unspecified unspecified unspecified unspecified  	O	null
3 ###NUMBER### ###NUMBER### ###NUMBER### numeral unspecified unspecified unspecified unspecified unspecified  	O	null
4 צמח צמח צמח noun masculine singular absolute unspecified unspecified  	O	null
5 , , , punctuation unspecified unspecified unspecified unspecified unspecified  	O	null
6 עדה עד עדה properName unspecified unspecified unspecified unspecified unspecified  	I_PERS	null
7 . . . punctuation unspecified unspecified unspecified unspecified unspecified  	O	null

0 " " " punctuation unspecified unspecified unspecified unspecified unspecified  	O	null
1 בין בין בין preposition unspecified unspecified unspecified unspecified unspecified  	O	null
2 ה ה הספירות definiteArticle unspecified unspecified unspecified unspecified unspecified 0 
2 הספירות ספירה הספירות noun feminine plural absolute unspecified unspecified  	O	null
3 של של של shel-preposition unspecified unspecified unspecified unspecified unspecified  	O	null
4 נתיבה נתיבה נתיבה properName unspecified unspecified unspecified unspecified unspecified  	I_PERS	null
5 בן-יהודה בן-יהודה בן-יהודה properName unspecified unspecified unspecified unspecified unspecified  	I_PERS	null
6 " " " punctuation unspecified unspecified unspecified unspecified unspecified  	O	null
7 . . . punctuation unspecified unspecified unspecified unspecified unspecified  	O	null

0 סימן סימן סימן noun masculine singular construct unspecified unspecified  	O	null
1 קריאה קריאה קריאה noun feminine singular absolute unspecified unspecified  	O	null
2 ###NUMBER### ###NUMBER### ###NUMBER### numeral unspecified unspecified unspecified unspecified unspecified  	O	null
3 - - - punctuation unspecified unspecified unspecified unspecified unspecified  	O	null
4 ###NUMBER### ###NUMBER### ###NUMBER### numeral unspecified unspecified unspecified unspecified unspecified  	O	null
5 . . . punctuation unspecified unspecified unspecified unspecified unspecified  	O	null

0 אפריל אפריל אפריל properName unspecified unspecified unspecified unspecified unspecified  	I_DATE	null
1 ###NUMBER### ###NUMBER### ###NUMBER### numeral unspecified unspecified unspecified unspecified unspecified  	I_DATE	null
2 . . . punctuation unspecified unspecified unspecified unspecified unspecified  	O	null

0 ###NUMBER### ###NUMBER### ###NUMBER### numeral unspecified unspecified unspecified unspecified unspecified  	O	null
1 - - - punctuation unspecified unspecified unspecified unspecified unspecified  	O	null
2 ###NUMBER### ###NUMBER### ###NUMBER### numeral unspecified unspecified unspecified unspecified unspecified  	O	null
3 . . . punctuation unspecified unspecified unspecified unspecified unspecified  	O	null

