0 Name Name Name foreign unspecified unspecified unspecified unspecified unspecified  	O	null
1 : : : punctuation unspecified unspecified unspecified unspecified unspecified  	O	null
2 גורל גורל גורל noun masculine singular absolute unspecified unspecified  	O	null
3 , , , punctuation unspecified unspecified unspecified unspecified unspecified  	O	null
4 יונתן יונתן יונתן properName unspecified unspecified unspecified unspecified unspecified  	I_PERS	null
5 חיים חיים חיים properName unspecified unspecified unspecified unspecified unspecified  	I_PERS	null
6 Birth Birth Birth foreign unspecified unspecified unspecified unspecified unspecified  	O	null
7 Year Year Year foreign unspecified unspecified unspecified unspecified unspecified  	O	null
8 : : : punctuation unspecified unspecified unspecified unspecified unspecified  	O	null
9 ###NUMBER### ###NUMBER### ###NUMBER### numeral unspecified unspecified unspecified unspecified unspecified  	I_DATE	null
10 Birth Birth Birth foreign unspecified unspecified unspecified unspecified unspecified  	O	null
11 Place Place Place foreign unspecified unspecified unspecified unspecified unspecified  	O	null
12 : : : punctuation unspecified unspecified unspecified unspecified unspecified  	O	null
13 ירושלים ירושלים ירושלים properName unspecified unspecified unspecified unspecified unspecified  	I_LOC	null
14 ל ל למשפחת preposition unspecified unspecified unspecified unspecified unspecified 0 
14 משפחת משפחה למשפחת noun feminine singular construct unspecified unspecified  	O	null
15 פעילי פעיל פעילי noun masculine plural construct unspecified unspecified  	O	null
16 Occupation Occupation Occupation foreign unspecified unspecified unspecified unspecified unspecified  	O	null
17 : : : punctuation unspecified unspecified unspecified unspecified unspecified  	O	null
18 משורר משורר משורר noun masculine singular absolute unspecified unspecified  	O	null
19 ו ו ועורך conjunction unspecified unspecified unspecified unspecified unspecified 0 
19 עורך עורך ועורך noun masculine singular construct unspecified unspecified  	O	null
20 Entry Entry Entry foreign unspecified unspecified unspecified unspecified unspecified  	I_ORG	null
21 writer writer writer foreign unspecified unspecified unspecified unspecified unspecified  	I_ORG	null
22 : : : punctuation unspecified unspecified unspecified unspecified unspecified  	O	null
23 אביב אביב אביב properName unspecified unspecified unspecified unspecified unspecified  	I_ORG	null
24 עקרוני עקרוני עקרוני adjective masculine singular absolute unspecified unspecified  	O	null
25 Entry Entry Entry foreign unspecified unspecified unspecified unspecified unspecified  	O	null
26 Value Value Value foreign unspecified unspecified unspecified unspecified unspecified  	O	null
27 : : : punctuation unspecified unspecified unspecified unspecified unspecified  	O	null
28 נולד נולד נולד verb masculine singular unspecified 3 past  	O	null
29 ב ב בירושלים preposition unspecified unspecified unspecified unspecified unspecified 0 
29 ירושלים ירושלים בירושלים properName unspecified unspecified unspecified unspecified unspecified  	I_LOC	null
30 ל ל למשפחת preposition unspecified unspecified unspecified unspecified unspecified 0 
30 משפחת משפחה למשפחת noun feminine singular construct unspecified unspecified  	O	null
31 פעילי פעיל פעילי noun masculine plural construct unspecified unspecified  	O	null
32 ציבור ציבור ציבור noun masculine singular absolute unspecified unspecified  	O	null
33 , , , punctuation unspecified unspecified unspecified unspecified unspecified  	O	null
34 משפטנים משפטן משפטנים noun masculine plural absolute unspecified unspecified  	O	null
35 ו ו ואנשי conjunction unspecified unspecified unspecified unspecified unspecified 0 
35 אנשי איש ואנשי noun masculine plural construct unspecified unspecified  	O	null
36 עסקים עסק עסקים noun masculine plural absolute unspecified unspecified  	O	null
37 ש ש שפעלו relativizer/subordinatingConjunction unspecified unspecified unspecified unspecified unspecified 0 
37 פעלו פעל שפעלו verb masculine-and-feminine plural unspecified 3 past  	O	null
38 ב ב בעיר preposition unspecified unspecified unspecified unspecified unspecified 0 
38 ה ה בעיר definiteArticle unspecified unspecified unspecified unspecified unspecified 0 
38 העיר עיר בעיר noun feminine singular absolute unspecified unspecified  	O	null
39 מ מ מאמצע preposition unspecified unspecified unspecified unspecified unspecified 0 
39 אמצע אמצע מאמצע noun masculine singular construct unspecified unspecified  	O	null
40 ה ה המאה definiteArticle unspecified unspecified unspecified unspecified unspecified 0 
40 המאה ORD-CARD100 המאה numeral feminine plural absolute unspecified unspecified  	O	null
41 ה ה התשע definiteArticle unspecified unspecified unspecified unspecified unspecified 0 
41 התשע CARD9 התשע numeral feminine singular absolute unspecified unspecified  	O	null
42 - - - punctuation unspecified unspecified unspecified unspecified unspecified  	O	null
43 עשרה CARD10 עשרה numeral masculine plural absolute unspecified unspecified  	O	null
44 . . . punctuation unspecified unspecified unspecified unspecified unspecified  	O	null

0 למד למד למד verb masculine singular unspecified 3 past  	O	null
1 ב ב בגימנסיה preposition unspecified unspecified unspecified unspecified unspecified 0 
1 ה ה בגימנסיה definiteArticle unspecified unspecified unspecified unspecified unspecified 0 
1 הגימנסיה הגימנסיה בגימנסיה noun feminine singular absolute unspecified unspecified  	O	null
2 ה ה העברית definiteArticle unspecified unspecified unspecified unspecified unspecified 0 
2 העברית עברי העברית adjective feminine singular absolute unspecified unspecified  	O	null
3 ו ו ובאוניברסיטה conjunction unspecified unspecified unspecified unspecified unspecified 0 
3 ב ב ובאוניברסיטה preposition unspecified unspecified unspecified unspecified unspecified 0 
3 ה ה ובאוניברסיטה definiteArticle unspecified unspecified unspecified unspecified unspecified 0 
3 האוניברסיטה אוניברסיטה ובאוניברסיטה noun feminine singular absolute unspecified unspecified  	O	null
4 ה ה העברית definiteArticle unspecified unspecified unspecified unspecified unspecified 0 
4 העברית עברי העברית adjective feminine singular absolute unspecified unspecified  	O	null
5 ב ב בירושלים preposition unspecified unspecified unspecified unspecified unspecified 0 
5 ירושלים ירושלים בירושלים properName unspecified unspecified unspecified unspecified unspecified  	I_LOC	null
6 . . . punctuation unspecified unspecified unspecified unspecified unspecified  	O	null

0 בעל בעל בעל noun masculine singular construct unspecified unspecified  	O	null
1 תואר תואר תואר noun masculine singular construct unspecified unspecified  	O	null
2 ראשון ORD1 ראשון numeral masculine singular absolute unspecified unspecified  	O	null
3 ו ו ושני conjunction unspecified unspecified unspecified unspecified unspecified 0 
3 שני שני ושני noun masculine singular absolute unspecified unspecified  	O	null
4 ב ב בספרות preposition unspecified unspecified unspecified unspecified unspecified 0 
4 ספרות ספרות בספרות noun feminine singular absolute unspecified unspecified  	O	null
5 עברית עברי עברית adjective feminine singular absolute unspecified unspecified  	O	null
6 ו ו והיסטוריה conjunction unspecified unspecified unspecified unspecified unspecified 0 
6 היסטוריה היסטוריה והיסטוריה noun feminine singular absolute unspecified unspecified  	O	null
7 של של של shel-preposition unspecified unspecified unspecified unspecified unspecified  	O	null
8 עם עם עם preposition unspecified unspecified unspecified unspecified unspecified  	I_ORG	null
9 ישראל ישראל ישראל properName unspecified unspecified unspecified unspecified unspecified  	I_ORG	null
10 . . . punctuation unspecified unspecified unspecified unspecified unspecified  	O	null

0 מ מ מ preposition unspecified unspecified unspecified unspecified unspecified 0 	O	null
1 - - - punctuation unspecified unspecified unspecified unspecified unspecified  	O	null
2 ###NUMBER### ###NUMBER### ###NUMBER### numeral unspecified unspecified unspecified unspecified unspecified  	I_DATE	null
3 לימד לימד לימד verb masculine singular unspecified 3 past  	O	null
4 ב ב בבתי preposition unspecified unspecified unspecified unspecified unspecified 0 
4 בתי בית בבתי noun masculine plural construct unspecified unspecified  	O	null
5 ספר ספר ספר noun masculine singular absolute unspecified unspecified  	O	null
6 עיוניים עיוני עיוניים adjective masculine plural absolute unspecified unspecified  	O	null
7 ו ו ומקצועיים conjunction unspecified unspecified unspecified unspecified unspecified 0 
7 מקצועיים מקצועי ומקצועיים adjective masculine plural absolute unspecified unspecified  	O	null
8 , , , punctuation unspecified unspecified unspecified unspecified unspecified  	O	null
9 גם גם גם conjunction unspecified unspecified unspecified unspecified unspecified  	O	null
10 ב ב במזרחירושלים preposition unspecified unspecified unspecified unspecified unspecified 0 
10 מזרחירושלים מזרחירושלים במזרחירושלים noun masculine singular absolute unspecified unspecified  	O	null
11 , , , punctuation unspecified unspecified unspecified unspecified unspecified  	O	null
12 ו ו וכן conjunction unspecified unspecified unspecified unspecified unspecified 0 
12 כן כן וכן conjunction unspecified unspecified unspecified unspecified unspecified  	O	null
13 ב ב באוניברסיטה preposition unspecified unspecified unspecified unspecified unspecified 0 
13 ה ה באוניברסיטה definiteArticle unspecified unspecified unspecified unspecified unspecified 0 
13 האוניברסיטה אוניברסיטה באוניברסיטה noun feminine singular absolute unspecified unspecified  	O	null
14 ה ה העממית definiteArticle unspecified unspecified unspecified unspecified unspecified 0 
14 העממית עממי העממית adjective feminine singular absolute unspecified unspecified  	O	null
15 , , , punctuation unspecified unspecified unspecified unspecified unspecified  	O	null
16 ב ב במרכז preposition unspecified unspecified unspecified unspecified unspecified 0 
16 ה ה במרכז definiteArticle unspecified unspecified unspecified unspecified unspecified 0 
16 המרכז מרכז במרכז noun masculine singular absolute unspecified unspecified  	O	null
17 ל ל ללימודים preposition unspecified unspecified unspecified unspecified unspecified 0 
17 לימודים לימוד ללימודים noun masculine plural absolute unspecified unspecified  	O	null
18 קדם קדם קדם wPrefix unspecified unspecified unspecified unspecified unspecified  	O	null
19 - - - punctuation unspecified unspecified unspecified unspecified unspecified  	O	null
20 אקדמיים אקדמי אקדמיים adjective masculine plural absolute unspecified unspecified  	O	null
21 של של של shel-preposition unspecified unspecified unspecified unspecified unspecified  	O	null
22 ה ה האוניברסיטה definiteArticle unspecified unspecified unspecified unspecified unspecified 0 
22 האוניברסיטה אוניברסיטה האוניברסיטה noun feminine singular absolute unspecified unspecified  	I_ORG	null
23 ה ה העברית definiteArticle unspecified unspecified unspecified unspecified unspecified 0 
23 העברית עברי העברית adjective feminine singular absolute unspecified unspecified  	I_ORG	null
24 ו ו ועוד conjunction unspecified unspecified unspecified unspecified unspecified 0 
24 עוד עוד ועוד adverb unspecified unspecified unspecified unspecified unspecified  	I_LOC	null
25 . . . punctuation unspecified unspecified unspecified unspecified unspecified  	O	null

0 הפיק הפיק הפיק verb masculine singular unspecified 3 past  	O	null
1 ו ו וערך conjunction unspecified unspecified unspecified unspecified unspecified 0 
1 ערך ערך וערך verb masculine singular unspecified 3 past  	O	null
2 את את את at-preposition unspecified unspecified unspecified unspecified unspecified  	O	null
3 ה ה הביטאונים definiteArticle unspecified unspecified unspecified unspecified unspecified 0 
3 הביטאונים ביטאון הביטאונים noun masculine plural absolute unspecified unspecified  	O	null
4 ידיעות ידיעה ידיעות noun feminine plural absolute unspecified unspecified  	O	null
5 ה ה הסטודנט definiteArticle unspecified unspecified unspecified unspecified unspecified 0 
5 הסטודנט סטודנט הסטודנט noun masculine singular absolute unspecified unspecified  	O	null
6 , , , punctuation unspecified unspecified unspecified unspecified unspecified  	O	null
7 ה ה הדור definiteArticle unspecified unspecified unspecified unspecified unspecified 0 
7 הדור דור הדור noun masculine singular absolute unspecified unspecified  	O	null
8 ה ה הצעיר definiteArticle unspecified unspecified unspecified unspecified unspecified 0 
8 הצעיר צעיר הצעיר adjective masculine singular absolute unspecified unspecified  	O	null
9 , , , punctuation unspecified unspecified unspecified unspecified unspecified  	O	null
10 אוגדן אוגדן אוגדן noun masculine singular absolute unspecified unspecified  	O	null
11 ) ) ) punctuation unspecified unspecified unspecified unspecified unspecified  	O	null
12 , , , punctuation unspecified unspecified unspecified unspecified unspecified  	O	null
13 ###NUMBER### ###NUMBER### ###NUMBER### numeral unspecified unspecified unspecified unspecified unspecified  	I_DATE	null
14 ירושלים ירושלים ירושלים properName unspecified unspecified unspecified unspecified unspecified  	I_LOC	null
15 , , , punctuation unspecified unspecified unspecified unspecified unspecified  	O	null
16 מאסף מאסף מאסף adjective masculine singular absolute unspecified unspecified  	O	null
17 ל ל לדברי preposition unspecified unspecified unspecified unspecified unspecified 0 
17 דברי דבר לדברי noun masculine plural construct unspecified unspecified  	O	null
18 ספרות ספרות ספרות noun feminine singular absolute unspecified unspecified  	O	null
19 - - - punctuation unspecified unspecified unspecified unspecified unspecified  	O	null
20 ###NUMBER### ###NUMBER### ###NUMBER### numeral unspecified unspecified unspecified unspecified unspecified  	I_DATE	null
21 ) ) ) punctuation unspecified unspecified unspecified unspecified unspecified  	O	null
22 . . . punctuation unspecified unspecified unspecified unspecified unspecified  	O	null

0 ###NUMBER### ###NUMBER### ###NUMBER### numeral unspecified unspecified unspecified unspecified unspecified  	I_DATE	null
1 היה הוא היה copula masculine singular unspecified 3 past  	O	null
2 חבר חבר חבר noun masculine singular construct unspecified unspecified  	O	null
3 ועד ועד ועד noun masculine singular construct unspecified unspecified  	O	null
4 אגודת אגודה אגודת noun feminine singular construct unspecified unspecified  	O	null
5 ה ה הסופרים definiteArticle unspecified unspecified unspecified unspecified unspecified 0 
5 הסופרים סופר הסופרים noun masculine plural absolute unspecified unspecified  	O	null
6 ה ה העבריים definiteArticle unspecified unspecified unspecified unspecified unspecified 0 
6 העבריים עברי העבריים adjective masculine plural absolute unspecified unspecified  	O	null
7 ו ו ויו"ר conjunction unspecified unspecified unspecified unspecified unspecified 0 
7 יו"ר יו"ר ויו"ר noun masculine singular construct unspecified unspecified  	O	null
8 ה ה האגודה definiteArticle unspecified unspecified unspecified unspecified unspecified 0 
8 האגודה אגודה האגודה noun feminine singular absolute unspecified unspecified  	O	null
9 ב ב בירושלים preposition unspecified unspecified unspecified unspecified unspecified 0 
9 ירושלים ירושלים בירושלים properName unspecified unspecified unspecified unspecified unspecified  	I_LOC	null
10 . . . punctuation unspecified unspecified unspecified unspecified unspecified  	O	null

0 ספר ספר ספרו noun masculine singular absolute unspecified unspecified  
0 ו ו ספרו possessive masculine singular unspecified 3 unspecified 0 	O	null
1 ה ה הראשון definiteArticle unspecified unspecified unspecified unspecified unspecified 0 
1 הראשון ORD1 הראשון numeral masculine singular absolute unspecified unspecified  	O	null
2 , , , punctuation unspecified unspecified unspecified unspecified unspecified  	O	null
3 מ מ משירי preposition unspecified unspecified unspecified unspecified unspecified 0 
3 שירי שיר משירי noun masculine plural construct unspecified unspecified  	O	null
4 ה ה התקווה definiteArticle unspecified unspecified unspecified unspecified unspecified 0 
4 התקווה תקווה התקווה noun feminine singular absolute unspecified unspecified  	O	null
5 ה ה הטובה definiteArticle unspecified unspecified unspecified unspecified unspecified 0 
5 הטובה טוב הטובה adjective feminine singular absolute unspecified unspecified  	O	null
6 , , , punctuation unspecified unspecified unspecified unspecified unspecified  	O	null
7 ראה ראה ראה verb masculine singular unspecified 3 past  	O	null
8 אור אור אור noun masculine singular absolute unspecified unspecified  	O	null
9 ב ב ב preposition unspecified unspecified unspecified unspecified unspecified 0 	O	null
10 - - - punctuation unspecified unspecified unspecified unspecified unspecified  	O	null
11 ###NUMBER### ###NUMBER### ###NUMBER### numeral unspecified unspecified unspecified unspecified unspecified  	I_DATE	null
12 ב ב בהוצאת preposition unspecified unspecified unspecified unspecified unspecified 0 
12 הוצאת הוצאה בהוצאת noun feminine singular construct unspecified unspecified  	O	null
13 אוגדן אוגדן אוגדן noun masculine singular absolute unspecified unspecified  	O	null
14 . . . punctuation unspecified unspecified unspecified unspecified unspecified  	O	null

0 אחרי אחרי אחריו preposition unspecified unspecified unspecified unspecified unspecified  
0 ו ו אחריו pronomial masculine singular unspecified 3 unspecified 0 	O	null
1 ראו ראה ראו verb masculine-and-feminine plural unspecified 3 past  	O	null
2 אור אור אור noun masculine singular construct unspecified unspecified  	O	null
3 עלים עלה עלים noun masculine plural absolute unspecified unspecified  	O	null
4 רוטטים רטט רוטטים verb masculine plural unspecified any beinoni  	O	null
5 בצל בצל בצל noun masculine singular absolute unspecified unspecified  	O	null
6 ) ) ) punctuation unspecified unspecified unspecified unspecified unspecified  	O	null
7 ; ; ; punctuation unspecified unspecified unspecified unspecified unspecified  	O	null
8 ###NUMBER### ###NUMBER### ###NUMBER### numeral unspecified unspecified unspecified unspecified unspecified  	I_DATE	null
9 קינת קינה קינת noun feminine singular construct unspecified unspecified  	O	null
10 ירושלים ירושלים ירושלים properName unspecified unspecified unspecified unspecified unspecified  	I_LOC	null
11 ה ה האחרת definiteArticle unspecified unspecified unspecified unspecified unspecified 0 
11 האחרת אחר האחרת adjective feminine singular absolute unspecified unspecified  	O	null
12 ) ) ) punctuation unspecified unspecified unspecified unspecified unspecified  	O	null
13 ; ; ; punctuation unspecified unspecified unspecified unspecified unspecified  	O	null
14 ###NUMBER### ###NUMBER### ###NUMBER### numeral unspecified unspecified unspecified unspecified unspecified  	I_DATE	null
15 פתאום פתאום פתאום adverb unspecified unspecified unspecified unspecified unspecified  	O	null
16 נפתח נפתח נפתח verb masculine singular unspecified 3 past  	O	null
17 צהר צהר צהר properName unspecified unspecified unspecified unspecified unspecified  	O	null
18 ) ) ) punctuation unspecified unspecified unspecified unspecified unspecified  	O	null
19 ; ; ; punctuation unspecified unspecified unspecified unspecified unspecified  	O	null
20 ###NUMBER### ###NUMBER### ###NUMBER### numeral unspecified unspecified unspecified unspecified unspecified  	I_DATE	null
21 מרחק מרחק מרחק noun masculine singular absolute unspecified unspecified  	O	null
22 ו ו וגעגוע conjunction unspecified unspecified unspecified unspecified unspecified 0 
22 געגוע געגוע וגעגוע noun masculine singular absolute unspecified unspecified  	O	null
23 ) ) ) punctuation unspecified unspecified unspecified unspecified unspecified  	O	null
24 . . . punctuation unspecified unspecified unspecified unspecified unspecified  	O	null
25 ###NUMBER### ###NUMBER### ###NUMBER### numeral unspecified unspecified unspecified unspecified unspecified  	I_DATE	null
26 ב ב במרחק preposition unspecified unspecified unspecified unspecified unspecified 0 
26 מרחק מרחק במרחק noun masculine singular absolute unspecified unspecified  	O	null
27 ו ו וגעגוע conjunction unspecified unspecified unspecified unspecified unspecified 0 
27 געגוע געגוע וגעגוע noun masculine singular absolute unspecified unspecified  	O	null
28 בולט בולט בולט adjective masculine singular absolute unspecified unspecified  	O	null
29 במיוחד במיוחד במיוחד adverb unspecified unspecified unspecified unspecified unspecified  	O	null
30 ה ה הרקע definiteArticle unspecified unspecified unspecified unspecified unspecified 0 
30 הרקע רקע הרקע noun masculine singular absolute unspecified unspecified  	O	null
31 ה ה הלשוני definiteArticle unspecified unspecified unspecified unspecified unspecified 0 
31 הלשוני לשוני הלשוני adjective masculine singular absolute unspecified unspecified  	O	null
32 - - - punctuation unspecified unspecified unspecified unspecified unspecified  	O	null
33 ספרותי ספרותי ספרותי adjective masculine singular absolute unspecified unspecified  	O	null
34 ה ה הרחב definiteArticle unspecified unspecified unspecified unspecified unspecified 0 
34 הרחב רחב הרחב adjective masculine singular absolute unspecified unspecified  	O	null
35 , , , punctuation unspecified unspecified unspecified unspecified unspecified  	O	null
36 ה ה המשתרע definiteArticle unspecified unspecified unspecified unspecified unspecified 0 
36 המשתרע השתרע המשתרע participle masculine singular absolute any unspecified  	O	null
37 מ מ מהתנ"ך preposition unspecified unspecified unspecified unspecified unspecified 0 
37 ה ה מהתנ"ך definiteArticle unspecified unspecified unspecified unspecified unspecified 0 
37 התנ"ך התנ"ך מהתנ"ך noun masculine singular absolute unspecified unspecified  	O	null
38 , , , punctuation unspecified unspecified unspecified unspecified unspecified  	O	null
39 דרך דרך דרך preposition unspecified unspecified unspecified unspecified unspecified  	O	null
40 שירת שירה שירתם noun feminine singular absolute unspecified unspecified  
40 ם ם שירתם possessive masculine plural unspecified 3 unspecified 0 	O	null
41 של של של shel-preposition unspecified unspecified unspecified unspecified unspecified  	O	null
42 משוררי משורר משוררי noun masculine plural construct unspecified unspecified  	O	null
43 ספרד ספרד ספרד properName unspecified unspecified unspecified unspecified unspecified  	I_LOC	null
44 ו ו ועד conjunction unspecified unspecified unspecified unspecified unspecified 0 
44 עד עד ועד preposition unspecified unspecified unspecified unspecified unspecified  	O	null
45 ה ה השירה definiteArticle unspecified unspecified unspecified unspecified unspecified 0 
45 השירה שירה השירה noun feminine singular absolute unspecified unspecified  	O	null
46 ה ה העברית definiteArticle unspecified unspecified unspecified unspecified unspecified 0 
46 העברית עברי העברית adjective feminine singular absolute unspecified unspecified  	O	null
47 ה ה החדשה definiteArticle unspecified unspecified unspecified unspecified unspecified 0 
47 החדשה חדש החדשה adjective feminine singular absolute unspecified unspecified  	O	null
48 . . . punctuation unspecified unspecified unspecified unspecified unspecified  	O	null

0 ה ה הרקע definiteArticle unspecified unspecified unspecified unspecified unspecified 0 
0 הרקע רקע הרקע noun masculine singular absolute unspecified unspecified  	O	null
1 ה ה הלשוני definiteArticle unspecified unspecified unspecified unspecified unspecified 0 
1 הלשוני לשוני הלשוני adjective masculine singular absolute unspecified unspecified  	O	null
2 - - - punctuation unspecified unspecified unspecified unspecified unspecified  	O	null
3 ספרותי ספרותי ספרותי adjective masculine singular absolute unspecified unspecified  	O	null
4 מעוגן עוגן מעוגן verb masculine singular unspecified any beinoni  	O	null
5 ב ב במערך preposition unspecified unspecified unspecified unspecified unspecified 0 
5 מערך מערך במערך properName unspecified unspecified unspecified unspecified unspecified  	I_ORG	null
6 שירי שירי שירי adjective masculine singular absolute unspecified unspecified  	O	null
7 ל ל לירי preposition unspecified unspecified unspecified unspecified unspecified 0 
7 ה ה לירי definiteArticle unspecified unspecified unspecified unspecified unspecified 0 
7 הירי ירי לירי noun masculine singular absolute unspecified unspecified  	O	null
8 , , , punctuation unspecified unspecified unspecified unspecified unspecified  	O	null
9 ש ש שיש relativizer/subordinatingConjunction unspecified unspecified unspecified unspecified unspecified 0 
9 יש יש שיש existential unspecified unspecified unspecified unspecified unspecified  	O	null
10 ב ב בו preposition unspecified unspecified unspecified unspecified unspecified  
10 ו ו בו pronomial masculine singular unspecified 3 unspecified 0 	O	null
11 עיסוק עיסוק עיסוק noun masculine singular absolute unspecified unspecified  	O	null
12 ב ב בשאלות preposition unspecified unspecified unspecified unspecified unspecified 0 
12 ה ה בשאלות definiteArticle unspecified unspecified unspecified unspecified unspecified 0 
12 השאלות שאלה בשאלות noun feminine plural absolute unspecified unspecified  	O	null
13 ה ה המהותיות definiteArticle unspecified unspecified unspecified unspecified unspecified 0 
13 המהותיות מהותי המהותיות adjective feminine plural absolute unspecified unspecified  	O	null
14 של של של shel-preposition unspecified unspecified unspecified unspecified unspecified  	O	null
15 ה ה החיים definiteArticle unspecified unspecified unspecified unspecified unspecified 0 
15 החיים חיים החיים noun masculine plural absolute unspecified unspecified  	O	null
16 , , , punctuation unspecified unspecified unspecified unspecified unspecified  	O	null
17 הן הן הן conjunction unspecified unspecified unspecified unspecified unspecified  	O	null
18 ב ב בהיבט preposition unspecified unspecified unspecified unspecified unspecified 0 
18 ה ה בהיבט definiteArticle unspecified unspecified unspecified unspecified unspecified 0 
18 ההיבט היבט בהיבט noun masculine singular absolute unspecified unspecified  	O	null
19 ה ה היהודי definiteArticle unspecified unspecified unspecified unspecified unspecified 0 
19 היהודי יהודי היהודי adjective masculine singular absolute unspecified unspecified  	O	null
20 ו ו והן conjunction unspecified unspecified unspecified unspecified unspecified 0 
20 הן הן והן conjunction unspecified unspecified unspecified unspecified unspecified  	O	null
21 ב ב בהיבט preposition unspecified unspecified unspecified unspecified unspecified 0 
21 ה ה בהיבט definiteArticle unspecified unspecified unspecified unspecified unspecified 0 
21 ההיבט היבט בהיבט noun masculine singular absolute unspecified unspecified  	O	null
22 ה ה הכלל definiteArticle unspecified unspecified unspecified unspecified unspecified 0 
22 הכלל כלל הכלל wPrefix unspecified unspecified unspecified unspecified unspecified  	I_ORG	null
23 - - - punctuation unspecified unspecified unspecified unspecified unspecified  	I_ORG	null
24 אנושי אנושי אנושי adjective masculine singular absolute unspecified unspecified  	I_ORG	null
25 . . . punctuation unspecified unspecified unspecified unspecified unspecified  	O	null

0 ב ב בספר preposition unspecified unspecified unspecified unspecified unspecified 0 
0 ספר ספר בספר noun masculine singular construct unspecified unspecified  	O	null
1 נמצאת נמצא נמצאת verb feminine singular unspecified any beinoni  	O	null
2 התייחסות התייחסות התייחסות noun feminine singular construct unspecified unspecified  	O	null
3 ל ל למשפחת preposition unspecified unspecified unspecified unspecified unspecified 0 
3 משפחת משפחה למשפחת noun feminine singular construct unspecified unspecified  	O	null
4 ה ה המשורר definiteArticle unspecified unspecified unspecified unspecified unspecified 0 
4 המשורר משורר המשורר noun masculine singular absolute unspecified unspecified  	O	null
5 , , , punctuation unspecified unspecified unspecified unspecified unspecified  	O	null
6 ה ה המעורה definiteArticle unspecified unspecified unspecified unspecified unspecified 0 
6 המעורה מעורה המעורה adjective feminine singular absolute unspecified unspecified  	O	null
7 דורות דור דורות properName unspecified unspecified unspecified unspecified unspecified  	I_PERS	null
8 ב ב בירושלים preposition unspecified unspecified unspecified unspecified unspecified 0 
8 ירושלים ירושלים בירושלים properName unspecified unspecified unspecified unspecified unspecified  	I_LOC	null
9 : : : punctuation unspecified unspecified unspecified unspecified unspecified  	O	null
10 " " " punctuation unspecified unspecified unspecified unspecified unspecified  	O	null
11 הָעֵץ הַנּוֹשֵׂא זְרוֹעוֹת קְרוּעוֹת הָעֵץ הַנּוֹשֵׂא זְרוֹעוֹת קְרוּעוֹת הָעֵץ הַנּוֹשֵׂא זְרוֹעוֹת קְרוּעוֹת properName unspecified unspecified unspecified unspecified unspecified  	I_ORG	null
12 , , , punctuation unspecified unspecified unspecified unspecified unspecified  	O	null
13 יְבֵשׁוֹת יְבֵשׁוֹת יְבֵשׁוֹת properName unspecified unspecified unspecified unspecified unspecified  	I_PERS	null
14 / / / punctuation unspecified unspecified unspecified unspecified unspecified  	O	null
15 [ [ [ punctuation unspecified unspecified unspecified unspecified unspecified  	O	null
16 ... ... ... punctuation unspecified unspecified unspecified unspecified unspecified  	O	null
17 ] ] ] punctuation unspecified unspecified unspecified unspecified unspecified  	O	null
18       punctuation unspecified unspecified unspecified unspecified unspecified  	O	null
19 ב ב בַּיְצִיאָה מֵהָעִיר preposition unspecified unspecified unspecified unspecified unspecified 0 
19 ה ה בַּיְצִיאָה מֵהָעִיר definiteArticle unspecified unspecified unspecified unspecified unspecified 0 
19 הַּיְצִיאָה מֵהָעִיר הַּיְצִיאָה מֵהָעִיר בַּיְצִיאָה מֵהָעִיר noun masculine singular absolute unspecified unspecified  	O	null
20 / / / punctuation unspecified unspecified unspecified unspecified unspecified  	O	null
21 [ [ [ punctuation unspecified unspecified unspecified unspecified unspecified  	O	null
22 ... ... ... punctuation unspecified unspecified unspecified unspecified unspecified  	O	null
23 ] ] ] punctuation unspecified unspecified unspecified unspecified unspecified  	O	null
24 הוּא הוּא הוּא verb masculine singular unspecified 3 past  	O	null
25 מ מ מְסַמֵּן preposition unspecified unspecified unspecified unspecified unspecified 0 
25 ְסַמֵּן ְסַמֵּן מְסַמֵּן properName unspecified unspecified unspecified unspecified unspecified  	I_PERS	null
26 ל ל לִי preposition unspecified unspecified unspecified unspecified unspecified 0 
26 ִי ִי לִי properName unspecified unspecified unspecified unspecified unspecified  	I_PERS	null
27 / / / punctuation unspecified unspecified unspecified unspecified unspecified  	O	null
28 אֶת אֶת אֶת noun masculine singular absolute unspecified unspecified  	O	null
29 קִבְרֵי קִבְרֵי קִבְרֵי noun masculine singular absolute unspecified unspecified  	O	null
30 אִמִּי אִמִּי אִמִּי properName unspecified unspecified unspecified unspecified unspecified  	I_PERS	null
31 ו ו וְסָבָתִי conjunction unspecified unspecified unspecified unspecified unspecified 0 
31 ְסָבָתִי ְסָבָתִי וְסָבָתִי properName unspecified unspecified unspecified unspecified unspecified  	I_PERS	null
32 / / / punctuation unspecified unspecified unspecified unspecified unspecified  	O	null
33 ש ש שֶׁשָּׁרְשֵׁיהֶן relativizer/subordinatingConjunction unspecified unspecified unspecified unspecified unspecified 0 
33 ֶׁשָּׁרְשֵׁיהֶן ֶׁשָּׁרְשֵׁיהֶן שֶׁשָּׁרְשֵׁיהֶן noun masculine singular absolute unspecified unspecified  	O	null
34 ב ב בִּירוּשָׁלַיִם preposition unspecified unspecified unspecified unspecified unspecified 0 
34 ִּירוּשָׁלַיִם ִּירוּשָׁלַיִם בִּירוּשָׁלַיִם properName unspecified unspecified unspecified unspecified unspecified  	I_LOC	null
35 / / / punctuation unspecified unspecified unspecified unspecified unspecified  	O	null
36 ב ב בִּימֵי preposition unspecified unspecified unspecified unspecified unspecified 0 
36 ה ה בִּימֵי definiteArticle unspecified unspecified unspecified unspecified unspecified 0 
36 הִּימֵי הִּימֵי בִּימֵי noun masculine singular absolute unspecified unspecified  	O	null
37 ה ה הַבְּרִיטִי definiteArticle unspecified unspecified unspecified unspecified unspecified 0 
37 הַבְּרִיטִי הַבְּרִיטִי הַבְּרִיטִי adjective masculine singular absolute unspecified unspecified  	O	null
38 וְהַתּוּרְכִּי וְהַתּוּרְכִּי וְהַתּוּרְכִּי properName unspecified unspecified unspecified unspecified unspecified  	I_PERS	null
39 / / / punctuation unspecified unspecified unspecified unspecified unspecified  	O	null
40 וַאֲצִילוּתָן וַאֲצִילוּתָן וַאֲצִילוּתָן noun masculine singular absolute unspecified unspecified  	O	null
41 אֲצִילוּת אֲצִילוּת אֲצִילוּת properName unspecified unspecified unspecified unspecified unspecified  	I_PERS	null
42 יָפָה יָפָה יָפָה properName unspecified unspecified unspecified unspecified unspecified  	I_PERS	null
43 , , , punctuation unspecified unspecified unspecified unspecified unspecified  	O	null
44 יְחֵפָה יְחֵפָה יְחֵפָה noun masculine singular construct unspecified unspecified  	O	null
45 / / / punctuation unspecified unspecified unspecified unspecified unspecified  	O	null
46 חַפָּה חַפָּה חַפָּה noun feminine singular absolute unspecified unspecified  	O	null
47 מִגִּנּוּנִים מִגִּנּוּנִים מִגִּנּוּנִים noun masculine singular absolute unspecified unspecified  	O	null
48 וּמִכְּתָרִים וּמִכְּתָרִים וּמִכְּתָרִים noun feminine singular absolute unspecified unspecified  	O	null
49 " " " punctuation unspecified unspecified unspecified unspecified unspecified  	O	null
50 ( ( ( punctuation unspecified unspecified unspecified unspecified unspecified  	O	null
51 ללא ללא ללא preposition unspecified unspecified unspecified unspecified unspecified  	O	null
52 כותרת כותרת כותרת noun feminine singular construct unspecified unspecified  	O	null
53 ) ) ) punctuation unspecified unspecified unspecified unspecified unspecified  	O	null
54 . . . punctuation unspecified unspecified unspecified unspecified unspecified  	O	null

0 ב ב בשירי preposition unspecified unspecified unspecified unspecified unspecified 0 
0 שירי שיר בשירי noun masculine plural construct unspecified unspecified  	O	null
1 ה ה האהבה definiteArticle unspecified unspecified unspecified unspecified unspecified 0 
1 האהבה אהבה האהבה noun feminine singular absolute unspecified unspecified  	O	null
2 ש ש שבספר relativizer/subordinatingConjunction unspecified unspecified unspecified unspecified unspecified 0 
2 ב ב שבספר preposition unspecified unspecified unspecified unspecified unspecified 0 
2 ספר ספר שבספר noun masculine singular construct unspecified unspecified  	O	null
3 מודגש הודגש מודגש verb masculine singular unspecified any beinoni  	O	null
4 רצון רצון רצון noun masculine singular construct unspecified unspecified  	O	null
5 ה ה המשורר definiteArticle unspecified unspecified unspecified unspecified unspecified 0 
5 המשורר משורר המשורר noun masculine singular absolute unspecified unspecified  	O	null
6 לומר אמר לומר verb unspecified unspecified unspecified unspecified infinitive  	O	null
7 את את את at-preposition unspecified unspecified unspecified unspecified unspecified  	O	null
8 אשר אשר אשר properName masculine singular unspecified unspecified unspecified  	I_PERS	null
9 על על על preposition unspecified unspecified unspecified unspecified unspecified  	O	null
10 לב לב לבו noun masculine singular absolute unspecified unspecified  
10 ו ו לבו possessive masculine singular unspecified 3 unspecified 0 	O	null
11 , , , punctuation unspecified unspecified unspecified unspecified unspecified  	O	null
12 אך אך אך conjunction unspecified unspecified unspecified unspecified unspecified  	O	null
13 ה ה הדברים definiteArticle unspecified unspecified unspecified unspecified unspecified 0 
13 הדברים דבר הדברים noun masculine plural absolute unspecified unspecified  	O	null
14 אינם הוא אינם copula masculine plural unspecified 3 beinoni  	O	null
15 מגיעים הגיע מגיעים verb masculine plural unspecified any beinoni  	O	null
16 ל ל לכלל preposition unspecified unspecified unspecified unspecified unspecified 0 
16 כלל כלל לכלל properName unspecified unspecified unspecified unspecified unspecified  	O	null
17 הבעה הבעה הבעה noun feminine singular absolute unspecified unspecified  	O	null
18 : : : punctuation unspecified unspecified unspecified unspecified unspecified  	O	null
19 " " " punctuation unspecified unspecified unspecified unspecified unspecified  	O	null
20 מִלִּים מִלִּים מִלִּים noun masculine plural absolute unspecified unspecified  	O	null
21 ש ש שֶׁרָצִיתִי relativizer/subordinatingConjunction unspecified unspecified unspecified unspecified unspecified 0 
21 ֶׁרָצִיתִי ֶׁרָצִיתִי שֶׁרָצִיתִי adjective masculine singular absolute unspecified unspecified  	O	null
22 ל ל לְהַגִּיד preposition unspecified unspecified unspecified unspecified unspecified 0 
22 ה ה לְהַגִּיד definiteArticle unspecified unspecified unspecified unspecified unspecified 0 
22 הְהַגִּיד הְהַגִּיד לְהַגִּיד noun feminine singular absolute unspecified unspecified  	O	null
23 לָך לָך לָך properName unspecified unspecified unspecified unspecified unspecified  	I_PERS	null
24 ְ ְ ְ punctuation unspecified unspecified unspecified unspecified unspecified  	O	null
25 / / / punctuation unspecified unspecified unspecified unspecified unspecified  	O	null
26 עָבְרו עָבְרו עָבְרו verb masculine-and-feminine plural unspecified 3 past  	O	null
27 ּ ּ ּ punctuation unspecified unspecified unspecified unspecified unspecified  	O	null
28 כִּרְסִיסֵי כִּרְסִיסֵי כִּרְסִיסֵי noun masculine singular absolute unspecified unspecified  	O	null
29 טַל טַל טַל properName unspecified unspecified unspecified unspecified unspecified  	I_PERS	null
30 / / / punctuation unspecified unspecified unspecified unspecified unspecified  	O	null
31 עַל עַל עַל noun masculine singular construct unspecified unspecified  	O	null
32 גְּדֵרוֹת גְּדֵרוֹת גְּדֵרוֹת properName unspecified unspecified unspecified unspecified unspecified  	I_PERS	null
33 מ מ מְנֻמָּרוֹת preposition unspecified unspecified unspecified unspecified unspecified 0 
33 ְנֻמָּרוֹת ְנֻמָּרוֹת מְנֻמָּרוֹת properName unspecified unspecified unspecified unspecified unspecified  	I_PERS	null
34 / / / punctuation unspecified unspecified unspecified unspecified unspecified  	O	null
35 ש ש שֶׁלִּוּו relativizer/subordinatingConjunction unspecified unspecified unspecified unspecified unspecified 0 
35 ֶׁלִּוּו ֶׁלִּוּו שֶׁלִּוּו properName masculine singular unspecified unspecified unspecified  	I_PERS	null
36 ּ ּ ּ punctuation unspecified unspecified unspecified unspecified unspecified  	O	null
37 אֶת אֶת אֶת properName unspecified unspecified unspecified unspecified unspecified  	I_PERS	null
38 דַּרְכֵּך דַּרְכֵּך דַּרְכֵּך properName unspecified unspecified unspecified unspecified unspecified  	I_PERS	null
39 ְ ְ ְ punctuation unspecified unspecified unspecified unspecified unspecified  	O	null
40 / / / punctuation unspecified unspecified unspecified unspecified unspecified  	O	null
41 בְּעָבְרֵך בְּעָבְרֵך בְּעָבְרֵך properName unspecified unspecified unspecified unspecified unspecified  	I_PERS	null
42 ְ ְ ְ punctuation unspecified unspecified unspecified unspecified unspecified  	O	null
43 " " " punctuation unspecified unspecified unspecified unspecified unspecified  	O	null
44 ( ( ( punctuation unspecified unspecified unspecified unspecified unspecified  	O	null
45 ללא ללא ללא preposition unspecified unspecified unspecified unspecified unspecified  	O	null
46 כותרת כותרת כותרת noun feminine singular construct unspecified unspecified  	O	null
47 ) ) ) punctuation unspecified unspecified unspecified unspecified unspecified  	O	null
48 . . . punctuation unspecified unspecified unspecified unspecified unspecified  	O	null

0 ב ב בשנים preposition unspecified unspecified unspecified unspecified unspecified 0 
0 שנים שנה בשנים noun feminine plural absolute unspecified unspecified  	O	null
1 ###NUMBER### ###NUMBER### ###NUMBER### numeral unspecified unspecified unspecified unspecified unspecified  	I_DATE	null
2 - - - punctuation unspecified unspecified unspecified unspecified unspecified  	O	null
3 ###NUMBER### ###NUMBER### ###NUMBER### numeral unspecified unspecified unspecified unspecified unspecified  	I_DATE	null
4 ראו ראה ראו verb masculine-and-feminine plural unspecified 3 past  	O	null
5 אור אור אור noun masculine singular construct unspecified unspecified  	O	null
6 ספרי ספר ספרי noun masculine plural construct unspecified unspecified  	O	null
7 הוראת הוראה הוראת noun feminine singular construct unspecified unspecified  	O	null
8 ספרות ספרות ספרות noun feminine singular absolute unspecified unspecified  	O	null
9 ש ש שכתב relativizer/subordinatingConjunction unspecified unspecified unspecified unspecified unspecified 0 
9 כתב כתב שכתב verb masculine singular unspecified 3 past  	O	null
10 על על על preposition unspecified unspecified unspecified unspecified unspecified  	O	null
11 שירת שירה שירת noun feminine singular construct unspecified unspecified  	O	null
12 שלונסקי שלונסקי שלונסקי properName unspecified unspecified unspecified unspecified unspecified  	I_LOC	null
13 , , , punctuation unspecified unspecified unspecified unspecified unspecified  	O	null
14 מרטין מרטין מרטין properName unspecified unspecified unspecified unspecified unspecified  	I_PERS	null
15 בובר בובר בובר properName unspecified unspecified unspecified unspecified unspecified  	I_PERS	null
16 , , , punctuation unspecified unspecified unspecified unspecified unspecified  	O	null
17 אנטיגונה אנטיגונה אנטיגונה properName unspecified unspecified unspecified unspecified unspecified  	I_PERS	null
18 , , , punctuation unspecified unspecified unspecified unspecified unspecified  	O	null
19 ה ה הזקן definiteArticle unspecified unspecified unspecified unspecified unspecified 0 
19 הזקן זקן הזקן noun masculine singular absolute unspecified unspecified  	O	null
20 ו ו והים conjunction unspecified unspecified unspecified unspecified unspecified 0 
20 ה ה והים definiteArticle unspecified unspecified unspecified unspecified unspecified 0 
20 הים ים והים noun masculine singular absolute unspecified unspecified  	O	null
21 . . . punctuation unspecified unspecified unspecified unspecified unspecified  	O	null

0 חלקים חלק חלקים noun masculine plural absolute unspecified unspecified  	O	null
1 מ מ ממחקרו preposition unspecified unspecified unspecified unspecified unspecified 0 
1 מחקר מחקר ממחקרו noun masculine singular absolute unspecified unspecified  
1 ו ו ממחקרו possessive masculine singular unspecified 3 unspecified 0 	O	null
2 ה ה הדת definiteArticle unspecified unspecified unspecified unspecified unspecified 0 
2 הדת דת הדת noun feminine singular absolute unspecified unspecified  	O	null
3 , , , punctuation unspecified unspecified unspecified unspecified unspecified  	O	null
4 ה ה התרבות definiteArticle unspecified unspecified unspecified unspecified unspecified 0 
4 התרבות תרבות התרבות noun feminine singular absolute unspecified unspecified  	O	null
5 ו ו והחיים conjunction unspecified unspecified unspecified unspecified unspecified 0 
5 ה ה והחיים definiteArticle unspecified unspecified unspecified unspecified unspecified 0 
5 החיים חיים והחיים noun masculine plural absolute unspecified unspecified  	O	null
6 של של של shel-preposition unspecified unspecified unspecified unspecified unspecified  	O	null
7 יהודי יהודי יהודי noun masculine singular absolute unspecified unspecified  	O	null
8 גרוזיה גרוזיה גרוזיה properName unspecified unspecified unspecified unspecified unspecified  	I_LOC	null
9 ( ( ( punctuation unspecified unspecified unspecified unspecified unspecified  	O	null
10 ###NUMBER### ###NUMBER### ###NUMBER### numeral unspecified unspecified unspecified unspecified unspecified  	I_DATE	null
11 ) ) ) punctuation unspecified unspecified unspecified unspecified unspecified  	O	null
12 פורסמו פורסם פורסמו verb masculine-and-feminine plural unspecified 3 past  	O	null
13 ב ב בכתבי preposition unspecified unspecified unspecified unspecified unspecified 0 
13 כתבי כתב בכתבי noun masculine plural construct unspecified unspecified  	O	null
14 עת עת עת noun feminine singular absolute unspecified unspecified  	O	null
15 . . . punctuation unspecified unspecified unspecified unspecified unspecified  	O	null

0 זכה זכה זכה verb masculine singular unspecified 3 past  	O	null
1 ב ב בפרס preposition unspecified unspecified unspecified unspecified unspecified 0 
1 פרס פרס בפרס noun masculine singular absolute unspecified unspecified  	O	null
2 הרי הרי הרי conjunction unspecified unspecified unspecified unspecified unspecified  	O	null
3 הרשון הרשון הרשון properName unspecified unspecified unspecified unspecified unspecified  	I_PERS	null
4 מטעם מטעם מטעם preposition unspecified unspecified unspecified unspecified unspecified  	O	null
5 ה ה האוניברסיטה definiteArticle unspecified unspecified unspecified unspecified unspecified 0 
5 האוניברסיטה אוניברסיטה האוניברסיטה noun feminine singular absolute unspecified unspecified  	I_ORG	null
6 ה ה העברית definiteArticle unspecified unspecified unspecified unspecified unspecified 0 
6 העברית עברי העברית adjective feminine singular absolute unspecified unspecified  	I_ORG	null
7 ) ) ) punctuation unspecified unspecified unspecified unspecified unspecified  	O	null
8 , , , punctuation unspecified unspecified unspecified unspecified unspecified  	O	null
9 ###NUMBER### ###NUMBER### ###NUMBER### numeral unspecified unspecified unspecified unspecified unspecified  	I_DATE	null
10 ב ב בפרס preposition unspecified unspecified unspecified unspecified unspecified 0 
10 פרס פרס בפרס properName masculine singular unspecified unspecified unspecified  	I_PERS	null
11 אולסוונגר אולסוונגר אולסוונגר properName unspecified unspecified unspecified unspecified unspecified  	I_PERS	null
12 מטעם מטעם מטעם preposition unspecified unspecified unspecified unspecified unspecified  	O	null
13 ה ה המרכז definiteArticle unspecified unspecified unspecified unspecified unspecified 0 
13 המרכז מרכז המרכז noun masculine singular absolute unspecified unspecified  	O	null
14 ל ל לחקר preposition unspecified unspecified unspecified unspecified unspecified 0 
14 חקר חקר לחקר noun masculine singular construct unspecified unspecified  	O	null
15 ה ה הפולקלור definiteArticle unspecified unspecified unspecified unspecified unspecified 0 
15 הפולקלור הפולקלור הפולקלור noun masculine singular absolute unspecified unspecified  	O	null
16 של של של shel-preposition unspecified unspecified unspecified unspecified unspecified  	O	null
17 ה ה האוניברסיטה definiteArticle unspecified unspecified unspecified unspecified unspecified 0 
17 האוניברסיטה אוניברסיטה האוניברסיטה noun feminine singular absolute unspecified unspecified  	I_ORG	null
18 ה ה העברית definiteArticle unspecified unspecified unspecified unspecified unspecified 0 
18 העברית עברי העברית adjective feminine singular absolute unspecified unspecified  	I_ORG	null
19 ) ) ) punctuation unspecified unspecified unspecified unspecified unspecified  	O	null
20 , , , punctuation unspecified unspecified unspecified unspecified unspecified  	O	null
21 ###NUMBER### ###NUMBER### ###NUMBER### numeral unspecified unspecified unspecified unspecified unspecified  	I_DATE	null
22 ו ו ובעיטור conjunction unspecified unspecified unspecified unspecified unspecified 0 
22 ב ב ובעיטור preposition unspecified unspecified unspecified unspecified unspecified 0 
22 עיטור עיטור ובעיטור noun masculine singular construct unspecified unspecified  	O	null
23 " " " punctuation unspecified unspecified unspecified unspecified unspecified  	O	null
24 חתן חתן חתן noun masculine singular construct unspecified unspecified  	O	null
25 ה ה האור definiteArticle unspecified unspecified unspecified unspecified unspecified 0 
25 האור אור האור noun masculine singular absolute unspecified unspecified  	O	null
26 " " " punctuation unspecified unspecified unspecified unspecified unspecified  	O	null
27 מטעם מטעם מטעם preposition unspecified unspecified unspecified unspecified unspecified  	O	null
28 ה ה המועצה definiteArticle unspecified unspecified unspecified unspecified unspecified 0 
28 המועצה מועצה המועצה noun feminine singular absolute unspecified unspecified  	O	null
29 ה ה הציונית definiteArticle unspecified unspecified unspecified unspecified unspecified 0 
29 הציונית ציוני הציונית adjective feminine singular absolute unspecified unspecified  	O	null
30 ב ב בישראל preposition unspecified unspecified unspecified unspecified unspecified 0 
30 ישראל ישראל בישראל properName unspecified unspecified unspecified unspecified unspecified  	I_LOC	null
31 ) ) ) punctuation unspecified unspecified unspecified unspecified unspecified  	O	null
32 . . . punctuation unspecified unspecified unspecified unspecified unspecified  	O	null
33 ###NUMBER### ###NUMBER### ###NUMBER### numeral unspecified unspecified unspecified unspecified unspecified  	I_DATE	null
34 ב ב ב preposition unspecified unspecified unspecified unspecified unspecified 0 	O	null
35 - - - punctuation unspecified unspecified unspecified unspecified unspecified  	O	null
36 ###NUMBER### ###NUMBER### ###NUMBER### numeral unspecified unspecified unspecified unspecified unspecified  	I_DATE	null
37 הפיקה הפיק הפיקה verb feminine singular unspecified 3 past  	O	null
38 עיריית עירייה עיריית noun feminine singular construct unspecified unspecified  	I_ORG	null
39 ירושלים ירושלים ירושלים properName unspecified unspecified unspecified unspecified unspecified  	I_ORG	null
40 סרט סרט סרט noun masculine singular absolute unspecified unspecified  	O	null
41 על על על preposition unspecified unspecified unspecified unspecified unspecified  	O	null
42 חיי חיים חייו noun masculine plural absolute unspecified unspecified  
42 ו ו חייו possessive masculine singular unspecified 3 unspecified 0 	O	null
43 ב ב בשם preposition unspecified unspecified unspecified unspecified unspecified 0 
43 שם שם בשם noun masculine singular construct unspecified unspecified  	O	null
44 זקן זקן זקן noun masculine singular construct unspecified unspecified  	O	null
45 מורי מורה מורי properName unspecified unspecified unspecified unspecified unspecified  	I_PERS	null
46 ירושלים ירושלים ירושלים properName unspecified unspecified unspecified unspecified unspecified  	I_LOC	null
47 . . . punctuation unspecified unspecified unspecified unspecified unspecified  	O	null

0 References References References foreign unspecified unspecified unspecified unspecified unspecified  	O	null
1 : : : punctuation unspecified unspecified unspecified unspecified unspecified  	O	null
2 בן בן בן properName unspecified unspecified unspecified unspecified unspecified  	I_ORG	null
3 - - - properName unspecified unspecified unspecified unspecified unspecified  	I_ORG	null
4 מרדכי מרדכי מרדכי properName unspecified unspecified unspecified unspecified unspecified  	I_ORG	null
5 , , , punctuation unspecified unspecified unspecified unspecified unspecified  	O	null
6 יצחק יצחק יצחק properName unspecified unspecified unspecified unspecified unspecified  	I_PERS	null
7 . . . punctuation unspecified unspecified unspecified unspecified unspecified  	O	null

0 " " " punctuation unspecified unspecified unspecified unspecified unspecified  	O	null
1 קינת קינה קינת noun feminine singular construct unspecified unspecified  	O	null
2 ירושלים ירושלים ירושלים properName unspecified unspecified unspecified unspecified unspecified  	I_LOC	null
3 ה ה האחרת definiteArticle unspecified unspecified unspecified unspecified unspecified 0 
3 האחרת אחר האחרת adjective feminine singular absolute unspecified unspecified  	O	null
4 " " " punctuation unspecified unspecified unspecified unspecified unspecified  	O	null
5 . . . punctuation unspecified unspecified unspecified unspecified unspecified  	O	null

0 מאזנייםמ"ט מאזנייםמ"ט מאזנייםמ"ט properName unspecified unspecified unspecified unspecified unspecified  	I_PERS	null
1 . . . punctuation unspecified unspecified unspecified unspecified unspecified  	O	null

0 ###NUMBER### ###NUMBER### ###NUMBER### numeral unspecified unspecified unspecified unspecified unspecified  	I_DATE	null
1 . . . punctuation unspecified unspecified unspecified unspecified unspecified  	O	null

0 ; ; ; punctuation unspecified unspecified unspecified unspecified unspecified  	O	null
1 ###NUMBER### ###NUMBER### ###NUMBER### numeral unspecified unspecified unspecified unspecified unspecified  	O	null
2 גרנות גורן גרנות noun feminine plural absolute unspecified unspecified  	O	null
3 , , , punctuation unspecified unspecified unspecified unspecified unspecified  	O	null
4 משה משה משה properName unspecified unspecified unspecified unspecified unspecified  	I_PERS	null
5 . . . punctuation unspecified unspecified unspecified unspecified unspecified  	O	null

0 " " " punctuation unspecified unspecified unspecified unspecified unspecified  	O	null
1 כפוי כפוי כפוי adjective masculine singular absolute unspecified unspecified  	O	null
2 אל אל אל preposition unspecified unspecified unspecified unspecified unspecified  	O	null
3 ה ה המילה definiteArticle unspecified unspecified unspecified unspecified unspecified 0 
3 המילה מילה המילה noun feminine singular absolute unspecified unspecified  	O	null
4 " " " punctuation unspecified unspecified unspecified unspecified unspecified  	O	null
5 . . . punctuation unspecified unspecified unspecified unspecified unspecified  	O	null

0 מאזנייםע"ח מאזנייםע"ח מאזנייםע"ח properName unspecified unspecified unspecified unspecified unspecified  	O	null
1 ) ) ) punctuation unspecified unspecified unspecified unspecified unspecified  	O	null
2 . . . punctuation unspecified unspecified unspecified unspecified unspecified  	O	null
3 ###NUMBER### ###NUMBER### ###NUMBER### numeral unspecified unspecified unspecified unspecified unspecified  	I_ORG	null
4 יוני יוני יוני properName unspecified unspecified unspecified unspecified unspecified  	I_DATE	null
5 ###NUMBER### ###NUMBER### ###NUMBER### numeral unspecified unspecified unspecified unspecified unspecified  	I_DATE	null
6 . . . punctuation unspecified unspecified unspecified unspecified unspecified  	O	null

0 ###NUMBER### ###NUMBER### ###NUMBER### numeral unspecified unspecified unspecified unspecified unspecified  	O	null
1 ־ ־ ־ punctuation unspecified unspecified unspecified unspecified unspecified  	O	null
2 ###NUMBER### ###NUMBER### ###NUMBER### numeral unspecified unspecified unspecified unspecified unspecified  	O	null
3 . . . punctuation unspecified unspecified unspecified unspecified unspecified  	O	null

