0 Name Name Name foreign unspecified unspecified unspecified unspecified unspecified  	O	null
1 : : : punctuation unspecified unspecified unspecified unspecified unspecified  	O	null
2 גלבוע גלבוע גלבוע properName unspecified unspecified unspecified unspecified unspecified  	I_PERS	null
3 , , , punctuation unspecified unspecified unspecified unspecified unspecified  	O	null
4 מנוחה מנוחה מנוחה noun feminine singular absolute unspecified unspecified  	O	null
5 Birth Birth Birth foreign unspecified unspecified unspecified unspecified unspecified  	O	null
6 Year Year Year foreign unspecified unspecified unspecified unspecified unspecified  	O	null
7 : : : punctuation unspecified unspecified unspecified unspecified unspecified  	O	null
8 ###NUMBER### ###NUMBER### ###NUMBER### numeral unspecified unspecified unspecified unspecified unspecified  	I_DATE	null
9 Death Death Death foreign unspecified unspecified unspecified unspecified unspecified  	O	null
10 Year Year Year foreign unspecified unspecified unspecified unspecified unspecified  	O	null
11 : : : punctuation unspecified unspecified unspecified unspecified unspecified  	O	null
12 ###NUMBER### ###NUMBER### ###NUMBER### numeral unspecified unspecified unspecified unspecified unspecified  	I_DATE	null
13 Birth Birth Birth foreign unspecified unspecified unspecified unspecified unspecified  	O	null
14 Place Place Place foreign unspecified unspecified unspecified unspecified unspecified  	O	null
15 : : : punctuation unspecified unspecified unspecified unspecified unspecified  	O	null
16 ירושלים ירושלים ירושלים properName unspecified unspecified unspecified unspecified unspecified  	I_LOC	null
17 Occupation Occupation Occupation foreign unspecified unspecified unspecified unspecified unspecified  	O	null
18 : : : punctuation unspecified unspecified unspecified unspecified unspecified  	O	null
19 חוקרת חקר חוקרת verb feminine singular unspecified any beinoni  	O	null
20 ספרות ספרות ספרות noun feminine singular absolute unspecified unspecified  	O	null
21 , , , punctuation unspecified unspecified unspecified unspecified unspecified  	O	null
22 מבקרת מבקר מבקרת noun feminine singular absolute unspecified unspecified  	O	null
23 ו ו ומשוררת conjunction unspecified unspecified unspecified unspecified unspecified 0 
23 משוררת משורר ומשוררת noun feminine singular absolute unspecified unspecified  	O	null
24 Entry Entry Entry foreign unspecified unspecified unspecified unspecified unspecified  	O	null
25 writer writer writer foreign unspecified unspecified unspecified unspecified unspecified  	O	null
26 : : : punctuation unspecified unspecified unspecified unspecified unspecified  	O	null
27 אבנר אבנר אבנר properName unspecified unspecified unspecified unspecified unspecified  	I_PERS	null
28 הולצמן הולצמן הולצמן properName unspecified unspecified unspecified unspecified unspecified  	I_PERS	null
29 Entry Entry Entry foreign unspecified unspecified unspecified unspecified unspecified  	O	null
30 Value Value Value foreign unspecified unspecified unspecified unspecified unspecified  	O	null
31 : : : punctuation unspecified unspecified unspecified unspecified unspecified  	O	null
32 נולדה נולד נולדה verb feminine singular unspecified 3 past  	O	null
33 ב ב בירושלים preposition unspecified unspecified unspecified unspecified unspecified 0 
33 ירושלים ירושלים בירושלים properName unspecified unspecified unspecified unspecified unspecified  	I_LOC	null
34 . . . punctuation unspecified unspecified unspecified unspecified unspecified  	O	null

0 למדה למד למדה verb feminine singular unspecified 3 past  	O	null
1 ב ב בבית preposition unspecified unspecified unspecified unspecified unspecified 0 
1 בית בית בבית noun masculine singular construct unspecified unspecified  	O	null
2 ה ה הספר definiteArticle unspecified unspecified unspecified unspecified unspecified 0 
2 הספר ספר הספר noun masculine singular absolute unspecified unspecified  	O	null
3 " " " punctuation unspecified unspecified unspecified unspecified unspecified  	O	null
4 ה ה הריאלי definiteArticle unspecified unspecified unspecified unspecified unspecified 0 
4 הריאלי ריאלי הריאלי adjective masculine singular absolute unspecified unspecified  	O	null
5 " " " punctuation unspecified unspecified unspecified unspecified unspecified  	O	null
6 ב ב בחיפה preposition unspecified unspecified unspecified unspecified unspecified 0 
6 חיפה חיפה בחיפה properName unspecified unspecified unspecified unspecified unspecified  	I_LOC	null
7 , , , punctuation unspecified unspecified unspecified unspecified unspecified  	O	null
8 ו ו ובמלחמת conjunction unspecified unspecified unspecified unspecified unspecified 0 
8 ב ב ובמלחמת preposition unspecified unspecified unspecified unspecified unspecified 0 
8 מלחמת מלחמה ובמלחמת noun feminine singular construct unspecified unspecified  	O	null
9 ה ה העצמאות definiteArticle unspecified unspecified unspecified unspecified unspecified 0 
9 העצמאות עצמאות העצמאות noun feminine singular absolute unspecified unspecified  	O	null
10 שירתה שירת שירתה verb feminine singular unspecified 3 past  	O	null
11 ב ב בצה"ל preposition unspecified unspecified unspecified unspecified unspecified 0 
11 צה"ל צה"ל בצה"ל properName unspecified unspecified unspecified unspecified unspecified  	I_ORG	null
12 ו ו ועסקה conjunction unspecified unspecified unspecified unspecified unspecified 0 
12 עסקה עסק ועסקה verb feminine singular unspecified 3 past  	O	null
13 ב ב בטיפול preposition unspecified unspecified unspecified unspecified unspecified 0 
13 טיפול טיפול בטיפול noun masculine singular absolute unspecified unspecified  	O	null
14 ב ב במשפחות preposition unspecified unspecified unspecified unspecified unspecified 0 
14 משפחות משפחה במשפחות noun feminine plural construct unspecified unspecified  	O	null
15 ה ה הנפגעים definiteArticle unspecified unspecified unspecified unspecified unspecified 0 
15 הנפגעים נפגע הנפגעים noun masculine plural absolute unspecified unspecified  	O	null
16 . . . punctuation unspecified unspecified unspecified unspecified unspecified  	O	null

0 סיימה סיים סיימה verb feminine singular unspecified 3 past  	O	null
1 את את את at-preposition unspecified unspecified unspecified unspecified unspecified  	O	null
2 בית בית בית noun masculine singular construct unspecified unspecified  	O	null
3 ה ה המדרש definiteArticle unspecified unspecified unspecified unspecified unspecified 0 
3 המדרש מדרש המדרש noun masculine singular absolute unspecified unspecified  	O	null
4 ל ל למורים preposition unspecified unspecified unspecified unspecified unspecified 0 
4 ה ה למורים definiteArticle unspecified unspecified unspecified unspecified unspecified 0 
4 המורים מורה למורים noun masculine plural absolute unspecified unspecified  	O	null
5 בתלאביב בתלאביב בתלאביב properName unspecified unspecified unspecified unspecified unspecified  	I_PERS	null
6 ו ו ולמדה conjunction unspecified unspecified unspecified unspecified unspecified 0 
6 למדה למד ולמדה verb feminine singular unspecified 3 past  	O	null
7 ספרות ספרות ספרות noun feminine singular absolute unspecified unspecified  	O	null
8 ו ו וחינוך conjunction unspecified unspecified unspecified unspecified unspecified 0 
8 חינוך חינוך וחינוך noun masculine singular absolute unspecified unspecified  	O	null
9 ל ל לתואר preposition unspecified unspecified unspecified unspecified unspecified 0 
9 תואר תואר לתואר noun masculine singular absolute unspecified unspecified  	O	null
10 ראשון ORD1 ראשון numeral masculine singular absolute unspecified unspecified  	O	null
11 ב ב באוניברסיטה preposition unspecified unspecified unspecified unspecified unspecified 0 
11 ה ה באוניברסיטה definiteArticle unspecified unspecified unspecified unspecified unspecified 0 
11 האוניברסיטה אוניברסיטה באוניברסיטה noun feminine singular absolute unspecified unspecified  	O	null
12 ה ה העברית definiteArticle unspecified unspecified unspecified unspecified unspecified 0 
12 העברית עברי העברית adjective feminine singular absolute unspecified unspecified  	O	null
13 ב ב בירושלים preposition unspecified unspecified unspecified unspecified unspecified 0 
13 ירושלים ירושלים בירושלים properName unspecified unspecified unspecified unspecified unspecified  	I_LOC	null
14 . . . punctuation unspecified unspecified unspecified unspecified unspecified  	O	null

0 את את את at-preposition unspecified unspecified unspecified unspecified unspecified  	O	null
1 לימודי לימוד לימודי noun masculine plural construct unspecified unspecified  	O	null
2 ה ה התואר definiteArticle unspecified unspecified unspecified unspecified unspecified 0 
2 התואר תואר התואר noun masculine singular absolute unspecified unspecified  	O	null
3 ה ה השני definiteArticle unspecified unspecified unspecified unspecified unspecified 0 
3 השני ORD2 השני numeral masculine singular absolute unspecified unspecified  	O	null
4 ו ו והשלישי conjunction unspecified unspecified unspecified unspecified unspecified 0 
4 ה ה והשלישי definiteArticle unspecified unspecified unspecified unspecified unspecified 0 
4 השלישי ORD3 והשלישי numeral masculine singular absolute unspecified unspecified  	O	null
5 ב ב בספרות preposition unspecified unspecified unspecified unspecified unspecified 0 
5 ספרות ספרות בספרות noun feminine singular construct unspecified unspecified  	O	null
6 עברית עברית עברית properName feminine singular unspecified unspecified unspecified  	I_ORG	null
7 השלימה השלים השלימה verb feminine singular unspecified 3 past  	O	null
8 ב ב באוניברסיטת preposition unspecified unspecified unspecified unspecified unspecified 0 
8 אוניברסיטת אוניברסיטה באוניברסיטת noun feminine singular construct unspecified unspecified  	O	null
9 תלאביב תלאביב תלאביב properName unspecified unspecified unspecified unspecified unspecified  	I_ORG	null
10 , , , punctuation unspecified unspecified unspecified unspecified unspecified  	O	null
11 ו ו וב conjunction unspecified unspecified unspecified unspecified unspecified 0 
11 ב ב וב preposition unspecified unspecified unspecified unspecified unspecified 0 	O	null
12 - - - punctuation unspecified unspecified unspecified unspecified unspecified  	O	null
13 ###NUMBER### ###NUMBER### ###NUMBER### numeral unspecified unspecified unspecified unspecified unspecified  	I_DATE	null
14 הוענק הוענק הוענק verb masculine singular unspecified 3 past  	O	null
15 ל ל לה preposition unspecified unspecified unspecified unspecified unspecified  
15 ה ה לה pronomial feminine singular unspecified 3 unspecified 0 	O	null
16 תואר תואר תואר noun masculine singular absolute unspecified unspecified  	O	null
17 דוקטור דוקטור דוקטור noun masculine singular absolute unspecified unspecified  	O	null
18 . . . punctuation unspecified unspecified unspecified unspecified unspecified  	O	null

0 מאז מאז מאז adverb unspecified unspecified unspecified unspecified unspecified  	O	null
1 ###NUMBER### ###NUMBER### ###NUMBER### numeral unspecified unspecified unspecified unspecified unspecified  	I_DATE	null
2 לימדה לימד לימדה verb feminine singular unspecified 3 past  	O	null
3 ב ב במוסדות preposition unspecified unspecified unspecified unspecified unspecified 0 
3 מוסדות מוסד במוסדות noun masculine plural absolute unspecified unspecified  	O	null
4 שונים שונה שונים adjective masculine plural absolute unspecified unspecified  	O	null
5 ל ל להכשרת preposition unspecified unspecified unspecified unspecified unspecified 0 
5 הכשרת הכשרה להכשרת noun feminine singular construct unspecified unspecified  	O	null
6 מורים מורה מורים noun masculine plural absolute unspecified unspecified  	O	null
7 , , , punctuation unspecified unspecified unspecified unspecified unspecified  	O	null
8 ו ו ומ conjunction unspecified unspecified unspecified unspecified unspecified 0 
8 מ מ ומ preposition unspecified unspecified unspecified unspecified unspecified 0 	O	null
9 - - - punctuation unspecified unspecified unspecified unspecified unspecified  	O	null
10 ###NUMBER### ###NUMBER### ###NUMBER### numeral unspecified unspecified unspecified unspecified unspecified  	I_DATE	null
11 ואילך ואילך ואילך adverb unspecified unspecified unspecified unspecified unspecified  	O	null
12 נמנתה נמנה נמנתה verb feminine singular unspecified 3 past  	O	null
13 עם עם עם preposition unspecified unspecified unspecified unspecified unspecified  	O	null
14 סגל סגל סגל noun masculine singular construct unspecified unspecified  	O	null
15 ה ה החוג definiteArticle unspecified unspecified unspecified unspecified unspecified 0 
15 החוג חוג החוג noun masculine singular absolute unspecified unspecified  	O	null
16 ל ל לספרות preposition unspecified unspecified unspecified unspecified unspecified 0 
16 ספרות ספרות לספרות noun feminine singular absolute unspecified unspecified  	O	null
17 עברית עברי עברית adjective feminine singular absolute unspecified unspecified  	O	null
18 ב ב באוניברסיטת preposition unspecified unspecified unspecified unspecified unspecified 0 
18 אוניברסיטת אוניברסיטה באוניברסיטת noun feminine singular construct unspecified unspecified  	I_ORG	null
19 תלאביב תלאביב תלאביב properName unspecified unspecified unspecified unspecified unspecified  	I_ORG	null
20 , , , punctuation unspecified unspecified unspecified unspecified unspecified  	O	null
21 שבו ישב שבו verb masculine-and-feminine plural unspecified 2 imperative  	O	null
22 התקדמה התקדם התקדמה verb feminine singular unspecified 3 past  	O	null
23 עד עד עד preposition unspecified unspecified unspecified unspecified unspecified  	O	null
24 ל ל לדרגת preposition unspecified unspecified unspecified unspecified unspecified 0 
24 דרגת דרגה לדרגת noun feminine singular construct unspecified unspecified  	O	null
25 פרופסורחבר פרופסורחבר פרופסורחבר adjective masculine singular construct unspecified unspecified  	O	null
26 . . . punctuation unspecified unspecified unspecified unspecified unspecified  	O	null

0 ב ב ב preposition unspecified unspecified unspecified unspecified unspecified 0 	O	null
1 - - - punctuation unspecified unspecified unspecified unspecified unspecified  	O	null
2 ###NUMBER### ###NUMBER### ###NUMBER### numeral unspecified unspecified unspecified unspecified unspecified  	I_DATE	null
3 פרשה פרשה פרשה noun feminine singular absolute unspecified unspecified  	O	null
4 ל ל לגמלאות preposition unspecified unspecified unspecified unspecified unspecified 0 
4 גמלאות גמלה לגמלאות noun feminine plural absolute unspecified unspecified  	O	null
5 . . . punctuation unspecified unspecified unspecified unspecified unspecified  	O	null

0 התמקדה התמקד התמקדה verb feminine singular unspecified 3 past  	O	null
1 ב ב בספרות preposition unspecified unspecified unspecified unspecified unspecified 0 
1 ה ה בספרות definiteArticle unspecified unspecified unspecified unspecified unspecified 0 
1 הספרות ספרות בספרות noun feminine singular absolute unspecified unspecified  	O	null
2 ה ה העברית definiteArticle unspecified unspecified unspecified unspecified unspecified 0 
2 העברית עברי העברית adjective feminine singular absolute unspecified unspecified  	O	null
3 של של של shel-preposition unspecified unspecified unspecified unspecified unspecified  	O	null
4 ה ה המאה definiteArticle unspecified unspecified unspecified unspecified unspecified 0 
4 המאה ORD-CARD100 המאה numeral feminine plural absolute unspecified unspecified  	O	null
5 ה ה התשע definiteArticle unspecified unspecified unspecified unspecified unspecified 0 
5 התשע CARD9 התשע numeral feminine singular absolute unspecified unspecified  	O	null
6 - - - punctuation unspecified unspecified unspecified unspecified unspecified  	O	null
7 עשרה CARD10 עשרה numeral masculine plural absolute unspecified unspecified  	O	null
8 . . . punctuation unspecified unspecified unspecified unspecified unspecified  	O	null

0 אחדים אחדים אחדים adjective masculine plural absolute unspecified unspecified  	O	null
1 מ מ ממחקריה preposition unspecified unspecified unspecified unspecified unspecified 0 
1 מחקרי מחקר ממחקריה noun masculine plural absolute unspecified unspecified  
1 ה ה ממחקריה possessive feminine singular unspecified 3 unspecified 0 	O	null
2 על על על preposition unspecified unspecified unspecified unspecified unspecified  	O	null
3 ה ה הסיפורת definiteArticle unspecified unspecified unspecified unspecified unspecified 0 
3 הסיפורת סיפורת הסיפורת noun feminine singular absolute unspecified unspecified  	O	null
4 ב ב בתקופת preposition unspecified unspecified unspecified unspecified unspecified 0 
4 תקופת תקופה בתקופת noun feminine singular construct unspecified unspecified  	O	null
5 ה ה ההשכלה definiteArticle unspecified unspecified unspecified unspecified unspecified 0 
5 ההשכלה השכלה ההשכלה noun feminine singular absolute unspecified unspecified  	O	null
6 כונס כונס כונסו noun masculine singular absolute unspecified unspecified  
6 ו ו כונסו possessive masculine singular unspecified 3 unspecified 0 	O	null
7 ב ב בספרה preposition unspecified unspecified unspecified unspecified unspecified 0 
7 ה ה בספרה definiteArticle unspecified unspecified unspecified unspecified unspecified 0 
7 הספרה ספרה בספרה noun feminine singular absolute unspecified unspecified  	O	null
8 מבנים מבנה מבנים noun masculine plural absolute unspecified unspecified  	O	null
9 ו ו ומשמעויות conjunction unspecified unspecified unspecified unspecified unspecified 0 
9 משמעויות משמעות ומשמעויות noun feminine plural construct unspecified unspecified  	O	null
10 ) ) ) punctuation unspecified unspecified unspecified unspecified unspecified  	O	null
11 . . . punctuation unspecified unspecified unspecified unspecified unspecified  	O	null
12 ###NUMBER### ###NUMBER### ###NUMBER### numeral unspecified unspecified unspecified unspecified unspecified  	I_DATE	null
13 הקדישה הקדיש הקדישה verb feminine singular unspecified 3 past  	O	null
14 עבודות עבודה עבודות noun feminine plural construct unspecified unspecified  	O	null
15 רבות רב רבות verb feminine plural unspecified any beinoni  	O	null
16 ל ל ליצירתו preposition unspecified unspecified unspecified unspecified unspecified 0 
16 יצירת יצירה ליצירתו noun feminine singular absolute unspecified unspecified  
16 ו ו ליצירתו possessive masculine singular unspecified 3 unspecified 0 	O	null
17 של של של shel-preposition unspecified unspecified unspecified unspecified unspecified  	O	null
18 דוד דוד דוד properName unspecified unspecified unspecified unspecified unspecified  	I_PERS	null
19 פרישמן פרישמן פרישמן properName unspecified unspecified unspecified unspecified unspecified  	I_PERS	null
20 , , , punctuation unspecified unspecified unspecified unspecified unspecified  	O	null
21 בתוך תיווך בתוכן verb unspecified unspecified unspecified unspecified infinitive  
21 ן ן בתוכן accusative-or-nominative feminine plural unspecified 3 unspecified 0 	O	null
22 ספרה סיפר ספרה verb feminine singular unspecified 3 past  	O	null
23 בין בין בין conjunction unspecified unspecified unspecified unspecified unspecified  	O	null
24 ריאליזם ריאליזם ריאליזם noun masculine singular construct unspecified unspecified  	O	null
25 ל ל לרומנטיקה preposition unspecified unspecified unspecified unspecified unspecified 0 
25 ה ה לרומנטיקה definiteArticle unspecified unspecified unspecified unspecified unspecified 0 
25 הרומנטיקה רומנטיקה לרומנטיקה noun feminine singular absolute unspecified unspecified  	O	null
26 : : : punctuation unspecified unspecified unspecified unspecified unspecified  	O	null
27 פרישמן פרישמן פרישמן properName unspecified unspecified unspecified unspecified unspecified  	O	null
28 ה ה המבקר definiteArticle unspecified unspecified unspecified unspecified unspecified 0 
28 המבקר מבקר המבקר noun masculine singular absolute unspecified unspecified  	O	null
29 ( ( ( punctuation unspecified unspecified unspecified unspecified unspecified  	O	null
30 ###NUMBER### ###NUMBER### ###NUMBER### numeral unspecified unspecified unspecified unspecified unspecified  	I_DATE	null
31 ) ) ) punctuation unspecified unspecified unspecified unspecified unspecified  	O	null
32 ו ו ומבחר conjunction unspecified unspecified unspecified unspecified unspecified 0 
32 מבחר מבחר ומבחר quantifier unspecified unspecified construct unspecified unspecified  	O	null
33 מאמרי מאמר מאמרי noun masculine plural construct unspecified unspecified  	O	null
34 ה ה הביקורת definiteArticle unspecified unspecified unspecified unspecified unspecified 0 
34 הביקורת ביקורת הביקורת noun feminine singular absolute unspecified unspecified  	O	null
35 שערכה שערך שערכה verb feminine singular unspecified 3 past  	O	null
36 על על על preposition unspecified unspecified unspecified unspecified unspecified  	O	null
37 יצירת יצירה יצירתו noun feminine singular absolute unspecified unspecified  
37 ו ו יצירתו possessive masculine singular unspecified 3 unspecified 0 	O	null
38 ) ) ) punctuation unspecified unspecified unspecified unspecified unspecified  	O	null
39 . . . punctuation unspecified unspecified unspecified unspecified unspecified  	O	null
40 ###NUMBER### ###NUMBER### ###NUMBER### numeral unspecified unspecified unspecified unspecified unspecified  	I_DATE	null
41 מאמרי מאמר מאמריה noun masculine plural absolute unspecified unspecified  
41 ה ה מאמריה possessive feminine singular unspecified 3 unspecified 0 	O	null
42 על על על preposition unspecified unspecified unspecified unspecified unspecified  	O	null
43 עליית עלייה עליית noun feminine singular construct unspecified unspecified  	O	null
44 ה ה הריאליזם definiteArticle unspecified unspecified unspecified unspecified unspecified 0 
44 הריאליזם ריאליזם הריאליזם noun masculine singular absolute unspecified unspecified  	O	null
45 ב ב בסיפורת preposition unspecified unspecified unspecified unspecified unspecified 0 
45 סיפורת סיפורת בסיפורת noun feminine singular construct unspecified unspecified  	O	null
46 ה ה העברית definiteArticle unspecified unspecified unspecified unspecified unspecified 0 
46 העברית עברית העברית properName feminine singular unspecified unspecified unspecified  	O	null
47 כונס כונס כונסו noun masculine singular absolute unspecified unspecified  
47 ו ו כונסו possessive masculine singular unspecified 3 unspecified 0 	O	null
48 ב ב בספרה preposition unspecified unspecified unspecified unspecified unspecified 0 
48 ה ה בספרה definiteArticle unspecified unspecified unspecified unspecified unspecified 0 
48 הספרה ספרה בספרה noun feminine singular absolute unspecified unspecified  	O	null
49 ה ה המהלך definiteArticle unspecified unspecified unspecified unspecified unspecified 0 
49 המהלך מהלך המהלך noun masculine singular absolute unspecified unspecified  	O	null
50 ה ה החדש definiteArticle unspecified unspecified unspecified unspecified unspecified 0 
50 החדש חדש החדש adjective masculine singular absolute unspecified unspecified  	O	null
51 ו ו ומחוצה conjunction unspecified unspecified unspecified unspecified unspecified 0 
51 מחוצה מחץ ומחוצה participle feminine singular absolute any unspecified  	O	null
52 לו לו לו conjunction unspecified unspecified unspecified unspecified unspecified  	O	null
53 ב ב בספרות preposition unspecified unspecified unspecified unspecified unspecified 0 
53 ספרות ספרה בספרות noun feminine plural construct unspecified unspecified  	O	null
54 ה ה העברית definiteArticle unspecified unspecified unspecified unspecified unspecified 0 
54 העברית עברית העברית properName feminine singular unspecified unspecified unspecified  	I_ORG	null
55 ) ) ) punctuation unspecified unspecified unspecified unspecified unspecified  	O	null
56 . . . punctuation unspecified unspecified unspecified unspecified unspecified  	O	null
57 ###NUMBER### ###NUMBER### ###NUMBER### numeral unspecified unspecified unspecified unspecified unspecified  	I_DATE	null
58 היא הוא היא pronoun feminine singular unspecified 3 unspecified  	O	null
59 היתה הוא היתה copula feminine singular unspecified 3 past  	O	null
60 חוקרת חקר חוקרת participle feminine singular construct any unspecified  	O	null
61 מובהקת הובהק מובהקת verb feminine singular unspecified any beinoni  	O	null
62 של של של shel-preposition unspecified unspecified unspecified unspecified unspecified  	O	null
63 ה ה העיתונות definiteArticle unspecified unspecified unspecified unspecified unspecified 0 
63 העיתונות עיתונות העיתונות noun feminine singular absolute unspecified unspecified  	O	null
64 ה ה העברית definiteArticle unspecified unspecified unspecified unspecified unspecified 0 
64 העברית עברית העברית properName feminine singular unspecified unspecified unspecified  	I_PERS	null
65 ל ל לדורותיה preposition unspecified unspecified unspecified unspecified unspecified 0 
65 דורותי דור לדורותיה noun masculine plural absolute unspecified unspecified  
65 ה ה לדורותיה possessive feminine singular unspecified 3 unspecified 0 	O	null
66 , , , punctuation unspecified unspecified unspecified unspecified unspecified  	O	null
67 ו ו וגולת conjunction unspecified unspecified unspecified unspecified unspecified 0 
67 גולת גולה וגולת noun feminine singular construct unspecified unspecified  	O	null
68 ה ה הכותרת definiteArticle unspecified unspecified unspecified unspecified unspecified 0 
68 הכותרת כותרת הכותרת noun feminine singular absolute unspecified unspecified  	O	null
69 של של של shel-preposition unspecified unspecified unspecified unspecified unspecified  	O	null
70 עיסוק עיסוק עיסוקה noun masculine singular absolute unspecified unspecified  
70 ה ה עיסוקה possessive feminine singular unspecified 3 unspecified 0 	O	null
71 זה זה זה pronoun masculine singular unspecified 3 unspecified  	O	null
72 הוא הוא הוא pronoun masculine singular unspecified 3 unspecified  	O	null
73 לקסיקון לקסיקון לקסיקון noun masculine singular construct unspecified unspecified  	O	null
74 ה ה העיתונות definiteArticle unspecified unspecified unspecified unspecified unspecified 0 
74 העיתונות עיתונות העיתונות noun feminine singular absolute unspecified unspecified  	O	null
75 ה ה העברית definiteArticle unspecified unspecified unspecified unspecified unspecified 0 
75 העברית עברית העברית properName feminine singular unspecified unspecified unspecified  	O	null
76 ב ב במאותהשמונה preposition unspecified unspecified unspecified unspecified unspecified 0 
76 ה ה במאותהשמונה definiteArticle unspecified unspecified unspecified unspecified unspecified 0 
76 המאותהשמונה המאותהשמונה במאותהשמונה noun feminine singular absolute unspecified unspecified  	O	null
77 - - - punctuation unspecified unspecified unspecified unspecified unspecified  	O	null
78 עשרה CARD10 עשרה numeral masculine plural absolute unspecified unspecified  	O	null
79 ו ו והתשע conjunction unspecified unspecified unspecified unspecified unspecified 0 
79 ה ה והתשע definiteArticle unspecified unspecified unspecified unspecified unspecified 0 
79 התשע CARD9 והתשע numeral feminine singular absolute unspecified unspecified  	O	null
80 - - - punctuation unspecified unspecified unspecified unspecified unspecified  	O	null
81 עשרה CARD10 עשרה numeral masculine plural absolute unspecified unspecified  	O	null
82 ) ) ) punctuation unspecified unspecified unspecified unspecified unspecified  	O	null
83 , , , punctuation unspecified unspecified unspecified unspecified unspecified  	O	null
84 ###NUMBER### ###NUMBER### ###NUMBER### numeral unspecified unspecified unspecified unspecified unspecified  	I_DATE	null
85 ה ה המשמש definiteArticle unspecified unspecified unspecified unspecified unspecified 0 
85 המשמש משמש המשמש noun masculine singular absolute unspecified unspecified  	O	null
86 ספר ספר ספר noun masculine singular construct unspecified unspecified  	O	null
87 יסוד יסוד יסוד noun masculine singular construct unspecified unspecified  	O	null
88 ב ב בתחומו preposition unspecified unspecified unspecified unspecified unspecified 0 
88 תחום תחום בתחומו noun masculine singular absolute unspecified unspecified  
88 ו ו בתחומו possessive masculine singular unspecified 3 unspecified 0 	O	null
89 . . . punctuation unspecified unspecified unspecified unspecified unspecified  	O	null

0 בד בד בד noun masculine singular absolute unspecified unspecified  	O	null
1 ב ב בבד preposition unspecified unspecified unspecified unspecified unspecified 0 
1 בד בד בבד noun masculine singular absolute unspecified unspecified  	O	null
2 חקרה חקר חקרה verb feminine singular unspecified 3 past  	O	null
3 את את את at-preposition unspecified unspecified unspecified unspecified unspecified  	O	null
4 ה ה הסיפורת definiteArticle unspecified unspecified unspecified unspecified unspecified 0 
4 הסיפורת סיפורת הסיפורת noun feminine singular absolute unspecified unspecified  	O	null
5 של של של shel-preposition unspecified unspecified unspecified unspecified unspecified  	O	null
6 בני בן בני noun masculine plural construct unspecified unspecified  	O	null
7 דורה דורה דורה properName unspecified unspecified unspecified unspecified unspecified  	I_PERS	null
8 ו ו ופירסמה conjunction unspecified unspecified unspecified unspecified unspecified 0 
8 פירסמה פרסם ופירסמה verb feminine singular unspecified 3 past  	O	null
9 מונוגרפיות מונוגרפיות מונוגרפיות noun feminine plural absolute unspecified unspecified  	O	null
10 על על על preposition unspecified unspecified unspecified unspecified unspecified  	O	null
11 חנוך חנוך חנוך properName unspecified unspecified unspecified unspecified unspecified  	I_PERS	null
12 ב ב ברטוב preposition unspecified unspecified unspecified unspecified unspecified 0 
12 רטוב רטוב ברטוב adjective masculine singular absolute unspecified unspecified  	O	null
13 ( ( ( punctuation unspecified unspecified unspecified unspecified unspecified  	O	null
14 פצעיזהות פצעיזהות פצעיזהות properName unspecified unspecified unspecified unspecified unspecified  	I_PERS	null
15 , , , punctuation unspecified unspecified unspecified unspecified unspecified  	O	null
16 ) ) ) punctuation unspecified unspecified unspecified unspecified unspecified  	O	null
17 ###NUMBER### ###NUMBER### ###NUMBER### numeral unspecified unspecified unspecified unspecified unspecified  	I_DATE	null
18 ו ו ועל conjunction unspecified unspecified unspecified unspecified unspecified 0 
18 על על ועל preposition unspecified unspecified unspecified unspecified unspecified  	O	null
19 בנימין בנימין בנימין properName unspecified unspecified unspecified unspecified unspecified  	I_PERS	null
20 תמוז תמוז תמוז properName unspecified unspecified unspecified unspecified unspecified  	I_PERS	null
21 ( ( ( punctuation unspecified unspecified unspecified unspecified unspecified  	O	null
22 חלומות חלום חלומות noun masculine plural construct unspecified unspecified  	O	null
23 ה ה הזהב definiteArticle unspecified unspecified unspecified unspecified unspecified 0 
23 הזהב זהב הזהב noun masculine singular absolute unspecified unspecified  	O	null
24 ו ו ושברונם conjunction unspecified unspecified unspecified unspecified unspecified 0 
24 שברון שברון ושברונם noun masculine singular absolute unspecified unspecified  
24 ם ם ושברונם possessive masculine plural unspecified 3 unspecified 0 	O	null
25 , , , punctuation unspecified unspecified unspecified unspecified unspecified  	O	null
26 ) ) ) punctuation unspecified unspecified unspecified unspecified unspecified  	O	null
27 , , , punctuation unspecified unspecified unspecified unspecified unspecified  	O	null
28 ###NUMBER### ###NUMBER### ###NUMBER### numeral unspecified unspecified unspecified unspecified unspecified  	I_DATE	null
29 ו ו וכן conjunction unspecified unspecified unspecified unspecified unspecified 0 
29 כן כן וכן conjunction unspecified unspecified unspecified unspecified unspecified  	O	null
30 מאמרים מאמר מאמרים noun masculine plural absolute unspecified unspecified  	O	null
31 על על על preposition unspecified unspecified unspecified unspecified unspecified  	O	null
32 דימוי דימוי דימויו noun masculine singular absolute unspecified unspecified  
32 ו ו דימויו possessive masculine singular unspecified 3 unspecified 0 	O	null
33 של של של shel-preposition unspecified unspecified unspecified unspecified unspecified  	O	null
34 ה ה הצבר definiteArticle unspecified unspecified unspecified unspecified unspecified 0 
34 הצבר צבר הצבר noun masculine singular absolute unspecified unspecified  	O	null
35 ב ב בסיפורת preposition unspecified unspecified unspecified unspecified unspecified 0 
35 ה ה בסיפורת definiteArticle unspecified unspecified unspecified unspecified unspecified 0 
35 הסיפורת סיפורת בסיפורת noun feminine singular absolute unspecified unspecified  	O	null
36 ו ו ובביקורת conjunction unspecified unspecified unspecified unspecified unspecified 0 
36 ב ב ובביקורת preposition unspecified unspecified unspecified unspecified unspecified 0 
36 ביקורת ביקורת ובביקורת noun feminine singular absolute unspecified unspecified  	O	null
37 . . . punctuation unspecified unspecified unspecified unspecified unspecified  	O	null

0 כמו כמו כמו conjunction unspecified unspecified unspecified unspecified unspecified  	O	null
1 כן כן כן conjunction unspecified unspecified unspecified unspecified unspecified  	O	null
2 עסקה עסק עסקה verb feminine singular unspecified 3 past  	O	null
3 ב ב בספרות preposition unspecified unspecified unspecified unspecified unspecified 0 
3 ספרות ספרות בספרות noun feminine singular construct unspecified unspecified  	O	null
4 ה ה הילדים definiteArticle unspecified unspecified unspecified unspecified unspecified 0 
4 הילדים ילד הילדים noun masculine plural absolute unspecified unspecified  	O	null
5 ה ה העברית definiteArticle unspecified unspecified unspecified unspecified unspecified 0 
5 העברית עברי העברית adjective feminine singular absolute unspecified unspecified  	O	null
6 ב ב בשירה preposition unspecified unspecified unspecified unspecified unspecified 0 
6 שירה שירה בשירה noun feminine singular absolute unspecified unspecified  	O	null
7 ו ו ובפרוזה conjunction unspecified unspecified unspecified unspecified unspecified 0 
7 ב ב ובפרוזה preposition unspecified unspecified unspecified unspecified unspecified 0 
7 פרוזה פרוזה ובפרוזה noun feminine singular absolute unspecified unspecified  	O	null
8 , , , punctuation unspecified unspecified unspecified unspecified unspecified  	O	null
9 ו ו ומבחר conjunction unspecified unspecified unspecified unspecified unspecified 0 
9 מבחר מבחר ומבחר quantifier unspecified unspecified construct unspecified unspecified  	O	null
10 מ מ ממאמריה preposition unspecified unspecified unspecified unspecified unspecified 0 
10 מאמרי מאמר ממאמריה noun masculine plural absolute unspecified unspecified  
10 ה ה ממאמריה possessive feminine singular unspecified 3 unspecified 0 	O	null
11 ב ב בתחום preposition unspecified unspecified unspecified unspecified unspecified 0 
11 תחום תחום בתחום noun masculine singular construct unspecified unspecified  	O	null
12 זה זה זה pronoun masculine singular unspecified 3 unspecified  	O	null
13 כונס כונס כונס verb masculine singular unspecified 3 past  	O	null
14 ב ב בספרה preposition unspecified unspecified unspecified unspecified unspecified 0 
14 ספר ספר בספרה noun masculine singular absolute unspecified unspecified  
14 ה ה בספרה possessive feminine singular unspecified 3 unspecified 0 	O	null
15 על על על preposition unspecified unspecified unspecified unspecified unspecified  	O	null
16 ספרות ספרות ספרות noun feminine singular construct unspecified unspecified  	O	null
17 ילדים ילד ילדים noun masculine plural absolute unspecified unspecified  	O	null
18 ו ו ונוער conjunction unspecified unspecified unspecified unspecified unspecified 0 
18 נוער נוער ונוער noun masculine singular absolute unspecified unspecified  	O	null
19 ) ) ) punctuation unspecified unspecified unspecified unspecified unspecified  	O	null
20 . . . punctuation unspecified unspecified unspecified unspecified unspecified  	O	null
21 ###NUMBER### ###NUMBER### ###NUMBER### numeral unspecified unspecified unspecified unspecified unspecified  	I_DATE	null
22 אחד CARD1 אחד numeral masculine singular construct unspecified unspecified  	O	null
23 ה ה החוטים definiteArticle unspecified unspecified unspecified unspecified unspecified 0 
23 החוטים חוט החוטים noun masculine plural absolute unspecified unspecified  	O	null
24 ה ה המחברים definiteArticle unspecified unspecified unspecified unspecified unspecified 0 
24 המחברים חיבר המחברים participle masculine plural absolute any unspecified  	O	null
25 את את את at-preposition unspecified unspecified unspecified unspecified unspecified  	O	null
26 שלל שלל שלל noun masculine singular construct unspecified unspecified  	O	null
27 ה ה הנושאים definiteArticle unspecified unspecified unspecified unspecified unspecified 0 
27 הנושאים נושא הנושאים noun masculine plural absolute unspecified unspecified  	O	null
28 ש ש שעסקה relativizer/subordinatingConjunction unspecified unspecified unspecified unspecified unspecified 0 
28 עסקה עסק שעסקה verb feminine singular unspecified 3 past  	O	null
29 ב ב בהם preposition unspecified unspecified unspecified unspecified unspecified  
29 הם הם בהם pronomial masculine plural unspecified 3 unspecified 0 	O	null
30 הוא הוא הוא pronoun masculine singular unspecified 3 unspecified  	O	null
31 ה ה העניין definiteArticle unspecified unspecified unspecified unspecified unspecified 0 
31 העניין עניין העניין noun masculine singular absolute unspecified unspecified  	O	null
32 ה ה המתמיד definiteArticle unspecified unspecified unspecified unspecified unspecified 0 
32 המתמיד מתמיד המתמיד adjective masculine singular absolute unspecified unspecified  	O	null
33 ש ש שגילתה relativizer/subordinatingConjunction unspecified unspecified unspecified unspecified unspecified 0 
33 גילתה גילה שגילתה verb feminine singular unspecified 3 past  	O	null
34 ב ב בקשרים preposition unspecified unspecified unspecified unspecified unspecified 0 
34 קשרים קשר בקשרים noun masculine plural absolute unspecified unspecified  	O	null
35 בין בין בין preposition unspecified unspecified unspecified unspecified unspecified  	O	null
36 ספרות ספרות ספרות noun feminine singular absolute unspecified unspecified  	O	null
37 ל ל לאידיאולוגיה preposition unspecified unspecified unspecified unspecified unspecified 0 
37 ה ה לאידיאולוגיה definiteArticle unspecified unspecified unspecified unspecified unspecified 0 
37 האידיאולוגיה אידיאולוגיה לאידיאולוגיה noun feminine singular absolute unspecified unspecified  	O	null
38 , , , punctuation unspecified unspecified unspecified unspecified unspecified  	O	null
39 החל החל החל verb masculine singular unspecified 3 past  	O	null
40 ב ב בבדיקת preposition unspecified unspecified unspecified unspecified unspecified 0 
40 בדיקת בדיקה בבדיקת noun feminine singular construct unspecified unspecified  	O	null
41 רישום רישום רישומה noun masculine singular absolute unspecified unspecified  
41 ה ה רישומה possessive feminine singular unspecified 3 unspecified 0 	O	null
42 של של של shel-preposition unspecified unspecified unspecified unspecified unspecified  	O	null
43 השקפת השקפה השקפת noun feminine singular construct unspecified unspecified  	O	null
44 ה ה העולם definiteArticle unspecified unspecified unspecified unspecified unspecified 0 
44 העולם עולם העולם noun masculine singular absolute unspecified unspecified  	O	null
45 ה ה המשכילית definiteArticle unspecified unspecified unspecified unspecified unspecified 0 
45 המשכילית המשכילית המשכילית adjective feminine singular absolute unspecified unspecified  	O	null
46 ב ב בספרות preposition unspecified unspecified unspecified unspecified unspecified 0 
46 ה ה בספרות definiteArticle unspecified unspecified unspecified unspecified unspecified 0 
46 הספרות ספרות בספרות noun feminine singular absolute unspecified unspecified  	O	null
47 ו ו ובעיתונות conjunction unspecified unspecified unspecified unspecified unspecified 0 
47 ב ב ובעיתונות preposition unspecified unspecified unspecified unspecified unspecified 0 
47 ה ה ובעיתונות definiteArticle unspecified unspecified unspecified unspecified unspecified 0 
47 העיתונות עיתונות ובעיתונות noun feminine singular absolute unspecified unspecified  	O	null
48 ה ה העברית definiteArticle unspecified unspecified unspecified unspecified unspecified 0 
48 העברית עברי העברית adjective feminine singular absolute unspecified unspecified  	O	null
49 ב ב בראשיתן preposition unspecified unspecified unspecified unspecified unspecified 0 
49 ראשית ראשית בראשיתן noun feminine singular absolute unspecified unspecified  
49 ן ן בראשיתן possessive feminine plural unspecified 3 unspecified 0 	O	null
50 , , , punctuation unspecified unspecified unspecified unspecified unspecified  	O	null
51 ו ו וכלה conjunction unspecified unspecified unspecified unspecified unspecified 0 
51 כלה כלה וכלה verb masculine singular unspecified 3 past  	O	null
52 ב ב במעקב preposition unspecified unspecified unspecified unspecified unspecified 0 
52 מעקב מעקב במעקב noun masculine singular absolute unspecified unspecified  	O	null
53 אחר אחר אחר preposition unspecified unspecified unspecified unspecified unspecified  	O	null
54 גיבוש גיבוש גיבושה noun masculine singular absolute unspecified unspecified  
54 ה ה גיבושה possessive feminine singular unspecified 3 unspecified 0 	O	null
55 ו ו ותנודותיה conjunction unspecified unspecified unspecified unspecified unspecified 0 
55 תנודות תנודה ותנודותיה noun feminine plural absolute unspecified unspecified  
55 ה ה ותנודותיה possessive feminine singular unspecified 3 unspecified 0 	O	null
56 של של של shel-preposition unspecified unspecified unspecified unspecified unspecified  	O	null
57 ה ה הזהות definiteArticle unspecified unspecified unspecified unspecified unspecified 0 
57 הזהות זהות הזהות noun feminine singular absolute unspecified unspecified  	O	null
58 ה ה הצברית definiteArticle unspecified unspecified unspecified unspecified unspecified 0 
58 הצברית צברי הצברית adjective feminine singular absolute unspecified unspecified  	O	null
59 בקרב בקרב בקרב preposition unspecified unspecified unspecified unspecified unspecified  	O	null
60 בני בן בני noun masculine plural construct unspecified unspecified  	O	null
61 דור דור דור noun masculine singular construct unspecified unspecified  	O	null
62 תש"ח תש"ח תש"ח noun masculine singular absolute unspecified unspecified  	O	null
63 בין בין בין preposition unspecified unspecified unspecified unspecified unspecified  	O	null
64 ה ה הקוטב definiteArticle unspecified unspecified unspecified unspecified unspecified 0 
64 הקוטב קוטב הקוטב noun masculine singular absolute unspecified unspecified  	O	null
65 ה ה הכנעני definiteArticle unspecified unspecified unspecified unspecified unspecified 0 
65 הכנעני כנעני הכנעני adjective masculine singular absolute unspecified unspecified  	O	null
66 ל ל לקוטב preposition unspecified unspecified unspecified unspecified unspecified 0 
66 ה ה לקוטב definiteArticle unspecified unspecified unspecified unspecified unspecified 0 
66 הקוטב קוטב לקוטב noun masculine singular absolute unspecified unspecified  	O	null
67 ה ה היהודי definiteArticle unspecified unspecified unspecified unspecified unspecified 0 
67 היהודי יהודי היהודי adjective masculine singular absolute unspecified unspecified  	O	null
68 . . . punctuation unspecified unspecified unspecified unspecified unspecified  	O	null

0 בצד בצד בצד preposition unspecified unspecified unspecified unspecified unspecified  	O	null
1 עבודת עבודה עבודתה noun feminine singular absolute unspecified unspecified  
1 ה ה עבודתה possessive feminine singular unspecified 3 unspecified 0 	O	null
2 ה ה המחקרית definiteArticle unspecified unspecified unspecified unspecified unspecified 0 
2 המחקרית מחקרי המחקרית adjective feminine singular absolute unspecified unspecified  	O	null
3 פירסמה פרסם פירסמה verb feminine singular unspecified 3 past  	O	null
4 מנוחה מנוחה מנוחה properName unspecified unspecified unspecified unspecified unspecified  	I_PERS	null
5 גלבוע גלבוע גלבוע properName unspecified unspecified unspecified unspecified unspecified  	I_PERS	null
6 רשימות רשימה רשימות noun feminine plural construct unspecified unspecified  	O	null
7 ביקורת ביקורת ביקורת noun feminine singular construct unspecified unspecified  	O	null
8 על על על preposition unspecified unspecified unspecified unspecified unspecified  	O	null
9 ה ה הספרות definiteArticle unspecified unspecified unspecified unspecified unspecified 0 
9 הספרות ספרה הספרות noun feminine plural absolute unspecified unspecified  	O	null
10 ה ה השוטפת definiteArticle unspecified unspecified unspecified unspecified unspecified 0 
10 השוטפת שטף השוטפת participle feminine singular absolute any unspecified  	O	null
11 , , , punctuation unspecified unspecified unspecified unspecified unspecified  	O	null
12 ב ב בעיקר preposition unspecified unspecified unspecified unspecified unspecified 0 
12 עיקר עיקר בעיקר quantifier unspecified unspecified construct unspecified unspecified  	O	null
13 ב ב בעיתון preposition unspecified unspecified unspecified unspecified unspecified 0 
13 עיתון עיתון בעיתון noun masculine singular construct unspecified unspecified  	O	null
14 דבר דבר דבר noun masculine singular construct unspecified unspecified  	O	null
15 , , , punctuation unspecified unspecified unspecified unspecified unspecified  	O	null
16 עסקה עסק עסקה verb feminine singular unspecified 3 past  	O	null
17 ב ב בפעילות preposition unspecified unspecified unspecified unspecified unspecified 0 
17 פעילות פעילות בפעילות noun feminine singular construct unspecified unspecified  	O	null
18 ציבורית ציבורית ציבורית noun feminine singular construct unspecified unspecified  	O	null
19 ענפה ענף ענפה adjective feminine singular absolute unspecified unspecified  	O	null
20 במוסדותתרבות במוסדותתרבות במוסדותתרבות noun feminine plural construct unspecified unspecified  	O	null
21 שונים שנה שונים verb masculine plural unspecified any beinoni  	O	null
22 , , , punctuation unspecified unspecified unspecified unspecified unspecified  	O	null
23 ו ו ובמיוחד conjunction unspecified unspecified unspecified unspecified unspecified 0 
23 במיוחד במיוחד ובמיוחד adverb unspecified unspecified unspecified unspecified unspecified  	O	null
24 ב ב באגודת preposition unspecified unspecified unspecified unspecified unspecified 0 
24 אגודת אגודה באגודת noun feminine singular construct unspecified unspecified  	O	null
25 ה ה הסופרים definiteArticle unspecified unspecified unspecified unspecified unspecified 0 
25 הסופרים סופר הסופרים noun masculine plural absolute unspecified unspecified  	O	null
26 ה ה העבריים definiteArticle unspecified unspecified unspecified unspecified unspecified 0 
26 העבריים עברי העבריים adjective masculine plural absolute unspecified unspecified  	O	null
27 , , , punctuation unspecified unspecified unspecified unspecified unspecified  	O	null
28 חיברה חיבר חיברה verb feminine singular unspecified 3 past  	O	null
29 ספרי ספר ספרי noun masculine plural construct unspecified unspecified  	O	null
30 סיפורת סיפורת סיפורת noun feminine singular construct unspecified unspecified  	O	null
31 ל ל לילדים preposition unspecified unspecified unspecified unspecified unspecified 0 
31 ה ה לילדים definiteArticle unspecified unspecified unspecified unspecified unspecified 0 
31 הילדים ילד לילדים noun masculine plural absolute unspecified unspecified  	O	null
32 ו ו ולנוער conjunction unspecified unspecified unspecified unspecified unspecified 0 
32 ל ל ולנוער preposition unspecified unspecified unspecified unspecified unspecified 0 
32 נוער נוער ולנוער noun masculine singular construct unspecified unspecified  	O	null
33 ( ( ( punctuation unspecified unspecified unspecified unspecified unspecified  	O	null
34 שביל שביל שביל noun masculine singular construct unspecified unspecified  	O	null
35 ה ה החמורים definiteArticle unspecified unspecified unspecified unspecified unspecified 0 
35 החמורים חמור החמורים noun masculine plural absolute unspecified unspecified  	O	null
36 , , , punctuation unspecified unspecified unspecified unspecified unspecified  	O	null
37 ; ; ; punctuation unspecified unspecified unspecified unspecified unspecified  	O	null
38 ###NUMBER### ###NUMBER### ###NUMBER### numeral unspecified unspecified unspecified unspecified unspecified  	I_DATE	null
39 סוד סוד סודו noun masculine singular absolute unspecified unspecified  
39 ו ו סודו possessive masculine singular unspecified 3 unspecified 0 	O	null
40 של של של shel-preposition unspecified unspecified unspecified unspecified unspecified  	O	null
41 גילי גיל גילי properName unspecified unspecified unspecified unspecified unspecified  	I_PERS	null
42 , , , punctuation unspecified unspecified unspecified unspecified unspecified  	O	null
43 ) ) ) punctuation unspecified unspecified unspecified unspecified unspecified  	O	null
44 ###NUMBER### ###NUMBER### ###NUMBER### numeral unspecified unspecified unspecified unspecified unspecified  	I_DATE	null
45 ה ה המבוססים definiteArticle unspecified unspecified unspecified unspecified unspecified 0 
45 המבוססים בוסס המבוססים participle masculine plural absolute any unspecified  	O	null
46 בחלק חילק בחלקם verb unspecified unspecified unspecified unspecified infinitive  
46 ם ם בחלקם accusative-or-nominative masculine plural unspecified 3 unspecified 0 	O	null
47 על על על preposition unspecified unspecified unspecified unspecified unspecified  	O	null
48 חוויות חוויה חוויות noun feminine plural construct unspecified unspecified  	O	null
49 נעורי נעורים נעוריה noun masculine plural absolute unspecified unspecified  
49 ה ה נעוריה possessive feminine singular unspecified 3 unspecified 0 	O	null
50 , , , punctuation unspecified unspecified unspecified unspecified unspecified  	O	null
51 ו ו וכתבה conjunction unspecified unspecified unspecified unspecified unspecified 0 
51 כתבה כתב וכתבה verb feminine singular unspecified 3 past  	O	null
52 שירה שירה שירה noun feminine singular absolute unspecified unspecified  	O	null
53 ל ל לירית preposition unspecified unspecified unspecified unspecified unspecified 0 
53 ירית ירייה לירית noun feminine singular construct unspecified unspecified  	O	null
54 , , , punctuation unspecified unspecified unspecified unspecified unspecified  	O	null
55 ש ש שכונסה relativizer/subordinatingConjunction unspecified unspecified unspecified unspecified unspecified 0 
55 כונסה כונס שכונסה verb feminine singular unspecified 3 past  	O	null
56 ב ב בחלקה preposition unspecified unspecified unspecified unspecified unspecified 0 
56 ה ה בחלקה definiteArticle unspecified unspecified unspecified unspecified unspecified 0 
56 החלקה חלק בחלקה adjective feminine singular absolute unspecified unspecified  	O	null
57 ב ב בספריה preposition unspecified unspecified unspecified unspecified unspecified 0 
57 ה ה בספריה definiteArticle unspecified unspecified unspecified unspecified unspecified 0 
57 הספריה ספרייה בספריה noun feminine singular absolute unspecified unspecified  	O	null
58 באינמקום באינמקום באינמקום properName unspecified unspecified unspecified unspecified unspecified  	I_LOC	null
59 ( ( ( punctuation unspecified unspecified unspecified unspecified unspecified  	O	null
60 ###NUMBER### ###NUMBER### ###NUMBER### numeral unspecified unspecified unspecified unspecified unspecified  	I_DATE	null
61 ) ) ) punctuation unspecified unspecified unspecified unspecified unspecified  	O	null
62 ו ו וגנים conjunction unspecified unspecified unspecified unspecified unspecified 0 
62 גנים גן וגנים noun masculine plural absolute unspecified unspecified  	O	null
63 תלויים תלה תלויים participle masculine plural absolute any unspecified  	O	null
64 ) ) ) punctuation unspecified unspecified unspecified unspecified unspecified  	O	null
65 . . . punctuation unspecified unspecified unspecified unspecified unspecified  	O	null
66 ###NUMBER### ###NUMBER### ###NUMBER### numeral unspecified unspecified unspecified unspecified unspecified  	I_DATE	null
67 ה ה החוויה definiteArticle unspecified unspecified unspecified unspecified unspecified 0 
67 החוויה חוויה החוויה noun feminine singular absolute unspecified unspecified  	O	null
68 ה ה המרכזית definiteArticle unspecified unspecified unspecified unspecified unspecified 0 
68 המרכזית מרכזי המרכזית adjective feminine singular absolute unspecified unspecified  	O	null
69 ה ה המעוצבת definiteArticle unspecified unspecified unspecified unspecified unspecified 0 
69 המעוצבת עוצב המעוצבת participle feminine singular absolute any unspecified  	O	null
70 ב ב בשיריה preposition unspecified unspecified unspecified unspecified unspecified 0 
70 שירי שיר בשיריה noun masculine plural absolute unspecified unspecified  
70 ה ה בשיריה possessive feminine singular unspecified 3 unspecified 0 	O	null
71 היא הוא היא pronoun feminine singular unspecified 3 unspecified  	O	null
72 ה ה ההתפעמות definiteArticle unspecified unspecified unspecified unspecified unspecified 0 
72 ההתפעמות התפעמות ההתפעמות noun feminine singular absolute unspecified unspecified  	O	null
73 מ מ מעצם preposition unspecified unspecified unspecified unspecified unspecified 0 
73 עצם עצם מעצם quantifier unspecified unspecified construct unspecified unspecified  	O	null
74 ה ה ההימצאות definiteArticle unspecified unspecified unspecified unspecified unspecified 0 
74 ההימצאות הימצאות ההימצאות noun feminine singular absolute unspecified unspecified  	O	null
75 ב ב בעולם preposition unspecified unspecified unspecified unspecified unspecified 0 
75 עולם עולם בעולם noun masculine singular construct unspecified unspecified  	O	null
76 ה ה הספרות definiteArticle unspecified unspecified unspecified unspecified unspecified 0 
76 הספרות ספרה הספרות noun feminine plural absolute unspecified unspecified  	O	null
77 ו ו והאמנות conjunction unspecified unspecified unspecified unspecified unspecified 0 
77 ה ה והאמנות definiteArticle unspecified unspecified unspecified unspecified unspecified 0 
77 האמנות אמנה והאמנות noun feminine plural absolute unspecified unspecified  	O	null
78 כ כ כקוראת preposition unspecified unspecified unspecified unspecified unspecified 0 
78 ה ה כקוראת definiteArticle unspecified unspecified unspecified unspecified unspecified 0 
78 הקוראת קרא כקוראת participle feminine singular absolute any unspecified  	O	null
79 , , , punctuation unspecified unspecified unspecified unspecified unspecified  	O	null
80 כ כ ככותבת preposition unspecified unspecified unspecified unspecified unspecified 0 
80 ה ה ככותבת definiteArticle unspecified unspecified unspecified unspecified unspecified 0 
80 הכותבת כתב ככותבת participle feminine singular absolute any unspecified  	O	null
81 ו ו וכמתבוננת conjunction unspecified unspecified unspecified unspecified unspecified 0 
81 כ כ וכמתבוננת preposition unspecified unspecified unspecified unspecified unspecified 0 
81 מתבוננת התבונן וכמתבוננת verb feminine singular unspecified any beinoni  	O	null
82 . . . punctuation unspecified unspecified unspecified unspecified unspecified  	O	null

0 References References References foreign unspecified unspecified unspecified unspecified unspecified  	O	null
1 : : : punctuation unspecified unspecified unspecified unspecified unspecified  	O	null
2 הולצמן הולצמן הולצמן properName unspecified unspecified unspecified unspecified unspecified  	I_ORG	null
3 , , , punctuation unspecified unspecified unspecified unspecified unspecified  	O	null
4 אבנר אבנר אבנר properName unspecified unspecified unspecified unspecified unspecified  	I_PERS	null
5 . . . punctuation unspecified unspecified unspecified unspecified unspecified  	O	null

0 " " " punctuation unspecified unspecified unspecified unspecified unspecified  	O	null
1 מנוחה מנוחה מנוחה properName unspecified unspecified unspecified unspecified unspecified  	I_PERS	null
2 גלבוע גלבוע גלבוע properName unspecified unspecified unspecified unspecified unspecified  	I_PERS	null
3 ז"ל ז"ל ז"ל title masculine-and-feminine singular-and-plural unspecified unspecified unspecified  	O	null
4 " " " punctuation unspecified unspecified unspecified unspecified unspecified  	O	null
5 . . . punctuation unspecified unspecified unspecified unspecified unspecified  	O	null

0 מדעי מדע מדעי noun masculine plural construct unspecified unspecified  	O	null
1 ה ה היהדות definiteArticle unspecified unspecified unspecified unspecified unspecified 0 
1 היהדות יהדות היהדות noun feminine singular absolute unspecified unspecified  	O	null
2 : : : punctuation unspecified unspecified unspecified unspecified unspecified  	O	null
3 כתב כתב כתב noun masculine singular construct unspecified unspecified  	O	null
4 - - - punctuation unspecified unspecified unspecified unspecified unspecified  	O	null
5 עת עת עת noun feminine singular absolute unspecified unspecified  	O	null
6 של של של shel-preposition unspecified unspecified unspecified unspecified unspecified  	O	null
7 ה ה האיגוד definiteArticle unspecified unspecified unspecified unspecified unspecified 0 
7 האיגוד איגוד האיגוד noun masculine singular absolute unspecified unspecified  	O	null
8 ה ה העולמי definiteArticle unspecified unspecified unspecified unspecified unspecified 0 
8 העולמי עולמי העולמי adjective masculine singular absolute unspecified unspecified  	O	null
9 ל ל למדעי preposition unspecified unspecified unspecified unspecified unspecified 0 
9 מדעי מדע למדעי noun masculine plural construct unspecified unspecified  	O	null
10 ה ה היהדות definiteArticle unspecified unspecified unspecified unspecified unspecified 0 
10 היהדות יהדות היהדות noun feminine singular absolute unspecified unspecified  	O	null
11 . . . punctuation unspecified unspecified unspecified unspecified unspecified  	O	null
12 ###NUMBER### ###NUMBER### ###NUMBER### numeral unspecified unspecified unspecified unspecified unspecified  	O	null
13 ###NUMBER### ###NUMBER### ###NUMBER### numeral unspecified unspecified unspecified unspecified unspecified  	O	null
14 - - - punctuation unspecified unspecified unspecified unspecified unspecified  	O	null
15 ###NUMBER### ###NUMBER### ###NUMBER### numeral unspecified unspecified unspecified unspecified unspecified  	O	null
16 . . . punctuation unspecified unspecified unspecified unspecified unspecified  	O	null

