0 Name Name Name foreign unspecified unspecified unspecified unspecified unspecified  	O	null
1 : : : punctuation unspecified unspecified unspecified unspecified unspecified  	O	null
2 דיקר דיקר דיקר noun masculine singular absolute unspecified unspecified  	O	null
3 , , , punctuation unspecified unspecified unspecified unspecified unspecified  	O	null
4 אביטל אביטל אביטל properName unspecified unspecified unspecified unspecified unspecified  	I_PERS	null
5 Birth Birth Birth foreign unspecified unspecified unspecified unspecified unspecified  	O	null
6 Year Year Year foreign unspecified unspecified unspecified unspecified unspecified  	O	null
7 : : : punctuation unspecified unspecified unspecified unspecified unspecified  	O	null
8 ###NUMBER### ###NUMBER### ###NUMBER### numeral unspecified unspecified unspecified unspecified unspecified  	I_DATE	null
9 Birth Birth Birth foreign unspecified unspecified unspecified unspecified unspecified  	O	null
10 Place Place Place foreign unspecified unspecified unspecified unspecified unspecified  	O	null
11 : : : punctuation unspecified unspecified unspecified unspecified unspecified  	O	null
12 ירושלים ירושלים ירושלים properName unspecified unspecified unspecified unspecified unspecified  	I_LOC	null
13 Occupation Occupation Occupation foreign unspecified unspecified unspecified unspecified unspecified  	O	null
14 : : : punctuation unspecified unspecified unspecified unspecified unspecified  	O	null
15 סופרת סופר סופרת noun feminine singular absolute unspecified unspecified  	O	null
16 , , , punctuation unspecified unspecified unspecified unspecified unspecified  	O	null
17 שחקנית שחקן שחקנית noun feminine singular absolute unspecified unspecified  	O	null
18 ו ו ועיתונאית conjunction unspecified unspecified unspecified unspecified unspecified 0 
18 עיתונאית עיתונאית ועיתונאית noun feminine singular absolute unspecified unspecified  	O	null
19 Entry Entry Entry foreign unspecified unspecified unspecified unspecified unspecified  	O	null
20 writer writer writer foreign unspecified unspecified unspecified unspecified unspecified  	O	null
21 : : : punctuation unspecified unspecified unspecified unspecified unspecified  	O	null
22 אמנון אמנון אמנון properName unspecified unspecified unspecified unspecified unspecified  	I_PERS	null
23 ז'קונט ז'קונט ז'קונט properName unspecified unspecified unspecified unspecified unspecified  	I_PERS	null
24 Entry Entry Entry foreign unspecified unspecified unspecified unspecified unspecified  	O	null
25 Value Value Value foreign unspecified unspecified unspecified unspecified unspecified  	O	null
26 : : : punctuation unspecified unspecified unspecified unspecified unspecified  	O	null
27 נולדה נולד נולדה verb feminine singular unspecified 3 past  	O	null
28 ב ב בירושלים preposition unspecified unspecified unspecified unspecified unspecified 0 
28 ירושלים ירושלים בירושלים properName unspecified unspecified unspecified unspecified unspecified  	I_LOC	null
29 . . . punctuation unspecified unspecified unspecified unspecified unspecified  	O	null

0 למדה למד למדה verb feminine singular unspecified 3 past  	I_LOC	null
1 משחק משחק משחק noun masculine singular absolute unspecified unspecified  	I_LOC	null
2 בסטודיו בסטודיו בסטודיו properName unspecified unspecified unspecified unspecified unspecified  	I_LOC	null
3 ל ל למשחק preposition unspecified unspecified unspecified unspecified unspecified 0 
3 ה ה למשחק definiteArticle unspecified unspecified unspecified unspecified unspecified 0 
3 המשחק משחק למשחק noun masculine singular absolute unspecified unspecified  	O	null
4 של של של shel-preposition unspecified unspecified unspecified unspecified unspecified  	O	null
5 ניסן ניסן ניסן properName unspecified unspecified unspecified unspecified unspecified  	I_PERS	null
6 נתיב נתיב נתיב properName unspecified unspecified unspecified unspecified unspecified  	I_PERS	null
7 ו ו ובסטודיו conjunction unspecified unspecified unspecified unspecified unspecified 0 
7 ב ב ובסטודיו preposition unspecified unspecified unspecified unspecified unspecified 0 
7 סטודיו סטודיו ובסטודיו noun masculine singular absolute unspecified unspecified  	O	null
8 ל ל למשחק preposition unspecified unspecified unspecified unspecified unspecified 0 
8 ה ה למשחק definiteArticle unspecified unspecified unspecified unspecified unspecified 0 
8 המשחק משחק למשחק noun masculine singular absolute unspecified unspecified  	O	null
9 של של של shel-preposition unspecified unspecified unspecified unspecified unspecified  	O	null
10 ל ל לי preposition unspecified unspecified unspecified unspecified unspecified  
10 י י לי pronomial masculine-and-feminine singular unspecified 1 unspecified 0 	O	null
11 סטרסברג סטרסברג סטרסברג properName unspecified unspecified unspecified unspecified unspecified  	I_PERS	null
12 בניויורק בניויורק בניויורק properName unspecified unspecified unspecified unspecified unspecified  	I_PERS	null
13 . . . punctuation unspecified unspecified unspecified unspecified unspecified  	O	null

0 השתתפה השתתף השתתפה verb feminine singular unspecified 3 past  	O	null
1 ב ב בכמה preposition unspecified unspecified unspecified unspecified unspecified 0 
1 כמה כמה בכמה quantifier unspecified unspecified construct unspecified unspecified  	O	null
2 סרטים סרט סרטים noun masculine plural absolute unspecified unspecified  	O	null
3 ישראליים ישראלי ישראליים adjective masculine plural absolute unspecified unspecified  	O	null
4 , , , punctuation unspecified unspecified unspecified unspecified unspecified  	O	null
5 ב ב בהם preposition unspecified unspecified unspecified unspecified unspecified  
5 הם הם בהם pronomial masculine plural unspecified 3 unspecified 0 	O	null
6 ה ה הקיץ definiteArticle unspecified unspecified unspecified unspecified unspecified 0 
6 הקיץ קיץ הקיץ noun masculine singular absolute unspecified unspecified  	O	null
7 של של של shel-preposition unspecified unspecified unspecified unspecified unspecified  	O	null
8 אביה אביה אביה properName unspecified unspecified unspecified unspecified unspecified  	I_PERS	null
9 ) ) ) punctuation unspecified unspecified unspecified unspecified unspecified  	O	null
10 , , , punctuation unspecified unspecified unspecified unspecified unspecified  	O	null
11 ###NUMBER### ###NUMBER### ###NUMBER### numeral unspecified unspecified unspecified unspecified unspecified  	I_DATE	null
12 ו ו וכן conjunction unspecified unspecified unspecified unspecified unspecified 0 
12 כן כן וכן conjunction unspecified unspecified unspecified unspecified unspecified  	O	null
13 ב ב בסרטים preposition unspecified unspecified unspecified unspecified unspecified 0 
13 סרטים סרט בסרטים noun masculine plural absolute unspecified unspecified  	O	null
14 אמריקניים אמריקני אמריקניים adjective masculine plural absolute unspecified unspecified  	O	null
15 כמו כמו כמו preposition unspecified unspecified unspecified unspecified unspecified  	O	null
16 טריפל טריפל טריפל noun masculine singular absolute unspecified unspecified  	O	null
17 בוגי בוגי בוגי properName unspecified unspecified unspecified unspecified unspecified  	I_PERS	null
18 ) ) ) punctuation unspecified unspecified unspecified unspecified unspecified  	O	null
19 , , , punctuation unspecified unspecified unspecified unspecified unspecified  	O	null
20 ###NUMBER### ###NUMBER### ###NUMBER### numeral unspecified unspecified unspecified unspecified unspecified  	I_DATE	null
21 ליל ליל ליל noun masculine singular construct unspecified unspecified  	O	null
22 ה ה הקשת definiteArticle unspecified unspecified unspecified unspecified unspecified 0 
22 הקשת קשת הקשת noun feminine singular absolute unspecified unspecified  	O	null
23 ( ( ( punctuation unspecified unspecified unspecified unspecified unspecified  	O	null
24 ###NUMBER### ###NUMBER### ###NUMBER### numeral unspecified unspecified unspecified unspecified unspecified  	I_DATE	null
25 ) ) ) punctuation unspecified unspecified unspecified unspecified unspecified  	O	null
26 ו ו והחטא conjunction unspecified unspecified unspecified unspecified unspecified 0 
26 ה ה והחטא definiteArticle unspecified unspecified unspecified unspecified unspecified 0 
26 החטא חטא והחטא noun masculine singular absolute unspecified unspecified  	O	null
27 ו ו ועונשו conjunction unspecified unspecified unspecified unspecified unspecified 0 
27 עונש עונש ועונשו noun masculine singular absolute unspecified unspecified  
27 ו ו ועונשו possessive masculine singular unspecified 3 unspecified 0 	O	null
28 ) ) ) punctuation unspecified unspecified unspecified unspecified unspecified  	O	null
29 . . . punctuation unspecified unspecified unspecified unspecified unspecified  	O	null
30 ###NUMBER### ###NUMBER### ###NUMBER### numeral unspecified unspecified unspecified unspecified unspecified  	I_DATE	null
31 ב ב ב preposition unspecified unspecified unspecified unspecified unspecified 0 	O	null
32 - - - punctuation unspecified unspecified unspecified unspecified unspecified  	O	null
33 ###NUMBER### ###NUMBER### ###NUMBER### numeral unspecified unspecified unspecified unspecified unspecified  	I_DATE	null
34 זכתה זכה זכתה verb feminine singular unspecified 3 past  	O	null
35 ב ב בפרס preposition unspecified unspecified unspecified unspecified unspecified 0 
35 פרס פרס בפרס properName masculine singular unspecified unspecified unspecified  	I_PERS	null
36 אופיר אופיר אופיר properName unspecified unspecified unspecified unspecified unspecified  	I_PERS	null
37 ל ל לשחקנית preposition unspecified unspecified unspecified unspecified unspecified 0 
37 ה ה לשחקנית definiteArticle unspecified unspecified unspecified unspecified unspecified 0 
37 השחקנית שחקן לשחקנית noun feminine singular absolute unspecified unspecified  	O	null
38 משנה שינה משנה verb masculine singular unspecified any beinoni  	O	null
39 על על על preposition unspecified unspecified unspecified unspecified unspecified  	O	null
40 הופעת הופעה הופעתה noun feminine singular absolute unspecified unspecified  
40 ה ה הופעתה possessive feminine singular unspecified 3 unspecified 0 	O	null
41 ב ב בסרט preposition unspecified unspecified unspecified unspecified unspecified 0 
41 סרט סרט בסרט noun masculine singular construct unspecified unspecified  	O	null
42 ה ה החיים definiteArticle unspecified unspecified unspecified unspecified unspecified 0 
42 החיים חיים החיים noun masculine plural absolute unspecified unspecified  	O	null
43 על על על preposition unspecified unspecified unspecified unspecified unspecified  	O	null
44 פי פה פי noun masculine singular construct unspecified unspecified  	O	null
45 אגפא אגפא אגפא properName unspecified unspecified unspecified unspecified unspecified  	I_LOC	null
46 . . . punctuation unspecified unspecified unspecified unspecified unspecified  	O	null

0 שיחקה שיחק שיחקה verb feminine singular unspecified 3 past  	O	null
1 גם גם גם conjunction unspecified unspecified unspecified unspecified unspecified  	O	null
2 ב ב במחזות preposition unspecified unspecified unspecified unspecified unspecified 0 
2 מחזות מחזה במחזות noun masculine plural construct unspecified unspecified  	O	null
3 תיאטרון תיאטרון תיאטרון properName unspecified unspecified unspecified unspecified unspecified  	I_ORG	null
4 , , , punctuation unspecified unspecified unspecified unspecified unspecified  	O	null
5 ב ב בהם preposition unspecified unspecified unspecified unspecified unspecified  
5 הם הם בהם pronomial masculine plural unspecified 3 unspecified 0 	O	null
6 הזוגהמוזר הזוגהמוזר הזוגהמוזר verb masculine singular unspecified 3 past  	O	null
7 ו ו ועל conjunction unspecified unspecified unspecified unspecified unspecified 0 
7 על על ועל preposition unspecified unspecified unspecified unspecified unspecified  	O	null
8 עכברים עכבר עכברים noun masculine plural absolute unspecified unspecified  	O	null
9 ו ו ואנשים conjunction unspecified unspecified unspecified unspecified unspecified 0 
9 אנשים איש ואנשים noun masculine plural absolute unspecified unspecified  	O	null
10 , , , punctuation unspecified unspecified unspecified unspecified unspecified  	O	null
11 ו ו וזכתה conjunction unspecified unspecified unspecified unspecified unspecified 0 
11 זכתה זכה וזכתה verb feminine singular unspecified 3 past  	O	null
12 ב ב בפרס preposition unspecified unspecified unspecified unspecified unspecified 0 
12 פרס פרס בפרס noun masculine singular construct unspecified unspecified  	O	null
13 ה ה התיאטרון definiteArticle unspecified unspecified unspecified unspecified unspecified 0 
13 התיאטרון תיאטרון התיאטרון noun masculine singular absolute unspecified unspecified  	O	null
14 ה ה הישראלי definiteArticle unspecified unspecified unspecified unspecified unspecified 0 
14 הישראלי ישראלי הישראלי adjective masculine singular absolute unspecified unspecified  	O	null
15 ל ל לשחקנית preposition unspecified unspecified unspecified unspecified unspecified 0 
15 ה ה לשחקנית definiteArticle unspecified unspecified unspecified unspecified unspecified 0 
15 השחקנית שחקן לשחקנית noun feminine singular absolute unspecified unspecified  	O	null
16 מ מ משנה preposition unspecified unspecified unspecified unspecified unspecified 0 
16 שנה שנה משנה noun feminine singular absolute unspecified unspecified  	O	null
17 על על על preposition unspecified unspecified unspecified unspecified unspecified  	O	null
18 תפקיד תפקיד תפקידה noun masculine singular absolute unspecified unspecified  
18 ה ה תפקידה possessive feminine singular unspecified 3 unspecified 0 	O	null
19 ב ב במימפחד preposition unspecified unspecified unspecified unspecified unspecified 0 
19 מימפח מימפח במימפחד noun masculine-and-feminine plural absolute unspecified unspecified  
19 י י במימפחד possessive masculine-and-feminine singular unspecified 1 unspecified 0 	O	null
20 מווירג'יניה מווירג'יניה מווירג'יניה properName unspecified unspecified unspecified unspecified unspecified  	I_PERS	null
21 וולף וולף וולף properName unspecified unspecified unspecified unspecified unspecified  	I_PERS	null
22 ) ) ) punctuation unspecified unspecified unspecified unspecified unspecified  	O	null
23 . . . punctuation unspecified unspecified unspecified unspecified unspecified  	O	null
24 ###NUMBER### ###NUMBER### ###NUMBER### numeral unspecified unspecified unspecified unspecified unspecified  	I_DATE	null
25 עסקה עסק עסקה verb feminine singular unspecified 3 past  	O	null
26 גם גם גם conjunction unspecified unspecified unspecified unspecified unspecified  	O	null
27 ב ב בדוגמנות preposition unspecified unspecified unspecified unspecified unspecified 0 
27 דוגמנות דוגמנות בדוגמנות noun feminine singular absolute unspecified unspecified  	O	null
28 ו ו ובכתיבה conjunction unspecified unspecified unspecified unspecified unspecified 0 
28 ב ב ובכתיבה preposition unspecified unspecified unspecified unspecified unspecified 0 
28 כתיבה כתיבה ובכתיבה noun feminine singular absolute unspecified unspecified  	O	null
29 עיתונאית עיתונאי עיתונאית adjective feminine singular absolute unspecified unspecified  	O	null
30 . . . punctuation unspecified unspecified unspecified unspecified unspecified  	O	null

0 ב ב ב preposition unspecified unspecified unspecified unspecified unspecified 0 	O	null
1 - - - punctuation unspecified unspecified unspecified unspecified unspecified  	O	null
2 ###NUMBER### ###NUMBER### ###NUMBER### numeral unspecified unspecified unspecified unspecified unspecified  	I_DATE	null
3 התפרסם התפרסם התפרסם verb masculine singular unspecified 3 past  	O	null
4 ספר ספר ספרה noun masculine singular absolute unspecified unspecified  
4 ה ה ספרה possessive feminine singular unspecified 3 unspecified 0 	O	null
5 ה ה הראשון definiteArticle unspecified unspecified unspecified unspecified unspecified 0 
5 הראשון ORD1 הראשון numeral masculine singular absolute unspecified unspecified  	O	null
6 , , , punctuation unspecified unspecified unspecified unspecified unspecified  	O	null
7 מאז מאז מאז adverb unspecified unspecified unspecified unspecified unspecified  	O	null
8 ה ה הלילה definiteArticle unspecified unspecified unspecified unspecified unspecified 0 
8 הלילה לילה הלילה noun masculine singular absolute unspecified unspecified  	O	null
9 ה ה ההוא definiteArticle unspecified unspecified unspecified unspecified unspecified 0 
9 ההוא ההוא ההוא pronoun masculine singular unspecified 3 unspecified  	O	null
10 ( ( ( punctuation unspecified unspecified unspecified unspecified unspecified  	O	null
11 כתר כתר כתר noun masculine singular absolute unspecified unspecified  	O	null
12 ) ) ) punctuation unspecified unspecified unspecified unspecified unspecified  	O	null
13 , , , punctuation unspecified unspecified unspecified unspecified unspecified  	O	null
14 ש ש שחלקו relativizer/subordinatingConjunction unspecified unspecified unspecified unspecified unspecified 0 
14 חלק חלק שחלקו noun masculine singular absolute unspecified unspecified  
14 ו ו שחלקו possessive masculine singular unspecified 3 unspecified 0 	O	null
15 מבוסס בוסס מבוסס verb masculine singular unspecified any beinoni  	O	null
16 על על על preposition unspecified unspecified unspecified unspecified unspecified  	O	null
17 סיפור סיפור סיפור noun masculine singular construct unspecified unspecified  	O	null
18 ילדות ילדות ילדותה noun feminine singular absolute unspecified unspecified  
18 ה ה ילדותה possessive feminine singular unspecified 3 unspecified 0 	O	null
19 ב ב בירושלים preposition unspecified unspecified unspecified unspecified unspecified 0 
19 ירושלים ירושלים בירושלים properName unspecified unspecified unspecified unspecified unspecified  	I_LOC	null
20 ב ב בזמן preposition unspecified unspecified unspecified unspecified unspecified 0 
20 זמן זמן בזמן noun masculine singular construct unspecified unspecified  	O	null
21 מלחמת מלחמה מלחמת noun feminine singular construct unspecified unspecified  	O	null
22 ששת CARD6 ששת numeral masculine plural construct unspecified unspecified  	O	null
23 ה ה הימים definiteArticle unspecified unspecified unspecified unspecified unspecified 0 
23 הימים יום הימים noun masculine plural absolute unspecified unspecified  	O	null
24 . . . punctuation unspecified unspecified unspecified unspecified unspecified  	O	null

0 ב ב במרכז preposition unspecified unspecified unspecified unspecified unspecified 0 
0 מרכז מרכז במרכז noun masculine singular construct unspecified unspecified  	O	null
1 ה ה הספר definiteArticle unspecified unspecified unspecified unspecified unspecified 0 
1 הספר ספר הספר noun masculine singular absolute unspecified unspecified  	O	null
2 רותי רותי רותי properName unspecified unspecified unspecified unspecified unspecified  	I_PERS	null
3 , , , punctuation unspecified unspecified unspecified unspecified unspecified  	O	null
4 אישה איש אישה noun feminine singular absolute unspecified unspecified  	O	null
5 צעירה צעיר צעירה adjective feminine singular absolute unspecified unspecified  	O	null
6 ו ו וחיננית conjunction unspecified unspecified unspecified unspecified unspecified 0 
6 חיננית חינני וחיננית adjective feminine singular absolute unspecified unspecified  	O	null
7 , , , punctuation unspecified unspecified unspecified unspecified unspecified  	O	null
8 אם אם אם conjunction unspecified unspecified unspecified unspecified unspecified  	O	null
9 ל ל לשני preposition unspecified unspecified unspecified unspecified unspecified 0 
9 שני CARD2 לשני numeral masculine dual construct unspecified unspecified  	O	null
10 ילדים ילד ילדים noun masculine plural absolute unspecified unspecified  	O	null
11 רכים רך רכים adjective masculine plural absolute unspecified unspecified  	O	null
12 ב ב בשנים preposition unspecified unspecified unspecified unspecified unspecified 0 
12 שנים שנה בשנים noun feminine plural absolute unspecified unspecified  	O	null
13 , , , punctuation unspecified unspecified unspecified unspecified unspecified  	O	null
14 ש ש שבעלה relativizer/subordinatingConjunction unspecified unspecified unspecified unspecified unspecified 0 
14 ב ב שבעלה preposition unspecified unspecified unspecified unspecified unspecified 0 
14 עלה עלה שבעלה noun masculine singular construct unspecified unspecified  	O	null
15 יואב יואב יואב properName unspecified unspecified unspecified unspecified unspecified  	I_LOC	null
16 נעדר נעדר נעדר verb masculine singular unspecified 3 past  	O	null
17 ב ב במלחמה preposition unspecified unspecified unspecified unspecified unspecified 0 
17 ה ה במלחמה definiteArticle unspecified unspecified unspecified unspecified unspecified 0 
17 המלחמה מלחמה במלחמה noun feminine singular absolute unspecified unspecified  	O	null
18 ו ו ואחר conjunction unspecified unspecified unspecified unspecified unspecified 0 
18 אחר אחר ואחר preposition unspecified unspecified unspecified unspecified unspecified  	O	null
19 כך כך כך pronoun unspecified unspecified unspecified unspecified unspecified  	O	null
20 הוכרז הוכרז הוכרז verb masculine singular unspecified 3 past  	O	null
21 חלל חלל חלל noun masculine singular absolute unspecified unspecified  	O	null
22 . . . punctuation unspecified unspecified unspecified unspecified unspecified  	O	null

0 רותי רותי רותי properName unspecified unspecified unspecified unspecified unspecified  	I_PERS	null
1 נעה נע נעה properName unspecified unspecified unspecified unspecified unspecified  	I_PERS	null
2 ב ב בעולם preposition unspecified unspecified unspecified unspecified unspecified 0 
2 עולם עולם בעולם noun masculine singular absolute unspecified unspecified  	O	null
3 אפרורי אפרורי אפרורי adjective masculine singular absolute unspecified unspecified  	O	null
4 ש ש שהכול relativizer/subordinatingConjunction unspecified unspecified unspecified unspecified unspecified 0 
4 ה ה שהכול definiteArticle unspecified unspecified unspecified unspecified unspecified 0 
4 הכול כול שהכול quantifier unspecified unspecified unspecified unspecified unspecified  	O	null
5 ב ב בו preposition unspecified unspecified unspecified unspecified unspecified  
5 ו ו בו pronomial masculine singular unspecified 3 unspecified 0 	O	null
6 נטול נטול נטול adjective masculine singular absolute unspecified unspecified  	O	null
7 משמעות משמעות משמעות noun feminine singular absolute unspecified unspecified  	O	null
8 ו ו ומנסה conjunction unspecified unspecified unspecified unspecified unspecified 0 
8 מנסה ניסה ומנסה verb masculine singular unspecified any beinoni  	O	null
9 להתמודד התמודד להתמודד verb unspecified unspecified unspecified unspecified infinitive  	O	null
10 עם עם עם preposition unspecified unspecified unspecified unspecified unspecified  	O	null
11 ה ה הדמיון definiteArticle unspecified unspecified unspecified unspecified unspecified 0 
11 הדמיון דמיון הדמיון noun masculine singular absolute unspecified unspecified  	O	null
12 ה ה הרב definiteArticle unspecified unspecified unspecified unspecified unspecified 0 
12 הרב רב הרב adjective masculine singular absolute unspecified unspecified  	O	null
13 של של של shel-preposition unspecified unspecified unspecified unspecified unspecified  	O	null
14 בת בת בתה noun feminine singular absolute unspecified unspecified  
14 ה ה בתה possessive feminine singular unspecified 3 unspecified 0 	O	null
15 ה ה הקטנה definiteArticle unspecified unspecified unspecified unspecified unspecified 0 
15 הקטנה קטן הקטנה adjective feminine singular absolute unspecified unspecified  	O	null
16 ל ל לאביה preposition unspecified unspecified unspecified unspecified unspecified 0 
16 אבי אב לאביה noun masculine singular absolute unspecified unspecified  
16 ה ה לאביה possessive feminine singular unspecified 3 unspecified 0 	O	null
17 ה ה המת definiteArticle unspecified unspecified unspecified unspecified unspecified 0 
17 המת מת המת adjective masculine singular absolute unspecified unspecified  	O	null
18 , , , punctuation unspecified unspecified unspecified unspecified unspecified  	O	null
19 ו ו וכן conjunction unspecified unspecified unspecified unspecified unspecified 0 
19 כן כן וכן conjunction unspecified unspecified unspecified unspecified unspecified  	O	null
20 עם עם עם preposition unspecified unspecified unspecified unspecified unspecified  	O	null
21 צרכי צורך צרכיה noun masculine plural absolute unspecified unspecified  
21 ה ה צרכיה possessive feminine singular unspecified 3 unspecified 0 	O	null
22 כ כ כאישה preposition unspecified unspecified unspecified unspecified unspecified 0 
22 אישה איש כאישה noun feminine singular absolute unspecified unspecified  	O	null
23 צעירה צעיר צעירה adjective feminine singular absolute unspecified unspecified  	O	null
24 ו ו ומינית conjunction unspecified unspecified unspecified unspecified unspecified 0 
24 מינית מיני ומינית adjective feminine singular absolute unspecified unspecified  	O	null
25 , , , punctuation unspecified unspecified unspecified unspecified unspecified  	O	null
26 עם עם עם preposition unspecified unspecified unspecified unspecified unspecified  	O	null
27 קשיי קושי קשיי noun masculine plural construct unspecified unspecified  	O	null
28 ה ה הקיום definiteArticle unspecified unspecified unspecified unspecified unspecified 0 
28 הקיום קיום הקיום noun masculine singular absolute unspecified unspecified  	O	null
29 ו ו ועם conjunction unspecified unspecified unspecified unspecified unspecified 0 
29 עם עם ועם preposition unspecified unspecified unspecified unspecified unspecified  	O	null
30 רגשות רגש רגשות noun masculine plural construct unspecified unspecified  	O	null
31 ה ה הזעם definiteArticle unspecified unspecified unspecified unspecified unspecified 0 
31 הזעם זעם הזעם noun masculine singular absolute unspecified unspecified  	O	null
32 ו ו והאשמה conjunction unspecified unspecified unspecified unspecified unspecified 0 
32 ה ה והאשמה definiteArticle unspecified unspecified unspecified unspecified unspecified 0 
32 האשמה אשמה והאשמה noun feminine singular absolute unspecified unspecified  	O	null
33 . . . punctuation unspecified unspecified unspecified unspecified unspecified  	O	null

0 ספר ספר ספרה noun masculine singular absolute unspecified unspecified  
0 ה ה ספרה possessive feminine singular unspecified 3 unspecified 0 	O	null
1 ה ה השני definiteArticle unspecified unspecified unspecified unspecified unspecified 0 
1 השני ORD2 השני numeral masculine singular absolute unspecified unspecified  	O	null
2 , , , punctuation unspecified unspecified unspecified unspecified unspecified  	O	null
3 יומן יומן יומן noun masculine singular absolute unspecified unspecified  	O	null
4 על על על preposition unspecified unspecified unspecified unspecified unspecified  	O	null
5 רומן רומן רומן noun masculine singular construct unspecified unspecified  	O	null
6 שהיה שהייה שהיה noun feminine singular absolute unspecified unspecified  	O	null
7 ( ( ( punctuation unspecified unspecified unspecified unspecified unspecified  	O	null
8 ) ) ) punctuation unspecified unspecified unspecified unspecified unspecified  	O	null
9 , , , punctuation unspecified unspecified unspecified unspecified unspecified  	O	null
10 ###NUMBER### ###NUMBER### ###NUMBER### numeral unspecified unspecified unspecified unspecified unspecified  	I_DATE	null
11 מבוסס מבוסס מבוסס adjective masculine singular absolute unspecified unspecified  	O	null
12 גם גם גם conjunction unspecified unspecified unspecified unspecified unspecified  	O	null
13 הוא הוא הוא pronoun masculine singular unspecified 3 unspecified  	O	null
14 על על על preposition unspecified unspecified unspecified unspecified unspecified  	O	null
15 ניסיון ניסיון ניסיון noun masculine singular construct unspecified unspecified  	O	null
16 חיי חיים חייה noun masculine plural absolute unspecified unspecified  
16 ה ה חייה possessive feminine singular unspecified 3 unspecified 0 	O	null
17 , , , punctuation unspecified unspecified unspecified unspecified unspecified  	O	null
18 ו ו והפעם conjunction unspecified unspecified unspecified unspecified unspecified 0 
18 הפעם הפעם והפעם adverb unspecified unspecified unspecified unspecified unspecified  	O	null
19 על על על preposition unspecified unspecified unspecified unspecified unspecified  	O	null
20 ה ה הגירושים definiteArticle unspecified unspecified unspecified unspecified unspecified 0 
20 הגירושים גירוש הגירושים noun masculine plural absolute unspecified unspecified  	O	null
21 ש ש שעברה relativizer/subordinatingConjunction unspecified unspecified unspecified unspecified unspecified 0 
21 עברה עבר שעברה verb feminine singular unspecified 3 past  	O	null
22 . . . punctuation unspecified unspecified unspecified unspecified unspecified  	O	null

0 ה ה הספר definiteArticle unspecified unspecified unspecified unspecified unspecified 0 
0 הספר ספר הספר noun masculine singular absolute unspecified unspecified  	O	null
1 כתוב כתוב כתוב adjective masculine singular absolute unspecified unspecified  	O	null
2 ו ו ומעוצב conjunction unspecified unspecified unspecified unspecified unspecified 0 
2 מעוצב מעוצב ומעוצב adjective masculine singular absolute unspecified unspecified  	O	null
3 כ כ כבלוג preposition unspecified unspecified unspecified unspecified unspecified 0 
3 ה ה כבלוג definiteArticle unspecified unspecified unspecified unspecified unspecified 0 
3 הבלוג בלוג כבלוג noun masculine singular absolute unspecified unspecified  	O	null
4 ו ו ועוסק conjunction unspecified unspecified unspecified unspecified unspecified 0 
4 עוסק עסק ועוסק verb masculine singular unspecified any beinoni  	O	null
5 ב ב בהתפוררותו preposition unspecified unspecified unspecified unspecified unspecified 0 
5 התפוררות התפוררות בהתפוררותו noun feminine singular absolute unspecified unspecified  
5 ו ו בהתפוררותו possessive masculine singular unspecified 3 unspecified 0 	O	null
6 של של של shel-preposition unspecified unspecified unspecified unspecified unspecified  	O	null
7 ה ה הרומן definiteArticle unspecified unspecified unspecified unspecified unspecified 0 
7 הרומן רומן הרומן noun masculine singular absolute unspecified unspecified  	O	null
8 מבעד מבעד מבעד preposition unspecified unspecified unspecified unspecified unspecified  	O	null
9 ל ל לעיניה preposition unspecified unspecified unspecified unspecified unspecified 0 
9 עין עין לעיניה noun feminine plural absolute unspecified unspecified  
9 ה ה לעיניה possessive feminine singular unspecified 3 unspecified 0 	O	null
10 של של של shel-preposition unspecified unspecified unspecified unspecified unspecified  	O	null
11 ה ה הצלע definiteArticle unspecified unspecified unspecified unspecified unspecified 0 
11 הצלע צלע הצלע noun feminine singular absolute unspecified unspecified  	O	null
12 ה ה הנשית definiteArticle unspecified unspecified unspecified unspecified unspecified 0 
12 הנשית נשי הנשית adjective feminine singular absolute unspecified unspecified  	O	null
13 ב ב בו preposition unspecified unspecified unspecified unspecified unspecified  
13 ו ו בו pronomial masculine singular unspecified 3 unspecified 0 	O	null
14 . . . punctuation unspecified unspecified unspecified unspecified unspecified  	O	null

0 ה ה הספר definiteArticle unspecified unspecified unspecified unspecified unspecified 0 
0 הספר ספר הספר noun masculine singular absolute unspecified unspecified  	O	null
1 מיוחד מיוחד מיוחד adjective masculine singular absolute unspecified unspecified  	O	null
2 מ מ מבחינת preposition unspecified unspecified unspecified unspecified unspecified 0 
2 בחינת בחינה מבחינת noun feminine singular construct unspecified unspecified  	O	null
3 חזות חזות חזותו noun feminine singular absolute unspecified unspecified  
3 ו ו חזותו possessive masculine singular unspecified 3 unspecified 0 	O	null
4 ו ו ומעוצב conjunction unspecified unspecified unspecified unspecified unspecified 0 
4 מעוצב עוצב ומעוצב verb masculine singular unspecified any beinoni  	O	null
5 כ כ כמסך preposition unspecified unspecified unspecified unspecified unspecified 0 
5 ה ה כמסך definiteArticle unspecified unspecified unspecified unspecified unspecified 0 
5 המסך מסך כמסך noun masculine singular absolute unspecified unspecified  	O	null
6 של של של shel-preposition unspecified unspecified unspecified unspecified unspecified  	O	null
7 מחשב מחשב מחשב noun masculine singular absolute unspecified unspecified  	O	null
8 מקינטוש מקינטוש מקינטוש properName unspecified unspecified unspecified unspecified unspecified  	I_PERS	null
9 . . . punctuation unspecified unspecified unspecified unspecified unspecified  	O	null

0 ב ב בתחתית preposition unspecified unspecified unspecified unspecified unspecified 0 
0 תחתית תחתית בתחתית noun feminine singular construct unspecified unspecified  	O	null
1 ה ה העמודים definiteArticle unspecified unspecified unspecified unspecified unspecified 0 
1 העמודים עמוד העמודים noun masculine plural absolute unspecified unspecified  	O	null
2 מופיעים הופיע מופיעים verb masculine plural unspecified any beinoni  	O	null
3 ציורי ציור ציורי noun masculine plural construct unspecified unspecified  	O	null
4 סיגריות סיגריה סיגריות noun feminine plural absolute unspecified unspecified  	O	null
5 ו ו וכוסות conjunction unspecified unspecified unspecified unspecified unspecified 0 
5 כוסות כוס וכוסות noun feminine plural absolute unspecified unspecified  	O	null
6 קפה קפה קפה noun masculine singular absolute unspecified unspecified  	O	null
7 , , , punctuation unspecified unspecified unspecified unspecified unspecified  	O	null
8 שרבוטים שרבוט שרבוטים noun masculine plural absolute unspecified unspecified  	O	null
9 שונים שונה שונים adjective masculine plural absolute unspecified unspecified  	O	null
10 , , , punctuation unspecified unspecified unspecified unspecified unspecified  	O	null
11 כתמים כתם כתמים noun masculine plural absolute unspecified unspecified  	O	null
12 ו ו וציורים conjunction unspecified unspecified unspecified unspecified unspecified 0 
12 ציורים ציור וציורים noun masculine plural absolute unspecified unspecified  	O	null
13 ש ש שלבנותיה relativizer/subordinatingConjunction unspecified unspecified unspecified unspecified unspecified 0 
13 ל ל שלבנותיה preposition unspecified unspecified unspecified unspecified unspecified 0 
13 בנות בת שלבנותיה noun feminine plural absolute unspecified unspecified  
13 ה ה שלבנותיה possessive feminine singular unspecified 3 unspecified 0 	O	null
14 של של של shel-preposition unspecified unspecified unspecified unspecified unspecified  	O	null
15 ה ה המחברת definiteArticle unspecified unspecified unspecified unspecified unspecified 0 
15 המחברת מחברת המחברת noun feminine singular absolute unspecified unspecified  	O	null
16 . . . punctuation unspecified unspecified unspecified unspecified unspecified  	O	null

0 כוח כוח כוחה noun masculine singular absolute unspecified unspecified  
0 ה ה כוחה possessive feminine singular unspecified 3 unspecified 0 	O	null
1 של של של shel-preposition unspecified unspecified unspecified unspecified unspecified  	O	null
2 דיקר דיקר דיקר noun masculine singular absolute unspecified unspecified  	O	null
3 ב ב בכנותה preposition unspecified unspecified unspecified unspecified unspecified 0 
3 כנות כנות בכנותה noun feminine singular absolute unspecified unspecified  
3 ה ה בכנותה possessive feminine singular unspecified 3 unspecified 0 	O	null
4 ו ו ובישירותה conjunction unspecified unspecified unspecified unspecified unspecified 0 
4 ב ב ובישירותה preposition unspecified unspecified unspecified unspecified unspecified 0 
4 ישירות ישירות ובישירותה noun feminine singular absolute unspecified unspecified  
4 ה ה ובישירותה possessive feminine singular unspecified 3 unspecified 0 	O	null
5 . . . punctuation unspecified unspecified unspecified unspecified unspecified  	O	null

0 כתיבת כתיבה כתיבתה noun feminine singular absolute unspecified unspecified  
0 ה ה כתיבתה possessive feminine singular unspecified 3 unspecified 0 	O	null
1 אישית אישי אישית adjective feminine singular absolute unspecified unspecified  	O	null
2 , , , punctuation unspecified unspecified unspecified unspecified unspecified  	O	null
3 ה ה הקריאה definiteArticle unspecified unspecified unspecified unspecified unspecified 0 
3 הקריאה קריאה הקריאה noun feminine singular absolute unspecified unspecified  	O	null
4 ב ב בספריה preposition unspecified unspecified unspecified unspecified unspecified 0 
4 ה ה בספריה definiteArticle unspecified unspecified unspecified unspecified unspecified 0 
4 הספריה ספרייה בספריה noun feminine singular absolute unspecified unspecified  	O	null
5 זורמת זרם זורמת verb feminine singular unspecified any beinoni  	O	null
6 ו ו וחווייתית conjunction unspecified unspecified unspecified unspecified unspecified 0 
6 חווייתית חווייתי וחווייתית adjective feminine singular absolute unspecified unspecified  	O	null
7 ו ו ותחושותיה conjunction unspecified unspecified unspecified unspecified unspecified 0 
7 תחושות תחושה ותחושותיה noun feminine plural absolute unspecified unspecified  
7 ה ה ותחושותיה possessive feminine singular unspecified 3 unspecified 0 	O	null
8 , , , punctuation unspecified unspecified unspecified unspecified unspecified  	O	null
9 בעיקר בעיקר בעיקר adverb unspecified unspecified unspecified unspecified unspecified  	O	null
10 כאב כאב כאב noun masculine singular absolute unspecified unspecified  	O	null
11 ו ו וכמיהה conjunction unspecified unspecified unspecified unspecified unspecified 0 
11 כמיהה כמיהה וכמיהה noun feminine singular absolute unspecified unspecified  	O	null
12 ל ל לאהבה preposition unspecified unspecified unspecified unspecified unspecified 0 
12 אהבה אהבה לאהבה noun feminine singular absolute unspecified unspecified  	O	null
13 , , , punctuation unspecified unspecified unspecified unspecified unspecified  	O	null
14 עוברות עבר עוברות verb feminine plural unspecified any beinoni  	O	null
15 אל אל אל preposition unspecified unspecified unspecified unspecified unspecified  	O	null
16 ה ה הקוראים definiteArticle unspecified unspecified unspecified unspecified unspecified 0 
16 הקוראים קורא הקוראים noun masculine plural absolute unspecified unspecified  	O	null
17 ב ב בעוצמה preposition unspecified unspecified unspecified unspecified unspecified 0 
17 ה ה בעוצמה definiteArticle unspecified unspecified unspecified unspecified unspecified 0 
17 העוצמה עוצמה בעוצמה noun feminine singular absolute unspecified unspecified  	O	null
18 . . . punctuation unspecified unspecified unspecified unspecified unspecified  	O	null

0 References References References foreign unspecified unspecified unspecified unspecified unspecified  	O	null
1 : : : punctuation unspecified unspecified unspecified unspecified unspecified  	O	null
2 מ מ מיקולינסקי preposition unspecified unspecified unspecified unspecified unspecified 0 
2 יקולינסקי יקולינסקי מיקולינסקי properName unspecified unspecified unspecified unspecified unspecified  	I_ORG	null
3 , , , punctuation unspecified unspecified unspecified unspecified unspecified  	O	null
4 רומי רום רומי noun masculine plural construct unspecified unspecified  	O	null
5 . . . punctuation unspecified unspecified unspecified unspecified unspecified  	O	null

0 " " " punctuation unspecified unspecified unspecified unspecified unspecified  	O	null
1 רומן רומן רומן properName unspecified unspecified unspecified unspecified unspecified  	I_PERS	null
2 פולנסקי פולנסקי פולנסקי properName unspecified unspecified unspecified unspecified unspecified  	I_PERS	null
3 " " " punctuation unspecified unspecified unspecified unspecified unspecified  	O	null
4 . . . punctuation unspecified unspecified unspecified unspecified unspecified  	O	null
5 וואלה וואלה וואלה interjection unspecified unspecified unspecified unspecified unspecified  	O	null
6 ! ! ! punctuation unspecified unspecified unspecified unspecified unspecified  	O	null

0 תרבות תרבות תרבות noun feminine singular absolute unspecified unspecified  	O	null
1 ו ו ובידור conjunction unspecified unspecified unspecified unspecified unspecified 0 
1 בידור בידור ובידור noun masculine singular absolute unspecified unspecified  	O	null
2 . . . punctuation unspecified unspecified unspecified unspecified unspecified  	O	null

0 ###NUMEXP### ###NUMEXP### ###NUMEXP### numberExpression unspecified unspecified unspecified unspecified unspecified  	I_DATE	null
1 ; ; ; punctuation unspecified unspecified unspecified unspecified unspecified  	O	null
2 מ מ מנהיים preposition unspecified unspecified unspecified unspecified unspecified 0 
2 נהיים נהיה מנהיים participle masculine plural absolute any unspecified  	O	null
3 , , , punctuation unspecified unspecified unspecified unspecified unspecified  	O	null
4 נועה נועה נועה properName unspecified unspecified unspecified unspecified unspecified  	I_PERS	null
5 . . . punctuation unspecified unspecified unspecified unspecified unspecified  	O	null

0 " " " punctuation unspecified unspecified unspecified unspecified unspecified  	O	null
1 ה ה המוות definiteArticle unspecified unspecified unspecified unspecified unspecified 0 
1 המוות מוות המוות noun masculine singular absolute unspecified unspecified  	O	null
2 עלפי עילף עלפי verb feminine singular unspecified 2 imperative  	O	null
3 דיקר דיקר דיקר verb masculine singular unspecified 3 past  	O	null
4 " " " punctuation unspecified unspecified unspecified unspecified unspecified  	O	null
5 . . . punctuation unspecified unspecified unspecified unspecified unspecified  	O	null

0 עיתון עיתון עיתון noun masculine singular construct unspecified unspecified  	O	null
1 תלאביב תלאביב תלאביב properName unspecified unspecified unspecified unspecified unspecified  	O	null
2 ספרות ספרות ספרות noun feminine singular absolute unspecified unspecified  	O	null
3 ו ו ותרבות conjunction unspecified unspecified unspecified unspecified unspecified 0 
3 תרבות תרבות ותרבות noun feminine singular absolute unspecified unspecified  	O	null
4 . . . punctuation unspecified unspecified unspecified unspecified unspecified  	O	null

0 ###NUMEXP### ###NUMEXP### ###NUMEXP### numberExpression unspecified unspecified unspecified unspecified unspecified  	I_DATE	null
1 . . . punctuation unspecified unspecified unspecified unspecified unspecified  	O	null

