0 Name Name Name foreign unspecified unspecified unspecified unspecified unspecified  	O	null
1 : : : punctuation unspecified unspecified unspecified unspecified unspecified  	O	null
2 דרוויש דרוויש דרוויש properName unspecified unspecified unspecified unspecified unspecified  	I_ORG	null
3 , , , punctuation unspecified unspecified unspecified unspecified unspecified  	O	null
4 זכי זך זכי adjective masculine plural construct unspecified unspecified  	O	null
5 Birth Birth Birth foreign unspecified unspecified unspecified unspecified unspecified  	O	null
6 Year Year Year foreign unspecified unspecified unspecified unspecified unspecified  	O	null
7 : : : punctuation unspecified unspecified unspecified unspecified unspecified  	O	null
8 ###NUMBER### ###NUMBER### ###NUMBER### numeral unspecified unspecified unspecified unspecified unspecified  	I_DATE	null
9 Birth Birth Birth foreign unspecified unspecified unspecified unspecified unspecified  	I_ORG	null
10 Place Place Place foreign unspecified unspecified unspecified unspecified unspecified  	I_ORG	null
11 : : : punctuation unspecified unspecified unspecified unspecified unspecified  	I_LOC	null
12 כפר כפר כפר noun masculine singular construct unspecified unspecified  	I_LOC	null
13 אל אל אל properName unspecified unspecified unspecified unspecified unspecified  	I_LOC	null
14 - - - properName unspecified unspecified unspecified unspecified unspecified  	I_LOC	null
15 ב ב ברווה preposition unspecified unspecified unspecified unspecified unspecified 0 
15 רווה רווה ברווה properName masculine singular unspecified unspecified unspecified  	I_LOC	null
16 ב ב בגליל preposition unspecified unspecified unspecified unspecified unspecified 0 
16 גליל גליל בגליל properName unspecified unspecified unspecified unspecified unspecified  	I_LOC	null
17 , , , punctuation unspecified unspecified unspecified unspecified unspecified  	O	null
18 ש ש שנהרס relativizer/subordinatingConjunction unspecified unspecified unspecified unspecified unspecified 0 
18 נהרס נהרס שנהרס verb masculine singular unspecified 3 past  	O	null
19 Occupation Occupation Occupation foreign unspecified unspecified unspecified unspecified unspecified  	O	null
20 : : : punctuation unspecified unspecified unspecified unspecified unspecified  	O	null
21 סופר ספר סופר participle masculine singular absolute any unspecified  	O	null
22 , , , punctuation unspecified unspecified unspecified unspecified unspecified  	O	null
23 מחזאי מחזאי מחזאי noun masculine singular construct unspecified unspecified  	O	null
24 , , , punctuation unspecified unspecified unspecified unspecified unspecified  	O	null
25 מתרגם מתרגם מתרגם noun masculine singular construct unspecified unspecified  	O	null
26 ו ו ועורךבשפה conjunction unspecified unspecified unspecified unspecified unspecified 0 
26 עורךבשפה עורךבשפה ועורךבשפה noun feminine singular absolute unspecified unspecified  	O	null
27 ה ה הערבית definiteArticle unspecified unspecified unspecified unspecified unspecified 0 
27 הערבית ערבי הערבית adjective feminine singular absolute unspecified unspecified  	O	null
28 Entry Entry Entry foreign unspecified unspecified unspecified unspecified unspecified  	O	null
29 writer writer writer foreign unspecified unspecified unspecified unspecified unspecified  	O	null
30 : : : punctuation unspecified unspecified unspecified unspecified unspecified  	O	null
31 אריאל אריאל אריאל properName unspecified unspecified unspecified unspecified unspecified  	I_ORG	null
32 שיטרית שיטרית שיטרית properName unspecified unspecified unspecified unspecified unspecified  	I_ORG	null
33 Entry Entry Entry foreign unspecified unspecified unspecified unspecified unspecified  	O	null
34 Value Value Value foreign unspecified unspecified unspecified unspecified unspecified  	O	null
35 : : : punctuation unspecified unspecified unspecified unspecified unspecified  	O	null
36 נולד נולד נולד verb masculine singular unspecified 3 past  	I_LOC	null
37 ב ב בכפר preposition unspecified unspecified unspecified unspecified unspecified 0 
37 כפר כפר בכפר noun masculine singular construct unspecified unspecified  	I_LOC	null
38 אל אל אל properName unspecified unspecified unspecified unspecified unspecified  	I_LOC	null
39 - - - properName unspecified unspecified unspecified unspecified unspecified  	I_LOC	null
40 ב ב ברווה preposition unspecified unspecified unspecified unspecified unspecified 0 
40 רווה רווה ברווה properName masculine singular unspecified unspecified unspecified  	I_LOC	null
41 ב ב בגליל preposition unspecified unspecified unspecified unspecified unspecified 0 
41 גליל גליל בגליל properName unspecified unspecified unspecified unspecified unspecified  	I_LOC	null
42 , , , punctuation unspecified unspecified unspecified unspecified unspecified  	O	null
43 ש ש שנהרס relativizer/subordinatingConjunction unspecified unspecified unspecified unspecified unspecified 0 
43 נהרס נהרס שנהרס verb masculine singular unspecified 3 past  	O	null
44 כליל כליל כליל properName masculine singular unspecified unspecified unspecified  	I_PERS	null
45 ב ב ב preposition unspecified unspecified unspecified unspecified unspecified 0 	I_ORG	null
46 - - - punctuation unspecified unspecified unspecified unspecified unspecified  	I_ORG	null
47 ###NUMBER### ###NUMBER### ###NUMBER### numeral unspecified unspecified unspecified unspecified unspecified  	I_DATE	null
48 . . . punctuation unspecified unspecified unspecified unspecified unspecified  	O	null

0 את את את at-preposition unspecified unspecified unspecified unspecified unspecified  	O	null
1 לימודי לימוד לימודי noun masculine plural construct unspecified unspecified  	O	null
2 ה ה התיכון definiteArticle unspecified unspecified unspecified unspecified unspecified 0 
2 התיכון תיכון התיכון noun masculine singular absolute unspecified unspecified  	O	null
3 סיים סיים סיים verb masculine singular unspecified 3 past  	O	null
4 ב ב בכפר preposition unspecified unspecified unspecified unspecified unspecified 0 
4 ה ה בכפר definiteArticle unspecified unspecified unspecified unspecified unspecified 0 
4 הכפר כפר בכפר noun masculine singular absolute unspecified unspecified  	O	null
5 יסיף סייף יסיף verb masculine singular unspecified 3 future  	O	null
6 . . . punctuation unspecified unspecified unspecified unspecified unspecified  	O	null

0 מתגורר התגורר מתגורר verb masculine singular unspecified any beinoni  	I_LOC	null
1 ב ב בכפר preposition unspecified unspecified unspecified unspecified unspecified 0 
1 כפר כפר בכפר noun masculine singular construct unspecified unspecified  	I_LOC	null
2 ג'דיידה ג'דיידה ג'דיידה properName unspecified unspecified unspecified unspecified unspecified  	I_LOC	null
3 ב ב בגליל preposition unspecified unspecified unspecified unspecified unspecified 0 
3 ה ה בגליל definiteArticle unspecified unspecified unspecified unspecified unspecified 0 
3 הגליל גליל בגליל properName unspecified unspecified unspecified unspecified unspecified  	I_LOC	null
4 . . . punctuation unspecified unspecified unspecified unspecified unspecified  	O	null

0 בעל בעל בעל noun masculine singular construct unspecified unspecified  	O	null
1 תואר תואר תואר noun masculine singular construct unspecified unspecified  	O	null
2 ראשון ORD1 ראשון numeral masculine singular absolute unspecified unspecified  	O	null
3 ו ו ושני conjunction unspecified unspecified unspecified unspecified unspecified 0 
3 שני שני ושני noun masculine singular absolute unspecified unspecified  	O	null
4 ב ב בערבית preposition unspecified unspecified unspecified unspecified unspecified 0 
4 ערבית ערבית בערבית properName feminine singular unspecified unspecified unspecified  	O	null
5 ו ו ובחינוך conjunction unspecified unspecified unspecified unspecified unspecified 0 
5 ב ב ובחינוך preposition unspecified unspecified unspecified unspecified unspecified 0 
5 ה ה ובחינוך definiteArticle unspecified unspecified unspecified unspecified unspecified 0 
5 החינוך חינוך ובחינוך noun masculine singular absolute unspecified unspecified  	O	null
6 מ מ מאוניברסיטת preposition unspecified unspecified unspecified unspecified unspecified 0 
6 אוניברסיטת אוניברסיטה מאוניברסיטת noun feminine singular construct unspecified unspecified  	I_ORG	null
7 חיפה חיפה חיפה properName unspecified unspecified unspecified unspecified unspecified  	I_ORG	null
8 . . . punctuation unspecified unspecified unspecified unspecified unspecified  	O	null

0 שימש שימש שימש verb masculine singular unspecified 3 past  	O	null
1 מורה מורה מורה noun masculine singular absolute unspecified unspecified  	O	null
2 ב ב בבתי preposition unspecified unspecified unspecified unspecified unspecified 0 
2 בתי בית בבתי noun masculine plural construct unspecified unspecified  	O	null
3 ספר ספר ספר noun masculine singular absolute unspecified unspecified  	O	null
4 יסודיים יסודי יסודיים adjective masculine plural absolute unspecified unspecified  	O	null
5 ו ו ותיכוניים conjunction unspecified unspecified unspecified unspecified unspecified 0 
5 תיכוניים תיכוני ותיכוניים adjective masculine plural absolute unspecified unspecified  	O	null
6 , , , punctuation unspecified unspecified unspecified unspecified unspecified  	O	null
7 ו ו ולאחר conjunction unspecified unspecified unspecified unspecified unspecified 0 
7 לאחר לאחר ולאחר conjunction unspecified unspecified unspecified unspecified unspecified  	O	null
8 מכן מיכן מכן verb masculine singular unspecified 2 imperative  	O	null
9 גם גם גם conjunction unspecified unspecified unspecified unspecified unspecified  	O	null
10 מנהל מנהל מנהל noun masculine singular construct unspecified unspecified  	O	null
11 בית בית בית noun masculine singular construct unspecified unspecified  	O	null
12 ה ה הספר definiteArticle unspecified unspecified unspecified unspecified unspecified 0 
12 הספר ספר הספר noun masculine singular absolute unspecified unspecified  	O	null
13 ה ה התיכון definiteArticle unspecified unspecified unspecified unspecified unspecified 0 
13 התיכון תיכון התיכון adjective masculine singular absolute unspecified unspecified  	O	null
14 " " " punctuation unspecified unspecified unspecified unspecified unspecified  	O	null
15 אל-שעב אל-שעב אל-שעב properName unspecified unspecified unspecified unspecified unspecified  	I_ORG	null
16 " " " punctuation unspecified unspecified unspecified unspecified unspecified  	O	null
17 . . . punctuation unspecified unspecified unspecified unspecified unspecified  	O	null

0 היה הוא היה copula masculine singular unspecified 3 past  	O	null
1 עורך עורך עורך noun masculine singular construct unspecified unspecified  	O	null
2 ה ה העיתון definiteArticle unspecified unspecified unspecified unspecified unspecified 0 
2 העיתון עיתון העיתון noun masculine singular absolute unspecified unspecified  	O	null
3 אסואר אסואר אסואר properName unspecified unspecified unspecified unspecified unspecified  	O	null
4 ו ו והעורך conjunction unspecified unspecified unspecified unspecified unspecified 0 
4 ה ה והעורך definiteArticle unspecified unspecified unspecified unspecified unspecified 0 
4 העורך עורך והעורך noun masculine singular absolute unspecified unspecified  	O	null
5 ה ה הראשי definiteArticle unspecified unspecified unspecified unspecified unspecified 0 
5 הראשי ראשי הראשי adjective masculine singular absolute unspecified unspecified  	O	null
6 ב ב בנדאא preposition unspecified unspecified unspecified unspecified unspecified 0 
6 נדאא נדאא בנדאא noun masculine singular absolute unspecified unspecified  	O	null
7 אל אל אל preposition unspecified unspecified unspecified unspecified unspecified  	O	null
8 - - - properName unspecified unspecified unspecified unspecified unspecified  	I_ORG	null
9 אסואר אסואר אסואר properName unspecified unspecified unspecified unspecified unspecified  	I_ORG	null
10 ו ו וכן conjunction unspecified unspecified unspecified unspecified unspecified 0 
10 כן כן וכן conjunction unspecified unspecified unspecified unspecified unspecified  	O	null
11 שימש שימש שימש verb masculine singular unspecified 3 past  	O	null
12 ראש ראש ראש noun masculine singular construct unspecified unspecified  	O	null
13 מחלקת מחלק מחלקת noun feminine singular construct unspecified unspecified  	O	null
14 ה ה התרבות definiteArticle unspecified unspecified unspecified unspecified unspecified 0 
14 התרבות תרבות התרבות noun feminine singular absolute unspecified unspecified  	O	null
15 ב ב באגודת preposition unspecified unspecified unspecified unspecified unspecified 0 
15 אגודת אגודה באגודת noun feminine singular construct unspecified unspecified  	O	null
16 ה ה הסופרים definiteArticle unspecified unspecified unspecified unspecified unspecified 0 
16 הסופרים סופר הסופרים noun masculine plural absolute unspecified unspecified  	O	null
17 ה ה הפלסטינים definiteArticle unspecified unspecified unspecified unspecified unspecified 0 
17 הפלסטינים פלסטיני הפלסטינים adjective masculine plural absolute unspecified unspecified  	O	null
18 ב ב בישראל preposition unspecified unspecified unspecified unspecified unspecified 0 
18 ישראל ישראל בישראל properName unspecified unspecified unspecified unspecified unspecified  	I_LOC	null
19 . . . punctuation unspecified unspecified unspecified unspecified unspecified  	O	null

0 חיבר חיבר חיבר verb masculine singular unspecified 3 past  	O	null
1 תשעה CARD9 תשעה numeral masculine plural absolute unspecified unspecified  	O	null
2 קובצי קבץ קובצי participle masculine plural construct any unspecified  	O	null
3 סיפורים סיפור סיפורים noun masculine plural absolute unspecified unspecified  	O	null
4 קצרים קצר קצרים adjective masculine plural absolute unspecified unspecified  	O	null
5 , , , punctuation unspecified unspecified unspecified unspecified unspecified  	O	null
6 שני CARD2 שני numeral masculine dual construct unspecified unspecified  	O	null
7 רומנים רומן רומנים noun masculine plural absolute unspecified unspecified  	O	null
8 ו ו ושני conjunction unspecified unspecified unspecified unspecified unspecified 0 
8 שני CARD2 ושני numeral masculine dual construct unspecified unspecified  	O	null
9 מחזות מחזה מחזות noun masculine plural absolute unspecified unspecified  	O	null
10 , , , punctuation unspecified unspecified unspecified unspecified unspecified  	O	null
11 ו ו וממשיך conjunction unspecified unspecified unspecified unspecified unspecified 0 
11 ממשיך המשיך וממשיך verb masculine singular unspecified any beinoni  	O	null
12 לפרסם פרסם לפרסם verb unspecified unspecified unspecified unspecified infinitive  	O	null
13 מאמרים מאמר מאמרים noun masculine plural absolute unspecified unspecified  	O	null
14 ו ו וסיפורים conjunction unspecified unspecified unspecified unspecified unspecified 0 
14 סיפורים סיפור וסיפורים noun masculine plural absolute unspecified unspecified  	O	null
15 ב ב בעיתונות preposition unspecified unspecified unspecified unspecified unspecified 0 
15 ה ה בעיתונות definiteArticle unspecified unspecified unspecified unspecified unspecified 0 
15 העיתונות עיתונות בעיתונות noun feminine singular absolute unspecified unspecified  	O	null
16 . . . punctuation unspecified unspecified unspecified unspecified unspecified  	O	null

0 על על על preposition unspecified unspecified unspecified unspecified unspecified  	O	null
1 פי פה פי noun masculine singular construct unspecified unspecified  	O	null
2 ה ה החלוקה definiteArticle unspecified unspecified unspecified unspecified unspecified 0 
2 החלוקה חלוקה החלוקה noun feminine singular absolute unspecified unspecified  	O	null
3 של של של shel-preposition unspecified unspecified unspecified unspecified unspecified  	O	null
4 ה ה החוקר definiteArticle unspecified unspecified unspecified unspecified unspecified 0 
4 החוקר חוקר החוקר noun masculine singular absolute unspecified unspecified  	O	null
5 מחמוד מחמוד מחמוד properName unspecified unspecified unspecified unspecified unspecified  	I_PERS	null
6 גנאים גנאי גנאים noun masculine plural absolute unspecified unspecified  	O	null
7 ) ) ) punctuation unspecified unspecified unspecified unspecified unspecified  	O	null
8 , , , punctuation unspecified unspecified unspecified unspecified unspecified  	O	null
9 ###NUMBER### ###NUMBER### ###NUMBER### numeral unspecified unspecified unspecified unspecified unspecified  	I_DATE	null
10 דרוויש דרוויש דרוויש noun feminine singular construct unspecified unspecified  	O	null
11 משתייך השתייך משתייך verb masculine singular unspecified any beinoni  	O	null
12 ל ל לדור preposition unspecified unspecified unspecified unspecified unspecified 0 
12 ה ה לדור definiteArticle unspecified unspecified unspecified unspecified unspecified 0 
12 הדור דור לדור noun masculine singular absolute unspecified unspecified  	O	null
13 ה ה השני definiteArticle unspecified unspecified unspecified unspecified unspecified 0 
13 השני ORD2 השני numeral masculine singular absolute unspecified unspecified  	O	null
14 של של של shel-preposition unspecified unspecified unspecified unspecified unspecified  	O	null
15 סופרים סופר סופרים noun masculine plural absolute unspecified unspecified  	O	null
16 פלסטינים פלסטיני פלסטינים adjective masculine plural absolute unspecified unspecified  	O	null
17 אזרחי אזרח אזרחי noun masculine plural construct unspecified unspecified  	O	null
18 מדינת מדינה מדינת noun feminine singular construct unspecified unspecified  	I_ORG	null
19 ישראל ישראל ישראל properName unspecified unspecified unspecified unspecified unspecified  	I_ORG	null
20 . . . punctuation unspecified unspecified unspecified unspecified unspecified  	O	null

0 את את את at-preposition unspecified unspecified unspecified unspecified unspecified  	O	null
1 קובץ קובץ קובץ noun masculine singular construct unspecified unspecified  	O	null
2 ה ה הסיפורים definiteArticle unspecified unspecified unspecified unspecified unspecified 0 
2 הסיפורים סיפור הסיפורים noun masculine plural absolute unspecified unspecified  	O	null
3 ה ה הראשון definiteArticle unspecified unspecified unspecified unspecified unspecified 0 
3 הראשון ORD1 הראשון numeral masculine singular absolute unspecified unspecified  	O	null
4 של של שלו shel-preposition unspecified unspecified unspecified unspecified unspecified  
4 ו ו שלו pronomial masculine singular unspecified 3 unspecified 0 	O	null
5 , , , punctuation unspecified unspecified unspecified unspecified unspecified  	O	null
6 חורף חורף חורף noun masculine singular construct unspecified unspecified  	O	null
7 ה ה ההתנכרות definiteArticle unspecified unspecified unspecified unspecified unspecified 0 
7 ההתנכרות התנכרות ההתנכרות noun feminine singular absolute unspecified unspecified  	O	null
8 , , , punctuation unspecified unspecified unspecified unspecified unspecified  	O	null
9 פירסםב פירסםב פירסםב properName unspecified unspecified unspecified unspecified unspecified  	I_LOC	null
10 - - - punctuation unspecified unspecified unspecified unspecified unspecified  	O	null
11 ( ( ( punctuation unspecified unspecified unspecified unspecified unspecified  	I_ORG	null
12 ירושלים ירושלים ירושלים properName unspecified unspecified unspecified unspecified unspecified  	I_LOC	null
13 : : : punctuation unspecified unspecified unspecified unspecified unspecified  	O	null
14 מג'ללת מג'ללת מג'ללת properName unspecified unspecified unspecified unspecified unspecified  	I_PERS	null
15 אל אל אל properName unspecified unspecified unspecified unspecified unspecified  	I_PERS	null
16 - - - properName unspecified unspecified unspecified unspecified unspecified  	I_PERS	null
17 ש ש שרק relativizer/subordinatingConjunction unspecified unspecified unspecified unspecified unspecified 0 
17 רק רק שרק adverb unspecified unspecified unspecified unspecified unspecified  	O	null
18 ) ) ) punctuation unspecified unspecified unspecified unspecified unspecified  	O	null
19 . . . punctuation unspecified unspecified unspecified unspecified unspecified  	O	null

0 את את את at-preposition unspecified unspecified unspecified unspecified unspecified  	O	null
1 ה ה הרומן definiteArticle unspecified unspecified unspecified unspecified unspecified 0 
1 הרומן רומן הרומן noun masculine singular absolute unspecified unspecified  	O	null
2 ה ה הראשון definiteArticle unspecified unspecified unspecified unspecified unspecified 0 
2 הראשון ORD1 הראשון numeral masculine singular absolute unspecified unspecified  	O	null
3 של של שלו shel-preposition unspecified unspecified unspecified unspecified unspecified  
3 ו ו שלו pronomial masculine singular unspecified 3 unspecified 0 	O	null
4 , , , punctuation unspecified unspecified unspecified unspecified unspecified  	O	null
5 ה ה היציאה definiteArticle unspecified unspecified unspecified unspecified unspecified 0 
5 היציאה יציאה היציאה noun feminine singular absolute unspecified unspecified  	O	null
6 מ מ ממישור preposition unspecified unspecified unspecified unspecified unspecified 0 
6 מישור מישור ממישור noun masculine singular construct unspecified unspecified  	O	null
7 אבן אבן אבן properName unspecified unspecified unspecified unspecified unspecified  	I_PERS	null
8 עאמר עאמר עאמר properName unspecified unspecified unspecified unspecified unspecified  	I_PERS	null
9 , , , punctuation unspecified unspecified unspecified unspecified unspecified  	O	null
10 פירסם פרסם פירסם verb masculine singular unspecified 3 past  	O	null
11 ב ב ב preposition unspecified unspecified unspecified unspecified unspecified 0 	O	null
12 - - - punctuation unspecified unspecified unspecified unspecified unspecified  	O	null
13 ###NUMBER### ###NUMBER### ###NUMBER### numeral unspecified unspecified unspecified unspecified unspecified  	I_DATE	null
14 . . . punctuation unspecified unspecified unspecified unspecified unspecified  	O	null

0 תירגם תרגם תירגם verb masculine singular unspecified 3 past  	I_LOC	null
1 ל ל לערבית preposition unspecified unspecified unspecified unspecified unspecified 0 
1 ערבית ערבית לערבית properName feminine singular unspecified unspecified unspecified  	I_PERS	null
2 , , , punctuation unspecified unspecified unspecified unspecified unspecified  	O	null
3 בין בין בין preposition unspecified unspecified unspecified unspecified unspecified  	O	null
4 ה ה השאר definiteArticle unspecified unspecified unspecified unspecified unspecified 0 
4 השאר שאר השאר noun masculine singular absolute unspecified unspecified  	O	null
5 , , , punctuation unspecified unspecified unspecified unspecified unspecified  	O	null
6 את את את at-preposition unspecified unspecified unspecified unspecified unspecified  	O	null
7 ספר ספר ספרו noun masculine singular absolute unspecified unspecified  
7 ו ו ספרו possessive masculine singular unspecified 3 unspecified 0 	O	null
8 ה ה המחקרי definiteArticle unspecified unspecified unspecified unspecified unspecified 0 
8 המחקרי מחקרי המחקרי adjective masculine singular absolute unspecified unspecified  	O	null
9 של של של shel-preposition unspecified unspecified unspecified unspecified unspecified  	O	null
10 שמעון שמעון שמעון properName unspecified unspecified unspecified unspecified unspecified  	I_PERS	null
11 ב ב בלס preposition unspecified unspecified unspecified unspecified unspecified 0 
11 לס לס בלס noun masculine singular construct unspecified unspecified  	O	null
12 ה ה הספרותהערבית definiteArticle unspecified unspecified unspecified unspecified unspecified 0 
12 הספרותהערבית הספרותהערבית הספרותהערבית noun feminine plural absolute unspecified unspecified  	O	null
13 ב ב בצל preposition unspecified unspecified unspecified unspecified unspecified 0 
13 צל צל בצל noun masculine singular construct unspecified unspecified  	O	null
14 ה ה המלחמה definiteArticle unspecified unspecified unspecified unspecified unspecified 0 
14 המלחמה מלחמה המלחמה noun feminine singular absolute unspecified unspecified  	O	null
15 ) ) ) punctuation unspecified unspecified unspecified unspecified unspecified  	O	null
16 . . . punctuation unspecified unspecified unspecified unspecified unspecified  	O	null
17 מבחר מבחר מבחר quantifier unspecified unspecified construct unspecified unspecified  	O	null
18 ###NUMBER### ###NUMBER### ###NUMBER### numeral unspecified unspecified unspecified unspecified unspecified  	I_DATE	null
19 מ מ מסיפוריו preposition unspecified unspecified unspecified unspecified unspecified 0 
19 סיפורי סיפור מסיפוריו noun masculine plural absolute unspecified unspecified  
19 ו ו מסיפוריו possessive masculine singular unspecified 3 unspecified 0 	O	null
20 תורגם תורגם תורגם verb masculine singular unspecified 3 past  	O	null
21 ל ל לאנגלית preposition unspecified unspecified unspecified unspecified unspecified 0 
21 אנגלית אנגלית לאנגלית properName feminine singular unspecified unspecified unspecified  	I_LOC	null
22 . . . punctuation unspecified unspecified unspecified unspecified unspecified  	O	null

0 ב ב בסיפוריו preposition unspecified unspecified unspecified unspecified unspecified 0 
0 סיפורי סיפור בסיפוריו noun masculine plural absolute unspecified unspecified  
0 ו ו בסיפוריו possessive masculine singular unspecified 3 unspecified 0 	O	null
1 מורגשת הורגש מורגשת verb feminine singular unspecified any beinoni  	O	null
2 זיקה זיקה זיקה noun feminine singular absolute unspecified unspecified  	O	null
3 ל ל למסורת preposition unspecified unspecified unspecified unspecified unspecified 0 
3 מסורת מסור למסורת adjective feminine singular construct unspecified unspecified  	O	null
4 ה ה הסיפורת definiteArticle unspecified unspecified unspecified unspecified unspecified 0 
4 הסיפורת סיפורת הסיפורת noun feminine singular absolute unspecified unspecified  	O	null
5 ה ה הערבית definiteArticle unspecified unspecified unspecified unspecified unspecified 0 
5 הערבית ערבי הערבית adjective feminine singular absolute unspecified unspecified  	O	null
6 ל ל לדורותיה preposition unspecified unspecified unspecified unspecified unspecified 0 
6 דורותי דור לדורותיה noun masculine plural absolute unspecified unspecified  
6 ה ה לדורותיה possessive feminine singular unspecified 3 unspecified 0 	O	null
7 , , , punctuation unspecified unspecified unspecified unspecified unspecified  	O	null
8 כפי כפי כפי conjunction unspecified unspecified unspecified unspecified unspecified  	O	null
9 ש ש שמשתמע relativizer/subordinatingConjunction unspecified unspecified unspecified unspecified unspecified 0 
9 משתמע השתמע שמשתמע verb masculine singular unspecified any beinoni  	O	null
10 בבירור בבירור בבירור adverb unspecified unspecified unspecified unspecified unspecified  	O	null
11 , , , punctuation unspecified unspecified unspecified unspecified unspecified  	O	null
12 בין בין בין conjunction unspecified unspecified unspecified unspecified unspecified  	O	null
13 ה ה השאר definiteArticle unspecified unspecified unspecified unspecified unspecified 0 
13 השאר שאר השאר quantifier unspecified unspecified unspecified unspecified unspecified  	O	null
14 , , , punctuation unspecified unspecified unspecified unspecified unspecified  	O	null
15 מן מן מן preposition unspecified unspecified unspecified unspecified unspecified  	O	null
16 ה ה הסיפור definiteArticle unspecified unspecified unspecified unspecified unspecified 0 
16 הסיפור סיפור הסיפור noun masculine singular absolute unspecified unspecified  	O	null
17 " " " punctuation unspecified unspecified unspecified unspecified unspecified  	O	null
18 אלף אלף אלף properName feminine singular unspecified unspecified unspecified  	I_ORG	null
19 לילה לילה לילה properName unspecified unspecified unspecified unspecified unspecified  	I_ORG	null
20 ולילותיים ולילותיים ולילותיים adjective masculine plural absolute unspecified unspecified  	O	null
21 " " " punctuation unspecified unspecified unspecified unspecified unspecified  	O	null
22 ( ( ( punctuation unspecified unspecified unspecified unspecified unspecified  	O	null
23 מ מ מתוך preposition unspecified unspecified unspecified unspecified unspecified 0 
23 תוך תוך מתוך wPrefix unspecified unspecified unspecified unspecified unspecified  	O	null
24 ה ה הקובץ definiteArticle unspecified unspecified unspecified unspecified unspecified 0 
24 הקובץ קובץ הקובץ noun masculine singular absolute unspecified unspecified  	O	null
25 ה ה הכלבים definiteArticle unspecified unspecified unspecified unspecified unspecified 0 
25 הכלבים כלב הכלבים noun masculine plural absolute unspecified unspecified  	O	null
26 , , , punctuation unspecified unspecified unspecified unspecified unspecified  	O	null
27 , , , punctuation unspecified unspecified unspecified unspecified unspecified  	O	null
28 ###NUMBER### ###NUMBER### ###NUMBER### numeral unspecified unspecified unspecified unspecified unspecified  	I_DATE	null
29 מערבית מערבי מערבית noun feminine singular absolute unspecified unspecified  	O	null
30 : : : punctuation unspecified unspecified unspecified unspecified unspecified  	O	null
31 משה משה משה properName unspecified unspecified unspecified unspecified unspecified  	I_PERS	null
32 חכם חכם חכם adjective masculine singular absolute unspecified unspecified  	O	null
33 , , , punctuation unspecified unspecified unspecified unspecified unspecified  	O	null
34 מ מ מתוךסיפורים preposition unspecified unspecified unspecified unspecified unspecified 0 
34 תוךסיפורים תוךסיפורים מתוךסיפורים noun masculine plural absolute unspecified unspecified  	O	null
35 פלסטיניים פלסטיני פלסטיניים adjective masculine plural absolute unspecified unspecified  	O	null
36 , , , punctuation unspecified unspecified unspecified unspecified unspecified  	O	null
37 , , , punctuation unspecified unspecified unspecified unspecified unspecified  	O	null
38 ###NUMBER### ###NUMBER### ###NUMBER### numeral unspecified unspecified unspecified unspecified unspecified  	I_DATE	null
39 ###NUMBER### ###NUMBER### ###NUMBER### numeral unspecified unspecified unspecified unspecified unspecified  	O	null
40 - - - punctuation unspecified unspecified unspecified unspecified unspecified  	O	null
41 ###NUMBER### ###NUMBER### ###NUMBER### numeral unspecified unspecified unspecified unspecified unspecified  	O	null
42 ) ) ) punctuation unspecified unspecified unspecified unspecified unspecified  	O	null
43 . . . punctuation unspecified unspecified unspecified unspecified unspecified  	O	null

0 סגנון סגנון סגנון noun masculine singular construct unspecified unspecified  	O	null
1 סיפורי סיפור סיפוריו noun masculine plural absolute unspecified unspecified  
1 ו ו סיפוריו possessive masculine singular unspecified 3 unspecified 0 	O	null
2 נע נע נע verb masculine singular unspecified 3 past  	O	null
3 בין בין בין preposition unspecified unspecified unspecified unspecified unspecified  	O	null
4 ה ה הריאליסטי definiteArticle unspecified unspecified unspecified unspecified unspecified 0 
4 הריאליסטי ריאליסטי הריאליסטי adjective masculine singular absolute unspecified unspecified  	O	null
5 לפנטסטי לפנטסטי לפנטסטי adverb unspecified unspecified unspecified unspecified unspecified  	O	null
6 . . . punctuation unspecified unspecified unspecified unspecified unspecified  	O	null

0 ב ב בחלק preposition unspecified unspecified unspecified unspecified unspecified 0 
0 חלק חלק בחלק noun masculine singular construct unspecified unspecified  	O	null
1 מספרי מספר מספריו noun masculine plural absolute unspecified unspecified  
1 ו ו מספריו possessive masculine singular unspecified 3 unspecified 0 	O	null
2 התרכז התרכז התרכז verb masculine singular unspecified 3 past  	O	null
3 ב ב בקשר preposition unspecified unspecified unspecified unspecified unspecified 0 
3 קשר קשר בקשר noun masculine singular absolute unspecified unspecified  	O	null
4 ש ש שבין relativizer/subordinatingConjunction unspecified unspecified unspecified unspecified unspecified 0 
4 בין בין שבין preposition unspecified unspecified unspecified unspecified unspecified  	O	null
5 ה ה הפלסטיני definiteArticle unspecified unspecified unspecified unspecified unspecified 0 
5 הפלסטיני פלסטיני הפלסטיני adjective masculine singular absolute unspecified unspecified  	O	null
6 ל ל לאדמתו preposition unspecified unspecified unspecified unspecified unspecified 0 
6 אדמת אדמה לאדמתו noun feminine singular absolute unspecified unspecified  
6 ו ו לאדמתו possessive masculine singular unspecified 3 unspecified 0 	O	null
7 , , , punctuation unspecified unspecified unspecified unspecified unspecified  	O	null
8 ב ב במרחב preposition unspecified unspecified unspecified unspecified unspecified 0 
8 ה ה במרחב definiteArticle unspecified unspecified unspecified unspecified unspecified 0 
8 המרחב מרחב במרחב noun masculine singular absolute unspecified unspecified  	O	null
9 ה ה הפלסטיני definiteArticle unspecified unspecified unspecified unspecified unspecified 0 
9 הפלסטיני פלסטיני הפלסטיני adjective masculine singular absolute unspecified unspecified  	O	null
10 ו ו ובעברו conjunction unspecified unspecified unspecified unspecified unspecified 0 
10 ב ב ובעברו preposition unspecified unspecified unspecified unspecified unspecified 0 
10 עבר עבר ובעברו noun masculine singular absolute unspecified unspecified  
10 ו ו ובעברו possessive masculine singular unspecified 3 unspecified 0 	O	null
11 , , , punctuation unspecified unspecified unspecified unspecified unspecified  	O	null
12 כפי כפי כפי conjunction unspecified unspecified unspecified unspecified unspecified  	O	null
13 ש ש שמשתמע relativizer/subordinatingConjunction unspecified unspecified unspecified unspecified unspecified 0 
13 משתמע השתמע שמשתמע verb masculine singular unspecified any beinoni  	O	null
14 למשל למשל למשל conjunction unspecified unspecified unspecified unspecified unspecified  	O	null
15 מ מ מהסיפור preposition unspecified unspecified unspecified unspecified unspecified 0 
15 ה ה מהסיפור definiteArticle unspecified unspecified unspecified unspecified unspecified 0 
15 הסיפור סיפור מהסיפור noun masculine singular absolute unspecified unspecified  	O	null
16 " " " punctuation unspecified unspecified unspecified unspecified unspecified  	O	null
17 סוסים סוס סוסים noun masculine plural absolute unspecified unspecified  	O	null
18 " " " punctuation unspecified unspecified unspecified unspecified unspecified  	O	null
19 . . . punctuation unspecified unspecified unspecified unspecified unspecified  	O	null

0 עסק עסק עסק verb masculine singular unspecified 3 past  	O	null
1 גם גם גם conjunction unspecified unspecified unspecified unspecified unspecified  	O	null
2 ב ב בנושאים preposition unspecified unspecified unspecified unspecified unspecified 0 
2 נושאים נושא בנושאים noun masculine plural absolute unspecified unspecified  	O	null
3 אחרים אחר אחרים adjective masculine plural absolute unspecified unspecified  	O	null
4 : : : punctuation unspecified unspecified unspecified unspecified unspecified  	O	null
5 ה ה המתח definiteArticle unspecified unspecified unspecified unspecified unspecified 0 
5 המתח מתח המתח noun masculine singular absolute unspecified unspecified  	O	null
6 בין בין בין preposition unspecified unspecified unspecified unspecified unspecified  	O	null
7 דור דור דור noun masculine singular construct unspecified unspecified  	O	null
8 ה ה הבנים definiteArticle unspecified unspecified unspecified unspecified unspecified 0 
8 הבנים בן הבנים noun masculine plural absolute unspecified unspecified  	O	null
9 ל ל לדור preposition unspecified unspecified unspecified unspecified unspecified 0 
9 דור דור לדור noun masculine singular construct unspecified unspecified  	O	null
10 ה ה האבות definiteArticle unspecified unspecified unspecified unspecified unspecified 0 
10 האבות אב האבות noun masculine plural absolute unspecified unspecified  	O	null
11 ו ו והקשר conjunction unspecified unspecified unspecified unspecified unspecified 0 
11 ה ה והקשר definiteArticle unspecified unspecified unspecified unspecified unspecified 0 
11 הקשר קשר והקשר noun masculine singular absolute unspecified unspecified  	O	null
12 ה ה המשתנה definiteArticle unspecified unspecified unspecified unspecified unspecified 0 
12 המשתנה משתנה המשתנה adjective masculine singular absolute unspecified unspecified  	O	null
13 של של של shel-preposition unspecified unspecified unspecified unspecified unspecified  	O	null
14 כל כול כל quantifier unspecified unspecified construct unspecified unspecified  	O	null
15 דור דור דור noun masculine singular absolute unspecified unspecified  	O	null
16 ל ל לאדמת preposition unspecified unspecified unspecified unspecified unspecified 0 
16 אדמת אדמה לאדמת noun feminine singular construct unspecified unspecified  	O	null
17 ה ה המולדת definiteArticle unspecified unspecified unspecified unspecified unspecified 0 
17 המולדת מולדת המולדת noun feminine singular absolute unspecified unspecified  	O	null
18 ( ( ( punctuation unspecified unspecified unspecified unspecified unspecified  	O	null
19 למשל למשל למשל conjunction unspecified unspecified unspecified unspecified unspecified  	O	null
20 ב ב בסיפור preposition unspecified unspecified unspecified unspecified unspecified 0 
20 ה ה בסיפור definiteArticle unspecified unspecified unspecified unspecified unspecified 0 
20 הסיפור סיפור בסיפור noun masculine singular absolute unspecified unspecified  	O	null
21 ה ה הקצר definiteArticle unspecified unspecified unspecified unspecified unspecified 0 
21 הקצר קצר הקצר adjective masculine singular absolute unspecified unspecified  	O	null
22 " " " punctuation unspecified unspecified unspecified unspecified unspecified  	O	null
23 ה ה האדמה definiteArticle unspecified unspecified unspecified unspecified unspecified 0 
23 האדמה אדמה האדמה noun feminine singular absolute unspecified unspecified  	O	null
24 " " " punctuation unspecified unspecified unspecified unspecified unspecified  	O	null
25 מתוך מתוך מתוך preposition unspecified unspecified unspecified unspecified unspecified  	O	null
26 ה ה הקובץ definiteArticle unspecified unspecified unspecified unspecified unspecified 0 
26 הקובץ קובץ הקובץ noun masculine singular absolute unspecified unspecified  	O	null
27 ה ה החורף definiteArticle unspecified unspecified unspecified unspecified unspecified 0 
27 החורף חורף החורף noun masculine singular absolute unspecified unspecified  	O	null
28 ו ו והגלות conjunction unspecified unspecified unspecified unspecified unspecified 0 
28 ה ה והגלות definiteArticle unspecified unspecified unspecified unspecified unspecified 0 
28 הגלות גלות והגלות noun feminine singular absolute unspecified unspecified  	O	null
29 , , , punctuation unspecified unspecified unspecified unspecified unspecified  	O	null
30 מערבית מערבי מערבית noun feminine singular absolute unspecified unspecified  	O	null
31 : : : punctuation unspecified unspecified unspecified unspecified unspecified  	O	null
32 משה משה משה properName unspecified unspecified unspecified unspecified unspecified  	I_PERS	null
33 חכם חכם חכם adjective masculine singular absolute unspecified unspecified  	O	null
34 , , , punctuation unspecified unspecified unspecified unspecified unspecified  	O	null
35 מתוךסיפורים מתוךסיפורים מתוךסיפורים adjective masculine singular construct unspecified unspecified  	O	null
36 פלסטיניים פלסטיני פלסטיניים adjective masculine plural absolute unspecified unspecified  	O	null
37 , , , punctuation unspecified unspecified unspecified unspecified unspecified  	O	null
38 , , , punctuation unspecified unspecified unspecified unspecified unspecified  	O	null
39 ###NUMBER### ###NUMBER### ###NUMBER### numeral unspecified unspecified unspecified unspecified unspecified  	I_DATE	null
40 - - - punctuation unspecified unspecified unspecified unspecified unspecified  	O	null
41 ###NUMBER### ###NUMBER### ###NUMBER### numeral unspecified unspecified unspecified unspecified unspecified  	O	null
42 ) ) ) punctuation unspecified unspecified unspecified unspecified unspecified  	O	null
43 ; ; ; punctuation unspecified unspecified unspecified unspecified unspecified  	O	null
44 ###NUMBER### ###NUMBER### ###NUMBER### numeral unspecified unspecified unspecified unspecified unspecified  	O	null
45 ה ה הבעיות definiteArticle unspecified unspecified unspecified unspecified unspecified 0 
45 הבעיות בעיה הבעיות noun feminine plural absolute unspecified unspecified  	O	null
46 ש ש שעמדו relativizer/subordinatingConjunction unspecified unspecified unspecified unspecified unspecified 0 
46 עמדו עמד שעמדו verb masculine-and-feminine plural unspecified 3 past  	O	null
47 מול מול מול preposition unspecified unspecified unspecified unspecified unspecified  	O	null
48 ה ה הדור definiteArticle unspecified unspecified unspecified unspecified unspecified 0 
48 הדור דור הדור noun masculine singular absolute unspecified unspecified  	O	null
49 הצעיר הצעיר הצעיר verb masculine singular unspecified 3 past  	O	null
50 שגדלבכפרים שגדלבכפרים שגדלבכפרים properName unspecified unspecified unspecified unspecified unspecified  	I_PERS	null
51 ו ו והפיתויים conjunction unspecified unspecified unspecified unspecified unspecified 0 
51 ה ה והפיתויים definiteArticle unspecified unspecified unspecified unspecified unspecified 0 
51 הפיתויים פיתוי והפיתויים noun masculine plural absolute unspecified unspecified  	O	null
52 של של של shel-preposition unspecified unspecified unspecified unspecified unspecified  	O	null
53 ה ה העיר definiteArticle unspecified unspecified unspecified unspecified unspecified 0 
53 העיר עיר העיר noun feminine singular absolute unspecified unspecified  	O	null
54 . . . punctuation unspecified unspecified unspecified unspecified unspecified  	O	null

0 עניין עניין עניין noun masculine singular absolute unspecified unspecified  	O	null
1 אחרון אחרון אחרון adjective masculine singular absolute unspecified unspecified  	O	null
2 זה זה זה pronoun masculine singular unspecified 3 unspecified  	O	null
3 בא בא בא verb masculine singular unspecified 3 past  	O	null
4 ל ל לידי preposition unspecified unspecified unspecified unspecified unspecified 0 
4 ידי יד לידי noun feminine plural construct unspecified unspecified  	O	null
5 ביטוי ביטוי ביטוי noun masculine singular absolute unspecified unspecified  	O	null
6 ב ב בסיפור preposition unspecified unspecified unspecified unspecified unspecified 0 
6 ה ה בסיפור definiteArticle unspecified unspecified unspecified unspecified unspecified 0 
6 הסיפור סיפור בסיפור noun masculine singular absolute unspecified unspecified  	O	null
7 ה ה הקצר definiteArticle unspecified unspecified unspecified unspecified unspecified 0 
7 הקצר קצר הקצר adjective masculine singular absolute unspecified unspecified  	O	null
8 " " " punctuation unspecified unspecified unspecified unspecified unspecified  	O	null
9 ה ה החורף definiteArticle unspecified unspecified unspecified unspecified unspecified 0 
9 החורף חורף החורף noun masculine singular absolute unspecified unspecified  	O	null
10 ו ו והגלות conjunction unspecified unspecified unspecified unspecified unspecified 0 
10 ה ה והגלות definiteArticle unspecified unspecified unspecified unspecified unspecified 0 
10 הגלות גלות והגלות noun feminine singular absolute unspecified unspecified  	O	null
11 " " " punctuation unspecified unspecified unspecified unspecified unspecified  	O	null
12 ( ( ( punctuation unspecified unspecified unspecified unspecified unspecified  	O	null
13 מערבית מערבי מערבית noun feminine singular absolute unspecified unspecified  	O	null
14 : : : punctuation unspecified unspecified unspecified unspecified unspecified  	O	null
15 נעים נעים נעים properName unspecified unspecified unspecified unspecified unspecified  	I_PERS	null
16 עריידי עריידי עריידי properName unspecified unspecified unspecified unspecified unspecified  	I_PERS	null
17 , , , punctuation unspecified unspecified unspecified unspecified unspecified  	O	null
18 מתוך מתוך מתוך preposition unspecified unspecified unspecified unspecified unspecified  	O	null
19 חיילים חייל חיילים noun masculine plural absolute unspecified unspecified  	O	null
20 של של של shel-preposition unspecified unspecified unspecified unspecified unspecified  	O	null
21 מים מים מים noun masculine plural absolute unspecified unspecified  	O	null
22 , , , punctuation unspecified unspecified unspecified unspecified unspecified  	O	null
23 , , , punctuation unspecified unspecified unspecified unspecified unspecified  	O	null
24 ###NUMBER### ###NUMBER### ###NUMBER### numeral unspecified unspecified unspecified unspecified unspecified  	I_DATE	null
25 ###NUMBER### ###NUMBER### ###NUMBER### numeral unspecified unspecified unspecified unspecified unspecified  	O	null
26 - - - punctuation unspecified unspecified unspecified unspecified unspecified  	O	null
27 ###NUMBER### ###NUMBER### ###NUMBER### numeral unspecified unspecified unspecified unspecified unspecified  	O	null
28 ) ) ) punctuation unspecified unspecified unspecified unspecified unspecified  	O	null
29 . . . punctuation unspecified unspecified unspecified unspecified unspecified  	O	null

0 כאן כאן כאן adverb unspecified unspecified unspecified unspecified unspecified  	O	null
1 הוא הוא הוא pronoun masculine singular unspecified 3 unspecified  	O	null
2 מגולל גולל מגולל verb masculine singular unspecified any beinoni  	O	null
3 את את את at-preposition unspecified unspecified unspecified unspecified unspecified  	O	null
4 קורות קורה קורותיו noun feminine plural absolute unspecified unspecified  
4 ו ו קורותיו possessive masculine singular unspecified 3 unspecified 0 	O	null
5 של של של shel-preposition unspecified unspecified unspecified unspecified unspecified  	O	null
6 גבר גבר גבר noun masculine singular absolute unspecified unspecified  	O	null
7 צעיר צעיר צעיר adjective masculine singular absolute unspecified unspecified  	O	null
8 ש ש שעבר relativizer/subordinatingConjunction unspecified unspecified unspecified unspecified unspecified 0 
8 עבר עבר שעבר verb masculine singular unspecified 3 past  	O	null
9 מ מ מהכפר preposition unspecified unspecified unspecified unspecified unspecified 0 
9 ה ה מהכפר definiteArticle unspecified unspecified unspecified unspecified unspecified 0 
9 הכפר כפר מהכפר noun masculine singular absolute unspecified unspecified  	O	null
10 ל ל לעיר preposition unspecified unspecified unspecified unspecified unspecified 0 
10 ה ה לעיר definiteArticle unspecified unspecified unspecified unspecified unspecified 0 
10 העיר עיר לעיר noun feminine singular absolute unspecified unspecified  	O	null
11 . . . punctuation unspecified unspecified unspecified unspecified unspecified  	O	null

0 ה ה האיש definiteArticle unspecified unspecified unspecified unspecified unspecified 0 
0 האיש איש האיש noun masculine singular absolute unspecified unspecified  	O	null
1 מתגורר התגורר מתגורר verb masculine singular unspecified any beinoni  	O	null
2 ב ב בבניין preposition unspecified unspecified unspecified unspecified unspecified 0 
2 ה ה בבניין definiteArticle unspecified unspecified unspecified unspecified unspecified 0 
2 הבניין בניין בבניין noun masculine singular absolute unspecified unspecified  	O	null
3 ה ה הממוקם definiteArticle unspecified unspecified unspecified unspecified unspecified 0 
3 הממוקם מוקם הממוקם participle masculine singular absolute any unspecified  	O	null
4 על על על preposition unspecified unspecified unspecified unspecified unspecified  	O	null
5 ה ה הגבול definiteArticle unspecified unspecified unspecified unspecified unspecified 0 
5 הגבול גבול הגבול noun masculine singular absolute unspecified unspecified  	O	null
6 ש ש שבין relativizer/subordinatingConjunction unspecified unspecified unspecified unspecified unspecified 0 
6 בין בין שבין preposition unspecified unspecified unspecified unspecified unspecified  	O	null
7 ה ה החלק definiteArticle unspecified unspecified unspecified unspecified unspecified 0 
7 החלק חלק החלק noun masculine singular absolute unspecified unspecified  	O	null
8 ה ה הישן definiteArticle unspecified unspecified unspecified unspecified unspecified 0 
8 הישן ישן הישן adjective masculine singular absolute unspecified unspecified  	O	null
9 ל ל לחלק preposition unspecified unspecified unspecified unspecified unspecified 0 
9 ה ה לחלק definiteArticle unspecified unspecified unspecified unspecified unspecified 0 
9 החלק חלק לחלק noun masculine singular absolute unspecified unspecified  	O	null
10 ה ה החדש definiteArticle unspecified unspecified unspecified unspecified unspecified 0 
10 החדש חדש החדש adjective masculine singular absolute unspecified unspecified  	O	null
11 של של של shel-preposition unspecified unspecified unspecified unspecified unspecified  	O	null
12 ה ה העיר definiteArticle unspecified unspecified unspecified unspecified unspecified 0 
12 העיר עיר העיר noun feminine singular absolute unspecified unspecified  	O	null
13 , , , punctuation unspecified unspecified unspecified unspecified unspecified  	O	null
14 מיקום מיקום מיקום noun masculine singular construct unspecified unspecified  	O	null
15 ה ה המסמל definiteArticle unspecified unspecified unspecified unspecified unspecified 0 
15 המסמל סימל המסמל participle masculine singular absolute any unspecified  	O	null
16 את את את at-preposition unspecified unspecified unspecified unspecified unspecified  	O	null
17 מקום מקום מקומו noun masculine singular absolute unspecified unspecified  
17 ו ו מקומו possessive masculine singular unspecified 3 unspecified 0 	O	null
18 של של של shel-preposition unspecified unspecified unspecified unspecified unspecified  	O	null
19 ה ה הגיבור definiteArticle unspecified unspecified unspecified unspecified unspecified 0 
19 הגיבור גיבור הגיבור noun masculine singular absolute unspecified unspecified  	O	null
20 על על על preposition unspecified unspecified unspecified unspecified unspecified  	O	null
21 קו קו קו noun masculine singular construct unspecified unspecified  	I_LOC	null
22 ה ה התפר definiteArticle unspecified unspecified unspecified unspecified unspecified 0 
22 התפר תפר התפר noun masculine singular absolute unspecified unspecified  	I_LOC	null
23 בין בין בין preposition unspecified unspecified unspecified unspecified unspecified  	O	null
24 ה ה העולם definiteArticle unspecified unspecified unspecified unspecified unspecified 0 
24 העולם עולם העולם noun masculine singular absolute unspecified unspecified  	O	null
25 ה ה המסורתי definiteArticle unspecified unspecified unspecified unspecified unspecified 0 
25 המסורתי מסורתי המסורתי adjective masculine singular absolute unspecified unspecified  	O	null
26 ל ל לעולם preposition unspecified unspecified unspecified unspecified unspecified 0 
26 ה ה לעולם definiteArticle unspecified unspecified unspecified unspecified unspecified 0 
26 העולם עולם לעולם noun masculine singular absolute unspecified unspecified  	O	null
27 ה ה המודרני definiteArticle unspecified unspecified unspecified unspecified unspecified 0 
27 המודרני מודרני המודרני adjective masculine singular absolute unspecified unspecified  	O	null
28 . . . punctuation unspecified unspecified unspecified unspecified unspecified  	O	null

0 ה ה העיר definiteArticle unspecified unspecified unspecified unspecified unspecified 0 
0 העיר עיר העיר noun feminine singular absolute unspecified unspecified  	O	null
1 , , , punctuation unspecified unspecified unspecified unspecified unspecified  	O	null
2 ב ב בכללה preposition unspecified unspecified unspecified unspecified unspecified 0 
2 כלל כלל בכללה noun masculine singular absolute unspecified unspecified  
2 ה ה בכללה possessive feminine singular unspecified 3 unspecified 0 	O	null
3 , , , punctuation unspecified unspecified unspecified unspecified unspecified  	O	null
4 מסמלת סימל מסמלת verb feminine singular unspecified any beinoni  	O	null
5 את את את at-preposition unspecified unspecified unspecified unspecified unspecified  	O	null
6 ה ה העולם definiteArticle unspecified unspecified unspecified unspecified unspecified 0 
6 העולם עולם העולם noun masculine singular absolute unspecified unspecified  	O	null
7 ה ה המודרני definiteArticle unspecified unspecified unspecified unspecified unspecified 0 
7 המודרני מודרני המודרני adjective masculine singular absolute unspecified unspecified  	O	null
8 ו ו ומוצגת conjunction unspecified unspecified unspecified unspecified unspecified 0 
8 מוצגת הוצג ומוצגת verb feminine singular unspecified any beinoni  	O	null
9 כ כ כ preposition unspecified unspecified unspecified unspecified unspecified 0 	O	null
10 " " " punctuation unspecified unspecified unspecified unspecified unspecified  	O	null
11 גלות גלות גלות noun feminine singular absolute unspecified unspecified  	O	null
12 אצל אצל אצל preposition unspecified unspecified unspecified unspecified unspecified  	O	null
13 קרובים קרוב קרובים noun masculine plural absolute unspecified unspecified  	O	null
14 " " " punctuation unspecified unspecified unspecified unspecified unspecified  	O	null
15 , , , punctuation unspecified unspecified unspecified unspecified unspecified  	O	null
16 ש ש שהיא relativizer/subordinatingConjunction unspecified unspecified unspecified unspecified unspecified 0 
16 היא הוא שהיא pronoun feminine singular unspecified 3 unspecified  	O	null
17 , , , punctuation unspecified unspecified unspecified unspecified unspecified  	O	null
18 ל ל לדברי preposition unspecified unspecified unspecified unspecified unspecified 0 
18 דברי דבר לדברי noun masculine plural construct unspecified unspecified  	O	null
19 ה ה המחבר definiteArticle unspecified unspecified unspecified unspecified unspecified 0 
19 המחבר מחבר המחבר noun masculine singular absolute unspecified unspecified  	O	null
20 , , , punctuation unspecified unspecified unspecified unspecified unspecified  	O	null
21 כואבת כואב כואבת adjective feminine singular absolute unspecified unspecified  	O	null
22 יותר יותר יותר adverb unspecified unspecified unspecified unspecified unspecified  	O	null
23 מ מ מהגלות preposition unspecified unspecified unspecified unspecified unspecified 0 
23 ה ה מהגלות definiteArticle unspecified unspecified unspecified unspecified unspecified 0 
23 הגלות גלות מהגלות noun feminine singular absolute unspecified unspecified  	O	null
24 אצל אצל אצל preposition unspecified unspecified unspecified unspecified unspecified  	O	null
25 זרים זר זרים adjective masculine plural absolute unspecified unspecified  	O	null
26 . . . punctuation unspecified unspecified unspecified unspecified unspecified  	O	null

0 ה ה הסיפור definiteArticle unspecified unspecified unspecified unspecified unspecified 0 
0 הסיפור סיפור הסיפור noun masculine singular absolute unspecified unspecified  	O	null
1 " " " punctuation unspecified unspecified unspecified unspecified unspecified  	O	null
2 ה ה האיש definiteArticle unspecified unspecified unspecified unspecified unspecified 0 
2 האיש איש האיש noun masculine singular absolute unspecified unspecified  	O	null
3 ש ש שמשקר relativizer/subordinatingConjunction unspecified unspecified unspecified unspecified unspecified 0 
3 משקר שיקר שמשקר verb masculine singular unspecified any beinoni  	O	null
4 הרבה הרבה הרבה adverb unspecified unspecified unspecified unspecified unspecified  	I_ORG	null
5 " " " punctuation unspecified unspecified unspecified unspecified unspecified  	O	null
6 ( ( ( punctuation unspecified unspecified unspecified unspecified unspecified  	O	null
7 מערבית מערבי מערבית noun feminine singular absolute unspecified unspecified  	O	null
8 : : : punctuation unspecified unspecified unspecified unspecified unspecified  	O	null
9 נעים נעים נעים properName unspecified unspecified unspecified unspecified unspecified  	I_PERS	null
10 עריידי עריידי עריידי properName unspecified unspecified unspecified unspecified unspecified  	I_PERS	null
11 , , , punctuation unspecified unspecified unspecified unspecified unspecified  	O	null
12 מתוך מתוך מתוך preposition unspecified unspecified unspecified unspecified unspecified  	O	null
13 חיילים חייל חיילים noun masculine plural absolute unspecified unspecified  	O	null
14 של של של shel-preposition unspecified unspecified unspecified unspecified unspecified  	O	null
15 מים מים מים noun masculine plural absolute unspecified unspecified  	O	null
16 , , , punctuation unspecified unspecified unspecified unspecified unspecified  	O	null
17 , , , punctuation unspecified unspecified unspecified unspecified unspecified  	O	null
18 ###NUMBER### ###NUMBER### ###NUMBER### numeral unspecified unspecified unspecified unspecified unspecified  	I_DATE	null
19 - - - punctuation unspecified unspecified unspecified unspecified unspecified  	O	null
20 ###NUMBER### ###NUMBER### ###NUMBER### numeral unspecified unspecified unspecified unspecified unspecified  	O	null
21 ) ) ) punctuation unspecified unspecified unspecified unspecified unspecified  	O	null
22 ###NUMBER### ###NUMBER### ###NUMBER### numeral unspecified unspecified unspecified unspecified unspecified  	O	null
23 עוסק עסק עוסק verb masculine singular unspecified any beinoni  	O	null
24 גם גם גם conjunction unspecified unspecified unspecified unspecified unspecified  	O	null
25 הוא הוא הוא pronoun masculine singular unspecified 3 unspecified  	O	null
26 ב ב בקיום preposition unspecified unspecified unspecified unspecified unspecified 0 
26 קיום קיום בקיום noun masculine singular absolute unspecified unspecified  	O	null
27 ל ל לימינלי preposition unspecified unspecified unspecified unspecified unspecified 0 
27 ה ה לימינלי definiteArticle unspecified unspecified unspecified unspecified unspecified 0 
27 הימינלי הימינלי לימינלי adjective masculine singular absolute unspecified unspecified  	O	null
28 , , , punctuation unspecified unspecified unspecified unspecified unspecified  	O	null
29 הפעם הפעם הפעם adverb unspecified unspecified unspecified unspecified unspecified  	O	null
30 ב ב בגבול preposition unspecified unspecified unspecified unspecified unspecified 0 
30 ה ה בגבול definiteArticle unspecified unspecified unspecified unspecified unspecified 0 
30 הגבול גבול בגבול noun masculine singular absolute unspecified unspecified  	O	null
31 בין בין בין preposition unspecified unspecified unspecified unspecified unspecified  	O	null
32 ה ה האמת definiteArticle unspecified unspecified unspecified unspecified unspecified 0 
32 האמת אמת האמת noun feminine singular absolute unspecified unspecified  	O	null
33 ל ל לשקר preposition unspecified unspecified unspecified unspecified unspecified 0 
33 שקר שקר לשקר noun masculine singular absolute unspecified unspecified  	O	null
34 . . . punctuation unspecified unspecified unspecified unspecified unspecified  	O	null

0 גיבור גיבור גיבור noun masculine singular construct unspecified unspecified  	O	null
1 ה ה הסיפור definiteArticle unspecified unspecified unspecified unspecified unspecified 0 
1 הסיפור סיפור הסיפור noun masculine singular absolute unspecified unspecified  	O	null
2 למד למד למד verb masculine singular unspecified 3 past  	O	null
3 לשקר שיקר לשקר verb unspecified unspecified unspecified unspecified infinitive  	O	null
4 כבר כבר כבר adverb unspecified unspecified unspecified unspecified unspecified  	O	null
5 ב ב בילדותו preposition unspecified unspecified unspecified unspecified unspecified 0 
5 ילדות ילדות בילדותו noun feminine singular absolute unspecified unspecified  
5 ו ו בילדותו possessive masculine singular unspecified 3 unspecified 0 	O	null
6 כדי כדי כדי conjunction unspecified unspecified unspecified unspecified unspecified  	O	null
7 להימנע נמנע להימנע verb unspecified unspecified unspecified unspecified infinitive  	O	null
8 מ מ מעונשים preposition unspecified unspecified unspecified unspecified unspecified 0 
8 עונשים עונש מעונשים noun masculine plural absolute unspecified unspecified  	O	null
9 , , , punctuation unspecified unspecified unspecified unspecified unspecified  	O	null
10 אך אך אך conjunction unspecified unspecified unspecified unspecified unspecified  	O	null
11 עם עם עם preposition unspecified unspecified unspecified unspecified unspecified  	O	null
12 ה ה הזמן definiteArticle unspecified unspecified unspecified unspecified unspecified 0 
12 הזמן זמן הזמן noun masculine singular absolute unspecified unspecified  	O	null
13 נמחקים נמחק נמחקים verb masculine plural unspecified any beinoni  	O	null
14 ה ה הגבולות definiteArticle unspecified unspecified unspecified unspecified unspecified 0 
14 הגבולות גבול הגבולות noun masculine plural absolute unspecified unspecified  	O	null
15 בין בין בין preposition unspecified unspecified unspecified unspecified unspecified  	O	null
16 שקר שקר שקר noun masculine singular absolute unspecified unspecified  	O	null
17 ל ל לאמת preposition unspecified unspecified unspecified unspecified unspecified 0 
17 ה ה לאמת definiteArticle unspecified unspecified unspecified unspecified unspecified 0 
17 האמת אמת לאמת noun feminine singular absolute unspecified unspecified  	O	null
18 ו ו והוא conjunction unspecified unspecified unspecified unspecified unspecified 0 
18 הוא הוא והוא pronoun masculine singular unspecified 3 unspecified  	O	null
19 משקר שיקר משקר verb masculine singular unspecified any beinoni  	O	null
20 בלי בלי בלי preposition unspecified unspecified unspecified unspecified unspecified  	O	null
21 ה ה הרף definiteArticle unspecified unspecified unspecified unspecified unspecified 0 
21 הרף רף הרף noun masculine singular absolute unspecified unspecified  	O	null
22 . . . punctuation unspecified unspecified unspecified unspecified unspecified  	O	null

0 רוב רוב רוב noun masculine singular construct unspecified unspecified  	O	null
1 שקרי שקר שקריו noun masculine plural absolute unspecified unspecified  
1 ו ו שקריו possessive masculine singular unspecified 3 unspecified 0 	O	null
2 הם הוא הם pronoun masculine plural unspecified 3 unspecified  	O	null
3 " " " punctuation unspecified unspecified unspecified unspecified unspecified  	O	null
4 שקרים שקר שקרים noun masculine plural absolute unspecified unspecified  	O	null
5 לבנים לבן לבנים adjective masculine plural absolute unspecified unspecified  	O	null
6 " " " punctuation unspecified unspecified unspecified unspecified unspecified  	O	null
7 , , , punctuation unspecified unspecified unspecified unspecified unspecified  	O	null
8 עובדה עובדה עובדה noun feminine singular absolute unspecified unspecified  	O	null
9 ה ה המעמידה definiteArticle unspecified unspecified unspecified unspecified unspecified 0 
9 המעמידה העמיד המעמידה participle feminine singular absolute any unspecified  	O	null
10 ב ב בסימן preposition unspecified unspecified unspecified unspecified unspecified 0 
10 סימן סימן בסימן noun masculine singular construct unspecified unspecified  	O	null
11 שאלה שאלה שאלה noun feminine singular absolute unspecified unspecified  	O	null
12 את את את at-preposition unspecified unspecified unspecified unspecified unspecified  	O	null
13 חומרת חומרה חומרת noun feminine singular construct unspecified unspecified  	O	null
14 מעשה מעשה מעשה noun masculine singular construct unspecified unspecified  	O	null
15 ה ה השקר definiteArticle unspecified unspecified unspecified unspecified unspecified 0 
15 השקר שקר השקר noun masculine singular absolute unspecified unspecified  	O	null
16 . . . punctuation unspecified unspecified unspecified unspecified unspecified  	O	null

0 אולי אולי אולי adverb unspecified unspecified unspecified unspecified unspecified  	O	null
1 מ מ משום preposition unspecified unspecified unspecified unspecified unspecified 0 
1 שום שום משום quantifier unspecified unspecified construct unspecified unspecified  	O	null
2 כך כך כך pronoun unspecified unspecified unspecified unspecified unspecified  	O	null
3 מפתיע מפתיע מפתיע adjective masculine singular absolute unspecified unspecified  	O	null
4 ב ב באופן preposition unspecified unspecified unspecified unspecified unspecified 0 
4 אופן אופן באופן noun masculine singular absolute unspecified unspecified  	O	null
5 מיוחד מיוחד מיוחד adjective masculine singular absolute unspecified unspecified  	O	null
6 ה ה הסוף definiteArticle unspecified unspecified unspecified unspecified unspecified 0 
6 הסוף סוף הסוף noun masculine singular absolute unspecified unspecified  	O	null
7 ה ה הסוריאליסטי definiteArticle unspecified unspecified unspecified unspecified unspecified 0 
7 הסוריאליסטי הסוריאליסטי הסוריאליסטי adjective masculine singular absolute unspecified unspecified  	O	null
8 ו ו והגרוטסקי conjunction unspecified unspecified unspecified unspecified unspecified 0 
8 ה ה והגרוטסקי definiteArticle unspecified unspecified unspecified unspecified unspecified 0 
8 הגרוטסקי גרוטסקי והגרוטסקי adjective masculine singular absolute unspecified unspecified  	O	null
9 של של של shel-preposition unspecified unspecified unspecified unspecified unspecified  	O	null
10 ה ה הסיפור definiteArticle unspecified unspecified unspecified unspecified unspecified 0 
10 הסיפור סיפור הסיפור noun masculine singular absolute unspecified unspecified  	O	null
11 , , , punctuation unspecified unspecified unspecified unspecified unspecified  	O	null
12 כאשר כאשר כאשר conjunction unspecified unspecified unspecified unspecified unspecified  	O	null
13 אחד איחד אחד verb masculine singular unspecified 3 past  	O	null
14 מ מ מ preposition unspecified unspecified unspecified unspecified unspecified 0 	O	null
15 " " " punctuation unspecified unspecified unspecified unspecified unspecified  	O	null
16 ה ה השקרים definiteArticle unspecified unspecified unspecified unspecified unspecified 0 
16 השקרים שקר השקרים noun masculine plural absolute unspecified unspecified  	O	null
17 ה ה הלבנים definiteArticle unspecified unspecified unspecified unspecified unspecified 0 
17 הלבנים לבן הלבנים adjective masculine plural absolute unspecified unspecified  	O	null
18 " " " punctuation unspecified unspecified unspecified unspecified unspecified  	O	null
19 הללו הללו הללו pronoun masculine plural unspecified 3 unspecified  	O	null
20 הופך הפך הופך verb masculine singular unspecified any beinoni  	O	null
21 ל ל למציאות preposition unspecified unspecified unspecified unspecified unspecified 0 
21 מציאות מציאות למציאות noun feminine singular absolute unspecified unspecified  	O	null
22 אכזרית אכזר אכזרית adjective feminine singular absolute unspecified unspecified  	O	null
23 . . . punctuation unspecified unspecified unspecified unspecified unspecified  	O	null

0 ב ב בסיפוריו preposition unspecified unspecified unspecified unspecified unspecified 0 
0 סיפורי סיפור בסיפוריו noun masculine plural absolute unspecified unspecified  
0 ו ו בסיפוריו possessive masculine singular unspecified 3 unspecified 0 	O	null
1 קיים קיים קיים verb masculine singular unspecified 3 past  	O	null
2 מנעד מנעד מנעד noun masculine singular construct unspecified unspecified  	O	null
3 סגנוני סגנון סגנוני noun masculine plural construct unspecified unspecified  	O	null
4 רחב רחב רחב adjective masculine singular absolute unspecified unspecified  	O	null
5 , , , punctuation unspecified unspecified unspecified unspecified unspecified  	O	null
6 ה ה המתבטא definiteArticle unspecified unspecified unspecified unspecified unspecified 0 
6 המתבטא התבטא המתבטא participle masculine singular absolute any unspecified  	O	null
7 גם גם גם conjunction unspecified unspecified unspecified unspecified unspecified  	O	null
8 ב ב בשימוש preposition unspecified unspecified unspecified unspecified unspecified 0 
8 שימוש שימוש בשימוש noun masculine singular absolute unspecified unspecified  	O	null
9 ב ב בזרם preposition unspecified unspecified unspecified unspecified unspecified 0 
9 זרם זרם בזרם noun masculine singular construct unspecified unspecified  	O	null
10 ה ה התודעה definiteArticle unspecified unspecified unspecified unspecified unspecified 0 
10 התודעה תודעה התודעה noun feminine singular absolute unspecified unspecified  	O	null
11 ה ה המשולב definiteArticle unspecified unspecified unspecified unspecified unspecified 0 
11 המשולב משולב המשולב adjective masculine singular absolute unspecified unspecified  	O	null
12 ב ב ברכיבים preposition unspecified unspecified unspecified unspecified unspecified 0 
12 רכיבים רכיב ברכיבים noun masculine plural absolute unspecified unspecified  	O	null
13 פנטסטיים פנטסטיים פנטסטיים adjective masculine plural absolute unspecified unspecified  	O	null
14 . . . punctuation unspecified unspecified unspecified unspecified unspecified  	O	null

0 References References References foreign unspecified unspecified unspecified unspecified unspecified  	O	null
1 : : : punctuation unspecified unspecified unspecified unspecified unspecified  	O	null
2 غنايم غنايم غنايم properName unspecified unspecified unspecified unspecified unspecified  	I_ORG	null
3 , , , punctuation unspecified unspecified unspecified unspecified unspecified  	O	null
4 محمود محمود محمود properName unspecified unspecified unspecified unspecified unspecified  	I_PERS	null
5 . . . punctuation unspecified unspecified unspecified unspecified unspecified  	O	null

0 المدار المدار المدار adjective masculine singular construct unspecified unspecified  	O	null
1 الصعب الصعب الصعب adjective masculine singular construct unspecified unspecified  	O	null
2 : : : punctuation unspecified unspecified unspecified unspecified unspecified  	O	null
3 رحلة رحلة رحلة adjective masculine singular construct unspecified unspecified  	O	null
4 القصة القصة القصة adjective masculine singular construct unspecified unspecified  	O	null
5 الفلسطينية الفلسطينية الفلسطينية adjective masculine singular construct unspecified unspecified  	O	null
6 في في في adjective masculine singular construct unspecified unspecified  	O	null
7 إسرائيل إسرائيل إسرائيل properName unspecified unspecified unspecified unspecified unspecified  	I_LOC	null
8 . . . punctuation unspecified unspecified unspecified unspecified unspecified  	O	null

0 كفر كفر كفر adjective masculine singular construct unspecified unspecified  	O	null
1 قرع قرع قرع adjective masculine singular construct unspecified unspecified  	O	null
2 : : : punctuation unspecified unspecified unspecified unspecified unspecified  	O	null
3 دار دار دار adjective masculine singular construct unspecified unspecified  	O	null
4 الهدى الهدى الهدى properName unspecified unspecified unspecified unspecified unspecified  	I_LOC	null
5 . . . punctuation unspecified unspecified unspecified unspecified unspecified  	O	null

0 ###NUMBER### ###NUMBER### ###NUMBER### numeral unspecified unspecified unspecified unspecified unspecified  	I_DATE	null
1 . . . punctuation unspecified unspecified unspecified unspecified unspecified  	O	null

0 - - - punctuation unspecified unspecified unspecified unspecified unspecified  	O	null
1 ###NUMBER### ###NUMBER### ###NUMBER### numeral unspecified unspecified unspecified unspecified unspecified  	O	null
2 ; ; ; punctuation unspecified unspecified unspecified unspecified unspecified  	O	null
3 ###NUMBER### ###NUMBER### ###NUMBER### numeral unspecified unspecified unspecified unspecified unspecified  	O	null
4 القاسم القاسم القاسم properName unspecified unspecified unspecified unspecified unspecified  	I_PERS	null
5 , , , punctuation unspecified unspecified unspecified unspecified unspecified  	O	null
6 نبيه نبيه نبيه properName unspecified unspecified unspecified unspecified unspecified  	I_PERS	null
7 . . . punctuation unspecified unspecified unspecified unspecified unspecified  	O	null

0 " " " punctuation unspecified unspecified unspecified unspecified unspecified  	I_LOC	null
1 قصص قصص قصص properName unspecified unspecified unspecified unspecified unspecified  	I_ORG	null
2 الجياد الجياد الجياد adjective masculine singular construct unspecified unspecified  	O	null
3 والجديد والجديد والجديد adjective masculine singular construct unspecified unspecified  	O	null
4 في في في adjective masculine singular construct unspecified unspecified  	O	null
5 إبداع إبداع إبداع adjective masculine singular construct unspecified unspecified  	O	null
6 زكي زكي زكي adjective masculine singular construct unspecified unspecified  	O	null
7 درويش درويش درويش adjective masculine singular construct unspecified unspecified  	O	null
8 " " " punctuation unspecified unspecified unspecified unspecified unspecified  	O	null
9 . . . punctuation unspecified unspecified unspecified unspecified unspecified  	O	null

0 القصة القصة القصة adjective masculine singular construct unspecified unspecified  	O	null
1 الفلسطينية الفلسطينية الفلسطينية adjective masculine singular construct unspecified unspecified  	O	null
2 في في في adjective masculine singular construct unspecified unspecified  	O	null
3 مواجهة مواجهة مواجهة adjective masculine singular construct unspecified unspecified  	O	null
4 حزيران حزيران حزيران adjective masculine singular construct unspecified unspecified  	O	null
5 : : : punctuation unspecified unspecified unspecified unspecified unspecified  	O	null
6 دراسات دراسات دراسات adjective masculine singular construct unspecified unspecified  	O	null
7 نقدية نقدية نقدية properName unspecified unspecified unspecified unspecified unspecified  	I_LOC	null
8 . . . punctuation unspecified unspecified unspecified unspecified unspecified  	O	null

0 كفر كفر كفر adjective masculine singular construct unspecified unspecified  	O	null
1 قرع قرع قرع adjective masculine singular construct unspecified unspecified  	O	null
2 : : : punctuation unspecified unspecified unspecified unspecified unspecified  	O	null
3 دار دار دار adjective masculine singular construct unspecified unspecified  	O	null
4 الهدى الهدى الهدى properName unspecified unspecified unspecified unspecified unspecified  	I_LOC	null
5 . . . punctuation unspecified unspecified unspecified unspecified unspecified  	O	null

0 ###NUMBER### ###NUMBER### ###NUMBER### numeral unspecified unspecified unspecified unspecified unspecified  	I_DATE	null
1 . . . punctuation unspecified unspecified unspecified unspecified unspecified  	O	null

0 - - - punctuation unspecified unspecified unspecified unspecified unspecified  	O	null
1 ###NUMBER### ###NUMBER### ###NUMBER### numeral unspecified unspecified unspecified unspecified unspecified  	O	null
2 ; ; ; punctuation unspecified unspecified unspecified unspecified unspecified  	O	null
3 ###NUMBER### ###NUMBER### ###NUMBER### numeral unspecified unspecified unspecified unspecified unspecified  	O	null
4 Elad Elad Elad foreign unspecified unspecified unspecified unspecified unspecified  	O	null
5 - - - punctuation unspecified unspecified unspecified unspecified unspecified  	O	null
6 Bouskila Bouskila Bouskila foreign unspecified unspecified unspecified unspecified unspecified  	O	null
7 , , , punctuation unspecified unspecified unspecified unspecified unspecified  	O	null
8 Ami Ami Ami foreign unspecified unspecified unspecified unspecified unspecified  	O	null
9 . . . punctuation unspecified unspecified unspecified unspecified unspecified  	O	null

0 Modern Modern Modern foreign unspecified unspecified unspecified unspecified unspecified  	I_ORG	null
1 Palestinian Palestinian Palestinian foreign unspecified unspecified unspecified unspecified unspecified  	I_ORG	null
2 Literature Literature Literature foreign unspecified unspecified unspecified unspecified unspecified  	I_ORG	null
3 and and and foreign unspecified unspecified unspecified unspecified unspecified  	I_ORG	null
4 Culture Culture Culture foreign unspecified unspecified unspecified unspecified unspecified  	I_ORG	null
5 . . . punctuation unspecified unspecified unspecified unspecified unspecified  	O	null

0 London London London foreign unspecified unspecified unspecified unspecified unspecified  	O	null
1 : : : punctuation unspecified unspecified unspecified unspecified unspecified  	O	null
2 Frank Frank Frank foreign unspecified unspecified unspecified unspecified unspecified  	O	null
3 Cass Cass Cass foreign unspecified unspecified unspecified unspecified unspecified  	O	null
4 ###NUMBER### ###NUMBER### ###NUMBER### numeral unspecified unspecified unspecified unspecified unspecified  	I_DATE	null
5 . . . punctuation unspecified unspecified unspecified unspecified unspecified  	O	null

0 - - - punctuation unspecified unspecified unspecified unspecified unspecified  	O	null
1 ###NUMBER### ###NUMBER### ###NUMBER### numeral unspecified unspecified unspecified unspecified unspecified  	O	null
2 ; ; ; punctuation unspecified unspecified unspecified unspecified unspecified  	O	null
3 ###NUMBER### ###NUMBER### ###NUMBER### numeral unspecified unspecified unspecified unspecified unspecified  	O	null
4 Ghanayim Ghanayim Ghanayim foreign unspecified unspecified unspecified unspecified unspecified  	O	null
5 , , , punctuation unspecified unspecified unspecified unspecified unspecified  	O	null
6 Mahmud Mahmud Mahmud foreign unspecified unspecified unspecified unspecified unspecified  	O	null
7 . . . punctuation unspecified unspecified unspecified unspecified unspecified  	O	null

0 The The The foreign unspecified unspecified unspecified unspecified unspecified  	I_ORG	null
1 Quest Quest Quest foreign unspecified unspecified unspecified unspecified unspecified  	I_ORG	null
2 for for for foreign unspecified unspecified unspecified unspecified unspecified  	I_ORG	null
3 a a a foreign unspecified unspecified unspecified unspecified unspecified  	I_ORG	null
4 Lost Lost Lost foreign unspecified unspecified unspecified unspecified unspecified  	I_ORG	null
5 Identity Identity Identity foreign unspecified unspecified unspecified unspecified unspecified  	I_ORG	null
6 : : : punctuation unspecified unspecified unspecified unspecified unspecified  	O	null
7 Palestinian Palestinian Palestinian foreign unspecified unspecified unspecified unspecified unspecified  	O	null
8 Fiction Fiction Fiction foreign unspecified unspecified unspecified unspecified unspecified  	O	null
9 in in in foreign unspecified unspecified unspecified unspecified unspecified  	O	null
10 Israel Israel Israel foreign unspecified unspecified unspecified unspecified unspecified  	O	null
11 . . . punctuation unspecified unspecified unspecified unspecified unspecified  	O	null

0 Wiesbaden Wiesbaden Wiesbaden foreign unspecified unspecified unspecified unspecified unspecified  	O	null
1 : : : punctuation unspecified unspecified unspecified unspecified unspecified  	O	null
2 Harrassowitz Harrassowitz Harrassowitz foreign unspecified unspecified unspecified unspecified unspecified  	O	null
3 . . . punctuation unspecified unspecified unspecified unspecified unspecified  	O	null

0 ###NUMBER### ###NUMBER### ###NUMBER### numeral unspecified unspecified unspecified unspecified unspecified  	I_DATE	null
1 . . . punctuation unspecified unspecified unspecified unspecified unspecified  	O	null

0 - - - punctuation unspecified unspecified unspecified unspecified unspecified  	O	null
1 ###NUMBER### ###NUMBER### ###NUMBER### numeral unspecified unspecified unspecified unspecified unspecified  	O	null
2 , , , punctuation unspecified unspecified unspecified unspecified unspecified  	O	null
3 ###NUMBER### ###NUMBER### ###NUMBER### numeral unspecified unspecified unspecified unspecified unspecified  	O	null
4 ###NUMBER### ###NUMBER### ###NUMBER### numeral unspecified unspecified unspecified unspecified unspecified  	O	null
5 - - - punctuation unspecified unspecified unspecified unspecified unspecified  	O	null
6 ###NUMBER### ###NUMBER### ###NUMBER### numeral unspecified unspecified unspecified unspecified unspecified  	O	null
7 . . . punctuation unspecified unspecified unspecified unspecified unspecified  	O	null

