0 Name Name Name foreign unspecified unspecified unspecified unspecified unspecified  	O	null
1 : : : punctuation unspecified unspecified unspecified unspecified unspecified  	O	null
2 הופרט הופרט הופרט verb masculine singular unspecified 3 past  	O	null
3 ( ( ( punctuation unspecified unspecified unspecified unspecified unspecified  	O	null
4 ביגלאייזן ביגלאייזן ביגלאייזן properName unspecified unspecified unspecified unspecified unspecified  	I_ORG	null
5 ) ) ) punctuation unspecified unspecified unspecified unspecified unspecified  	O	null
6 , , , punctuation unspecified unspecified unspecified unspecified unspecified  	O	null
7 ה ה הילדֶה definiteArticle unspecified unspecified unspecified unspecified unspecified 0 
7 הילדֶה הילדֶה הילדֶה participle feminine singular absolute any unspecified  	O	null
8 Birth Birth Birth foreign unspecified unspecified unspecified unspecified unspecified  	O	null
9 Year Year Year foreign unspecified unspecified unspecified unspecified unspecified  	O	null
10 : : : punctuation unspecified unspecified unspecified unspecified unspecified  	O	null
11 ###NUMBER### ###NUMBER### ###NUMBER### numeral unspecified unspecified unspecified unspecified unspecified  	I_DATE	null
12 Death Death Death foreign unspecified unspecified unspecified unspecified unspecified  	O	null
13 Year Year Year foreign unspecified unspecified unspecified unspecified unspecified  	O	null
14 : : : punctuation unspecified unspecified unspecified unspecified unspecified  	O	null
15 ###NUMBER### ###NUMBER### ###NUMBER### numeral unspecified unspecified unspecified unspecified unspecified  	I_DATE	null
16 Birth Birth Birth foreign unspecified unspecified unspecified unspecified unspecified  	O	null
17 Place Place Place foreign unspecified unspecified unspecified unspecified unspecified  	O	null
18 : : : punctuation unspecified unspecified unspecified unspecified unspecified  	O	null
19 עיר עיר עיר noun feminine singular construct unspecified unspecified  	O	null
20 בילסקו בילסקו בילסקו properName unspecified unspecified unspecified unspecified unspecified  	I_LOC	null
21 - - - punctuation unspecified unspecified unspecified unspecified unspecified  	O	null
22 ביאלה ביאלה ביאלה noun masculine singular absolute unspecified unspecified  	O	null
23 , , , punctuation unspecified unspecified unspecified unspecified unspecified  	O	null
24 דרום דרום דרום noun masculine singular absolute unspecified unspecified  	O	null
25 Occupation Occupation Occupation foreign unspecified unspecified unspecified unspecified unspecified  	O	null
26 : : : punctuation unspecified unspecified unspecified unspecified unspecified  	O	null
27 סופרת סופר סופרת noun feminine singular absolute unspecified unspecified  	O	null
28 ב ב בשפה preposition unspecified unspecified unspecified unspecified unspecified 0 
28 ה ה בשפה definiteArticle unspecified unspecified unspecified unspecified unspecified 0 
28 השפה שפה בשפה noun feminine singular absolute unspecified unspecified  	O	null
29 ה ה הגרמנית definiteArticle unspecified unspecified unspecified unspecified unspecified 0 
29 הגרמנית גרמני הגרמנית adjective feminine singular absolute unspecified unspecified  	O	null
30 Entry Entry Entry foreign unspecified unspecified unspecified unspecified unspecified  	O	null
31 writer writer writer foreign unspecified unspecified unspecified unspecified unspecified  	O	null
32 : : : punctuation unspecified unspecified unspecified unspecified unspecified  	O	null
33 אלישע אלישע אלישע properName unspecified unspecified unspecified unspecified unspecified  	I_PERS	null
34 פורת פורת פורת properName unspecified unspecified unspecified unspecified unspecified  	I_PERS	null
35 ו ו ודקל conjunction unspecified unspecified unspecified unspecified unspecified 0 
35 דקל דקל ודקל properName unspecified unspecified unspecified unspecified unspecified  	I_PERS	null
36 שי שי שי properName unspecified unspecified unspecified unspecified unspecified  	I_PERS	null
37 ש ש שחורי relativizer/subordinatingConjunction unspecified unspecified unspecified unspecified unspecified 0 
37 חורי חור שחורי noun masculine plural construct unspecified unspecified  	O	null
38 Entry Entry Entry foreign unspecified unspecified unspecified unspecified unspecified  	O	null
39 Value Value Value foreign unspecified unspecified unspecified unspecified unspecified  	O	null
40 : : : punctuation unspecified unspecified unspecified unspecified unspecified  	O	null
41 נולדה נולד נולדה verb feminine singular unspecified 3 past  	O	null
42 ב ב בעיר preposition unspecified unspecified unspecified unspecified unspecified 0 
42 ה ה בעיר definiteArticle unspecified unspecified unspecified unspecified unspecified 0 
42 העיר עיר בעיר noun feminine singular absolute unspecified unspecified  	O	null
43 בילסקו בילסקו בילסקו properName unspecified unspecified unspecified unspecified unspecified  	I_LOC	null
44 - - - punctuation unspecified unspecified unspecified unspecified unspecified  	O	null
45 ביאלה ביאלה ביאלה noun masculine singular absolute unspecified unspecified  	O	null
46 , , , punctuation unspecified unspecified unspecified unspecified unspecified  	O	null
47 דרום דרום דרום noun masculine singular construct unspecified unspecified  	O	null
48 פולין פולין פולין properName unspecified unspecified unspecified unspecified unspecified  	I_LOC	null
49 , , , punctuation unspecified unspecified unspecified unspecified unspecified  	O	null
50 ל ל למשפחת preposition unspecified unspecified unspecified unspecified unspecified 0 
50 משפחת משפחה למשפחת noun feminine singular construct unspecified unspecified  	O	null
51 סוחרים סוחר סוחרים noun masculine plural absolute unspecified unspecified  	O	null
52 אדוקים אדוק אדוקים adjective masculine plural absolute unspecified unspecified  	O	null
53 ש ש שעסקו relativizer/subordinatingConjunction unspecified unspecified unspecified unspecified unspecified 0 
53 עסקו עסק שעסקו verb masculine-and-feminine plural unspecified 3 past  	O	null
54 ב ב במסחר preposition unspecified unspecified unspecified unspecified unspecified 0 
54 ה ה במסחר definiteArticle unspecified unspecified unspecified unspecified unspecified 0 
54 המסחר מסחר במסחר noun masculine singular absolute unspecified unspecified  	O	null
55 פירות פרי פירות noun masculine plural absolute unspecified unspecified  	O	null
56 ו ו וירקות conjunction unspecified unspecified unspecified unspecified unspecified 0 
56 ירקות ירק וירקות noun masculine plural absolute unspecified unspecified  	O	null
57 . . . punctuation unspecified unspecified unspecified unspecified unspecified  	O	null

0 ה ה העיר definiteArticle unspecified unspecified unspecified unspecified unspecified 0 
0 העיר עיר העיר noun feminine singular absolute unspecified unspecified  	O	null
1 היתה הוא היתה copula feminine singular unspecified 3 past  	O	null
2 ב ב באזור preposition unspecified unspecified unspecified unspecified unspecified 0 
2 אזור אזור באזור noun masculine singular construct unspecified unspecified  	O	null
3 ה ה ההשפעה definiteArticle unspecified unspecified unspecified unspecified unspecified 0 
3 ההשפעה השפעה ההשפעה noun feminine singular absolute unspecified unspecified  	O	null
4 ה ה הגרמנית definiteArticle unspecified unspecified unspecified unspecified unspecified 0 
4 הגרמנית גרמני הגרמנית adjective feminine singular absolute unspecified unspecified  	O	null
5 ו ו ובבית conjunction unspecified unspecified unspecified unspecified unspecified 0 
5 ב ב ובבית preposition unspecified unspecified unspecified unspecified unspecified 0 
5 בית בית ובבית noun masculine singular construct unspecified unspecified  	O	null
6 ה ה הספר definiteArticle unspecified unspecified unspecified unspecified unspecified 0 
6 הספר ספר הספר noun masculine singular absolute unspecified unspecified  	O	null
7 למדו למד למדו verb masculine-and-feminine plural unspecified 3 past  	O	null
8 ב ב בגרמנית preposition unspecified unspecified unspecified unspecified unspecified 0 
8 גרמנית גרמנית בגרמנית properName feminine singular unspecified unspecified unspecified  	I_LOC	null
9 , , , punctuation unspecified unspecified unspecified unspecified unspecified  	O	null
10 אך אך אך conjunction unspecified unspecified unspecified unspecified unspecified  	O	null
11 ב ב בבית preposition unspecified unspecified unspecified unspecified unspecified 0 
11 בית בית בבית noun masculine singular construct unspecified unspecified  	O	null
12 הוריה הוריה הוריה noun feminine singular absolute unspecified unspecified  	O	null
13 התנהלו התנהל התנהלו verb masculine-and-feminine plural unspecified 3 past  	O	null
14 ה ה החיים definiteArticle unspecified unspecified unspecified unspecified unspecified 0 
14 החיים חיים החיים noun masculine plural absolute unspecified unspecified  	O	null
15 ב ב ביידיש preposition unspecified unspecified unspecified unspecified unspecified 0 
15 יידיש יידיש ביידיש properName feminine singular unspecified unspecified unspecified  	I_PERS	null
16 ו ו ובפולנית conjunction unspecified unspecified unspecified unspecified unspecified 0 
16 ב ב ובפולנית preposition unspecified unspecified unspecified unspecified unspecified 0 
16 ה ה ובפולנית definiteArticle unspecified unspecified unspecified unspecified unspecified 0 
16 הפולנית פולנית ובפולנית properName feminine singular unspecified unspecified unspecified  	I_PERS	null
17 . . . punctuation unspecified unspecified unspecified unspecified unspecified  	O	null

0 ה ה המשפחה definiteArticle unspecified unspecified unspecified unspecified unspecified 0 
0 המשפחה משפחה המשפחה noun feminine singular absolute unspecified unspecified  	O	null
1 קיימה קיים קיימה verb feminine singular unspecified 3 past  	O	null
2 זיקה זיקה זיקה noun feminine singular absolute unspecified unspecified  	O	null
3 ל ל לארץ preposition unspecified unspecified unspecified unspecified unspecified 0 
3 ארץ ארץ לארץ noun feminine singular construct unspecified unspecified  	I_LOC	null
4 ישראל ישראל ישראל properName unspecified unspecified unspecified unspecified unspecified  	I_LOC	null
5 , , , punctuation unspecified unspecified unspecified unspecified unspecified  	O	null
6 אביה אביה אביה properName unspecified unspecified unspecified unspecified unspecified  	I_PERS	null
7 ביקר ביקר ביקר verb masculine singular unspecified 3 past  	O	null
8 ב ב בארץ preposition unspecified unspecified unspecified unspecified unspecified 0 
8 ה ה בארץ definiteArticle unspecified unspecified unspecified unspecified unspecified 0 
8 הארץ ארץ בארץ noun feminine singular absolute unspecified unspecified  	O	null
9 ו ו ואף conjunction unspecified unspecified unspecified unspecified unspecified 0 
9 אף אף ואף conjunction unspecified unspecified unspecified unspecified unspecified  	O	null
10 רכש רכש רכש verb masculine singular unspecified 3 past  	O	null
11 אדמות אדמה אדמות noun feminine plural absolute unspecified unspecified  	O	null
12 ב ב באזור preposition unspecified unspecified unspecified unspecified unspecified 0 
12 ה ה באזור definiteArticle unspecified unspecified unspecified unspecified unspecified 0 
12 האזור אזור באזור noun masculine singular absolute unspecified unspecified  	O	null
13 ברֵכות ברֵכות ברֵכות adjective feminine plural construct unspecified unspecified  	O	null
14 שלם שלם שלמה noun masculine singular absolute unspecified unspecified  
14 ה ה שלמה possessive feminine singular unspecified 3 unspecified 0 	O	null
15 ל ל ליד preposition unspecified unspecified unspecified unspecified unspecified 0 
15 יד יד ליד noun feminine singular construct unspecified unspecified  	O	null
16 בית בית בית properName feminine singular unspecified unspecified unspecified  	I_ORG	null
17 לחם.ב לחם.ב לחם.ב properName unspecified unspecified unspecified unspecified unspecified  	I_ORG	null
18 - - - punctuation unspecified unspecified unspecified unspecified unspecified  	O	null
19 נישאה נישא נישאה verb feminine singular unspecified 3 past  	O	null
20 לוולטר לוולטר לוולטר properName unspecified unspecified unspecified unspecified unspecified  	I_PERS	null
21 הופרט הופרט הופרט verb masculine singular unspecified 3 past  	O	null
22 מ מ מהעיר preposition unspecified unspecified unspecified unspecified unspecified 0 
22 ה ה מהעיר definiteArticle unspecified unspecified unspecified unspecified unspecified 0 
22 העיר עיר מהעיר noun feminine singular absolute unspecified unspecified  	O	null
23 טשין טשין טשין properName unspecified unspecified unspecified unspecified unspecified  	I_LOC	null
24 , , , punctuation unspecified unspecified unspecified unspecified unspecified  	O	null
25 צ'כיה צ'כיה צ'כיה properName unspecified unspecified unspecified unspecified unspecified  	I_PERS	null
26 , , , punctuation unspecified unspecified unspecified unspecified unspecified  	O	null
27 ש ש שבא relativizer/subordinatingConjunction unspecified unspecified unspecified unspecified unspecified 0 
27 בא בא שבא verb masculine singular unspecified 3 past  	O	null
28 מ מ מבית preposition unspecified unspecified unspecified unspecified unspecified 0 
28 בית בית מבית noun masculine singular construct unspecified unspecified  	O	null
29 מתבולל התבולל מתבולל verb masculine singular unspecified any beinoni  	O	null
30 אמיד אמיד אמיד adjective masculine singular absolute unspecified unspecified  	O	null
31 . . . punctuation unspecified unspecified unspecified unspecified unspecified  	O	null

0 ב ב ב preposition unspecified unspecified unspecified unspecified unspecified 0 	I_ORG	null
1 - - - punctuation unspecified unspecified unspecified unspecified unspecified  	I_ORG	null
2 ###NUMBER### ###NUMBER### ###NUMBER### numeral unspecified unspecified unspecified unspecified unspecified  	I_DATE	null
3 נולד נולד נולד verb masculine singular unspecified 3 past  	O	null
4 בן בן בנם noun masculine singular absolute unspecified unspecified  
4 ם ם בנם possessive masculine plural unspecified 3 unspecified 0 	O	null
5 , , , punctuation unspecified unspecified unspecified unspecified unspecified  	O	null
6 שמואל שמואל שמואל properName unspecified unspecified unspecified unspecified unspecified  	I_PERS	null
7 תומס תומס תומס properName unspecified unspecified unspecified unspecified unspecified  	I_PERS	null
8 הופרט הופרט הופרט verb masculine singular unspecified 3 past  	O	null
9 , , , punctuation unspecified unspecified unspecified unspecified unspecified  	O	null
10 ש ש שנקרא relativizer/subordinatingConjunction unspecified unspecified unspecified unspecified unspecified 0 
10 נקרא נקרא שנקרא verb masculine singular unspecified 3 past  	O	null
11 על על על preposition unspecified unspecified unspecified unspecified unspecified  	O	null
12 שם שם שמו noun masculine singular absolute unspecified unspecified  
12 ו ו שמו possessive masculine singular unspecified 3 unspecified 0 	O	null
13 של של של shel-preposition unspecified unspecified unspecified unspecified unspecified  	O	null
14 תומס תומס תומס properName unspecified unspecified unspecified unspecified unspecified  	I_PERS	null
15 מסריק מסריק מסריק properName unspecified unspecified unspecified unspecified unspecified  	I_PERS	null
16 . . . punctuation unspecified unspecified unspecified unspecified unspecified  	O	null

0 ערב ערב ערב noun masculine singular construct unspecified unspecified  	O	null
1 מלחמת מלחמה מלחמת noun feminine singular construct unspecified unspecified  	O	null
2 ה ה העולם definiteArticle unspecified unspecified unspecified unspecified unspecified 0 
2 העולם עולם העולם noun masculine singular absolute unspecified unspecified  	O	null
3 ה ה השנייה definiteArticle unspecified unspecified unspecified unspecified unspecified 0 
3 השנייה ORD2 השנייה numeral feminine singular absolute unspecified unspecified  	O	null
4 הגיע הגיע הגיע verb masculine singular unspecified 3 past  	O	null
5 ולטר ולטר ולטר properName unspecified unspecified unspecified unspecified unspecified  	O	null
6 ארצה ארצה ארצה adverb unspecified unspecified unspecified unspecified unspecified  	O	null
7 להכין הכין להכין verb unspecified unspecified unspecified unspecified infinitive  	O	null
8 את את את at-preposition unspecified unspecified unspecified unspecified unspecified  	O	null
9 עליית עלייה עליית noun feminine singular construct unspecified unspecified  	O	null
10 ה ה המשפחה definiteArticle unspecified unspecified unspecified unspecified unspecified 0 
10 המשפחה משפחה המשפחה noun feminine singular absolute unspecified unspecified  	O	null
11 ו ו והשתקע conjunction unspecified unspecified unspecified unspecified unspecified 0 
11 השתקע השתקע והשתקע verb masculine singular unspecified 3 past  	O	null
12 ב ב בחיפה preposition unspecified unspecified unspecified unspecified unspecified 0 
12 חיפה חיפה בחיפה properName unspecified unspecified unspecified unspecified unspecified  	I_LOC	null
13 . . . punctuation unspecified unspecified unspecified unspecified unspecified  	O	null

0 עם עם עם preposition unspecified unspecified unspecified unspecified unspecified  	O	null
1 ה ה הפלישה definiteArticle unspecified unspecified unspecified unspecified unspecified 0 
1 הפלישה פלישה הפלישה noun feminine singular absolute unspecified unspecified  	O	null
2 ה ה הנאצית definiteArticle unspecified unspecified unspecified unspecified unspecified 0 
2 הנאצית נאצי הנאצית adjective feminine singular absolute unspecified unspecified  	O	null
3 ל ל לצ'כוסלובקיה preposition unspecified unspecified unspecified unspecified unspecified 0 
3 צ'כוסלובקיה צ'כוסלובקיה לצ'כוסלובקיה properName unspecified unspecified unspecified unspecified unspecified  	I_LOC	null
4 נותק נותק נותק verb masculine singular unspecified 3 past  	O	null
5 ה ה הקשר definiteArticle unspecified unspecified unspecified unspecified unspecified 0 
5 הקשר קשר הקשר noun masculine singular absolute unspecified unspecified  	O	null
6 בין בין בין preposition unspecified unspecified unspecified unspecified unspecified  	O	null
7 ה ה האב definiteArticle unspecified unspecified unspecified unspecified unspecified 0 
7 האב אב האב noun masculine singular absolute unspecified unspecified  	O	null
8 לבין לבין לבין preposition unspecified unspecified unspecified unspecified unspecified  	O	null
9 ה ה האם definiteArticle unspecified unspecified unspecified unspecified unspecified 0 
9 האם אם האם noun feminine singular absolute unspecified unspecified  	O	null
10 ו ו והבן conjunction unspecified unspecified unspecified unspecified unspecified 0 
10 ה ה והבן definiteArticle unspecified unspecified unspecified unspecified unspecified 0 
10 הבן בן והבן noun masculine singular absolute unspecified unspecified  	O	null
11 . . . punctuation unspecified unspecified unspecified unspecified unspecified  	O	null

0 ה ה הילדה definiteArticle unspecified unspecified unspecified unspecified unspecified 0 
0 הילדה ילד הילדה noun feminine singular absolute unspecified unspecified  	O	null
1 נדדה נדד נדדה verb feminine singular unspecified 3 past  	O	null
2 , , , punctuation unspecified unspecified unspecified unspecified unspecified  	O	null
3 יד יד יד noun feminine singular absolute unspecified unspecified  	O	null
4 ב ב ביד preposition unspecified unspecified unspecified unspecified unspecified 0 
4 יד יד ביד noun feminine singular absolute unspecified unspecified  	O	null
5 עם עם עם preposition unspecified unspecified unspecified unspecified unspecified  	O	null
6 תומס תומס תומס properName unspecified unspecified unspecified unspecified unspecified  	I_PERS	null
7 , , , punctuation unspecified unspecified unspecified unspecified unspecified  	O	null
8 ב ב במסע preposition unspecified unspecified unspecified unspecified unspecified 0 
8 מסע מסע במסע noun masculine singular absolute unspecified unspecified  	O	null
9 נורא נורא נורא adjective masculine singular absolute unspecified unspecified  	O	null
10 , , , punctuation unspecified unspecified unspecified unspecified unspecified  	O	null
11 ש ש שבמהלכו relativizer/subordinatingConjunction unspecified unspecified unspecified unspecified unspecified 0 
11 ב ב שבמהלכו preposition unspecified unspecified unspecified unspecified unspecified 0 
11 מהלך מהלך שבמהלכו noun masculine singular absolute unspecified unspecified  
11 ו ו שבמהלכו possessive masculine singular unspecified 3 unspecified 0 	O	null
12 איבדה איבד איבדה verb feminine singular unspecified 3 past  	O	null
13 את את את at-preposition unspecified unspecified unspecified unspecified unspecified  	O	null
14 רוב רוב רוב noun masculine singular construct unspecified unspecified  	O	null
15 משפחת משפחה משפחתה noun feminine singular absolute unspecified unspecified  
15 ה ה משפחתה possessive feminine singular unspecified 3 unspecified 0 	O	null
16 . . . punctuation unspecified unspecified unspecified unspecified unspecified  	O	null

0 ה ה המסע definiteArticle unspecified unspecified unspecified unspecified unspecified 0 
0 המסע מסע המסע noun masculine singular absolute unspecified unspecified  	O	null
1 החל החל החל verb masculine singular unspecified 3 past  	O	null
2 ב ב בכפר preposition unspecified unspecified unspecified unspecified unspecified 0 
2 כפר כפר בכפר noun masculine singular absolute unspecified unspecified  	O	null
3 פולני פולני פולני adjective masculine singular absolute unspecified unspecified  	O	null
4 ו ו ומשם conjunction unspecified unspecified unspecified unspecified unspecified 0 
4 משם משם ומשם adverb unspecified unspecified unspecified unspecified unspecified  	O	null
5 ל ל לגטו preposition unspecified unspecified unspecified unspecified unspecified 0 
5 גטו גטו לגטו noun masculine singular construct unspecified unspecified  	O	null
6 ז'שוב ז'שוב ז'שוב properName unspecified unspecified unspecified unspecified unspecified  	I_LOC	null
7 , , , punctuation unspecified unspecified unspecified unspecified unspecified  	O	null
8 ל ל למחנה preposition unspecified unspecified unspecified unspecified unspecified 0 
8 מחנה מחנה למחנה noun masculine singular construct unspecified unspecified  	O	null
9 מעצר מעצר מעצר noun masculine singular absolute unspecified unspecified  	O	null
10 ו ו ולבסוף conjunction unspecified unspecified unspecified unspecified unspecified 0 
10 לבסוף לבסוף ולבסוף adverb unspecified unspecified unspecified unspecified unspecified  	O	null
11 ל ל לעשרים preposition unspecified unspecified unspecified unspecified unspecified 0 
11 עשרים ORD-CARD20 לעשרים numeral masculine-and-feminine plural construct unspecified unspecified  	O	null
12 ו ו ושניים conjunction unspecified unspecified unspecified unspecified unspecified 0 
12 שניים ORD2 ושניים numeral masculine plural absolute unspecified unspecified  	O	null
13 חודשי חודש חודשי noun masculine plural construct unspecified unspecified  	O	null
14 אימה אימה אימה noun feminine singular absolute unspecified unspecified  	O	null
15 בברגן-בלזן.ב בברגן-בלזן.ב בברגן-בלזן.ב properName unspecified unspecified unspecified unspecified unspecified  	I_ORG	null
16 - - - punctuation unspecified unspecified unspecified unspecified unspecified  	O	null
17 התאחדה התאחד התאחדה verb feminine singular unspecified 3 past  	O	null
18 ה ה המשפחה definiteArticle unspecified unspecified unspecified unspecified unspecified 0 
18 המשפחה משפחה המשפחה noun feminine singular absolute unspecified unspecified  	O	null
19 ב ב בחיפה preposition unspecified unspecified unspecified unspecified unspecified 0 
19 חיפה חיפה בחיפה properName unspecified unspecified unspecified unspecified unspecified  	I_LOC	null
20 . . . punctuation unspecified unspecified unspecified unspecified unspecified  	O	null

0 ה ה הילדה definiteArticle unspecified unspecified unspecified unspecified unspecified 0 
0 הילדה ילד הילדה noun feminine singular absolute unspecified unspecified  	O	null
1 כתבה כתב כתבה verb feminine singular unspecified 3 past  	O	null
2 את את את at-preposition unspecified unspecified unspecified unspecified unspecified  	O	null
3 סיפור סיפור סיפור noun masculine singular construct unspecified unspecified  	O	null
4 הצלת הצלה הצלתם noun feminine singular absolute unspecified unspecified  
4 ם ם הצלתם possessive masculine plural unspecified 3 unspecified 0 	O	null
5 , , , punctuation unspecified unspecified unspecified unspecified unspecified  	O	null
6 ש ש שהגיע relativizer/subordinatingConjunction unspecified unspecified unspecified unspecified unspecified 0 
6 הגיע הגיע שהגיע verb masculine singular unspecified 3 past  	O	null
7 כ כ ככתביד adverb unspecified unspecified unspecified unspecified unspecified 0 
7 כ כ ככתביד preposition unspecified unspecified unspecified unspecified unspecified 0 
7 תבי תבי ככתביד noun masculine singular absolute unspecified unspecified  
7 ו ו ככתביד possessive masculine singular unspecified 3 unspecified 0 	O	null
8 ל ל לידיו preposition unspecified unspecified unspecified unspecified unspecified 0 
8 יד יד לידיו noun feminine plural absolute unspecified unspecified  
8 ו ו לידיו possessive masculine singular unspecified 3 unspecified 0 	O	null
9 של של של shel-preposition unspecified unspecified unspecified unspecified unspecified  	O	null
10 ארנולד ארנולד ארנולד properName unspecified unspecified unspecified unspecified unspecified  	I_PERS	null
11 צווייג צווייג צווייג properName unspecified unspecified unspecified unspecified unspecified  	I_PERS	null
12 , , , punctuation unspecified unspecified unspecified unspecified unspecified  	O	null
13 ה ה הסופר definiteArticle unspecified unspecified unspecified unspecified unspecified 0 
13 הסופר סופר הסופר noun masculine singular absolute unspecified unspecified  	O	null
14 ה ה הגרמני definiteArticle unspecified unspecified unspecified unspecified unspecified 0 
14 הגרמני גרמני הגרמני adjective masculine singular absolute unspecified unspecified  	O	null
15 - - - punctuation unspecified unspecified unspecified unspecified unspecified  	O	null
16 יהודי יהודי יהודי adjective masculine singular absolute unspecified unspecified  	O	null
17 ה ה הנודע definiteArticle unspecified unspecified unspecified unspecified unspecified 0 
17 הנודע נודע הנודע adjective masculine singular absolute unspecified unspecified  	O	null
18 , , , punctuation unspecified unspecified unspecified unspecified unspecified  	O	null
19 ש ש שישב relativizer/subordinatingConjunction unspecified unspecified unspecified unspecified unspecified 0 
19 ישב ישב שישב verb masculine singular unspecified 3 past  	O	null
20 אז אז אז conjunction unspecified unspecified unspecified unspecified unspecified  	O	null
21 ב ב בחיפה preposition unspecified unspecified unspecified unspecified unspecified 0 
21 חיפה חיפה בחיפה properName unspecified unspecified unspecified unspecified unspecified  	I_LOC	null
22 . . . punctuation unspecified unspecified unspecified unspecified unspecified  	O	null

0 הוא הוא הוא pronoun masculine singular unspecified 3 unspecified  	O	null
1 עיבד עיבד עיבד verb masculine singular unspecified 3 past  	O	null
2 ו ו וערך conjunction unspecified unspecified unspecified unspecified unspecified 0 
2 ערך ערך וערך verb masculine singular unspecified 3 past  	O	null
3 את את את at-preposition unspecified unspecified unspecified unspecified unspecified  	O	null
4 ה ה הספר definiteArticle unspecified unspecified unspecified unspecified unspecified 0 
4 הספר ספר הספר noun masculine singular absolute unspecified unspecified  	O	null
5 , , , punctuation unspecified unspecified unspecified unspecified unspecified  	O	null
6 אך אך אך conjunction unspecified unspecified unspecified unspecified unspecified  	O	null
7 לקח לקח לקח verb masculine singular unspecified 3 past  	O	null
8 את את אותו at-preposition unspecified unspecified unspecified unspecified unspecified  
8 ו ו אותו pronomial masculine singular unspecified 3 unspecified 0 	O	null
9 ל ל לגרמניה preposition unspecified unspecified unspecified unspecified unspecified 0 
9 ה ה לגרמניה definiteArticle unspecified unspecified unspecified unspecified unspecified 0 
9 הגרמניה גרמני לגרמניה noun feminine singular absolute unspecified unspecified  	I_LOC	null
10 ה ה המזרחית definiteArticle unspecified unspecified unspecified unspecified unspecified 0 
10 המזרחית מזרחי המזרחית adjective feminine singular absolute unspecified unspecified  	O	null
11 כאשר כאשר כאשר conjunction unspecified unspecified unspecified unspecified unspecified  	O	null
12 שב שב שב verb masculine singular unspecified 3 past  	O	null
13 אל אל אליה preposition unspecified unspecified unspecified unspecified unspecified  
13 ה ה אליה pronomial feminine singular unspecified 3 unspecified 0 	O	null
14 . . . punctuation unspecified unspecified unspecified unspecified unspecified  	O	null

0 ה ה הספר definiteArticle unspecified unspecified unspecified unspecified unspecified 0 
0 הספר ספר הספר noun masculine singular absolute unspecified unspecified  	O	null
1 , , , punctuation unspecified unspecified unspecified unspecified unspecified  	O	null
2 Fahrt Fahrt Fahrt foreign unspecified unspecified unspecified unspecified unspecified  	O	null
3 zum zum zum foreign unspecified unspecified unspecified unspecified unspecified  	O	null
4 Acheron Acheron Acheron foreign unspecified unspecified unspecified unspecified unspecified  	O	null
5 ( ( ( punctuation unspecified unspecified unspecified unspecified unspecified  	O	null
6 Berlin Berlin Berlin foreign unspecified unspecified unspecified unspecified unspecified  	O	null
7 Verlag Verlag Verlag foreign unspecified unspecified unspecified unspecified unspecified  	O	null
8 , , , punctuation unspecified unspecified unspecified unspecified unspecified  	O	null
9 ) ) ) punctuation unspecified unspecified unspecified unspecified unspecified  	O	null
10 , , , punctuation unspecified unspecified unspecified unspecified unspecified  	O	null
11 ###NUMBER### ###NUMBER### ###NUMBER### numeral unspecified unspecified unspecified unspecified unspecified  	I_DATE	null
12 הופיע הופיע הופיע verb masculine singular unspecified 3 past  	O	null
13 לראשונה לראשונה לראשונה adverb unspecified unspecified unspecified unspecified unspecified  	O	null
14 ב ב בשמו preposition unspecified unspecified unspecified unspecified unspecified 0 
14 שם שם בשמו noun masculine singular absolute unspecified unspecified  
14 ו ו בשמו possessive masculine singular unspecified 3 unspecified 0 	O	null
15 של של של shel-preposition unspecified unspecified unspecified unspecified unspecified  	O	null
16 צווייג צווייג צווייג properName unspecified unspecified unspecified unspecified unspecified  	I_PERS	null
17 , , , punctuation unspecified unspecified unspecified unspecified unspecified  	O	null
18 אך אך אך conjunction unspecified unspecified unspecified unspecified unspecified  	O	null
19 הוא הוא הוא pronoun masculine singular unspecified 3 unspecified  	O	null
20 ציין ציין ציין verb masculine singular unspecified 3 past  	O	null
21 ש ש שנכתב relativizer/subordinatingConjunction unspecified unspecified unspecified unspecified unspecified 0 
21 נכתב נכתב שנכתב verb masculine singular unspecified 3 past  	O	null
22 על על על preposition unspecified unspecified unspecified unspecified unspecified  	O	null
23 פי פה פי noun masculine singular construct unspecified unspecified  	O	null
24 סיפור סיפור סיפורה noun masculine singular absolute unspecified unspecified  
24 ה ה סיפורה possessive feminine singular unspecified 3 unspecified 0 	O	null
25 של של של shel-preposition unspecified unspecified unspecified unspecified unspecified  	O	null
26 ה ה הילדה definiteArticle unspecified unspecified unspecified unspecified unspecified 0 
26 הילדה ילד הילדה noun feminine singular absolute unspecified unspecified  	O	null
27 הופרט הופרט הופרט verb masculine singular unspecified 3 past  	O	null
28 , , , punctuation unspecified unspecified unspecified unspecified unspecified  	O	null
29 ו ו וזכה conjunction unspecified unspecified unspecified unspecified unspecified 0 
29 זכה זכה וזכה verb masculine singular unspecified 3 past  	O	null
30 ל ל להצלחה preposition unspecified unspecified unspecified unspecified unspecified 0 
30 הצלחה הצלחה להצלחה noun feminine singular absolute unspecified unspecified  	O	null
31 מיידית מיידי מיידית adjective feminine singular absolute unspecified unspecified  	O	null
32 ו ו ואף conjunction unspecified unspecified unspecified unspecified unspecified 0 
32 אף אף ואף conjunction unspecified unspecified unspecified unspecified unspecified  	O	null
33 תורגם תורגם תורגם verb masculine singular unspecified 3 past  	O	null
34 ל ל להולנדית preposition unspecified unspecified unspecified unspecified unspecified 0 
34 ה ה להולנדית definiteArticle unspecified unspecified unspecified unspecified unspecified 0 
34 ההולנדית הולנדי להולנדית noun feminine singular absolute unspecified unspecified  	O	null
35 ו ו ולצ'כית conjunction unspecified unspecified unspecified unspecified unspecified 0 
35 ל ל ולצ'כית preposition unspecified unspecified unspecified unspecified unspecified 0 
35 ה ה ולצ'כית definiteArticle unspecified unspecified unspecified unspecified unspecified 0 
35 הצ'כית צ'כית ולצ'כית properName feminine singular unspecified unspecified unspecified  	I_LOC	null
36 . . . punctuation unspecified unspecified unspecified unspecified unspecified  	O	null

0 כותרת כותרת כותרתו noun feminine singular absolute unspecified unspecified  
0 ו ו כותרתו possessive masculine singular unspecified 3 unspecified 0 	O	null
1 מדמה דימה מדמה verb masculine singular unspecified any beinoni  	O	null
2 את את את at-preposition unspecified unspecified unspecified unspecified unspecified  	O	null
3 נדודי נדודים נדודיהם noun masculine plural absolute unspecified unspecified  
3 הם הם נדודיהם possessive masculine plural unspecified 3 unspecified 0 	O	null
4 של של של shel-preposition unspecified unspecified unspecified unspecified unspecified  	O	null
5 ה ה השניים definiteArticle unspecified unspecified unspecified unspecified unspecified 0 
5 השניים ORD2 השניים numeral masculine plural absolute unspecified unspecified  	O	null
6 כ כ כמסע preposition unspecified unspecified unspecified unspecified unspecified 0 
6 מסע מסע כמסע noun masculine singular absolute unspecified unspecified  	O	null
7 ל ל לאכרון preposition unspecified unspecified unspecified unspecified unspecified 0 
7 אכרון האכרון לאכרון properName unspecified unspecified unspecified unspecified unspecified  	I_LOC	null
8 , , , punctuation unspecified unspecified unspecified unspecified unspecified  	O	null
9 אחד איחד אחד verb masculine singular unspecified 3 past  	O	null
10 מ מ מנהרות preposition unspecified unspecified unspecified unspecified unspecified 0 
10 נהרות נהר מנהרות noun masculine plural construct unspecified unspecified  	O	null
11 ה ה השאול definiteArticle unspecified unspecified unspecified unspecified unspecified 0 
11 השאול שאול השאול noun feminine singular absolute unspecified unspecified  	O	null
12 . . . punctuation unspecified unspecified unspecified unspecified unspecified  	O	null

0 בן בן בנה noun masculine singular absolute unspecified unspecified  
0 ה ה בנה possessive feminine singular unspecified 3 unspecified 0 	O	null
1 של של של shel-preposition unspecified unspecified unspecified unspecified unspecified  	O	null
2 ה ה הילדה definiteArticle unspecified unspecified unspecified unspecified unspecified 0 
2 הילדה ילד הילדה noun feminine singular absolute unspecified unspecified  	O	null
3 ניסה ניסה ניסה verb masculine singular unspecified 3 past  	O	null
4 במשך במשך במשך preposition unspecified unspecified unspecified unspecified unspecified  	O	null
5 שנים שנה שנים noun feminine plural absolute unspecified unspecified  	O	null
6 למצוא מצא למצוא verb unspecified unspecified unspecified unspecified infinitive  	O	null
7 מו"ל מו"ל מו"ל noun masculine singular absolute unspecified unspecified  	O	null
8 עברי עברי עברי adjective masculine singular absolute unspecified unspecified  	O	null
9 ל ל לספר preposition unspecified unspecified unspecified unspecified unspecified 0 
9 ה ה לספר definiteArticle unspecified unspecified unspecified unspecified unspecified 0 
9 הספר ספר לספר noun masculine singular absolute unspecified unspecified  	O	null
10 , , , punctuation unspecified unspecified unspecified unspecified unspecified  	O	null
11 אך אך אך conjunction unspecified unspecified unspecified unspecified unspecified  	O	null
12 לא לא לא negation unspecified unspecified unspecified unspecified unspecified  	O	null
13 הצליח הצליח הצליח verb masculine singular unspecified 3 past  	O	null
14 . . . punctuation unspecified unspecified unspecified unspecified unspecified  	O	null

0 בעקבות בעקבות בעקבות preposition unspecified unspecified unspecified unspecified unspecified  	O	null
1 תוכנית תוכנייה תוכנית noun feminine singular construct unspecified unspecified  	O	null
2 רדיו רדיו רדיו noun masculine singular absolute unspecified unspecified  	O	null
3 של של שלו shel-preposition unspecified unspecified unspecified unspecified unspecified  
3 ו ו שלו pronomial masculine singular unspecified 3 unspecified 0 	O	null
4 נוצר נוצר נוצר verb masculine singular unspecified 3 past  	O	null
5 קשר קשר קשר noun masculine singular absolute unspecified unspecified  	O	null
6 בין בין בינו preposition unspecified unspecified unspecified unspecified unspecified  
6 ו ו בינו pronomial masculine singular unspecified 3 unspecified 0 	O	null
7 לבין לבין לבין preposition unspecified unspecified unspecified unspecified unspecified  	O	null
8 אבא אבא אבא noun masculine singular absolute unspecified unspecified  	O	null
9 קובנר קובנר קובנר properName unspecified unspecified unspecified unspecified unspecified  	O	null
10 ו ו והוצאת conjunction unspecified unspecified unspecified unspecified unspecified 0 
10 הוצאת הוצאה והוצאת noun feminine singular construct unspecified unspecified  	O	null
11 מורשת מורשת מורשת properName unspecified unspecified unspecified unspecified unspecified  	I_LOC	null
12 , , , punctuation unspecified unspecified unspecified unspecified unspecified  	O	null
13 ו ו והופרט conjunction unspecified unspecified unspecified unspecified unspecified 0 
13 הופרט הופרט והופרט verb masculine singular unspecified 3 past  	O	null
14 הכין הכין הכין verb masculine singular unspecified 3 past  	O	null
15 את את את at-preposition unspecified unspecified unspecified unspecified unspecified  	O	null
16 ה ה הגרסה definiteArticle unspecified unspecified unspecified unspecified unspecified 0 
16 הגרסה גרסה הגרסה noun feminine singular absolute unspecified unspecified  	O	null
17 ה ה העברית definiteArticle unspecified unspecified unspecified unspecified unspecified 0 
17 העברית עברי העברית adjective feminine singular absolute unspecified unspecified  	O	null
18 ב ב בשםיד preposition unspecified unspecified unspecified unspecified unspecified 0 
18 שםיד שםיד בשםיד adjective masculine singular construct unspecified unspecified  	O	null
19 ב ב ביד preposition unspecified unspecified unspecified unspecified unspecified 0 
19 יד יד ביד noun feminine singular absolute unspecified unspecified  	O	null
20 עם עם עם preposition unspecified unspecified unspecified unspecified unspecified  	O	null
21 תום תום תומי noun masculine singular absolute unspecified unspecified  
21 י י תומי possessive masculine-and-feminine singular unspecified 1 unspecified 0 	O	null
22 ) ) ) punctuation unspecified unspecified unspecified unspecified unspecified  	O	null
23 . . . punctuation unspecified unspecified unspecified unspecified unspecified  	O	null
24 ###NUMBER### ###NUMBER### ###NUMBER### numeral unspecified unspecified unspecified unspecified unspecified  	I_DATE	null
25 ה ה הספר definiteArticle unspecified unspecified unspecified unspecified unspecified 0 
25 הספר ספר הספר noun masculine singular absolute unspecified unspecified  	O	null
26 זכה זכה זכה verb masculine singular unspecified 3 past  	O	null
27 ל ל להצלחה preposition unspecified unspecified unspecified unspecified unspecified 0 
27 הצלחה הצלחה להצלחה noun feminine singular absolute unspecified unspecified  	O	null
28 ב ב בארץ preposition unspecified unspecified unspecified unspecified unspecified 0 
28 ה ה בארץ definiteArticle unspecified unspecified unspecified unspecified unspecified 0 
28 הארץ ארץ בארץ noun feminine singular absolute unspecified unspecified  	O	null
29 ו ו ולכמה conjunction unspecified unspecified unspecified unspecified unspecified 0 
29 ל ל ולכמה preposition unspecified unspecified unspecified unspecified unspecified 0 
29 כמה כמה ולכמה quantifier unspecified unspecified construct unspecified unspecified  	O	null
30 מהדורות מהדורה מהדורות noun feminine plural absolute unspecified unspecified  	O	null
31 . . . punctuation unspecified unspecified unspecified unspecified unspecified  	O	null

0 ה ה הנוסח definiteArticle unspecified unspecified unspecified unspecified unspecified 0 
0 הנוסח נוסח הנוסח noun masculine singular absolute unspecified unspecified  	O	null
1 ה ה העברי definiteArticle unspecified unspecified unspecified unspecified unspecified 0 
1 העברי עברי העברי adjective masculine singular absolute unspecified unspecified  	O	null
2 ה ה המשותף definiteArticle unspecified unspecified unspecified unspecified unspecified 0 
2 המשותף משותף המשותף adjective masculine singular absolute unspecified unspecified  	O	null
3 של של של shel-preposition unspecified unspecified unspecified unspecified unspecified  	O	null
4 ה ה הילדה definiteArticle unspecified unspecified unspecified unspecified unspecified 0 
4 הילדה ילד הילדה noun feminine singular absolute unspecified unspecified  	O	null
5 ו ו ובנה conjunction unspecified unspecified unspecified unspecified unspecified 0 
5 בנה בנה ובנה verb masculine singular unspecified 3 past  	O	null
6 תורגם תורגם תורגם verb masculine singular unspecified 3 past  	O	null
7 מחדש מחדש מחדש adverb unspecified unspecified unspecified unspecified unspecified  	O	null
8 ל ל לגרמנית preposition unspecified unspecified unspecified unspecified unspecified 0 
8 גרמנית גרמנית לגרמנית properName feminine singular unspecified unspecified unspecified  	I_LOC	null
9 , , , punctuation unspecified unspecified unspecified unspecified unspecified  	O	null
10 ל ל לצ'כית preposition unspecified unspecified unspecified unspecified unspecified 0 
10 ה ה לצ'כית definiteArticle unspecified unspecified unspecified unspecified unspecified 0 
10 הצ'כית צ'כית לצ'כית properName feminine singular unspecified unspecified unspecified  	I_LOC	null
11 , , , punctuation unspecified unspecified unspecified unspecified unspecified  	O	null
12 ל ל לערבית preposition unspecified unspecified unspecified unspecified unspecified 0 
12 ערבית ערבית לערבית properName feminine singular unspecified unspecified unspecified  	I_LOC	null
13 , , , punctuation unspecified unspecified unspecified unspecified unspecified  	O	null
14 ל ל לאנגלית preposition unspecified unspecified unspecified unspecified unspecified 0 
14 אנגלית אנגלית לאנגלית properName feminine singular unspecified unspecified unspecified  	I_LOC	null
15 ו ו ולאמהרית conjunction unspecified unspecified unspecified unspecified unspecified 0 
15 ל ל ולאמהרית preposition unspecified unspecified unspecified unspecified unspecified 0 
15 אמהרית אמהרית ולאמהרית properName unspecified unspecified unspecified unspecified unspecified  	B_LOC	null
16 . . . punctuation unspecified unspecified unspecified unspecified unspecified  	O	null

0 ספר ספר ספרה noun masculine singular absolute unspecified unspecified  
0 ה ה ספרה possessive feminine singular unspecified 3 unspecified 0 	O	null
1 ה ה השני definiteArticle unspecified unspecified unspecified unspecified unspecified 0 
1 השני ORD2 השני numeral masculine singular absolute unspecified unspecified  	O	null
2 , , , punctuation unspecified unspecified unspecified unspecified unspecified  	O	null
3 ה ה הרומן definiteArticle unspecified unspecified unspecified unspecified unspecified 0 
3 הרומן רומן הרומן noun masculine singular absolute unspecified unspecified  	O	null
4 דוקטור דוקטור דוקטור title masculine singular unspecified unspecified unspecified  	O	null
5 ורוניקה ורוניקה ורוניקה properName unspecified unspecified unspecified unspecified unspecified  	I_PERS	null
6 ) ) ) punctuation unspecified unspecified unspecified unspecified unspecified  	O	null
7 , , , punctuation unspecified unspecified unspecified unspecified unspecified  	O	null
8 ###NUMBER### ###NUMBER### ###NUMBER### numeral unspecified unspecified unspecified unspecified unspecified  	I_DATE	null
9 ראה ראה ראה verb masculine singular unspecified 3 past  	O	null
10 אור אור אור noun masculine singular absolute unspecified unspecified  	O	null
11 ב ב במלאות preposition unspecified unspecified unspecified unspecified unspecified 0 
11 מלאות מלאות במלאות noun feminine singular absolute unspecified unspecified  	O	null
12 ל ל לה preposition unspecified unspecified unspecified unspecified unspecified  
12 ה ה לה pronomial feminine singular unspecified 3 unspecified 0 	O	null
13 תשעים ORD-CARD90 תשעים numeral masculine-and-feminine plural construct unspecified unspecified  	O	null
14 , , , punctuation unspecified unspecified unspecified unspecified unspecified  	O	null
15 ו ו וגם conjunction unspecified unspecified unspecified unspecified unspecified 0 
15 גם גם וגם conjunction unspecified unspecified unspecified unspecified unspecified  	O	null
16 הוא הוא הוא pronoun masculine singular unspecified 3 unspecified  	O	null
17 תורגם תורגם תורגם verb masculine singular unspecified 3 past  	O	null
18 , , , punctuation unspecified unspecified unspecified unspecified unspecified  	O	null
19 עובד עובד עובד noun masculine singular absolute unspecified unspecified  	O	null
20 ו ו ונערך conjunction unspecified unspecified unspecified unspecified unspecified 0 
20 נערך נערך ונערך verb masculine singular unspecified 3 past  	O	null
21 בידי בידי בידי preposition unspecified unspecified unspecified unspecified unspecified  	O	null
22 שמואל שמואל שמואל properName unspecified unspecified unspecified unspecified unspecified  	I_PERS	null
23 הופרט הופרט הופרט verb masculine singular unspecified 3 past  	O	null
24 . . . punctuation unspecified unspecified unspecified unspecified unspecified  	O	null

0 ה ה הרומן definiteArticle unspecified unspecified unspecified unspecified unspecified 0 
0 הרומן רומן הרומן noun masculine singular absolute unspecified unspecified  	O	null
1 סובב סובב סובב verb masculine singular unspecified 3 past  	O	null
2 סביב סביב סביב preposition unspecified unspecified unspecified unspecified unspecified  	O	null
3 חיי חיים חייה noun masculine plural absolute unspecified unspecified  
3 ה ה חייה possessive feminine singular unspecified 3 unspecified 0 	O	null
4 של של של shel-preposition unspecified unspecified unspecified unspecified unspecified  	O	null
5 רופאה רופא רופאה noun feminine singular absolute unspecified unspecified  	O	null
6 יהודייה יהודי יהודייה adjective feminine singular absolute unspecified unspecified  	O	null
7 , , , punctuation unspecified unspecified unspecified unspecified unspecified  	O	null
8 כש כש כשמלחמת temporalSubConj unspecified unspecified unspecified unspecified unspecified 0 
8 מלחמת מלחמה כשמלחמת noun feminine singular construct unspecified unspecified  	O	null
9 ה ה העולם definiteArticle unspecified unspecified unspecified unspecified unspecified 0 
9 העולם עולם העולם noun masculine singular absolute unspecified unspecified  	O	null
10 ו ו והשואה conjunction unspecified unspecified unspecified unspecified unspecified 0 
10 ה ה והשואה definiteArticle unspecified unspecified unspecified unspecified unspecified 0 
10 השואה שואה והשואה noun feminine singular absolute unspecified unspecified  	O	null
11 משמשות שימש משמשות verb feminine plural unspecified any beinoni  	O	null
12 רקע רקע רקע noun masculine singular absolute unspecified unspecified  	O	null
13 ל ל לסיפור preposition unspecified unspecified unspecified unspecified unspecified 0 
13 ה ה לסיפור definiteArticle unspecified unspecified unspecified unspecified unspecified 0 
13 הסיפור סיפור לסיפור noun masculine singular absolute unspecified unspecified  	O	null
14 . . . punctuation unspecified unspecified unspecified unspecified unspecified  	O	null

0 ה ה הילדה definiteArticle unspecified unspecified unspecified unspecified unspecified 0 
0 הילדה ילד הילדה noun feminine singular absolute unspecified unspecified  	O	null
1 הופרט הופרט הופרט verb masculine singular unspecified 3 past  	O	null
2 הניחה הניח הניחה verb feminine singular unspecified 3 past  	O	null
3 אחרי אחרי אחריה preposition unspecified unspecified unspecified unspecified unspecified  
3 ה ה אחריה pronomial feminine singular unspecified 3 unspecified 0 	O	null
4 שני CARD2 שני numeral masculine dual construct unspecified unspecified  	O	null
5 רומנים רומן רומנים noun masculine plural absolute unspecified unspecified  	O	null
6 גמורים גמור גמורים adjective masculine plural absolute unspecified unspecified  	O	null
7 ב ב בגרמנית preposition unspecified unspecified unspecified unspecified unspecified 0 
7 גרמנית גרמנית בגרמנית properName feminine singular unspecified unspecified unspecified  	I_LOC	null
8 ו ו והתחלות conjunction unspecified unspecified unspecified unspecified unspecified 0 
8 התחלות התחלה והתחלות noun feminine plural absolute unspecified unspecified  	O	null
9 של של של shel-preposition unspecified unspecified unspecified unspecified unspecified  	O	null
10 רומן רומן רומן noun masculine singular absolute unspecified unspecified  	O	null
11 נוסף נוסף נוסף adjective masculine singular absolute unspecified unspecified  	O	null
12 . . . punctuation unspecified unspecified unspecified unspecified unspecified  	O	null

0 References References References foreign unspecified unspecified unspecified unspecified unspecified  	O	null
1 : : : punctuation unspecified unspecified unspecified unspecified unspecified  	O	null
2 הופרט הופרט הופרט verb masculine singular unspecified 3 past  	O	null
3 , , , punctuation unspecified unspecified unspecified unspecified unspecified  	O	null
4 שמואל שמואל שמואל properName unspecified unspecified unspecified unspecified unspecified  	I_PERS	null
5 . . . punctuation unspecified unspecified unspecified unspecified unspecified  	O	null

0 " " " punctuation unspecified unspecified unspecified unspecified unspecified  	O	null
1 מ מ מ preposition unspecified unspecified unspecified unspecified unspecified 0 	O	null
2 ' ' ' punctuation unspecified unspecified unspecified unspecified unspecified  	O	null
3 למה למה למה interrogative unspecified unspecified unspecified unspecified unspecified  	O	null
4 זה זה זה pronoun masculine singular unspecified 3 unspecified  	O	null
5 קרה קרה קרה verb masculine singular unspecified 3 past  	O	null
6 לנו לן לנו verb masculine-and-feminine plural unspecified 1 past  	O	null
7 ? ? ? punctuation unspecified unspecified unspecified unspecified unspecified  	O	null

0 ' ' ' punctuation unspecified unspecified unspecified unspecified unspecified  	I_ORG	null
1 אל אל אל preposition unspecified unspecified unspecified unspecified unspecified  	I_ORG	null
2 ' ' ' punctuation unspecified unspecified unspecified unspecified unspecified  	I_ORG	null
3 ידביד ידביד ידביד properName unspecified unspecified unspecified unspecified unspecified  	I_ORG	null
4 עם עם עם preposition unspecified unspecified unspecified unspecified unspecified  	O	null
5 תום תום תומי noun masculine singular absolute unspecified unspecified  
5 י י תומי possessive masculine-and-feminine singular unspecified 1 unspecified 0 	O	null
6 ' ' ' punctuation unspecified unspecified unspecified unspecified unspecified  	O	null
7 , , , punctuation unspecified unspecified unspecified unspecified unspecified  	O	null
8 גלגול גלגול גלגולי noun masculine singular absolute unspecified unspecified  
8 י י גלגולי possessive masculine-and-feminine singular unspecified 1 unspecified 0 	O	null
9 כתבהיד כתבהיד כתבהיד adjective masculine singular construct unspecified unspecified  	O	null
10 של של של shel-preposition unspecified unspecified unspecified unspecified unspecified  	O	null
11 ה ה הילדה definiteArticle unspecified unspecified unspecified unspecified unspecified 0 
11 הילדה ילד הילדה noun feminine singular absolute unspecified unspecified  	O	null
12 הופרט הופרט הופרט verb masculine singular unspecified 3 past  	O	null
13 ש ש שהופיע relativizer/subordinatingConjunction unspecified unspecified unspecified unspecified unspecified 0 
13 הופיע הופיע שהופיע verb masculine singular unspecified 3 past  	O	null
14 ב ב בהוצאת preposition unspecified unspecified unspecified unspecified unspecified 0 
14 הוצאת הוצאה בהוצאת noun feminine singular construct unspecified unspecified  	O	null
15 ' ' ' punctuation unspecified unspecified unspecified unspecified unspecified  	O	null
16 מורשת' מורשת' מורשת' properName unspecified unspecified unspecified unspecified unspecified  	O	null
17 ב ב בשש preposition unspecified unspecified unspecified unspecified unspecified 0 
17 שש CARD6 בשש numeral feminine singular absolute unspecified unspecified  	O	null
18 מהדורות מהדורה מהדורות noun feminine plural absolute unspecified unspecified  	O	null
19 " " " punctuation unspecified unspecified unspecified unspecified unspecified  	O	null
20 . . . punctuation unspecified unspecified unspecified unspecified unspecified  	O	null

0 ילקוט ילקוט ילקוט noun masculine singular construct unspecified unspecified  	O	null
1 מורשת מורשת מורשת properName unspecified unspecified unspecified unspecified unspecified  	I_LOC	null
2 . . . punctuation unspecified unspecified unspecified unspecified unspecified  	O	null

0 מ"ח מ"ח מ"ח noun masculine singular absolute unspecified unspecified  	O	null
1 . . . punctuation unspecified unspecified unspecified unspecified unspecified  	O	null

0 ###NUMBER### ###NUMBER### ###NUMBER### numeral unspecified unspecified unspecified unspecified unspecified  	I_DATE	null
1 . . . punctuation unspecified unspecified unspecified unspecified unspecified  	O	null

0 ###NUMBER### ###NUMBER### ###NUMBER### numeral unspecified unspecified unspecified unspecified unspecified  	O	null
1 - - - punctuation unspecified unspecified unspecified unspecified unspecified  	O	null
2 ###NUMBER### ###NUMBER### ###NUMBER### numeral unspecified unspecified unspecified unspecified unspecified  	O	null
3 . . . punctuation unspecified unspecified unspecified unspecified unspecified  	O	null

