0 Name Name Name foreign unspecified unspecified unspecified unspecified unspecified  	O	null
1 : : : punctuation unspecified unspecified unspecified unspecified unspecified  	O	null
2 הכהן הכהן הכהן properName unspecified unspecified unspecified unspecified unspecified  	I_PERS	null
3 , , , punctuation unspecified unspecified unspecified unspecified unspecified  	O	null
4 רן רן רן properName unspecified unspecified unspecified unspecified unspecified  	I_PERS	null
5 Birth Birth Birth foreign unspecified unspecified unspecified unspecified unspecified  	O	null
6 Year Year Year foreign unspecified unspecified unspecified unspecified unspecified  	O	null
7 : : : punctuation unspecified unspecified unspecified unspecified unspecified  	O	null
8 ###NUMBER### ###NUMBER### ###NUMBER### numeral unspecified unspecified unspecified unspecified unspecified  	I_DATE	null
9 Birth Birth Birth foreign unspecified unspecified unspecified unspecified unspecified  	O	null
10 Place Place Place foreign unspecified unspecified unspecified unspecified unspecified  	O	null
11 : : : punctuation unspecified unspecified unspecified unspecified unspecified  	O	null
12 הולנד הולנד הולנד properName unspecified unspecified unspecified unspecified unspecified  	I_LOC	null
13 Occupation Occupation Occupation foreign unspecified unspecified unspecified unspecified unspecified  	O	null
14 : : : punctuation unspecified unspecified unspecified unspecified unspecified  	O	null
15 מתרגם מתרגם מתרגם noun masculine singular construct unspecified unspecified  	O	null
16 וחוקרספרות וחוקרספרות וחוקרספרות adjective feminine plural construct unspecified unspecified  	O	null
17 Entry Entry Entry foreign unspecified unspecified unspecified unspecified unspecified  	O	null
18 writer writer writer foreign unspecified unspecified unspecified unspecified unspecified  	O	null
19 : : : punctuation unspecified unspecified unspecified unspecified unspecified  	O	null
20 זיסי זיסי זיסי properName unspecified unspecified unspecified unspecified unspecified  	I_ORG	null
21 סתוי סתווי סתוי adjective masculine singular absolute unspecified unspecified  	O	null
22 Entry Entry Entry foreign unspecified unspecified unspecified unspecified unspecified  	O	null
23 Value Value Value foreign unspecified unspecified unspecified unspecified unspecified  	O	null
24 : : : punctuation unspecified unspecified unspecified unspecified unspecified  	O	null
25 נולד נולד נולד verb masculine singular unspecified 3 past  	O	null
26 ב ב בהולנד preposition unspecified unspecified unspecified unspecified unspecified 0 
26 הולנד הולנד בהולנד properName unspecified unspecified unspecified unspecified unspecified  	I_LOC	null
27 . . . punctuation unspecified unspecified unspecified unspecified unspecified  	O	null

0 אבי אב אביו noun masculine singular absolute unspecified unspecified  
0 ו ו אביו possessive masculine singular unspecified 3 unspecified 0 	O	null
1 יליד יליד יליד noun masculine singular construct unspecified unspecified  	O	null
2 ה ה הארץ definiteArticle unspecified unspecified unspecified unspecified unspecified 0 
2 הארץ ארץ הארץ noun feminine singular absolute unspecified unspecified  	O	null
3 . . . punctuation unspecified unspecified unspecified unspecified unspecified  	O	null

0 אם אם אמו noun feminine singular absolute unspecified unspecified  
0 ו ו אמו possessive masculine singular unspecified 3 unspecified 0 	O	null
1 בת בת בת noun feminine singular absolute unspecified unspecified  	O	null
2 ל ל למשפחה preposition unspecified unspecified unspecified unspecified unspecified 0 
2 משפחה משפחה למשפחה noun feminine singular absolute unspecified unspecified  	O	null
3 יהודית יהודי יהודית adjective feminine singular absolute unspecified unspecified  	O	null
4 הולנדית הולנדי הולנדית adjective feminine singular absolute unspecified unspecified  	O	null
5 ו ו ושרדה conjunction unspecified unspecified unspecified unspecified unspecified 0 
5 שרדה שרד ושרדה verb feminine singular unspecified 3 past  	O	null
6 את את את at-preposition unspecified unspecified unspecified unspecified unspecified  	O	null
7 שנות שנה שנותיה noun feminine plural absolute unspecified unspecified  
7 ה ה שנותיה possessive feminine singular unspecified 3 unspecified 0 	O	null
8 ה ה הראשונות definiteArticle unspecified unspecified unspecified unspecified unspecified 0 
8 הראשונות ORD1 הראשונות numeral feminine plural absolute unspecified unspecified  	I_LOC	null
9 ב ב בהולנד preposition unspecified unspecified unspecified unspecified unspecified 0 
9 הולנד הולנד בהולנד properName unspecified unspecified unspecified unspecified unspecified  	I_LOC	null
10 ב ב בתקופת preposition unspecified unspecified unspecified unspecified unspecified 0 
10 תקופת תקופה בתקופת noun feminine singular construct unspecified unspecified  	O	null
11 ה ה השואה definiteArticle unspecified unspecified unspecified unspecified unspecified 0 
11 השואה שואה השואה noun feminine singular absolute unspecified unspecified  	O	null
12 . . . punctuation unspecified unspecified unspecified unspecified unspecified  	O	null

0 עלה עלה עלה verb masculine singular unspecified 3 past  	O	null
1 עם עם עם preposition unspecified unspecified unspecified unspecified unspecified  	O	null
2 הורי הורה הוריו noun masculine plural absolute unspecified unspecified  
2 ו ו הוריו possessive masculine singular unspecified 3 unspecified 0 	O	null
3 ב ב בגיל preposition unspecified unspecified unspecified unspecified unspecified 0 
3 גיל גיל בגיל noun masculine singular construct unspecified unspecified  	O	null
4 שנה שנה שנה noun feminine singular absolute unspecified unspecified  	O	null
5 , , , punctuation unspecified unspecified unspecified unspecified unspecified  	O	null
6 גדל גדל גדל verb masculine singular unspecified 3 past  	O	null
7 ב ב בחיפה preposition unspecified unspecified unspecified unspecified unspecified 0 
7 חיפה חיפה בחיפה properName unspecified unspecified unspecified unspecified unspecified  	I_LOC	null
8 ו ו ולמד conjunction unspecified unspecified unspecified unspecified unspecified 0 
8 למד למד ולמד verb masculine singular unspecified 3 past  	O	null
9 ב ב בבית preposition unspecified unspecified unspecified unspecified unspecified 0 
9 בית בית בבית noun masculine singular construct unspecified unspecified  	O	null
10 ה ה הספר definiteArticle unspecified unspecified unspecified unspecified unspecified 0 
10 הספר ספר הספר noun masculine singular absolute unspecified unspecified  	O	null
11 " " " punctuation unspecified unspecified unspecified unspecified unspecified  	O	null
12 ה ה הריאלי definiteArticle unspecified unspecified unspecified unspecified unspecified 0 
12 הריאלי ריאלי הריאלי adjective masculine singular absolute unspecified unspecified  	O	null
13 " " " punctuation unspecified unspecified unspecified unspecified unspecified  	O	null
14 . . . punctuation unspecified unspecified unspecified unspecified unspecified  	O	null

0 תואר תואר תואר noun masculine singular construct unspecified unspecified  	O	null
1 ראשון ראשון ראשון properName unspecified unspecified unspecified unspecified unspecified  	I_DATE	null
2 קיבל קיבל קיבל verb masculine singular unspecified 3 past  	O	null
3 ב ב בטכניון preposition unspecified unspecified unspecified unspecified unspecified 0 
3 ה ה בטכניון definiteArticle unspecified unspecified unspecified unspecified unspecified 0 
3 הטכניון טכניון בטכניון noun masculine singular absolute unspecified unspecified  	O	null
4 , , , punctuation unspecified unspecified unspecified unspecified unspecified  	O	null
5 ב ב במחלקה preposition unspecified unspecified unspecified unspecified unspecified 0 
5 ה ה במחלקה definiteArticle unspecified unspecified unspecified unspecified unspecified 0 
5 המחלקה מחלקה במחלקה noun feminine singular absolute unspecified unspecified  	O	null
6 ל ל למדעי preposition unspecified unspecified unspecified unspecified unspecified 0 
6 מדעי מדע למדעי noun masculine plural construct unspecified unspecified  	O	null
7 ה ה המחשב definiteArticle unspecified unspecified unspecified unspecified unspecified 0 
7 המחשב מחשב המחשב noun masculine singular absolute unspecified unspecified  	O	null
8 ) ) ) punctuation unspecified unspecified unspecified unspecified unspecified  	O	null
9 . . . punctuation unspecified unspecified unspecified unspecified unspecified  	O	null
10 ###NUMBER### ###NUMBER### ###NUMBER### numeral unspecified unspecified unspecified unspecified unspecified  	I_DATE	null
11 שנה שנה שנה noun feminine singular absolute unspecified unspecified  	O	null
12 אחת CARD1 אחת numeral feminine singular absolute unspecified unspecified  	O	null
13 למד למד למד verb masculine singular unspecified 3 past  	O	null
14 ב ב בחוג preposition unspecified unspecified unspecified unspecified unspecified 0 
14 ה ה בחוג definiteArticle unspecified unspecified unspecified unspecified unspecified 0 
14 החוג חוג בחוג noun masculine singular absolute unspecified unspecified  	O	null
15 ל ל לתורת preposition unspecified unspecified unspecified unspecified unspecified 0 
15 תורת תורה לתורת noun feminine singular construct unspecified unspecified  	O	null
16 ה ה הספרות definiteArticle unspecified unspecified unspecified unspecified unspecified 0 
16 הספרות ספרות הספרות noun feminine singular absolute unspecified unspecified  	O	null
17 ב ב באוניברסיטת preposition unspecified unspecified unspecified unspecified unspecified 0 
17 אוניברסיטת אוניברסיטה באוניברסיטת noun feminine singular construct unspecified unspecified  	O	null
18 לובן לובן לובן noun masculine singular absolute unspecified unspecified  	O	null
19 , , , punctuation unspecified unspecified unspecified unspecified unspecified  	O	null
20 בלגיה בלגיה בלגיה properName unspecified unspecified unspecified unspecified unspecified  	I_LOC	null
21 , , , punctuation unspecified unspecified unspecified unspecified unspecified  	O	null
22 ו ו ותואר conjunction unspecified unspecified unspecified unspecified unspecified 0 
22 תואר תואר ותואר noun masculine singular construct unspecified unspecified  	O	null
23 שני שני שני noun masculine singular absolute unspecified unspecified  	I_ORG	null
24 ב ב באוניברסיטת preposition unspecified unspecified unspecified unspecified unspecified 0 
24 אוניברסיטת אוניברסיטה באוניברסיטת noun feminine singular construct unspecified unspecified  	I_ORG	null
25 תלאביב תלאביב תלאביב properName unspecified unspecified unspecified unspecified unspecified  	I_ORG	null
26 ) ) ) punctuation unspecified unspecified unspecified unspecified unspecified  	O	null
27 . . . punctuation unspecified unspecified unspecified unspecified unspecified  	O	null
28 ###NUMBER### ###NUMBER### ###NUMBER### numeral unspecified unspecified unspecified unspecified unspecified  	I_DATE	null
29 כותרת כותרת כותרת noun feminine singular absolute unspecified unspecified  	O	null
30 עבודת עבודה עבודת noun feminine singular construct unspecified unspecified  	O	null
31 ה ה המוסמך definiteArticle unspecified unspecified unspecified unspecified unspecified 0 
31 המוסמך מוסמך המוסמך noun masculine singular absolute unspecified unspecified  	O	null
32 : : : punctuation unspecified unspecified unspecified unspecified unspecified  	O	null
33 סיפורי סיפור סיפורי noun masculine plural construct unspecified unspecified  	O	null
34 מקרא מקרא מקרא noun masculine singular absolute unspecified unspecified  	O	null
35 ל ל לילדים preposition unspecified unspecified unspecified unspecified unspecified 0 
35 ילדים ילד לילדים noun masculine plural absolute unspecified unspecified  	O	null
36 יהודים יהודי יהודים adjective masculine plural absolute unspecified unspecified  	O	null
37 ב ב בתקופת preposition unspecified unspecified unspecified unspecified unspecified 0 
37 תקופת תקופה בתקופת noun feminine singular construct unspecified unspecified  	O	null
38 ה ה ההשכלה definiteArticle unspecified unspecified unspecified unspecified unspecified 0 
38 ההשכלה השכלה ההשכלה noun feminine singular absolute unspecified unspecified  	O	null
39 ב ב בגרמניה preposition unspecified unspecified unspecified unspecified unspecified 0 
39 גרמניה גרמני בגרמניה properName unspecified unspecified unspecified unspecified unspecified  	I_LOC	null
40 : : : punctuation unspecified unspecified unspecified unspecified unspecified  	O	null
41 ה ה ההשכלה definiteArticle unspecified unspecified unspecified unspecified unspecified 0 
41 ההשכלה השכלה ההשכלה noun feminine singular absolute unspecified unspecified  	O	null
42 ב ב ביחסה preposition unspecified unspecified unspecified unspecified unspecified 0 
42 יחס יחס ביחסה noun masculine singular absolute unspecified unspecified  
42 ה ה ביחסה possessive feminine singular unspecified 3 unspecified 0 	O	null
43 ל ל לתנ"ך preposition unspecified unspecified unspecified unspecified unspecified 0 
43 ה ה לתנ"ך definiteArticle unspecified unspecified unspecified unspecified unspecified 0 
43 התנ"ך התנ"ך לתנ"ך noun masculine singular absolute unspecified unspecified  	O	null
44 , , , punctuation unspecified unspecified unspecified unspecified unspecified  	O	null
45 ל ל להיסטוריה preposition unspecified unspecified unspecified unspecified unspecified 0 
45 ה ה להיסטוריה definiteArticle unspecified unspecified unspecified unspecified unspecified 0 
45 ההיסטוריה היסטוריה להיסטוריה noun feminine singular absolute unspecified unspecified  	O	null
46 ו ו ולמודלים conjunction unspecified unspecified unspecified unspecified unspecified 0 
46 ל ל ולמודלים preposition unspecified unspecified unspecified unspecified unspecified 0 
46 מודלים מודל ולמודלים noun masculine plural absolute unspecified unspecified  	O	null
47 גרמניים גרמני גרמניים adjective masculine plural absolute unspecified unspecified  	O	null
48 ) ) ) punctuation unspecified unspecified unspecified unspecified unspecified  	O	null
49 . . . punctuation unspecified unspecified unspecified unspecified unspecified  	O	null
50 ###NUMBER### ###NUMBER### ###NUMBER### numeral unspecified unspecified unspecified unspecified unspecified  	I_DATE	null
51 את את את at-preposition unspecified unspecified unspecified unspecified unspecified  	O	null
52 עבודת עבודה עבודת noun feminine singular construct unspecified unspecified  	O	null
53 ה ה הדוקטור definiteArticle unspecified unspecified unspecified unspecified unspecified 0 
53 הדוקטור דוקטור הדוקטור noun masculine singular absolute unspecified unspecified  	O	null
54 של של שלו shel-preposition unspecified unspecified unspecified unspecified unspecified  
54 ו ו שלו pronomial masculine singular unspecified 3 unspecified 0 	O	null
55 כתב כתב כתב verb masculine singular unspecified 3 past  	O	null
56 ב ב באותו preposition unspecified unspecified unspecified unspecified unspecified 0 
56 אותו אותו באותו quantifier unspecified unspecified construct unspecified unspecified  	O	null
57 מוסד מוסד מוסד noun masculine singular absolute unspecified unspecified  	O	null
58 . . . punctuation unspecified unspecified unspecified unspecified unspecified  	O	null

0 כותרת כותרת כותרתה noun feminine singular absolute unspecified unspecified  
0 ה ה כותרתה possessive feminine singular unspecified 3 unspecified 0 	O	null
1 : : : punctuation unspecified unspecified unspecified unspecified unspecified  	O	null
2 התמודדות התמודדות התמודדות noun feminine singular construct unspecified unspecified  	O	null
3 חכמת חכמה חכמת noun feminine singular construct unspecified unspecified  	O	null
4 ישראל ישראל ישראל properName unspecified unspecified unspecified unspecified unspecified  	I_LOC	null
5 ב ב בגרמניה preposition unspecified unspecified unspecified unspecified unspecified 0 
5 גרמניה גרמני בגרמניה properName unspecified unspecified unspecified unspecified unspecified  	I_LOC	null
6 עם עם עם preposition unspecified unspecified unspecified unspecified unspecified  	O	null
7 ביקורת ביקורת ביקורת noun feminine singular construct unspecified unspecified  	O	null
8 ה ה המקרא definiteArticle unspecified unspecified unspecified unspecified unspecified 0 
8 המקרא מקרא המקרא noun masculine singular absolute unspecified unspecified  	O	null
9 ב ב במאה preposition unspecified unspecified unspecified unspecified unspecified 0 
9 ה ה במאה definiteArticle unspecified unspecified unspecified unspecified unspecified 0 
9 המאה ORD-CARD100 במאה numeral feminine plural absolute unspecified unspecified  	O	null
10 ה ה התשע definiteArticle unspecified unspecified unspecified unspecified unspecified 0 
10 התשע CARD9 התשע numeral feminine singular absolute unspecified unspecified  	O	null
11 - - - punctuation unspecified unspecified unspecified unspecified unspecified  	O	null
12 עשרה CARD10 עשרה numeral masculine plural absolute unspecified unspecified  	O	null
13 ) ) ) punctuation unspecified unspecified unspecified unspecified unspecified  	O	null
14 . . . punctuation unspecified unspecified unspecified unspecified unspecified  	O	null
15 ###NUMBER### ###NUMBER### ###NUMBER### numeral unspecified unspecified unspecified unspecified unspecified  	I_DATE	null
16 שימש שימש שימש verb masculine singular unspecified 3 past  	O	null
17 כ כ כמתרגל preposition unspecified unspecified unspecified unspecified unspecified 0 
17 מתרגל תרגל כמתרגל participle masculine singular absolute any unspecified  	O	null
18 ב ב בחוג preposition unspecified unspecified unspecified unspecified unspecified 0 
18 ה ה בחוג definiteArticle unspecified unspecified unspecified unspecified unspecified 0 
18 החוג חוג בחוג noun masculine singular absolute unspecified unspecified  	O	null
19 ל ל לתורת preposition unspecified unspecified unspecified unspecified unspecified 0 
19 תורת תורה לתורת noun feminine singular construct unspecified unspecified  	O	null
20 ה ה הספרות definiteArticle unspecified unspecified unspecified unspecified unspecified 0 
20 הספרות ספרות הספרות noun feminine singular absolute unspecified unspecified  	O	null
21 ב ב באוניברסיטת preposition unspecified unspecified unspecified unspecified unspecified 0 
21 אוניברסיטת אוניברסיטה באוניברסיטת noun feminine singular construct unspecified unspecified  	I_ORG	null
22 תלאביב תלאביב תלאביב properName unspecified unspecified unspecified unspecified unspecified  	I_ORG	null
23 - - - punctuation unspecified unspecified unspecified unspecified unspecified  	O	null
24 ###NUMBER### ###NUMBER### ###NUMBER### numeral unspecified unspecified unspecified unspecified unspecified  	I_DATE	null
25 ) ) ) punctuation unspecified unspecified unspecified unspecified unspecified  	O	null
26 . . . punctuation unspecified unspecified unspecified unspecified unspecified  	O	null

0 ###NUMBER### ###NUMBER### ###NUMBER### numeral unspecified unspecified unspecified unspecified unspecified  	I_DATE	null
1 עורךמשנה עורךמשנה עורךמשנה participle feminine singular construct any unspecified  	O	null
2 של של של shel-preposition unspecified unspecified unspecified unspecified unspecified  	O	null
3 ה ה הפרויקט definiteArticle unspecified unspecified unspecified unspecified unspecified 0 
3 הפרויקט פרויקט הפרויקט noun masculine singular absolute unspecified unspecified  	O	null
4 ה ה האנציקלופדי definiteArticle unspecified unspecified unspecified unspecified unspecified 0 
4 האנציקלופדי האנציקלופדי האנציקלופדי adjective masculine singular absolute unspecified unspecified  	O	null
5 The The The foreign unspecified unspecified unspecified unspecified unspecified  	I_ORG	null
6 Encyclopedia Encyclopedia Encyclopedia foreign unspecified unspecified unspecified unspecified unspecified  	I_ORG	null
7 of of of foreign unspecified unspecified unspecified unspecified unspecified  	I_ORG	null
8 the the the foreign unspecified unspecified unspecified unspecified unspecified  	I_ORG	null
9 Bible Bible Bible foreign unspecified unspecified unspecified unspecified unspecified  	I_ORG	null
10 and and and foreign unspecified unspecified unspecified unspecified unspecified  	I_ORG	null
11 its its its foreign unspecified unspecified unspecified unspecified unspecified  	I_ORG	null
12 Reception Reception Reception foreign unspecified unspecified unspecified unspecified unspecified  	I_ORG	null
13 . . . punctuation unspecified unspecified unspecified unspecified unspecified  	O	null

0 מתרגם מתרגם מתרגם noun masculine singular construct unspecified unspecified  	O	null
1 ספרות ספרות ספרות noun feminine singular absolute unspecified unspecified  	O	null
2 מ מ מגרמנית preposition unspecified unspecified unspecified unspecified unspecified 0 
2 גרמנית גרמנית מגרמנית properName feminine singular unspecified unspecified unspecified  	I_LOC	null
3 , , , punctuation unspecified unspecified unspecified unspecified unspecified  	O	null
4 מ מ מהולנדית preposition unspecified unspecified unspecified unspecified unspecified 0 
4 הולנדית הולנדי מהולנדית properName unspecified unspecified unspecified unspecified unspecified  	I_LOC	null
5 , , , punctuation unspecified unspecified unspecified unspecified unspecified  	O	null
6 מ מ מאנגלית preposition unspecified unspecified unspecified unspecified unspecified 0 
6 אנגלית אנגלית מאנגלית properName feminine singular unspecified unspecified unspecified  	I_LOC	null
7 , , , punctuation unspecified unspecified unspecified unspecified unspecified  	O	null
8 מ מ מלטינית preposition unspecified unspecified unspecified unspecified unspecified 0 
8 לטינית לטיני מלטינית noun feminine singular absolute unspecified unspecified  	O	null
9 ו ו ומאתיופית conjunction unspecified unspecified unspecified unspecified unspecified 0 
9 מ מ ומאתיופית preposition unspecified unspecified unspecified unspecified unspecified 0 
9 אתיופית אתיופי ומאתיופית noun feminine singular absolute unspecified unspecified  	O	null
10 קלאסית קלאסי קלאסית adjective feminine singular absolute unspecified unspecified  	O	null
11 ( ( ( punctuation unspecified unspecified unspecified unspecified unspecified  	O	null
12 גע גע געז noun masculine singular absolute unspecified unspecified  
12 ה ה געז possessive feminine singular unspecified 3 unspecified 0 	O	null
13 ) ) ) punctuation unspecified unspecified unspecified unspecified unspecified  	O	null
14 . . . punctuation unspecified unspecified unspecified unspecified unspecified  	O	null

0 מ מ מתרגומיו preposition unspecified unspecified unspecified unspecified unspecified 0 
0 תרגומי תרגום מתרגומיו noun masculine plural absolute unspecified unspecified  
0 ו ו מתרגומיו possessive masculine singular unspecified 3 unspecified 0 	O	null
1 : : : punctuation unspecified unspecified unspecified unspecified unspecified  	O	null
2 אנאטול אנאטול אנאטול properName unspecified unspecified unspecified unspecified unspecified  	I_PERS	null
3 רנייה רנייה רנייה properName unspecified unspecified unspecified unspecified unspecified  	I_PERS	null
4 , , , punctuation unspecified unspecified unspecified unspecified unspecified  	O	null
5 כיכר כיכר כיכר noun feminine singular construct unspecified unspecified  	O	null
6 ה ה העיר definiteArticle unspecified unspecified unspecified unspecified unspecified 0 
6 העיר עיר העיר noun feminine singular absolute unspecified unspecified  	O	null
7 ריקה ריק ריקה adjective feminine singular absolute unspecified unspecified  	O	null
8 , , , punctuation unspecified unspecified unspecified unspecified unspecified  	O	null
9 אודיסאה אודיסיאה אודיסאה noun feminine singular absolute unspecified unspecified  	O	null
10 יהודית יהודי יהודית adjective feminine singular absolute unspecified unspecified  	O	null
11 ב ב בבולחוב preposition unspecified unspecified unspecified unspecified unspecified 0 
11 בולחוב בולחוב בבולחוב properName unspecified unspecified unspecified unspecified unspecified  	I_LOC	null
12 ( ( ( punctuation unspecified unspecified unspecified unspecified unspecified  	O	null
13 מ מ מגרמנית preposition unspecified unspecified unspecified unspecified unspecified 0 
13 גרמנית גרמנית מגרמנית properName feminine singular unspecified unspecified unspecified  	I_LOC	null
14 , , , punctuation unspecified unspecified unspecified unspecified unspecified  	O	null
15 ) ) ) punctuation unspecified unspecified unspecified unspecified unspecified  	O	null
16 ; ; ; punctuation unspecified unspecified unspecified unspecified unspecified  	O	null
17 ###NUMBER### ###NUMBER### ###NUMBER### numeral unspecified unspecified unspecified unspecified unspecified  	I_DATE	null
18 היינריך היינריך היינריך properName masculine singular unspecified unspecified unspecified  	I_PERS	null
19 פון פון פון properName unspecified unspecified unspecified unspecified unspecified  	I_PERS	null
20 קלייסט קלייסט קלייסט properName unspecified unspecified unspecified unspecified unspecified  	I_PERS	null
21 , , , punctuation unspecified unspecified unspecified unspecified unspecified  	O	null
22 קולהאס קולהאס קולהאס properName unspecified unspecified unspecified unspecified unspecified  	I_PERS	null
23 ו ו ואחרים conjunction unspecified unspecified unspecified unspecified unspecified 0 
23 אחרים אחר ואחרים adjective masculine plural absolute unspecified unspecified  	O	null
24 , , , punctuation unspecified unspecified unspecified unspecified unspecified  	O	null
25 כל כול כל quantifier unspecified unspecified construct unspecified unspecified  	O	null
26 ה ה הנובלות definiteArticle unspecified unspecified unspecified unspecified unspecified 0 
26 הנובלות נובלה הנובלות noun feminine plural absolute unspecified unspecified  	O	null
27 ( ( ( punctuation unspecified unspecified unspecified unspecified unspecified  	O	null
28 מ מ מגרמנית preposition unspecified unspecified unspecified unspecified unspecified 0 
28 גרמנית גרמנית מגרמנית properName feminine singular unspecified unspecified unspecified  	I_ORG	null
29 , , , punctuation unspecified unspecified unspecified unspecified unspecified  	O	null
30 ) ) ) punctuation unspecified unspecified unspecified unspecified unspecified  	O	null
31 ; ; ; punctuation unspecified unspecified unspecified unspecified unspecified  	O	null
32 ###NUMBER### ###NUMBER### ###NUMBER### numeral unspecified unspecified unspecified unspecified unspecified  	I_DATE	null
33 אנה אנה אנה properName unspecified unspecified unspecified unspecified unspecified  	I_PERS	null
34 אנקוויסט אנקוויסט אנקוויסט properName unspecified unspecified unspecified unspecified unspecified  	I_PERS	null
35 , , , punctuation unspecified unspecified unspecified unspecified unspecified  	O	null
36 ה ה הסוד definiteArticle unspecified unspecified unspecified unspecified unspecified 0 
36 הסוד סוד הסוד noun masculine singular absolute unspecified unspecified  	O	null
37 ( ( ( punctuation unspecified unspecified unspecified unspecified unspecified  	O	null
38 מ מ מהולנדית preposition unspecified unspecified unspecified unspecified unspecified 0 
38 הולנדית הולנדית מהולנדית properName feminine singular unspecified unspecified unspecified  	I_ORG	null
39 , , , punctuation unspecified unspecified unspecified unspecified unspecified  	O	null
40 ) ) ) punctuation unspecified unspecified unspecified unspecified unspecified  	O	null
41 ; ; ; punctuation unspecified unspecified unspecified unspecified unspecified  	O	null
42 ###NUMBER### ###NUMBER### ###NUMBER### numeral unspecified unspecified unspecified unspecified unspecified  	I_DATE	null
43 קרל קרל קרל properName unspecified unspecified unspecified unspecified unspecified  	O	null
44 שמיט שמיט שמיט adjective masculine singular absolute unspecified unspecified  	O	null
45 , , , punctuation unspecified unspecified unspecified unspecified unspecified  	O	null
46 תיאולוגיה תיאולוגיה תיאולוגיה noun feminine singular absolute unspecified unspecified  	O	null
47 פוליטית פוליטי פוליטית adjective feminine singular absolute unspecified unspecified  	O	null
48 ( ( ( punctuation unspecified unspecified unspecified unspecified unspecified  	O	null
49 מ מ מגרמנית preposition unspecified unspecified unspecified unspecified unspecified 0 
49 גרמנית גרמנית מגרמנית properName feminine singular unspecified unspecified unspecified  	I_ORG	null
50 , , , punctuation unspecified unspecified unspecified unspecified unspecified  	O	null
51 ) ) ) punctuation unspecified unspecified unspecified unspecified unspecified  	O	null
52 ; ; ; punctuation unspecified unspecified unspecified unspecified unspecified  	O	null
53 ###NUMBER### ###NUMBER### ###NUMBER### numeral unspecified unspecified unspecified unspecified unspecified  	I_DATE	null
54 יוקה יוקה יוקה noun feminine singular absolute unspecified unspecified  	O	null
55 פון פון פון properName unspecified unspecified unspecified unspecified unspecified  	I_PERS	null
56 לוו לווה לוון participle masculine singular unspecified any unspecified  
56 ן ן לוון possessive feminine plural unspecified 3 unspecified 0 	I_ORG	null
57 , , , punctuation unspecified unspecified unspecified unspecified unspecified  	O	null
58 ל ל לוידע preposition unspecified unspecified unspecified unspecified unspecified 0 
58 וידע וידע לוידע noun masculine singular absolute unspecified unspecified  	O	null
59 ( ( ( punctuation unspecified unspecified unspecified unspecified unspecified  	O	null
60 מ מ מהולנדית preposition unspecified unspecified unspecified unspecified unspecified 0 
60 הולנדית הולנדית מהולנדית properName feminine singular unspecified unspecified unspecified  	I_ORG	null
61 , , , punctuation unspecified unspecified unspecified unspecified unspecified  	O	null
62 ) ) ) punctuation unspecified unspecified unspecified unspecified unspecified  	O	null
63 ; ; ; punctuation unspecified unspecified unspecified unspecified unspecified  	O	null
64 ###NUMBER### ###NUMBER### ###NUMBER### numeral unspecified unspecified unspecified unspecified unspecified  	I_DATE	null
65 אנה אנה אנה properName unspecified unspecified unspecified unspecified unspecified  	I_PERS	null
66 אנקוויסט אנקוויסט אנקוויסט properName unspecified unspecified unspecified unspecified unspecified  	I_PERS	null
67 , , , punctuation unspecified unspecified unspecified unspecified unspecified  	O	null
68 השיבה השיב השיבה verb feminine singular unspecified 3 past  	O	null
69 הביתה הביתה הביתה adverb unspecified unspecified unspecified unspecified unspecified  	O	null
70 ( ( ( punctuation unspecified unspecified unspecified unspecified unspecified  	O	null
71 מ מ מהולנדית preposition unspecified unspecified unspecified unspecified unspecified 0 
71 הולנדית הולנדית מהולנדית properName feminine singular unspecified unspecified unspecified  	I_ORG	null
72 , , , punctuation unspecified unspecified unspecified unspecified unspecified  	O	null
73 ) ) ) punctuation unspecified unspecified unspecified unspecified unspecified  	O	null
74 ; ; ; punctuation unspecified unspecified unspecified unspecified unspecified  	O	null
75 ###NUMBER### ###NUMBER### ###NUMBER### numeral unspecified unspecified unspecified unspecified unspecified  	I_DATE	null
76 כבוד כבוד כבוד noun masculine singular construct unspecified unspecified  	O	null
77 ה ה המלכים definiteArticle unspecified unspecified unspecified unspecified unspecified 0 
77 המלכים מלך המלכים noun masculine plural absolute unspecified unspecified  	O	null
78 , , , punctuation unspecified unspecified unspecified unspecified unspecified  	O	null
79 ה ה האפוס definiteArticle unspecified unspecified unspecified unspecified unspecified 0 
79 האפוס אפוס האפוס noun masculine singular absolute unspecified unspecified  	O	null
80 ה ה הלאומי definiteArticle unspecified unspecified unspecified unspecified unspecified 0 
80 הלאומי לאומי הלאומי adjective masculine singular absolute unspecified unspecified  	O	null
81 ה ה האתיופי definiteArticle unspecified unspecified unspecified unspecified unspecified 0 
81 האתיופי אתיופי האתיופי noun masculine singular absolute unspecified unspecified  	O	null
82 , , , punctuation unspecified unspecified unspecified unspecified unspecified  	O	null
83 ש ש שבמרכזו relativizer/subordinatingConjunction unspecified unspecified unspecified unspecified unspecified 0 
83 במרכז מרכז שבמרכזו verb unspecified unspecified unspecified unspecified infinitive  
83 ו ו שבמרכזו accusative-or-nominative masculine singular unspecified 3 unspecified 0 	O	null
84 ה ה הפגישה definiteArticle unspecified unspecified unspecified unspecified unspecified 0 
84 הפגישה פגישה הפגישה noun feminine singular absolute unspecified unspecified  	O	null
85 בין בין בין conjunction unspecified unspecified unspecified unspecified unspecified  	O	null
86 מ מ מלכת preposition unspecified unspecified unspecified unspecified unspecified 0 
86 לכת לכה מלכת noun feminine singular construct unspecified unspecified  	O	null
87 שבא שבא שבא properName unspecified unspecified unspecified unspecified unspecified  	I_LOC	null
88 ל ל לשלמה preposition unspecified unspecified unspecified unspecified unspecified 0 
88 ה ה לשלמה definiteArticle unspecified unspecified unspecified unspecified unspecified 0 
88 השלמה שלם לשלמה adjective feminine singular absolute unspecified unspecified  	O	null
89 ה ה המלך definiteArticle unspecified unspecified unspecified unspecified unspecified 0 
89 המלך מלך המלך noun masculine singular absolute unspecified unspecified  	O	null
90 ( ( ( punctuation unspecified unspecified unspecified unspecified unspecified  	O	null
91 מ מ משפת preposition unspecified unspecified unspecified unspecified unspecified 0 
91 שפת שפה משפת properName unspecified unspecified unspecified unspecified unspecified  	I_PERS	null
92 געז געז געז properName unspecified unspecified unspecified unspecified unspecified  	I_PERS	null
93 , , , punctuation unspecified unspecified unspecified unspecified unspecified  	O	null
94 עם עם עם preposition unspecified unspecified unspecified unspecified unspecified  	O	null
95 מבוא מבוא מבוא noun masculine singular construct unspecified unspecified  	O	null
96 מקיף הקיף מקיף verb masculine singular unspecified any beinoni  	O	null
97 , , , punctuation unspecified unspecified unspecified unspecified unspecified  	O	null
98 ###NUMBER### ###NUMBER### ###NUMBER### numeral unspecified unspecified unspecified unspecified unspecified  	I_DATE	null
99 ) ) ) punctuation unspecified unspecified unspecified unspecified unspecified  	O	null
100 . . . punctuation unspecified unspecified unspecified unspecified unspecified  	O	null

0 References References References foreign unspecified unspecified unspecified unspecified unspecified  	O	null
1 : : : punctuation unspecified unspecified unspecified unspecified unspecified  	O	null
2 אלטרס אלטרס אלטרס properName unspecified unspecified unspecified unspecified unspecified  	I_ORG	null
3 , , , punctuation unspecified unspecified unspecified unspecified unspecified  	O	null
4 אלון אלון אלון properName unspecified unspecified unspecified unspecified unspecified  	I_PERS	null
5 ( ( ( punctuation unspecified unspecified unspecified unspecified unspecified  	O	null
6 מראיין מראיין מראיין noun masculine singular absolute unspecified unspecified  	O	null
7 ) ) ) punctuation unspecified unspecified unspecified unspecified unspecified  	O	null
8 . . . punctuation unspecified unspecified unspecified unspecified unspecified  	O	null

0 " " " punctuation unspecified unspecified unspecified unspecified unspecified  	O	null
1 ה ה השפה definiteArticle unspecified unspecified unspecified unspecified unspecified 0 
1 השפה שפה השפה noun feminine singular absolute unspecified unspecified  	O	null
2 תמיד תמיד תמיד adverb unspecified unspecified unspecified unspecified unspecified  	I_ORG	null
3 כישפה כישף כישפה verb feminine singular unspecified 3 past  	O	null
4 את את אותי at-preposition unspecified unspecified unspecified unspecified unspecified  
4 י י אותי pronomial masculine-and-feminine singular unspecified 1 unspecified 0 	O	null
5 " " " punctuation unspecified unspecified unspecified unspecified unspecified  	O	null
6 . . . punctuation unspecified unspecified unspecified unspecified unspecified  	O	null
7 ידיעות ידיעה ידיעות noun feminine plural absolute unspecified unspecified  	O	null
8 אחרונותתרבות אחרונותתרבות אחרונותתרבות adjective feminine plural construct unspecified unspecified  	O	null
9 , , , punctuation unspecified unspecified unspecified unspecified unspecified  	O	null
10 ספרות ספרות ספרות noun feminine singular absolute unspecified unspecified  	O	null
11 , , , punctuation unspecified unspecified unspecified unspecified unspecified  	O	null
12 אמנות אמנות אמנות noun feminine singular absolute unspecified unspecified  	O	null
13 . . . punctuation unspecified unspecified unspecified unspecified unspecified  	O	null

0 ###NUMEXP### ###NUMEXP### ###NUMEXP### numberExpression unspecified unspecified unspecified unspecified unspecified  	I_DATE	null
1 . . . punctuation unspecified unspecified unspecified unspecified unspecified  	O	null

0 ; ; ; punctuation unspecified unspecified unspecified unspecified unspecified  	O	null
1 ###NUMBER### ###NUMBER### ###NUMBER### numeral unspecified unspecified unspecified unspecified unspecified  	O	null
2 קליינברג קליינברג קליינברג properName unspecified unspecified unspecified unspecified unspecified  	O	null
3 , , , punctuation unspecified unspecified unspecified unspecified unspecified  	O	null
4 אביעד אביעד אביעד properName unspecified unspecified unspecified unspecified unspecified  	I_PERS	null
5 . . . punctuation unspecified unspecified unspecified unspecified unspecified  	O	null

0 " " " punctuation unspecified unspecified unspecified unspecified unspecified  	O	null
1 יראת יראה יראת noun feminine singular construct unspecified unspecified  	O	null
2 כבוד כבוד כבוד noun masculine singular absolute unspecified unspecified  	O	null
3 ו ו ושיגעונו conjunction unspecified unspecified unspecified unspecified unspecified 0 
3 שיגעון שיגעון ושיגעונו noun masculine singular absolute unspecified unspecified  
3 ו ו ושיגעונו possessive masculine singular unspecified 3 unspecified 0 	O	null
4 " " " punctuation unspecified unspecified unspecified unspecified unspecified  	O	null
5 . . . punctuation unspecified unspecified unspecified unspecified unspecified  	O	null

0 ה ה הארץ definiteArticle unspecified unspecified unspecified unspecified unspecified 0 
0 הארץ ארץ הארץ noun feminine singular absolute unspecified unspecified  	O	null
1 ספרים ספר ספרים noun masculine plural absolute unspecified unspecified  	O	null
2 . . . punctuation unspecified unspecified unspecified unspecified unspecified  	O	null

0 ###NUMEXP### ###NUMEXP### ###NUMEXP### numberExpression unspecified unspecified unspecified unspecified unspecified  	I_DATE	null
1 . . . punctuation unspecified unspecified unspecified unspecified unspecified  	O	null

0 ###NUMBER### ###NUMBER### ###NUMBER### numeral unspecified unspecified unspecified unspecified unspecified  	O	null
1 . . . punctuation unspecified unspecified unspecified unspecified unspecified  	O	null

