0 Name Name Name foreign unspecified unspecified unspecified unspecified unspecified  	O	null
1 : : : punctuation unspecified unspecified unspecified unspecified unspecified  	O	null
2 זלוף זלוף זלוף adverb unspecified unspecified unspecified unspecified unspecified  	O	null
3 , , , punctuation unspecified unspecified unspecified unspecified unspecified  	O	null
4 לילי ליל לילי properName unspecified unspecified unspecified unspecified unspecified  	I_PERS	null
5 Birth Birth Birth foreign unspecified unspecified unspecified unspecified unspecified  	O	null
6 Year Year Year foreign unspecified unspecified unspecified unspecified unspecified  	O	null
7 : : : punctuation unspecified unspecified unspecified unspecified unspecified  	O	null
8 ###NUMBER### ###NUMBER### ###NUMBER### numeral unspecified unspecified unspecified unspecified unspecified  	I_DATE	null
9 Birth Birth Birth foreign unspecified unspecified unspecified unspecified unspecified  	O	null
10 Place Place Place foreign unspecified unspecified unspecified unspecified unspecified  	O	null
11 : : : punctuation unspecified unspecified unspecified unspecified unspecified  	O	null
12 עיראק עיראק עיראק properName unspecified unspecified unspecified unspecified unspecified  	I_LOC	null
13 Occupation Occupation Occupation foreign unspecified unspecified unspecified unspecified unspecified  	O	null
14 : : : punctuation unspecified unspecified unspecified unspecified unspecified  	O	null
15 משוררת משורר משוררת noun feminine singular absolute unspecified unspecified  	O	null
16 Entry Entry Entry foreign unspecified unspecified unspecified unspecified unspecified  	O	null
17 writer writer writer foreign unspecified unspecified unspecified unspecified unspecified  	O	null
18 : : : punctuation unspecified unspecified unspecified unspecified unspecified  	O	null
19 מיכל מיכל מיכל properName feminine singular unspecified unspecified unspecified  	I_ORG	null
20 פלס פלס פלס noun masculine singular absolute unspecified unspecified  	O	null
21 Entry Entry Entry foreign unspecified unspecified unspecified unspecified unspecified  	O	null
22 Value Value Value foreign unspecified unspecified unspecified unspecified unspecified  	O	null
23 : : : punctuation unspecified unspecified unspecified unspecified unspecified  	O	null
24 נולדה נולד נולדה verb feminine singular unspecified 3 past  	O	null
25 ב ב בעיראק preposition unspecified unspecified unspecified unspecified unspecified 0 
25 עיראק עיראק בעיראק properName unspecified unspecified unspecified unspecified unspecified  	I_LOC	null
26 . . . punctuation unspecified unspecified unspecified unspecified unspecified  	O	null

0 היתה הוא היתה copula feminine singular unspecified 3 past  	O	null
1 פעילה פעיל פעילה adjective feminine singular absolute unspecified unspecified  	O	null
2 ב ב בתנועת preposition unspecified unspecified unspecified unspecified unspecified 0 
2 תנועת תנועה בתנועת noun feminine singular construct unspecified unspecified  	O	null
3 ה ה המחתרת definiteArticle unspecified unspecified unspecified unspecified unspecified 0 
3 המחתרת מחתרת המחתרת noun feminine singular absolute unspecified unspecified  	I_ORG	null
4 ה ה היהודית definiteArticle unspecified unspecified unspecified unspecified unspecified 0 
4 היהודית יהודי היהודית adjective feminine singular absolute unspecified unspecified  	I_ORG	null
5 ב ב בעיראק preposition unspecified unspecified unspecified unspecified unspecified 0 
5 עיראק עיראק בעיראק properName unspecified unspecified unspecified unspecified unspecified  	I_LOC	null
6 , , , punctuation unspecified unspecified unspecified unspecified unspecified  	O	null
7 ו ו ובה conjunction unspecified unspecified unspecified unspecified unspecified 0 
7 ב ב ובה preposition unspecified unspecified unspecified unspecified unspecified  
7 ה ה ובה pronomial feminine singular unspecified 3 unspecified 0 	O	null
8 למדה למד למדה verb feminine singular unspecified 3 past  	O	null
9 עברית עברית עברית properName feminine singular unspecified unspecified unspecified  	I_PERS	null
10 . . . punctuation unspecified unspecified unspecified unspecified unspecified  	O	null

0 התייתמה התייתם התייתמה verb feminine singular unspecified 3 past  	O	null
1 מ מ מאמה preposition unspecified unspecified unspecified unspecified unspecified 0 
1 אמה אמה מאמה properName unspecified unspecified unspecified unspecified unspecified  	I_PERS	null
2 ב ב בגיל preposition unspecified unspecified unspecified unspecified unspecified 0 
2 גיל גיל בגיל noun masculine singular absolute unspecified unspecified  	O	null
3 צעיר צעיר צעיר adjective masculine singular absolute unspecified unspecified  	O	null
4 ו ו וב conjunction unspecified unspecified unspecified unspecified unspecified 0 
4 ב ב וב preposition unspecified unspecified unspecified unspecified unspecified 0 	I_ORG	null
5 - - - punctuation unspecified unspecified unspecified unspecified unspecified  	I_ORG	null
6 ###NUMBER### ###NUMBER### ###NUMBER### numeral unspecified unspecified unspecified unspecified unspecified  	I_DATE	null
7 עלתה עלה עלתה verb feminine singular unspecified 3 past  	O	null
8 ל ל לארץ preposition unspecified unspecified unspecified unspecified unspecified 0 
8 ארץ ארץ לארץ noun feminine singular construct unspecified unspecified  	O	null
9 דרך דרך דרך noun feminine singular construct unspecified unspecified  	O	null
10 טהרן טהראן טהרן properName unspecified unspecified unspecified unspecified unspecified  	I_LOC	null
11 , , , punctuation unspecified unspecified unspecified unspecified unspecified  	O	null
12 עם עם עם preposition unspecified unspecified unspecified unspecified unspecified  	O	null
13 אחי אח אחיה noun masculine plural absolute unspecified unspecified  
13 ה ה אחיה possessive feminine singular unspecified 3 unspecified 0 	I_LOC	null
14 ו ו ואחותה conjunction unspecified unspecified unspecified unspecified unspecified 0 
14 אחות אח ואחותה noun feminine singular absolute unspecified unspecified  
14 ה ה ואחותה possessive feminine singular unspecified 3 unspecified 0 	O	null
15 . . . punctuation unspecified unspecified unspecified unspecified unspecified  	O	null

0 אביה אביה אביה properName unspecified unspecified unspecified unspecified unspecified  	I_PERS	null
1 , , , punctuation unspecified unspecified unspecified unspecified unspecified  	O	null
2 ש ש שנפצע relativizer/subordinatingConjunction unspecified unspecified unspecified unspecified unspecified 0 
2 נפצע נפצע שנפצע verb masculine singular unspecified 3 past  	O	null
3 ב ב בפרעות preposition unspecified unspecified unspecified unspecified unspecified 0 
3 פרעות פרעות בפרעות noun feminine plural absolute unspecified unspecified  	O	null
4 , , , punctuation unspecified unspecified unspecified unspecified unspecified  	O	null
5 לא לא לא negation unspecified unspecified unspecified unspecified unspecified  	O	null
6 הצטרף הצטרף הצטרף verb masculine singular unspecified 3 past  	O	null
7 ל ל לילדיו preposition unspecified unspecified unspecified unspecified unspecified 0 
7 ילדי ילד לילדיו noun masculine plural absolute unspecified unspecified  
7 ו ו לילדיו possessive masculine singular unspecified 3 unspecified 0 	O	null
8 . . . punctuation unspecified unspecified unspecified unspecified unspecified  	O	null

0 עם עם עם preposition unspecified unspecified unspecified unspecified unspecified  	O	null
1 עליית עלייה עלייתה noun feminine singular absolute unspecified unspecified  
1 ה ה עלייתה possessive feminine singular unspecified 3 unspecified 0 	O	null
2 ארצה ארצה ארצה adverb unspecified unspecified unspecified unspecified unspecified  	O	null
3 נשלחה נשלח נשלחה verb feminine singular unspecified 3 past  	I_LOC	null
4 ל ל לקיבוץ preposition unspecified unspecified unspecified unspecified unspecified 0 
4 קיבוץ קיבוץ לקיבוץ noun masculine singular construct unspecified unspecified  	I_LOC	null
5 רמת רמה רמת noun feminine singular construct unspecified unspecified  	I_LOC	null
6 יוחנן יוחנן יוחנן properName unspecified unspecified unspecified unspecified unspecified  	I_PERS	null
7 . . . punctuation unspecified unspecified unspecified unspecified unspecified  	O	null

0 ב ב בזכות preposition unspecified unspecified unspecified unspecified unspecified 0 
0 זכות זכות בזכות noun feminine singular construct unspecified unspecified  	O	null
1 ידיעת ידיעה ידיעת noun feminine singular construct unspecified unspecified  	O	null
2 ה ה העברית definiteArticle unspecified unspecified unspecified unspecified unspecified 0 
2 העברית עברי העברית adjective feminine singular absolute unspecified unspecified  	O	null
3 של של שלה shel-preposition unspecified unspecified unspecified unspecified unspecified  
3 ה ה שלה pronomial feminine singular unspecified 3 unspecified 0 	O	null
4 גויסה גויס גויסה verb feminine singular unspecified 3 past  	O	null
5 ב ב ב preposition unspecified unspecified unspecified unspecified unspecified 0 	O	null
6 - - - punctuation unspecified unspecified unspecified unspecified unspecified  	O	null
7 ###NUMBER### ###NUMBER### ###NUMBER### numeral unspecified unspecified unspecified unspecified unspecified  	I_DATE	null
8 על על על preposition unspecified unspecified unspecified unspecified unspecified  	O	null
9 ידי יד ידי noun feminine plural construct unspecified unspecified  	O	null
10 ה ה התנועה definiteArticle unspecified unspecified unspecified unspecified unspecified 0 
10 התנועה תנועה התנועה noun feminine singular absolute unspecified unspecified  	O	null
11 ה ה הקיבוצית definiteArticle unspecified unspecified unspecified unspecified unspecified 0 
11 הקיבוצית קיבוצי הקיבוצית adjective feminine singular absolute unspecified unspecified  	O	null
12 לקלוט קלט לקלוט verb unspecified unspecified unspecified unspecified infinitive  	O	null
13 את את את at-preposition unspecified unspecified unspecified unspecified unspecified  	O	null
14 ה ה הצעירים definiteArticle unspecified unspecified unspecified unspecified unspecified 0 
14 הצעירים צעיר הצעירים noun masculine plural absolute unspecified unspecified  	O	null
15 ה ה היהודים definiteArticle unspecified unspecified unspecified unspecified unspecified 0 
15 היהודים יהודי היהודים adjective masculine plural absolute unspecified unspecified  	O	null
16 ש ש שעלו relativizer/subordinatingConjunction unspecified unspecified unspecified unspecified unspecified 0 
16 עלו עלה שעלו verb masculine-and-feminine plural unspecified 3 past  	O	null
17 מ מ מעיראק preposition unspecified unspecified unspecified unspecified unspecified 0 
17 עיראק עיראק מעיראק properName unspecified unspecified unspecified unspecified unspecified  	I_LOC	null
18 ו ו ונשלחו conjunction unspecified unspecified unspecified unspecified unspecified 0 
18 נשלחו נשלח ונשלחו verb masculine-and-feminine plural unspecified 3 past  	O	null
19 ל ל לקיבוצים preposition unspecified unspecified unspecified unspecified unspecified 0 
19 ה ה לקיבוצים definiteArticle unspecified unspecified unspecified unspecified unspecified 0 
19 הקיבוצים קיבוץ לקיבוצים noun masculine plural absolute unspecified unspecified  	O	null
20 ב ב ברחבי preposition unspecified unspecified unspecified unspecified unspecified 0 
20 רחבי רוחב ברחבי noun masculine plural construct unspecified unspecified  	O	null
21 ה ה הארץ definiteArticle unspecified unspecified unspecified unspecified unspecified 0 
21 הארץ ארץ הארץ noun feminine singular absolute unspecified unspecified  	O	null
22 . . . punctuation unspecified unspecified unspecified unspecified unspecified  	O	null

0 נישאה נישא נישאה verb feminine singular unspecified 3 past  	O	null
1 ב ב ב preposition unspecified unspecified unspecified unspecified unspecified 0 	I_ORG	null
2 - - - punctuation unspecified unspecified unspecified unspecified unspecified  	I_ORG	null
3 ###NUMBER### ###NUMBER### ###NUMBER### numeral unspecified unspecified unspecified unspecified unspecified  	I_DATE	null
4 ו ו ועברה conjunction unspecified unspecified unspecified unspecified unspecified 0 
4 עברה עבר ועברה verb feminine singular unspecified 3 past  	O	null
5 לגור גר לגור verb unspecified unspecified unspecified unspecified infinitive  	I_LOC	null
6 ב ב ברמת preposition unspecified unspecified unspecified unspecified unspecified 0 
6 רמת רמה ברמת properName unspecified unspecified unspecified unspecified unspecified  	I_LOC	null
7 גן גן גן properName unspecified unspecified unspecified unspecified unspecified  	I_LOC	null
8 , , , punctuation unspecified unspecified unspecified unspecified unspecified  	O	null
9 שם שם שם adverb unspecified unspecified unspecified unspecified unspecified  	O	null
10 היא הוא היא pronoun feminine singular unspecified 3 unspecified  	O	null
11 מתגוררת התגורר מתגוררת verb feminine singular unspecified any beinoni  	O	null
12 עד עד עד preposition unspecified unspecified unspecified unspecified unspecified  	O	null
13 ה ה היום definiteArticle unspecified unspecified unspecified unspecified unspecified 0 
13 היום יום היום noun masculine singular absolute unspecified unspecified  	O	null
14 . . . punctuation unspecified unspecified unspecified unspecified unspecified  	O	null

0 החלה החל החלה verb feminine singular unspecified 3 past  	O	null
1 לכתוב כתב לכתוב verb unspecified unspecified unspecified unspecified infinitive  	O	null
2 שירה שירה שירה noun feminine singular absolute unspecified unspecified  	O	null
3 ב ב בעת preposition unspecified unspecified unspecified unspecified unspecified 0 
3 עת עת בעת noun feminine singular construct unspecified unspecified  	O	null
4 שירות שירות שירותה noun masculine singular absolute unspecified unspecified  
4 ה ה שירותה possessive feminine singular unspecified 3 unspecified 0 	O	null
5 ב ב בנח"ל preposition unspecified unspecified unspecified unspecified unspecified 0 
5 ה ה בנח"ל definiteArticle unspecified unspecified unspecified unspecified unspecified 0 
5 הנח"ל נח"ל בנח"ל noun masculine singular absolute unspecified unspecified  	O	null
6 . . . punctuation unspecified unspecified unspecified unspecified unspecified  	O	null

0 ספר ספר ספר noun masculine singular construct unspecified unspecified  	O	null
1 שירי שיר שיריה noun masculine plural absolute unspecified unspecified  
1 ה ה שיריה possessive feminine singular unspecified 3 unspecified 0 	O	null
2 ה ה הראשון definiteArticle unspecified unspecified unspecified unspecified unspecified 0 
2 הראשון ORD1 הראשון numeral masculine singular absolute unspecified unspecified  	O	null
3 , , , punctuation unspecified unspecified unspecified unspecified unspecified  	O	null
4 צלילה צלילה צלילה noun feminine singular absolute unspecified unspecified  	O	null
5 , , , punctuation unspecified unspecified unspecified unspecified unspecified  	O	null
6 יצא יצא יצא verb masculine singular unspecified 3 past  	O	null
7 ל ל לאור preposition unspecified unspecified unspecified unspecified unspecified 0 
7 אור אור לאור noun masculine singular absolute unspecified unspecified  	O	null
8 ב ב ב preposition unspecified unspecified unspecified unspecified unspecified 0 	O	null
9 - - - punctuation unspecified unspecified unspecified unspecified unspecified  	O	null
10 ###NUMBER### ###NUMBER### ###NUMBER### numeral unspecified unspecified unspecified unspecified unspecified  	I_DATE	null
11 ב ב בהוצאת preposition unspecified unspecified unspecified unspecified unspecified 0 
11 הוצאת הוצאה בהוצאת noun feminine singular construct unspecified unspecified  	O	null
12 טרקלין טרקלין טרקלין noun masculine singular absolute unspecified unspecified  	O	null
13 . . . punctuation unspecified unspecified unspecified unspecified unspecified  	O	null

0 ה ה הספר definiteArticle unspecified unspecified unspecified unspecified unspecified 0 
0 הספר ספר הספר noun masculine singular absolute unspecified unspecified  	O	null
1 עוסק עסק עוסק verb masculine singular unspecified any beinoni  	O	null
2 בשָם בשָם בשָם properName unspecified unspecified unspecified unspecified unspecified  	I_PERS	null
3 , , , punctuation unspecified unspecified unspecified unspecified unspecified  	O	null
4 חיי חיים חייה noun masculine plural absolute unspecified unspecified  
4 ה ה חייה possessive feminine singular unspecified 3 unspecified 0 	O	null
5 ב ב בעיראק preposition unspecified unspecified unspecified unspecified unspecified 0 
5 עיראק עיראק בעיראק properName unspecified unspecified unspecified unspecified unspecified  	I_LOC	null
6 , , , punctuation unspecified unspecified unspecified unspecified unspecified  	O	null
7 בכאן בכאן בכאן properName unspecified unspecified unspecified unspecified unspecified  	I_PERS	null
8 , , , punctuation unspecified unspecified unspecified unspecified unspecified  	O	null
9 חיי חיים חייה noun masculine plural absolute unspecified unspecified  
9 ה ה חייה possessive feminine singular unspecified 3 unspecified 0 	O	null
10 ב ב בארץ preposition unspecified unspecified unspecified unspecified unspecified 0 
10 ה ה בארץ definiteArticle unspecified unspecified unspecified unspecified unspecified 0 
10 הארץ ארץ בארץ noun feminine singular absolute unspecified unspecified  	O	null
11 , , , punctuation unspecified unspecified unspecified unspecified unspecified  	O	null
12 ו ו ובקשרים conjunction unspecified unspecified unspecified unspecified unspecified 0 
12 ב ב ובקשרים preposition unspecified unspecified unspecified unspecified unspecified 0 
12 קשרים קשר ובקשרים noun masculine plural absolute unspecified unspecified  	O	null
13 בין בין ביניהם preposition unspecified unspecified unspecified unspecified unspecified  
13 הם הם ביניהם pronomial masculine plural unspecified 3 unspecified 0 	O	null
14 : : : punctuation unspecified unspecified unspecified unspecified unspecified  	O	null
15 ה ה הגעגועים definiteArticle unspecified unspecified unspecified unspecified unspecified 0 
15 הגעגועים געגוע הגעגועים noun masculine plural absolute unspecified unspecified  	O	null
16 ל ל למולדת preposition unspecified unspecified unspecified unspecified unspecified 0 
16 ה ה למולדת definiteArticle unspecified unspecified unspecified unspecified unspecified 0 
16 המולדת מולדת למולדת noun feminine singular absolute unspecified unspecified  	O	null
17 ה ה הישנה definiteArticle unspecified unspecified unspecified unspecified unspecified 0 
17 הישנה ישן הישנה adjective feminine singular absolute unspecified unspecified  	O	null
18 , , , punctuation unspecified unspecified unspecified unspecified unspecified  	O	null
19 זיכרונות זיכרון זיכרונות noun masculine plural construct unspecified unspecified  	O	null
20 ה ה הילדות definiteArticle unspecified unspecified unspecified unspecified unspecified 0 
20 הילדות ילדות הילדות noun feminine singular absolute unspecified unspecified  	O	null
21 ו ו והוריה conjunction unspecified unspecified unspecified unspecified unspecified 0 
21 הוריה הוריה והוריה noun feminine singular absolute unspecified unspecified  	O	null
22 ש ש שנותרו relativizer/subordinatingConjunction unspecified unspecified unspecified unspecified unspecified 0 
22 נותרו נותר שנותרו verb masculine-and-feminine plural unspecified 3 past  	O	null
23 ב ב בעיראק preposition unspecified unspecified unspecified unspecified unspecified 0 
23 עיראק עיראק בעיראק properName unspecified unspecified unspecified unspecified unspecified  	I_LOC	null
24 מ מ מזה preposition unspecified unspecified unspecified unspecified unspecified 0 
24 זה זה מזה pronoun masculine singular unspecified 3 unspecified  	O	null
25 , , , punctuation unspecified unspecified unspecified unspecified unspecified  	O	null
26 ו ו והמשפחה conjunction unspecified unspecified unspecified unspecified unspecified 0 
26 ה ה והמשפחה definiteArticle unspecified unspecified unspecified unspecified unspecified 0 
26 המשפחה משפחה והמשפחה noun feminine singular absolute unspecified unspecified  	O	null
27 ש ש שהקימה relativizer/subordinatingConjunction unspecified unspecified unspecified unspecified unspecified 0 
27 הקימה הקים שהקימה verb feminine singular unspecified 3 past  	O	null
28 ב ב בארץ preposition unspecified unspecified unspecified unspecified unspecified 0 
28 ארץ ארץ בארץ noun feminine singular construct unspecified unspecified  	O	null
29 מזה מזה מזה noun masculine singular absolute unspecified unspecified  	O	null
30 . . . punctuation unspecified unspecified unspecified unspecified unspecified  	O	null

0 תמה תמה תמה verb masculine singular unspecified 3 past  	O	null
1 זו זו זו pronoun feminine singular unspecified 3 unspecified  	O	null
2 תופשת תפש תופשת verb feminine singular unspecified any beinoni  	O	null
3 מקום מקום מקום noun masculine singular absolute unspecified unspecified  	O	null
4 מרכזי מרכזי מרכזי adjective masculine singular absolute unspecified unspecified  	O	null
5 גם גם גם conjunction unspecified unspecified unspecified unspecified unspecified  	O	null
6 ב ב בספריה preposition unspecified unspecified unspecified unspecified unspecified 0 
6 ספרי ספר בספריה noun masculine plural absolute unspecified unspecified  
6 ה ה בספריה possessive feminine singular unspecified 3 unspecified 0 	O	null
7 ה ה הבאים definiteArticle unspecified unspecified unspecified unspecified unspecified 0 
7 הבאים בא הבאים adjective masculine plural absolute unspecified unspecified  	O	null
8 : : : punctuation unspecified unspecified unspecified unspecified unspecified  	O	null
9 שעון שעון שעון noun masculine singular absolute unspecified unspecified  	O	null
10 עתיק עתיק עתיק adjective masculine singular absolute unspecified unspecified  	O	null
11 ) ) ) punctuation unspecified unspecified unspecified unspecified unspecified  	O	null
12 , , , punctuation unspecified unspecified unspecified unspecified unspecified  	O	null
13 נופים נוף נופים noun masculine plural absolute unspecified unspecified  	O	null
14 ###NUMBER### ###NUMBER### ###NUMBER### numeral unspecified unspecified unspecified unspecified unspecified  	I_DATE	null
15 ש ש שתוקים relativizer/subordinatingConjunction unspecified unspecified unspecified unspecified unspecified 0 
15 תוקים תוקים שתוקים adjective masculine singular construct unspecified unspecified  	O	null
16 ( ( ( punctuation unspecified unspecified unspecified unspecified unspecified  	O	null
17 ###NUMBER### ###NUMBER### ###NUMBER### numeral unspecified unspecified unspecified unspecified unspecified  	I_DATE	null
18 ) ) ) punctuation unspecified unspecified unspecified unspecified unspecified  	O	null
19 ו ו וקדשת conjunction unspecified unspecified unspecified unspecified unspecified 0 
19 קדשת קדשה וקדשת noun feminine singular construct unspecified unspecified  	O	null
20 ימים יום ימים noun masculine plural absolute unspecified unspecified  	O	null
21 ) ) ) punctuation unspecified unspecified unspecified unspecified unspecified  	O	null
22 . . . punctuation unspecified unspecified unspecified unspecified unspecified  	O	null
23 ###NUMBER### ###NUMBER### ###NUMBER### numeral unspecified unspecified unspecified unspecified unspecified  	I_DATE	null
24 ספר ספר ספרה noun masculine singular absolute unspecified unspecified  
24 ה ה ספרה possessive feminine singular unspecified 3 unspecified 0 	O	null
25 ה ה האחרון definiteArticle unspecified unspecified unspecified unspecified unspecified 0 
25 האחרון אחרון האחרון adjective masculine singular absolute unspecified unspecified  	O	null
26 עד עד עד preposition unspecified unspecified unspecified unspecified unspecified  	O	null
27 כה כה כה adverb unspecified unspecified unspecified unspecified unspecified  	O	null
28 הוא הוא הוא pronoun masculine singular unspecified 3 unspecified  	O	null
29 עד עד עד noun masculine singular absolute unspecified unspecified  	O	null
30 יחדל חדל יחדל verb masculine singular unspecified 3 future  	O	null
31 צילי צילי צילי properName unspecified unspecified unspecified unspecified unspecified  	I_PERS	null
32 ) ) ) punctuation unspecified unspecified unspecified unspecified unspecified  	O	null
33 . . . punctuation unspecified unspecified unspecified unspecified unspecified  	O	null
34 ###NUMBER### ###NUMBER### ###NUMBER### numeral unspecified unspecified unspecified unspecified unspecified  	I_DATE	null
35 כל כול כל quantifier unspecified unspecified construct unspecified unspecified  	O	null
36 שירי שיר שיריה noun masculine plural absolute unspecified unspecified  
36 ה ה שיריה possessive feminine singular unspecified 3 unspecified 0 	O	null
37 של של של shel-preposition unspecified unspecified unspecified unspecified unspecified  	O	null
38 זלוף זלוף זלוף noun feminine singular construct unspecified unspecified  	O	null
39 כתובים כתוב כתובים noun masculine plural absolute unspecified unspecified  	O	null
40 ב ב בשפה preposition unspecified unspecified unspecified unspecified unspecified 0 
40 שפה שפה בשפה noun feminine singular absolute unspecified unspecified  	O	null
41 גבוהה גבוה גבוהה adjective feminine singular absolute unspecified unspecified  	O	null
42 , , , punctuation unspecified unspecified unspecified unspecified unspecified  	O	null
43 ו ו והם conjunction unspecified unspecified unspecified unspecified unspecified 0 
43 הם הוא והם pronoun masculine plural unspecified 3 unspecified  	O	null
44 משובצים שובץ משובצים verb masculine plural unspecified any beinoni  	O	null
45 ב ב בציורי preposition unspecified unspecified unspecified unspecified unspecified 0 
45 ציורי ציור בציורי noun masculine plural construct unspecified unspecified  	O	null
46 לשון לשון לשון noun feminine singular absolute unspecified unspecified  	O	null
47 אישיים אישי אישיים adjective masculine plural absolute unspecified unspecified  	O	null
48 ה ה היוצרים definiteArticle unspecified unspecified unspecified unspecified unspecified 0 
48 היוצרים יצר היוצרים participle masculine plural absolute any unspecified  	O	null
49 אווירה אווירה אווירה noun feminine singular absolute unspecified unspecified  	O	null
50 ייחודית ייחודי ייחודית adjective feminine singular absolute unspecified unspecified  	O	null
51 . . . punctuation unspecified unspecified unspecified unspecified unspecified  	O	null

0 זכתה זכה זכתה verb feminine singular unspecified 3 past  	O	null
1 ב ב במענק preposition unspecified unspecified unspecified unspecified unspecified 0 
1 מענק מענק במענק noun masculine singular construct unspecified unspecified  	O	null
2 קרן קרן קרן noun feminine singular construct unspecified unspecified  	O	null
3 אח"י אח"י אח"י properName unspecified unspecified unspecified unspecified unspecified  	I_ORG	null
4 – – – punctuation unspecified unspecified unspecified unspecified unspecified  	O	null
5 יוצאי יוצא יוצאי noun masculine plural construct unspecified unspecified  	O	null
6 עיראק עיראק עיראק properName unspecified unspecified unspecified unspecified unspecified  	I_LOC	null
7 , , , punctuation unspecified unspecified unspecified unspecified unspecified  	O	null
8 ו ו ובמענק conjunction unspecified unspecified unspecified unspecified unspecified 0 
8 ב ב ובמענק preposition unspecified unspecified unspecified unspecified unspecified 0 
8 מענק מענק ובמענק noun masculine singular absolute unspecified unspecified  	O	null
9 מטעם מטעם מטעם preposition unspecified unspecified unspecified unspecified unspecified  	O	null
10 קרן קרן קרן noun feminine singular construct unspecified unspecified  	O	null
11 תל תל תל properName unspecified unspecified unspecified unspecified unspecified  	I_ORG	null
12 אביב אביב אביב properName unspecified unspecified unspecified unspecified unspecified  	I_ORG	null
13 על על על preposition unspecified unspecified unspecified unspecified unspecified  	O	null
14 שם שם שם noun masculine singular construct unspecified unspecified  	O	null
15 רבינוביץ רבינוביץ רבינוביץ properName unspecified unspecified unspecified unspecified unspecified  	I_PERS	null
16 ) ) ) punctuation unspecified unspecified unspecified unspecified unspecified  	O	null
17 . . . punctuation unspecified unspecified unspecified unspecified unspecified  	O	null
18 ###NUMBER### ###NUMBER### ###NUMBER### numeral unspecified unspecified unspecified unspecified unspecified  	I_DATE	null
19 References References References foreign unspecified unspecified unspecified unspecified unspecified  	O	null
20 : : : punctuation unspecified unspecified unspecified unspecified unspecified  	O	null
21 אלאלוף אלאלוף אלאלוף preposition unspecified unspecified unspecified unspecified unspecified  	O	null
22 - - - punctuation unspecified unspecified unspecified unspecified unspecified  	O	null
23 מימון מימון מימון noun masculine singular absolute unspecified unspecified  	O	null
24 , , , punctuation unspecified unspecified unspecified unspecified unspecified  	O	null
25 דלי דלי דליס noun masculine singular absolute unspecified unspecified  
25 ה ה דליס possessive feminine singular unspecified 3 unspecified 0 	O	null
26 . . . punctuation unspecified unspecified unspecified unspecified unspecified  	O	null

0 " " " punctuation unspecified unspecified unspecified unspecified unspecified  	O	null
1 שירים שיר שירים noun masculine plural absolute unspecified unspecified  	O	null
2 כ כ כמשאלת preposition unspecified unspecified unspecified unspecified unspecified 0 
2 משאלת משאלה כמשאלת noun feminine singular construct unspecified unspecified  	O	null
3 לב לב לב noun masculine singular absolute unspecified unspecified  	O	null
4 " " " punctuation unspecified unspecified unspecified unspecified unspecified  	O	null
5 . . . punctuation unspecified unspecified unspecified unspecified unspecified  	O	null

0 מאזניים מאזניים מאזניים noun masculine plural absolute unspecified unspecified  	O	null
1 ע"ו ע"ו ע"ו properName unspecified unspecified unspecified unspecified unspecified  	I_PERS	null
2 ) ) ) punctuation unspecified unspecified unspecified unspecified unspecified  	O	null
3 . . . punctuation unspecified unspecified unspecified unspecified unspecified  	O	null
4 ###NUMBER### ###NUMBER### ###NUMBER### numeral unspecified unspecified unspecified unspecified unspecified  	O	null
5 ###NUMBER### ###NUMBER### ###NUMBER### numeral unspecified unspecified unspecified unspecified unspecified  	I_DATE	null
6 . . . punctuation unspecified unspecified unspecified unspecified unspecified  	O	null

0 - - - punctuation unspecified unspecified unspecified unspecified unspecified  	O	null
1 ###NUMBER### ###NUMBER### ###NUMBER### numeral unspecified unspecified unspecified unspecified unspecified  	O	null
2 ; ; ; punctuation unspecified unspecified unspecified unspecified unspecified  	O	null
3 ###NUMBER### ###NUMBER### ###NUMBER### numeral unspecified unspecified unspecified unspecified unspecified  	O	null
4 יעוז יעוז יעוז properName unspecified unspecified unspecified unspecified unspecified  	O	null
5 - - - punctuation unspecified unspecified unspecified unspecified unspecified  	O	null
6 קסט קסט קסט properName unspecified unspecified unspecified unspecified unspecified  	I_ORG	null
7 , , , punctuation unspecified unspecified unspecified unspecified unspecified  	O	null
8 חנה חנה חנה properName unspecified unspecified unspecified unspecified unspecified  	I_PERS	null
9 . . . punctuation unspecified unspecified unspecified unspecified unspecified  	O	null

0 " " " punctuation unspecified unspecified unspecified unspecified unspecified  	O	null
1 צדפים צדף צדפים noun masculine plural absolute unspecified unspecified  	O	null
2 של של של shel-preposition unspecified unspecified unspecified unspecified unspecified  	O	null
3 בשלות בשלות בשלות noun feminine singular absolute unspecified unspecified  	O	null
4 עם עם עם preposition unspecified unspecified unspecified unspecified unspecified  	O	null
5 לילי ליל לילי noun masculine plural construct unspecified unspecified  	O	null
6 זלוף זלוף זלוף noun masculine singular absolute unspecified unspecified  	O	null
7 " " " punctuation unspecified unspecified unspecified unspecified unspecified  	O	null
8 . . . punctuation unspecified unspecified unspecified unspecified unspecified  	O	null

0 פסיפס פסיפס פסיפס noun masculine singular absolute unspecified unspecified  	O	null
1 ###NUMBER### ###NUMBER### ###NUMBER### numeral unspecified unspecified unspecified unspecified unspecified  	O	null
2 . . . punctuation unspecified unspecified unspecified unspecified unspecified  	O	null

0 ###NUMBER### ###NUMBER### ###NUMBER### numeral unspecified unspecified unspecified unspecified unspecified  	I_DATE	null
1 . . . punctuation unspecified unspecified unspecified unspecified unspecified  	O	null

0 ###NUMBER### ###NUMBER### ###NUMBER### numeral unspecified unspecified unspecified unspecified unspecified  	O	null
1 - - - punctuation unspecified unspecified unspecified unspecified unspecified  	O	null
2 ###NUMBER### ###NUMBER### ###NUMBER### numeral unspecified unspecified unspecified unspecified unspecified  	O	null
3 . . . punctuation unspecified unspecified unspecified unspecified unspecified  	O	null

