0 Name Name Name foreign unspecified unspecified unspecified unspecified unspecified  	O	null
1 : : : punctuation unspecified unspecified unspecified unspecified unspecified  	O	null
2 חזנוב חזנוב חזנוב properName unspecified unspecified unspecified unspecified unspecified  	I_ORG	null
3 , , , punctuation unspecified unspecified unspecified unspecified unspecified  	O	null
4 רוחמה רוחמה רוחמה properName masculine singular unspecified unspecified unspecified  	I_PERS	null
5 Birth Birth Birth foreign unspecified unspecified unspecified unspecified unspecified  	O	null
6 Year Year Year foreign unspecified unspecified unspecified unspecified unspecified  	O	null
7 : : : punctuation unspecified unspecified unspecified unspecified unspecified  	O	null
8 ###NUMBER### ###NUMBER### ###NUMBER### numeral unspecified unspecified unspecified unspecified unspecified  	I_DATE	null
9 Death Death Death foreign unspecified unspecified unspecified unspecified unspecified  	O	null
10 Year Year Year foreign unspecified unspecified unspecified unspecified unspecified  	O	null
11 : : : punctuation unspecified unspecified unspecified unspecified unspecified  	O	null
12 ###NUMBER### ###NUMBER### ###NUMBER### numeral unspecified unspecified unspecified unspecified unspecified  	I_DATE	null
13 Birth Birth Birth foreign unspecified unspecified unspecified unspecified unspecified  	O	null
14 Place Place Place foreign unspecified unspecified unspecified unspecified unspecified  	O	null
15 : : : punctuation unspecified unspecified unspecified unspecified unspecified  	O	null
16 ביירות בירות ביירות properName unspecified unspecified unspecified unspecified unspecified  	I_LOC	null
17 , , , punctuation unspecified unspecified unspecified unspecified unspecified  	O	null
18 בירת בירה בירת noun feminine singular construct unspecified unspecified  	O	null
19 לבנון לבנון לבנון properName unspecified unspecified unspecified unspecified unspecified  	I_LOC	null
20 , , , punctuation unspecified unspecified unspecified unspecified unspecified  	O	null
21 Occupation Occupation Occupation foreign unspecified unspecified unspecified unspecified unspecified  	O	null
22 : : : punctuation unspecified unspecified unspecified unspecified unspecified  	O	null
23 סופרת סופר סופרת noun feminine singular construct unspecified unspecified  	O	null
24 Entry Entry Entry foreign unspecified unspecified unspecified unspecified unspecified  	O	null
25 writer writer writer foreign unspecified unspecified unspecified unspecified unspecified  	O	null
26 : : : punctuation unspecified unspecified unspecified unspecified unspecified  	O	null
27 אלישע אלישע אלישע properName unspecified unspecified unspecified unspecified unspecified  	I_PERS	null
28 פורת פורת פורת properName unspecified unspecified unspecified unspecified unspecified  	I_PERS	null
29 ו ו ובתיה conjunction unspecified unspecified unspecified unspecified unspecified 0 
29 בתי בית ובתיה noun masculine plural absolute unspecified unspecified  
29 ה ה ובתיה possessive feminine singular unspecified 3 unspecified 0 	O	null
30 ש ש שמעוני relativizer/subordinatingConjunction unspecified unspecified unspecified unspecified unspecified 0 
30 מ מ שמעוני preposition unspecified unspecified unspecified unspecified unspecified 0 
30 עוני עוני שמעוני noun masculine singular absolute unspecified unspecified  	O	null
31 Entry Entry Entry foreign unspecified unspecified unspecified unspecified unspecified  	O	null
32 Value Value Value foreign unspecified unspecified unspecified unspecified unspecified  	O	null
33 : : : punctuation unspecified unspecified unspecified unspecified unspecified  	O	null
34 נולדה נולד נולדה verb feminine singular unspecified 3 past  	O	null
35 ב ב בביירות preposition unspecified unspecified unspecified unspecified unspecified 0 
35 ביירות בירות בביירות properName unspecified unspecified unspecified unspecified unspecified  	I_LOC	null
36 , , , punctuation unspecified unspecified unspecified unspecified unspecified  	O	null
37 בירת בירה בירת noun feminine singular construct unspecified unspecified  	O	null
38 לבנון לבנון לבנון properName unspecified unspecified unspecified unspecified unspecified  	I_LOC	null
39 , , , punctuation unspecified unspecified unspecified unspecified unspecified  	O	null
40 ל ל להוריה preposition unspecified unspecified unspecified unspecified unspecified 0 
40 הורי הורה להוריה noun masculine plural absolute unspecified unspecified  
40 ה ה להוריה possessive feminine singular unspecified 3 unspecified 0 	O	null
41 רבקה רבקה רבקה properName unspecified unspecified unspecified unspecified unspecified  	I_PERS	null
42 ו ו ושאול conjunction unspecified unspecified unspecified unspecified unspecified 0 
42 שאול שאול ושאול properName unspecified unspecified unspecified unspecified unspecified  	I_PERS	null
43 , , , punctuation unspecified unspecified unspecified unspecified unspecified  	O	null
44 עולים עולה עולים noun masculine plural absolute unspecified unspecified  	O	null
45 ציוניים ציוני ציוניים adjective masculine plural absolute unspecified unspecified  	O	null
46 מ מ מרוסיה preposition unspecified unspecified unspecified unspecified unspecified 0 
46 רוסיה רוסי מרוסיה properName unspecified unspecified unspecified unspecified unspecified  	I_LOC	null
47 , , , punctuation unspecified unspecified unspecified unspecified unspecified  	O	null
48 ש ש שיצאו relativizer/subordinatingConjunction unspecified unspecified unspecified unspecified unspecified 0 
48 יצאו יצא שיצאו verb masculine-and-feminine plural unspecified 3 past  	O	null
49 מ מ מהארץ preposition unspecified unspecified unspecified unspecified unspecified 0 
49 ה ה מהארץ definiteArticle unspecified unspecified unspecified unspecified unspecified 0 
49 הארץ ארץ מהארץ noun feminine singular absolute unspecified unspecified  	O	null
50 כדי כדי כדי conjunction unspecified unspecified unspecified unspecified unspecified  	O	null
51 להתבסס התבסס להתבסס verb unspecified unspecified unspecified unspecified infinitive  	O	null
52 כלכלית כלכלי כלכלית adjective feminine singular absolute unspecified unspecified  	O	null
53 . . . punctuation unspecified unspecified unspecified unspecified unspecified  	O	null

0 עד עד עד preposition unspecified unspecified unspecified unspecified unspecified  	O	null
1 גיל גיל גיל noun masculine singular construct unspecified unspecified  	O	null
2 עשר CARD10 עשר numeral feminine singular absolute unspecified unspecified  	O	null
3 חיה חי חיה verb feminine singular unspecified 3 past  	I_LOC	null
4 ב ב בעיר preposition unspecified unspecified unspecified unspecified unspecified 0 
4 עיר עיר בעיר noun feminine singular construct unspecified unspecified  	I_LOC	null
5 חאלב חאלב חאלב properName unspecified unspecified unspecified unspecified unspecified  	I_LOC	null
6 , , , punctuation unspecified unspecified unspecified unspecified unspecified  	O	null
7 סוריה סוריה סוריה properName unspecified unspecified unspecified unspecified unspecified  	I_LOC	null
8 , , , punctuation unspecified unspecified unspecified unspecified unspecified  	O	null
9 שם שם שם adverb unspecified unspecified unspecified unspecified unspecified  	O	null
10 ניהל ניהל ניהל verb masculine singular unspecified 3 past  	O	null
11 אבי אב אביה noun masculine singular absolute unspecified unspecified  
11 ה ה אביה possessive feminine singular unspecified 3 unspecified 0 	O	null
12 סניף סניף סניף noun masculine singular absolute unspecified unspecified  	O	null
13 של של של shel-preposition unspecified unspecified unspecified unspecified unspecified  	O	null
14 " " " punctuation unspecified unspecified unspecified unspecified unspecified  	O	null
15 כרמל כרמל כרמל properName unspecified unspecified unspecified unspecified unspecified  	I_ORG	null
16 מזרחי מזרחי מזרחי properName unspecified unspecified unspecified unspecified unspecified  	I_ORG	null
17 " " " punctuation unspecified unspecified unspecified unspecified unspecified  	O	null
18 . . . punctuation unspecified unspecified unspecified unspecified unspecified  	O	null

0 ב ב ב preposition unspecified unspecified unspecified unspecified unspecified 0 	I_ORG	null
1 - - - punctuation unspecified unspecified unspecified unspecified unspecified  	I_ORG	null
2 ###NUMBER### ###NUMBER### ###NUMBER### numeral unspecified unspecified unspecified unspecified unspecified  	I_DATE	null
3 נפטר נפטר נפטר verb masculine singular unspecified 3 past  	O	null
4 ה ה האב definiteArticle unspecified unspecified unspecified unspecified unspecified 0 
4 האב אב האב noun masculine singular absolute unspecified unspecified  	O	null
5 , , , punctuation unspecified unspecified unspecified unspecified unspecified  	O	null
6 ו ו והמשפחה conjunction unspecified unspecified unspecified unspecified unspecified 0 
6 ה ה והמשפחה definiteArticle unspecified unspecified unspecified unspecified unspecified 0 
6 המשפחה משפחה והמשפחה noun feminine singular absolute unspecified unspecified  	O	null
7 חזרה חזר חזרה verb feminine singular unspecified 3 past  	O	null
8 ארצה ארצה ארצה adverb unspecified unspecified unspecified unspecified unspecified  	O	null
9 ו ו והתיישבה conjunction unspecified unspecified unspecified unspecified unspecified 0 
9 התיישבה התיישב והתיישבה verb feminine singular unspecified 3 past  	O	null
10 ב ב בגדרה preposition unspecified unspecified unspecified unspecified unspecified 0 
10 גדרה גדרה בגדרה properName unspecified unspecified unspecified unspecified unspecified  	I_LOC	null
11 . . . punctuation unspecified unspecified unspecified unspecified unspecified  	O	null

0 למדה למד למדה verb feminine singular unspecified 3 past  	O	null
1 ב ב בסמינר preposition unspecified unspecified unspecified unspecified unspecified 0 
1 סמינר סמינר בסמינר noun masculine singular absolute unspecified unspecified  	O	null
2 ל ל למורים preposition unspecified unspecified unspecified unspecified unspecified 0 
2 ה ה למורים definiteArticle unspecified unspecified unspecified unspecified unspecified 0 
2 המורים מורה למורים noun masculine plural absolute unspecified unspecified  	O	null
3 " " " punctuation unspecified unspecified unspecified unspecified unspecified  	O	null
4 מזרחי מזרחי מזרחי properName unspecified unspecified unspecified unspecified unspecified  	I_ORG	null
5 " " " punctuation unspecified unspecified unspecified unspecified unspecified  	O	null
6 ב ב בירושלים preposition unspecified unspecified unspecified unspecified unspecified 0 
6 ירושלים ירושלים בירושלים properName unspecified unspecified unspecified unspecified unspecified  	I_LOC	null
7 . . . punctuation unspecified unspecified unspecified unspecified unspecified  	O	null

0 בעת בעת בעת noun masculine singular construct unspecified unspecified  	O	null
1 לימודי לימוד לימודיה noun masculine plural absolute unspecified unspecified  
1 ה ה לימודיה possessive feminine singular unspecified 3 unspecified 0 	O	null
2 הצטרפה הצטרף הצטרפה verb feminine singular unspecified 3 past  	O	null
3 ל ל לתנועת preposition unspecified unspecified unspecified unspecified unspecified 0 
3 תנועת תנועה לתנועת noun feminine singular construct unspecified unspecified  	O	null
4 " " " punctuation unspecified unspecified unspecified unspecified unspecified  	O	null
5 ה ה המחנות definiteArticle unspecified unspecified unspecified unspecified unspecified 0 
5 המחנות מחנה המחנות noun masculine plural absolute unspecified unspecified  	O	null
6 ה ה העולים definiteArticle unspecified unspecified unspecified unspecified unspecified 0 
6 העולים עולה העולים noun masculine plural absolute unspecified unspecified  	O	null
7 " " " punctuation unspecified unspecified unspecified unspecified unspecified  	O	null
8 . . . punctuation unspecified unspecified unspecified unspecified unspecified  	O	null

0 היא הוא היא pronoun feminine singular unspecified 3 unspecified  	O	null
1 הצטרפה הצטרף הצטרפה verb feminine singular unspecified 3 past  	O	null
2 גם גם גם conjunction unspecified unspecified unspecified unspecified unspecified  	O	null
3 ל ל לקבוצת preposition unspecified unspecified unspecified unspecified unspecified 0 
3 קבוצת קבוצה לקבוצת noun feminine singular construct unspecified unspecified  	O	null
4 " " " punctuation unspecified unspecified unspecified unspecified unspecified  	O	null
5 ה ה החוגים definiteArticle unspecified unspecified unspecified unspecified unspecified 0 
5 החוגים חוג החוגים noun masculine plural absolute unspecified unspecified  	O	null
6 " " " punctuation unspecified unspecified unspecified unspecified unspecified  	O	null
7 , , , punctuation unspecified unspecified unspecified unspecified unspecified  	O	null
8 ש ש שלימים relativizer/subordinatingConjunction unspecified unspecified unspecified unspecified unspecified 0 
8 לימים לימים שלימים adverb unspecified unspecified unspecified unspecified unspecified  	O	null
9 ייסדה ייסד ייסדה verb feminine singular unspecified 3 past  	O	null
10 את את את at-preposition unspecified unspecified unspecified unspecified unspecified  	O	null
11 קיבוץ קיבוץ קיבוץ noun masculine singular construct unspecified unspecified  	O	null
12 בית בית בית noun masculine singular construct unspecified unspecified  	O	null
13 ה ה השיטה definiteArticle unspecified unspecified unspecified unspecified unspecified 0 
13 השיטה שיטה השיטה noun feminine singular absolute unspecified unspecified  	O	null
14 , , , punctuation unspecified unspecified unspecified unspecified unspecified  	O	null
15 ו ו ונשלחה conjunction unspecified unspecified unspecified unspecified unspecified 0 
15 נשלחה נשלח ונשלחה verb feminine singular unspecified 3 past  	O	null
16 ל ל לעין preposition unspecified unspecified unspecified unspecified unspecified 0 
16 עין עין לעין noun feminine singular construct unspecified unspecified  	O	null
17 חרוד חרוד חרוד noun masculine singular absolute unspecified unspecified  	O	null
18 ללמוד למד ללמוד verb unspecified unspecified unspecified unspecified infinitive  	O	null
19 טיפול טיפול טיפול noun masculine singular absolute unspecified unspecified  	O	null
20 ב ב בילדים preposition unspecified unspecified unspecified unspecified unspecified 0 
20 ילדים ילד בילדים noun masculine plural absolute unspecified unspecified  	O	null
21 ב ב בגיל preposition unspecified unspecified unspecified unspecified unspecified 0 
21 ה ה בגיל definiteArticle unspecified unspecified unspecified unspecified unspecified 0 
21 הגיל גיל בגיל noun masculine singular absolute unspecified unspecified  	O	null
22 ה ה הרך definiteArticle unspecified unspecified unspecified unspecified unspecified 0 
22 הרך רך הרך adjective masculine singular absolute unspecified unspecified  	O	null
23 ) ) ) punctuation unspecified unspecified unspecified unspecified unspecified  	O	null
24 . . . punctuation unspecified unspecified unspecified unspecified unspecified  	O	null
25 ###NUMBER### ###NUMBER### ###NUMBER### numeral unspecified unspecified unspecified unspecified unspecified  	I_DATE	null
26 שם שם שם adverb unspecified unspecified unspecified unspecified unspecified  	O	null
27 פגשה פגש פגשה verb feminine singular unspecified 3 past  	O	null
28 את את את at-preposition unspecified unspecified unspecified unspecified unspecified  	O	null
29 ה ה הסופר definiteArticle unspecified unspecified unspecified unspecified unspecified 0 
29 הסופר סופר הסופר noun masculine singular absolute unspecified unspecified  	O	null
30 דוד דוד דוד properName unspecified unspecified unspecified unspecified unspecified  	I_PERS	null
31 מ מ מלץ preposition unspecified unspecified unspecified unspecified unspecified 0 
31 לץ לץ מלץ noun masculine singular absolute unspecified unspecified  	O	null
32 , , , punctuation unspecified unspecified unspecified unspecified unspecified  	O	null
33 ש ש שנפרד relativizer/subordinatingConjunction unspecified unspecified unspecified unspecified unspecified 0 
33 נפרד נפרד שנפרד verb masculine singular unspecified 3 past  	O	null
34 מ מ מהסופרת preposition unspecified unspecified unspecified unspecified unspecified 0 
34 ה ה מהסופרת definiteArticle unspecified unspecified unspecified unspecified unspecified 0 
34 הסופרת סופר מהסופרת noun feminine singular absolute unspecified unspecified  	O	null
35 יהודית יהודי יהודית adjective feminine singular absolute unspecified unspecified  	O	null
36 מנש מנש מנש properName unspecified unspecified unspecified unspecified unspecified  	I_PERS	null
37 , , , punctuation unspecified unspecified unspecified unspecified unspecified  	O	null
38 ו ו ונישאה conjunction unspecified unspecified unspecified unspecified unspecified 0 
38 נישאה נישא ונישאה verb feminine singular unspecified 3 past  	O	null
39 ל ל לו preposition unspecified unspecified unspecified unspecified unspecified  
39 ו ו לו pronomial masculine singular unspecified 3 unspecified 0 	O	null
40 . . . punctuation unspecified unspecified unspecified unspecified unspecified  	O	null

0 השלימה השלים השלימה verb feminine singular unspecified 3 past  	O	null
1 תואר תואר תואר noun masculine singular absolute unspecified unspecified  	O	null
2 ראשון ORD1 ראשון numeral masculine singular absolute unspecified unspecified  	O	null
3 ב ב בספרות preposition unspecified unspecified unspecified unspecified unspecified 0 
3 ספרות ספרות בספרות noun feminine singular absolute unspecified unspecified  	O	null
4 עברית עברי עברית adjective feminine singular absolute unspecified unspecified  	O	null
5 ו ו ובהיסטוריה conjunction unspecified unspecified unspecified unspecified unspecified 0 
5 ב ב ובהיסטוריה preposition unspecified unspecified unspecified unspecified unspecified 0 
5 ה ה ובהיסטוריה definiteArticle unspecified unspecified unspecified unspecified unspecified 0 
5 ההיסטוריה היסטוריה ובהיסטוריה noun feminine singular absolute unspecified unspecified  	O	null
6 ב ב באוניברסיטה preposition unspecified unspecified unspecified unspecified unspecified 0 
6 ה ה באוניברסיטה definiteArticle unspecified unspecified unspecified unspecified unspecified 0 
6 האוניברסיטה אוניברסיטה באוניברסיטה noun feminine singular absolute unspecified unspecified  	O	null
7 ה ה העברית definiteArticle unspecified unspecified unspecified unspecified unspecified 0 
7 העברית עברי העברית adjective feminine singular absolute unspecified unspecified  	O	null
8 ב ב בירושלים preposition unspecified unspecified unspecified unspecified unspecified 0 
8 ירושלים ירושלים בירושלים properName unspecified unspecified unspecified unspecified unspecified  	I_LOC	null
9 . . . punctuation unspecified unspecified unspecified unspecified unspecified  	O	null

0 ל ל לימים preposition unspecified unspecified unspecified unspecified unspecified 0 
0 ה ה לימים definiteArticle unspecified unspecified unspecified unspecified unspecified 0 
0 הימים יום לימים noun masculine plural absolute unspecified unspecified  	O	null
1 סיימה סיים סיימה verb feminine singular unspecified 3 past  	O	null
2 גם גם גם conjunction unspecified unspecified unspecified unspecified unspecified  	O	null
3 תואר תואר תואר noun masculine singular construct unspecified unspecified  	O	null
4 שני שני שני noun masculine singular absolute unspecified unspecified  	O	null
5 ב ב באותם preposition unspecified unspecified unspecified unspecified unspecified 0 
5 אותו אותו באותם quantifier unspecified unspecified unspecified unspecified unspecified  
5 הם הם באותם pronomial masculine plural unspecified 3 unspecified 0 	O	null
6 ה ה המקצועות definiteArticle unspecified unspecified unspecified unspecified unspecified 0 
6 המקצועות מקצוע המקצועות noun masculine plural absolute unspecified unspecified  	O	null
7 . . . punctuation unspecified unspecified unspecified unspecified unspecified  	O	null

0 התמסרה התמסר התמסרה verb feminine singular unspecified 3 past  	O	null
1 ל ל לחינוך preposition unspecified unspecified unspecified unspecified unspecified 0 
1 חינוך חינוך לחינוך noun masculine singular absolute unspecified unspecified  	O	null
2 מיוחד מיוחד מיוחד adjective masculine singular absolute unspecified unspecified  	O	null
3 . . . punctuation unspecified unspecified unspecified unspecified unspecified  	O	null

0 פירסמה פרסם פירסמה verb feminine singular unspecified 3 past  	O	null
1 ב ב בצעירותה preposition unspecified unspecified unspecified unspecified unspecified 0 
1 צעירות צעירות בצעירותה noun feminine singular absolute unspecified unspecified  
1 ה ה בצעירותה possessive feminine singular unspecified 3 unspecified 0 	O	null
2 סיפורים סיפור סיפורים noun masculine plural absolute unspecified unspecified  	O	null
3 קצרים קצר קצרים adjective masculine plural absolute unspecified unspecified  	O	null
4 ב ב בעלוני preposition unspecified unspecified unspecified unspecified unspecified 0 
4 עלוני עלון בעלוני noun masculine plural construct unspecified unspecified  	O	null
5 קיבוץ קיבוץ קיבוץ noun masculine singular construct unspecified unspecified  	I_LOC	null
6 עין עין עין properName unspecified unspecified unspecified unspecified unspecified  	I_LOC	null
7 חרוד חרוד חרוד noun masculine singular absolute unspecified unspecified  	O	null
8 , , , punctuation unspecified unspecified unspecified unspecified unspecified  	O	null
9 ו ו ולאחר conjunction unspecified unspecified unspecified unspecified unspecified 0 
9 לאחר לאחר ולאחר conjunction unspecified unspecified unspecified unspecified unspecified  	O	null
10 מכן מיכן מכן verb masculine singular unspecified 2 imperative  	O	null
11 ב ב במוספי preposition unspecified unspecified unspecified unspecified unspecified 0 
11 מוספי מוסף במוספי noun masculine plural construct unspecified unspecified  	O	null
12 ספרות ספרות ספרות noun feminine singular absolute unspecified unspecified  	O	null
13 ו ו ובכתביהעת conjunction unspecified unspecified unspecified unspecified unspecified 0 
13 בכתביהעת בכתביהעת ובכתביהעת adjective feminine singular construct unspecified unspecified  	O	null
14 מאזניים מאזניים מאזניים noun masculine plural absolute unspecified unspecified  	O	null
15 ו ו ומבפנים conjunction unspecified unspecified unspecified unspecified unspecified 0 
15 מבפנים מבפנים ומבפנים adverb unspecified unspecified unspecified unspecified unspecified  	I_LOC	null
16 . . . punctuation unspecified unspecified unspecified unspecified unspecified  	O	null

0 ב ב ב preposition unspecified unspecified unspecified unspecified unspecified 0 	I_ORG	null
1 - - - punctuation unspecified unspecified unspecified unspecified unspecified  	I_ORG	null
2 ###NUMBER### ###NUMBER### ###NUMBER### numeral unspecified unspecified unspecified unspecified unspecified  	I_DATE	null
3 החלה החל החלה verb feminine singular unspecified 3 past  	O	null
4 ב ב בכתיבת preposition unspecified unspecified unspecified unspecified unspecified 0 
4 כתיבת כתיבה בכתיבת noun feminine singular construct unspecified unspecified  	O	null
5 ספרה ספרה ספרה noun feminine singular absolute unspecified unspecified  	O	null
6 גדרות גדר גדרות noun feminine plural absolute unspecified unspecified  	O	null
7 , , , punctuation unspecified unspecified unspecified unspecified unspecified  	O	null
8 ש ש שראה relativizer/subordinatingConjunction unspecified unspecified unspecified unspecified unspecified 0 
8 ראה ראה שראה verb masculine singular unspecified 3 past  	O	null
9 אור אור אור noun masculine singular absolute unspecified unspecified  	O	null
10 ב ב ב preposition unspecified unspecified unspecified unspecified unspecified 0 	I_ORG	null
11 - - - punctuation unspecified unspecified unspecified unspecified unspecified  	I_ORG	null
12 ###NUMBER### ###NUMBER### ###NUMBER### numeral unspecified unspecified unspecified unspecified unspecified  	I_DATE	null
13 ( ( ( punctuation unspecified unspecified unspecified unspecified unspecified  	O	null
14 עם עם עם preposition unspecified unspecified unspecified unspecified unspecified  	O	null
15 עובד עובד עובד noun masculine singular absolute unspecified unspecified  	O	null
16 , , , punctuation unspecified unspecified unspecified unspecified unspecified  	O	null
17 ה ה המהדורה definiteArticle unspecified unspecified unspecified unspecified unspecified 0 
17 המהדורה מהדורה המהדורה noun feminine singular absolute unspecified unspecified  	O	null
18 ה ה השנייה definiteArticle unspecified unspecified unspecified unspecified unspecified 0 
18 השנייה ORD2 השנייה numeral feminine singular absolute unspecified unspecified  	O	null
19 יצאה יצא יצאה verb feminine singular unspecified 3 past  	O	null
20 ב ב ב preposition unspecified unspecified unspecified unspecified unspecified 0 	O	null
21 - - - punctuation unspecified unspecified unspecified unspecified unspecified  	O	null
22 ) ) ) punctuation unspecified unspecified unspecified unspecified unspecified  	O	null
23 . . . punctuation unspecified unspecified unspecified unspecified unspecified  	O	null
24 ###NUMBER### ###NUMBER### ###NUMBER### numeral unspecified unspecified unspecified unspecified unspecified  	I_DATE	null
25 ה ה הספר definiteArticle unspecified unspecified unspecified unspecified unspecified 0 
25 הספר ספר הספר noun masculine singular absolute unspecified unspecified  	O	null
26 מתעד תיעד מתעד verb masculine singular unspecified any beinoni  	O	null
27 אירועים אירוע אירועים noun masculine plural absolute unspecified unspecified  	O	null
28 ה ה העוסקים definiteArticle unspecified unspecified unspecified unspecified unspecified 0 
28 העוסקים עסק העוסקים participle masculine plural absolute any unspecified  	O	null
29 ב ב בעלייתם preposition unspecified unspecified unspecified unspecified unspecified 0 
29 עליית עלייה בעלייתם noun feminine singular absolute unspecified unspecified  
29 ם ם בעלייתם possessive masculine plural unspecified 3 unspecified 0 	O	null
30 של של של shel-preposition unspecified unspecified unspecified unspecified unspecified  	O	null
31 הביל הביל הביל adjective masculine singular absolute unspecified unspecified  	O	null
32 " " " punctuation unspecified unspecified unspecified unspecified unspecified  	O	null
33 ויים ויים ויים properName unspecified unspecified unspecified unspecified unspecified  	I_ORG	null
34 ל ל לפלשתינה preposition unspecified unspecified unspecified unspecified unspecified 0 
34 פלשתינה פלשתין לפלשתינה properName unspecified unspecified unspecified unspecified unspecified  	I_ORG	null
35 ו ו והתיישבותם conjunction unspecified unspecified unspecified unspecified unspecified 0 
35 התיישבות התיישבות והתיישבותם noun feminine singular absolute unspecified unspecified  
35 ם ם והתיישבותם possessive masculine plural unspecified 3 unspecified 0 	O	null
36 ב ב במושבת preposition unspecified unspecified unspecified unspecified unspecified 0 
36 מושבת מושבה במושבת noun feminine singular construct unspecified unspecified  	O	null
37 גדרה גדרה גדרה properName unspecified unspecified unspecified unspecified unspecified  	I_LOC	null
38 ( ( ( punctuation unspecified unspecified unspecified unspecified unspecified  	O	null
39 היא הוא היא pronoun feminine singular unspecified 3 unspecified  	O	null
40 גדרות גדר גדרות noun feminine plural construct unspecified unspecified  	O	null
41 ) ) ) punctuation unspecified unspecified unspecified unspecified unspecified  	O	null
42 . . . punctuation unspecified unspecified unspecified unspecified unspecified  	O	null

0 היא הוא היא pronoun feminine singular unspecified 3 unspecified  	O	null
1 מתארת תיאר מתארת verb feminine singular unspecified any beinoni  	O	null
2 את את את at-preposition unspecified unspecified unspecified unspecified unspecified  	O	null
3 ה ה האירועים definiteArticle unspecified unspecified unspecified unspecified unspecified 0 
3 האירועים אירוע האירועים noun masculine plural absolute unspecified unspecified  	O	null
4 ה ה ההיסטוריים definiteArticle unspecified unspecified unspecified unspecified unspecified 0 
4 ההיסטוריים היסטורי ההיסטוריים adjective masculine plural absolute unspecified unspecified  	O	null
5 דרך דרך דרך preposition unspecified unspecified unspecified unspecified unspecified  	O	null
6 קורות קורה קורות noun feminine plural construct unspecified unspecified  	O	null
7 משפחת משפחה משפחתה noun feminine singular absolute unspecified unspecified  
7 ה ה משפחתה possessive feminine singular unspecified 3 unspecified 0 	O	null
8 , , , punctuation unspecified unspecified unspecified unspecified unspecified  	O	null
9 ש ש ששבה relativizer/subordinatingConjunction unspecified unspecified unspecified unspecified unspecified 0 
9 שבה שב ששבה verb feminine singular unspecified 3 past  	O	null
10 ל ל לארץ preposition unspecified unspecified unspecified unspecified unspecified 0 
10 ה ה לארץ definiteArticle unspecified unspecified unspecified unspecified unspecified 0 
10 הארץ ארץ לארץ noun feminine singular absolute unspecified unspecified  	O	null
11 ו ו והתיישבה conjunction unspecified unspecified unspecified unspecified unspecified 0 
11 התיישבה התיישב והתיישבה verb feminine singular unspecified 3 past  	O	null
12 ב ב בגדרה preposition unspecified unspecified unspecified unspecified unspecified 0 
12 גדר גדר בגדרה noun feminine singular absolute unspecified unspecified  
12 ה ה בגדרה possessive feminine singular unspecified 3 unspecified 0 	I_LOC	null
13 לאחר לאחר לאחר preposition unspecified unspecified unspecified unspecified unspecified  	O	null
14 מות מוות מות noun masculine singular construct unspecified unspecified  	O	null
15 ה ה האב definiteArticle unspecified unspecified unspecified unspecified unspecified 0 
15 האב אב האב noun masculine singular absolute unspecified unspecified  	O	null
16 ב ב בסוריה preposition unspecified unspecified unspecified unspecified unspecified 0 
16 סוריה סוריה בסוריה properName unspecified unspecified unspecified unspecified unspecified  	I_LOC	null
17 . . . punctuation unspecified unspecified unspecified unspecified unspecified  	O	null

0 ה ה הספר definiteArticle unspecified unspecified unspecified unspecified unspecified 0 
0 הספר ספר הספר noun masculine singular absolute unspecified unspecified  	O	null
1 חושף חשף חושף verb masculine singular unspecified any beinoni  	O	null
2 את את את at-preposition unspecified unspecified unspecified unspecified unspecified  	O	null
3 חיי חיים חיי noun masculine plural construct unspecified unspecified  	O	null
4 ה ה האיכרים definiteArticle unspecified unspecified unspecified unspecified unspecified 0 
4 האיכרים איכר האיכרים noun masculine plural absolute unspecified unspecified  	O	null
5 ב ב במושבה preposition unspecified unspecified unspecified unspecified unspecified 0 
5 ה ה במושבה definiteArticle unspecified unspecified unspecified unspecified unspecified 0 
5 המושבה מושבה במושבה noun feminine singular absolute unspecified unspecified  	O	null
6 , , , punctuation unspecified unspecified unspecified unspecified unspecified  	O	null
7 על על על preposition unspecified unspecified unspecified unspecified unspecified  	O	null
8 מנהגי מנהג מנהגיהם noun masculine plural absolute unspecified unspecified  
8 הם הם מנהגיהם possessive masculine plural unspecified 3 unspecified 0 	O	null
9 ו ו והפכים conjunction unspecified unspecified unspecified unspecified unspecified 0 
9 ה ה והפכים definiteArticle unspecified unspecified unspecified unspecified unspecified 0 
9 הפכים פך והפכים noun masculine plural absolute unspecified unspecified  	O	null
10 ה ה הקטנים definiteArticle unspecified unspecified unspecified unspecified unspecified 0 
10 הקטנים קטן הקטנים adjective masculine plural absolute unspecified unspecified  	O	null
11 של של של shel-preposition unspecified unspecified unspecified unspecified unspecified  	O	null
12 חיי חיים חיי noun masculine plural construct unspecified unspecified  	O	null
13 ה ה היומיום definiteArticle unspecified unspecified unspecified unspecified unspecified 0 
13 היומיום היומיום היומיום noun masculine singular absolute unspecified unspecified  	O	null
14 , , , punctuation unspecified unspecified unspecified unspecified unspecified  	O	null
15 ו ו ובד conjunction unspecified unspecified unspecified unspecified unspecified 0 
15 בד בד ובד noun masculine singular absolute unspecified unspecified  	O	null
16 ב ב בבד preposition unspecified unspecified unspecified unspecified unspecified 0 
16 בד בד בבד noun masculine singular construct unspecified unspecified  	O	null
17 מאיר מאיר מאיר properName unspecified unspecified unspecified unspecified unspecified  	I_PERS	null
18 את את את at-preposition unspecified unspecified unspecified unspecified unspecified  	O	null
19 הוויית הוויית הוויית noun feminine singular construct unspecified unspecified  	O	null
20 ה ה היתמות definiteArticle unspecified unspecified unspecified unspecified unspecified 0 
20 היתמות יתמות היתמות noun feminine singular absolute unspecified unspecified  	O	null
21 ה ה המדכדכת definiteArticle unspecified unspecified unspecified unspecified unspecified 0 
21 המדכדכת דכדך המדכדכת participle feminine singular absolute any unspecified  	O	null
22 ש ש שחוו relativizer/subordinatingConjunction unspecified unspecified unspecified unspecified unspecified 0 
22 חוו חווה שחוו verb masculine-and-feminine plural unspecified 3 past  	O	null
23 היא הוא היא pronoun feminine singular unspecified 3 unspecified  	O	null
24 ו ו ואחותה conjunction unspecified unspecified unspecified unspecified unspecified 0 
24 אחות אח ואחותה noun feminine singular absolute unspecified unspecified  
24 ה ה ואחותה possessive feminine singular unspecified 3 unspecified 0 	O	null
25 ה ה הקטנה definiteArticle unspecified unspecified unspecified unspecified unspecified 0 
25 הקטנה קטן הקטנה adjective feminine singular absolute unspecified unspecified  	O	null
26 . . . punctuation unspecified unspecified unspecified unspecified unspecified  	O	null

0 ה ה המספרת definiteArticle unspecified unspecified unspecified unspecified unspecified 0 
0 המספרת סיפר המספרת participle feminine singular absolute any unspecified  	O	null
1 מצטיינת הצטיין מצטיינת verb feminine singular unspecified any beinoni  	O	null
2 ב ב בכושר preposition unspecified unspecified unspecified unspecified unspecified 0 
2 כושר כושר בכושר noun masculine singular construct unspecified unspecified  	O	null
3 התבוננות התבוננות התבוננות noun feminine singular absolute unspecified unspecified  	O	null
4 מעודן מעודן מעודן adjective masculine singular absolute unspecified unspecified  	O	null
5 ו ו ובחדות conjunction unspecified unspecified unspecified unspecified unspecified 0 
5 ב ב ובחדות preposition unspecified unspecified unspecified unspecified unspecified 0 
5 חדות חדות ובחדות noun feminine singular construct unspecified unspecified  	O	null
6 ראייה ראייה ראייה noun feminine singular absolute unspecified unspecified  	O	null
7 , , , punctuation unspecified unspecified unspecified unspecified unspecified  	O	null
8 ו ו ולוכדת conjunction unspecified unspecified unspecified unspecified unspecified 0 
8 לוכדת לכד ולוכדת verb feminine singular unspecified any beinoni  	O	null
9 את את את at-preposition unspecified unspecified unspecified unspecified unspecified  	O	null
10 ה ה הרגעים definiteArticle unspecified unspecified unspecified unspecified unspecified 0 
10 הרגעים רגע הרגעים noun masculine plural absolute unspecified unspecified  	O	null
11 ה ה האנושיים definiteArticle unspecified unspecified unspecified unspecified unspecified 0 
11 האנושיים אנושי האנושיים adjective masculine plural absolute unspecified unspecified  	O	null
12 ו ו והדיוקנאות conjunction unspecified unspecified unspecified unspecified unspecified 0 
12 ה ה והדיוקנאות definiteArticle unspecified unspecified unspecified unspecified unspecified 0 
12 הדיוקנאות דיוקן והדיוקנאות noun masculine plural absolute unspecified unspecified  	O	null
13 ה ה ההיסטוריים definiteArticle unspecified unspecified unspecified unspecified unspecified 0 
13 ההיסטוריים היסטורי ההיסטוריים adjective masculine plural absolute unspecified unspecified  	O	null
14 . . . punctuation unspecified unspecified unspecified unspecified unspecified  	O	null

0 קטעים קטע קטעים noun masculine plural absolute unspecified unspecified  	O	null
1 מ מ מהרומן preposition unspecified unspecified unspecified unspecified unspecified 0 
1 ה ה מהרומן definiteArticle unspecified unspecified unspecified unspecified unspecified 0 
1 הרומן רומן מהרומן noun masculine singular absolute unspecified unspecified  	O	null
2 כונסו כונס כונסו verb masculine-and-feminine plural unspecified 3 past  	O	null
3 ב ב באנתולוגיה preposition unspecified unspecified unspecified unspecified unspecified 0 
3 אנתולוגיה אנתולוגיה באנתולוגיה noun feminine singular absolute unspecified unspecified  	O	null
4 ש ש שערכה relativizer/subordinatingConjunction unspecified unspecified unspecified unspecified unspecified 0 
4 ערכה ערך שערכה verb feminine singular unspecified 3 past  	O	null
5 יפה יפה יפה adverb unspecified unspecified unspecified unspecified unspecified  	O	null
6 ב ב ברלוביץשאני preposition unspecified unspecified unspecified unspecified unspecified 0 
6 רלוביץשאני רלוביץשאני ברלוביץשאני adjective masculine singular construct unspecified unspecified  	O	null
7 אדמה אדמה אדמה noun feminine singular absolute unspecified unspecified  	O	null
8 ו ו ואדם conjunction unspecified unspecified unspecified unspecified unspecified 0 
8 אדם אדם ואדם noun masculine singular absolute unspecified unspecified  	O	null
9 ) ) ) punctuation unspecified unspecified unspecified unspecified unspecified  	O	null
10 . . . punctuation unspecified unspecified unspecified unspecified unspecified  	O	null
11 ###NUMBER### ###NUMBER### ###NUMBER### numeral unspecified unspecified unspecified unspecified unspecified  	I_DATE	null
12 ספר ספר ספרה noun masculine singular absolute unspecified unspecified  
12 ה ה ספרה possessive feminine singular unspecified 3 unspecified 0 	O	null
13 ה ה השני definiteArticle unspecified unspecified unspecified unspecified unspecified 0 
13 השני ORD2 השני numeral masculine singular absolute unspecified unspecified  	O	null
14 , , , punctuation unspecified unspecified unspecified unspecified unspecified  	O	null
15 אמא אמא אמא noun feminine singular absolute unspecified unspecified  	O	null
16 , , , punctuation unspecified unspecified unspecified unspecified unspecified  	O	null
17 מה מה מה interrogative unspecified unspecified unspecified unspecified unspecified  	O	null
18 הויה הויה הויה verb masculine singular unspecified any beinoni  	O	null
19 ב ב בנו preposition unspecified unspecified unspecified unspecified unspecified  
19 נו נו בנו pronomial masculine-and-feminine plural unspecified 1 unspecified 0 	O	null
20 , , , punctuation unspecified unspecified unspecified unspecified unspecified  	O	null
21 פורסם פורסם פורסם verb masculine singular unspecified 3 past  	O	null
22 ב ב ב preposition unspecified unspecified unspecified unspecified unspecified 0 	O	null
23 - - - punctuation unspecified unspecified unspecified unspecified unspecified  	O	null
24 , , , punctuation unspecified unspecified unspecified unspecified unspecified  	I_ORG	null
25 ###NUMBER### ###NUMBER### ###NUMBER### numeral unspecified unspecified unspecified unspecified unspecified  	I_DATE	null
26 ו ו ואף conjunction unspecified unspecified unspecified unspecified unspecified 0 
26 אף אף ואף conjunction unspecified unspecified unspecified unspecified unspecified  	O	null
27 הוא הוא הוא pronoun masculine singular unspecified 3 unspecified  	O	null
28 מתאר תיאר מתאר verb masculine singular unspecified any beinoni  	O	null
29 את את את at-preposition unspecified unspecified unspecified unspecified unspecified  	O	null
30 חיי חיים חיי noun masculine plural construct unspecified unspecified  	O	null
31 ה ה ההתיישבות definiteArticle unspecified unspecified unspecified unspecified unspecified 0 
31 ההתיישבות התיישבות ההתיישבות noun feminine singular absolute unspecified unspecified  	O	null
32 . . . punctuation unspecified unspecified unspecified unspecified unspecified  	O	null

0 עוד עוד עוד adverb unspecified unspecified unspecified unspecified unspecified  	O	null
1 פירסמה פרסם פירסמה verb feminine singular unspecified 3 past  	O	null
2 עם עם עם preposition unspecified unspecified unspecified unspecified unspecified  	O	null
3 דוד דוד דוד properName unspecified unspecified unspecified unspecified unspecified  	I_PERS	null
4 מ מ מלץ preposition unspecified unspecified unspecified unspecified unspecified 0 
4 לץ לץ מלץ noun masculine singular absolute unspecified unspecified  	O	null
5 את את את at-preposition unspecified unspecified unspecified unspecified unspecified  	O	null
6 קובץ קובץ קובץ noun masculine singular construct unspecified unspecified  	O	null
7 ה ה הסיפורים definiteArticle unspecified unspecified unspecified unspecified unspecified 0 
7 הסיפורים סיפור הסיפורים noun masculine plural absolute unspecified unspecified  	O	null
8 שני CARD2 שני numeral masculine dual construct unspecified unspecified  	O	null
9 סיפורים סיפור סיפורים noun masculine plural absolute unspecified unspecified  	O	null
10 ו ו ואחד conjunction unspecified unspecified unspecified unspecified unspecified 0 
10 אחד איחד ואחד verb masculine singular unspecified 3 past  	O	null
11 , , , punctuation unspecified unspecified unspecified unspecified unspecified  	O	null
12 ###NUMBER### ###NUMBER### ###NUMBER### numeral unspecified unspecified unspecified unspecified unspecified  	I_DATE	null
13 ו ו ולו conjunction unspecified unspecified unspecified unspecified unspecified 0 
13 לו לו ולו conjunction unspecified unspecified unspecified unspecified unspecified  	O	null
14 תרמה תרם תרמה verb feminine singular unspecified 3 past  	O	null
15 את את את at-preposition unspecified unspecified unspecified unspecified unspecified  	O	null
16 ה ה הסיפור definiteArticle unspecified unspecified unspecified unspecified unspecified 0 
16 הסיפור סיפור הסיפור noun masculine singular absolute unspecified unspecified  	O	null
17 " " " punctuation unspecified unspecified unspecified unspecified unspecified  	O	null
18 ה ה המאמין definiteArticle unspecified unspecified unspecified unspecified unspecified 0 
18 המאמין האמין המאמין participle masculine singular absolute any unspecified  	O	null
19 את את אתה at-preposition unspecified unspecified unspecified unspecified unspecified  
19 ה ה אתה pronomial feminine singular unspecified 3 unspecified 0 	O	null
20 " " " punctuation unspecified unspecified unspecified unspecified unspecified  	O	null
21 ) ) ) punctuation unspecified unspecified unspecified unspecified unspecified  	O	null
22 . . . punctuation unspecified unspecified unspecified unspecified unspecified  	O	null

0 ה ה הספר definiteArticle unspecified unspecified unspecified unspecified unspecified 0 
0 הספר ספר הספר noun masculine singular absolute unspecified unspecified  	O	null
1 ש ש שבתי relativizer/subordinatingConjunction unspecified unspecified unspecified unspecified unspecified 0 
1 בתי בית שבתי noun masculine plural construct unspecified unspecified  	O	null
2 אל אל אלייך preposition unspecified unspecified unspecified unspecified unspecified  
2 ך ך אלייך pronomial feminine singular unspecified 2 unspecified 0 	O	null
3 גדר גדר גדרה noun feminine singular absolute unspecified unspecified  
3 ה ה גדרה possessive feminine singular unspecified 3 unspecified 0 	O	null
4 ( ( ( punctuation unspecified unspecified unspecified unspecified unspecified  	O	null
5 ###NUMBER### ###NUMBER### ###NUMBER### numeral unspecified unspecified unspecified unspecified unspecified  	I_DATE	null
6 ) ) ) punctuation unspecified unspecified unspecified unspecified unspecified  	O	null
7 נכתב נכתב נכתב verb masculine singular unspecified 3 past  	O	null
8 ל ל לזכרו preposition unspecified unspecified unspecified unspecified unspecified 0 
8 זכר זכר לזכרו noun masculine singular absolute unspecified unspecified  
8 ו ו לזכרו possessive masculine singular unspecified 3 unspecified 0 	O	null
9 של של של shel-preposition unspecified unspecified unspecified unspecified unspecified  	O	null
10 ד"ר ד"ר ד"ר title unspecified singular unspecified unspecified unspecified  	O	null
11 משה משה משה properName unspecified unspecified unspecified unspecified unspecified  	I_PERS	null
12 מינץ מינץ מינץ properName unspecified unspecified unspecified unspecified unspecified  	I_PERS	null
13 , , , punctuation unspecified unspecified unspecified unspecified unspecified  	O	null
14 מייסד מייסד מייסד noun masculine singular construct unspecified unspecified  	O	null
15 בית בית בית noun masculine singular construct unspecified unspecified  	O	null
16 ה ה העם definiteArticle unspecified unspecified unspecified unspecified unspecified 0 
16 העם עם העם noun masculine singular absolute unspecified unspecified  	O	null
17 ב ב בגדרה preposition unspecified unspecified unspecified unspecified unspecified 0 
17 גדרה גדרה בגדרה properName unspecified unspecified unspecified unspecified unspecified  	I_LOC	null
18 . . . punctuation unspecified unspecified unspecified unspecified unspecified  	O	null

0 References References References foreign unspecified unspecified unspecified unspecified unspecified  	O	null
1 : : : punctuation unspecified unspecified unspecified unspecified unspecified  	O	null
2 ברלוביץ ברלוביץ ברלוביץ properName unspecified unspecified unspecified unspecified unspecified  	I_ORG	null
3 , , , punctuation unspecified unspecified unspecified unspecified unspecified  	O	null
4 יפה יפה יפה adverb unspecified unspecified unspecified unspecified unspecified  	O	null
5 . . . punctuation unspecified unspecified unspecified unspecified unspecified  	O	null

0 " " " punctuation unspecified unspecified unspecified unspecified unspecified  	O	null
1 ב ב בחיפוש preposition unspecified unspecified unspecified unspecified unspecified 0 
1 חיפוש חיפוש בחיפוש noun masculine singular absolute unspecified unspecified  	O	null
2 אחר אחר אחר adjective masculine singular absolute unspecified unspecified  	O	null
3 דיוקן דיוקן דיוקן noun masculine singular absolute unspecified unspecified  	O	null
4 ה ה ה numeral unspecified unspecified unspecified unspecified unspecified  	O	null
5 ' ' ' punctuation unspecified unspecified unspecified unspecified unspecified  	O	null
6 ארץ ארץ ארץ noun feminine singular construct unspecified unspecified  	O	null
7 - - - punctuation unspecified unspecified unspecified unspecified unspecified  	O	null
8 ישראלית' ישראלית' ישראלית' noun masculine singular absolute unspecified unspecified  	O	null
9 ב ב בספרות preposition unspecified unspecified unspecified unspecified unspecified 0 
9 ספרות ספרות בספרות noun feminine singular construct unspecified unspecified  	O	null
10 ה ה הנשים definiteArticle unspecified unspecified unspecified unspecified unspecified 0 
10 הנשים איש הנשים noun feminine plural absolute unspecified unspecified  	O	null
11 ב ב בתקופת preposition unspecified unspecified unspecified unspecified unspecified 0 
11 תקופת תקופה בתקופת noun feminine singular construct unspecified unspecified  	O	null
12 ה ה היישוב definiteArticle unspecified unspecified unspecified unspecified unspecified 0 
12 היישוב יישוב היישוב noun masculine singular absolute unspecified unspecified  	O	null
13 " " " punctuation unspecified unspecified unspecified unspecified unspecified  	O	null
14 . . . punctuation unspecified unspecified unspecified unspecified unspecified  	O	null
15 ביקורת ביקורת ביקורת noun feminine singular absolute unspecified unspecified  	O	null
16 ו ו ופרשנות conjunction unspecified unspecified unspecified unspecified unspecified 0 
16 פרשנות פרשנות ופרשנות noun feminine singular absolute unspecified unspecified  	O	null
17 ###NUMBER### ###NUMBER### ###NUMBER### numeral unspecified unspecified unspecified unspecified unspecified  	O	null
18 . . . punctuation unspecified unspecified unspecified unspecified unspecified  	O	null

0 ###NUMBER### ###NUMBER### ###NUMBER### numeral unspecified unspecified unspecified unspecified unspecified  	O	null
1 - - - punctuation unspecified unspecified unspecified unspecified unspecified  	O	null
2 ###NUMBER### ###NUMBER### ###NUMBER### numeral unspecified unspecified unspecified unspecified unspecified  	O	null
3 ; ; ; punctuation unspecified unspecified unspecified unspecified unspecified  	O	null
4 דור דור דור properName unspecified unspecified unspecified unspecified unspecified  	I_PERS	null
5 , , , punctuation unspecified unspecified unspecified unspecified unspecified  	O	null
6 משה משה משה properName unspecified unspecified unspecified unspecified unspecified  	I_PERS	null
7 . . . punctuation unspecified unspecified unspecified unspecified unspecified  	O	null

0 " " " punctuation unspecified unspecified unspecified unspecified unspecified  	O	null
1 ה ה הכתיבה definiteArticle unspecified unspecified unspecified unspecified unspecified 0 
1 הכתיבה כתיבה הכתיבה noun feminine singular absolute unspecified unspecified  	O	null
2 היא הוא היא copula feminine singular unspecified 3 beinoni  	O	null
3 ענין עניין ענין noun masculine singular absolute unspecified unspecified  	O	null
4 פרטי פרטי פרטי adjective masculine singular absolute unspecified unspecified  	O	null
5 ב ב בעיני preposition unspecified unspecified unspecified unspecified unspecified 0 
5 עיני עין בעיני noun feminine plural construct unspecified unspecified  	O	null
6 רוחמה רוחמה רוחמה properName masculine singular unspecified unspecified unspecified  	I_PERS	null
7 חזנוב חזנוב חזנוב properName unspecified unspecified unspecified unspecified unspecified  	I_PERS	null
8 מ מ מעין preposition unspecified unspecified unspecified unspecified unspecified 0 
8 עין עין מעין noun feminine singular construct unspecified unspecified  	O	null
9 חרוד חרוד חרוד noun masculine singular absolute unspecified unspecified  	O	null
10 " " " punctuation unspecified unspecified unspecified unspecified unspecified  	O	null
11 . . . punctuation unspecified unspecified unspecified unspecified unspecified  	O	null

0 מעריב מעריב מעריב properName unspecified unspecified unspecified unspecified unspecified  	I_ORG	null
1 ספרות ספרות ספרות noun feminine singular absolute unspecified unspecified  	O	null
2 . . . punctuation unspecified unspecified unspecified unspecified unspecified  	O	null

0 . . . punctuation unspecified unspecified unspecified unspecified unspecified  	O	null
1 ###NUMEXP### ###NUMEXP### ###NUMEXP### numberExpression unspecified unspecified unspecified unspecified unspecified  	I_DATE	null
2 - - - punctuation unspecified unspecified unspecified unspecified unspecified  	O	null
3 ###NUMBER### ###NUMBER### ###NUMBER### numeral unspecified unspecified unspecified unspecified unspecified  	O	null
4 ; ; ; punctuation unspecified unspecified unspecified unspecified unspecified  	O	null
5 ###NUMBER### ###NUMBER### ###NUMBER### numeral unspecified unspecified unspecified unspecified unspecified  	O	null
6 כצנלסון כצנלסון כצנלסון properName unspecified unspecified unspecified unspecified unspecified  	I_PERS	null
7 - - - properName unspecified unspecified unspecified unspecified unspecified  	I_PERS	null
8 שזר שזר שזר properName unspecified unspecified unspecified unspecified unspecified  	I_PERS	null
9 , , , punctuation unspecified unspecified unspecified unspecified unspecified  	O	null
10 רחל."רשימות". רחל."רשימות". רחל."רשימות". properName unspecified unspecified unspecified unspecified unspecified  	I_PERS	null
11 דברהפועלת דברהפועלת דברהפועלת verb masculine-and-feminine plural unspecified 2 imperative  	O	null
12 ט"ז ט"ז ט"ז properName unspecified unspecified unspecified unspecified unspecified  	I_PERS	null
13 ) ) ) punctuation unspecified unspecified unspecified unspecified unspecified  	O	null
14 . . . punctuation unspecified unspecified unspecified unspecified unspecified  	O	null
15 ###NUMBER### ###NUMBER### ###NUMBER### numeral unspecified unspecified unspecified unspecified unspecified  	I_DATE	null
16 . . . punctuation unspecified unspecified unspecified unspecified unspecified  	O	null

0 ###NUMBER### ###NUMBER### ###NUMBER### numeral unspecified unspecified unspecified unspecified unspecified  	O	null
1 ###NUMBER### ###NUMBER### ###NUMBER### numeral unspecified unspecified unspecified unspecified unspecified  	O	null
2 - - - punctuation unspecified unspecified unspecified unspecified unspecified  	O	null
3 ###NUMBER### ###NUMBER### ###NUMBER### numeral unspecified unspecified unspecified unspecified unspecified  	O	null
4 . . . punctuation unspecified unspecified unspecified unspecified unspecified  	O	null

