0 Name Name Name foreign unspecified unspecified unspecified unspecified unspecified  	O	null
1 : : : punctuation unspecified unspecified unspecified unspecified unspecified  	O	null
2 טרבאי טרבאי טרבאי properName unspecified unspecified unspecified unspecified unspecified  	I_ORG	null
3 , , , punctuation unspecified unspecified unspecified unspecified unspecified  	O	null
4 דוד דוד דוד properName unspecified unspecified unspecified unspecified unspecified  	I_PERS	null
5 Birth Birth Birth foreign unspecified unspecified unspecified unspecified unspecified  	O	null
6 Year Year Year foreign unspecified unspecified unspecified unspecified unspecified  	O	null
7 : : : punctuation unspecified unspecified unspecified unspecified unspecified  	O	null
8 ###NUMBER### ###NUMBER### ###NUMBER### numeral unspecified unspecified unspecified unspecified unspecified  	I_DATE	null
9 Birth Birth Birth foreign unspecified unspecified unspecified unspecified unspecified  	O	null
10 Place Place Place foreign unspecified unspecified unspecified unspecified unspecified  	O	null
11 : : : punctuation unspecified unspecified unspecified unspecified unspecified  	O	null
12 בודפשט בודפשט בודפשט properName unspecified unspecified unspecified unspecified unspecified  	I_LOC	null
13 , , , punctuation unspecified unspecified unspecified unspecified unspecified  	O	null
14 הונגריה הונגריה הונגריה properName unspecified unspecified unspecified unspecified unspecified  	I_LOC	null
15 Occupation Occupation Occupation foreign unspecified unspecified unspecified unspecified unspecified  	O	null
16 : : : punctuation unspecified unspecified unspecified unspecified unspecified  	O	null
17 סופר סופר סופר noun masculine singular absolute unspecified unspecified  	O	null
18 ו ו ומתרגם conjunction unspecified unspecified unspecified unspecified unspecified 0 
18 מתרגם מתרגם ומתרגם noun masculine singular absolute unspecified unspecified  	O	null
19 Entry Entry Entry foreign unspecified unspecified unspecified unspecified unspecified  	O	null
20 writer writer writer foreign unspecified unspecified unspecified unspecified unspecified  	O	null
21 : : : punctuation unspecified unspecified unspecified unspecified unspecified  	O	null
22 אמנון אמנון אמנון properName unspecified unspecified unspecified unspecified unspecified  	I_PERS	null
23 ז'קונט ז'קונט ז'קונט properName unspecified unspecified unspecified unspecified unspecified  	I_PERS	null
24 Entry Entry Entry foreign unspecified unspecified unspecified unspecified unspecified  	O	null
25 Value Value Value foreign unspecified unspecified unspecified unspecified unspecified  	O	null
26 : : : punctuation unspecified unspecified unspecified unspecified unspecified  	O	null
27 נולד נולד נולד verb masculine singular unspecified 3 past  	O	null
28 ב ב בבודפשט preposition unspecified unspecified unspecified unspecified unspecified 0 
28 בודפשט בודפשט בבודפשט properName unspecified unspecified unspecified unspecified unspecified  	I_LOC	null
29 , , , punctuation unspecified unspecified unspecified unspecified unspecified  	O	null
30 הונגריה הונגריה הונגריה properName unspecified unspecified unspecified unspecified unspecified  	I_LOC	null
31 . . . punctuation unspecified unspecified unspecified unspecified unspecified  	O	null

0 כש כש כשהיה temporalSubConj unspecified unspecified unspecified unspecified unspecified 0 
0 היה הוא כשהיה copula masculine singular unspecified 3 past  	O	null
1 ב ב בן preposition unspecified unspecified unspecified unspecified unspecified  
1 הן הן בן pronomial feminine plural unspecified 3 unspecified 0 	O	null
2 שלוש CARD3 שלוש numeral feminine singular absolute unspecified unspecified  	O	null
3 נפרדה נפרד נפרדה verb feminine singular unspecified 3 past  	O	null
4 אם אם אמו noun feminine singular absolute unspecified unspecified  
4 ו ו אמו possessive masculine singular unspecified 3 unspecified 0 	O	null
5 מ מ מאביו preposition unspecified unspecified unspecified unspecified unspecified 0 
5 אבי אב מאביו noun masculine singular absolute unspecified unspecified  
5 ו ו מאביו possessive masculine singular unspecified 3 unspecified 0 	O	null
6 , , , punctuation unspecified unspecified unspecified unspecified unspecified  	O	null
7 אד אד אדה punctuation masculine singular absolute unspecified unspecified  	O	null
8 טרבאי טרבאי טרבאי properName unspecified unspecified unspecified unspecified unspecified  	I_PERS	null
9 , , , punctuation unspecified unspecified unspecified unspecified unspecified  	O	null
10 סופר סופר סופר noun masculine singular construct unspecified unspecified  	O	null
11 ילדים ילד ילדים noun masculine plural absolute unspecified unspecified  	O	null
12 ידוע ידוע ידוע adjective masculine singular absolute unspecified unspecified  	O	null
13 ב ב בהונגריה preposition unspecified unspecified unspecified unspecified unspecified 0 
13 הונגריה הונגריה בהונגריה properName unspecified unspecified unspecified unspecified unspecified  	I_LOC	null
14 , , , punctuation unspecified unspecified unspecified unspecified unspecified  	O	null
15 ו ו וכשהיה conjunction unspecified unspecified unspecified unspecified unspecified 0 
15 כש כש וכשהיה temporalSubConj unspecified unspecified unspecified unspecified unspecified 0 
15 היה הוא וכשהיה copula masculine singular unspecified 3 past  	O	null
16 ב ב בן preposition unspecified unspecified unspecified unspecified unspecified  
16 הן הן בן pronomial feminine plural unspecified 3 unspecified 0 	O	null
17 ארבע CARD4 ארבע numeral feminine singular absolute unspecified unspecified  	O	null
18 - - - punctuation unspecified unspecified unspecified unspecified unspecified  	O	null
19 עשרה CARD10 עשרה numeral masculine plural absolute unspecified unspecified  	O	null
20 עלתה עלה עלתה verb feminine singular unspecified 3 past  	O	null
21 עם עם עמו preposition unspecified unspecified unspecified unspecified unspecified  
21 ו ו עמו pronomial masculine singular unspecified 3 unspecified 0 	O	null
22 ארצה ארצה ארצה adverb unspecified unspecified unspecified unspecified unspecified  	O	null
23 . . . punctuation unspecified unspecified unspecified unspecified unspecified  	O	null

0 ה ה האם definiteArticle unspecified unspecified unspecified unspecified unspecified 0 
0 האם אם האם noun feminine singular absolute unspecified unspecified  	O	null
1 , , , punctuation unspecified unspecified unspecified unspecified unspecified  	O	null
2 ש ש שעבדה relativizer/subordinatingConjunction unspecified unspecified unspecified unspecified unspecified 0 
2 עבדה עבד שעבדה verb feminine singular unspecified 3 past  	O	null
3 ב ב בבודפשט preposition unspecified unspecified unspecified unspecified unspecified 0 
3 בודפשט בודפשט בבודפשט properName unspecified unspecified unspecified unspecified unspecified  	I_LOC	null
4 כ כ כעורכת preposition unspecified unspecified unspecified unspecified unspecified 0 
4 עורכת עורך כעורכת noun feminine singular construct unspecified unspecified  	O	null
5 ספרים ספר ספרים noun masculine plural absolute unspecified unspecified  	O	null
6 , , , punctuation unspecified unspecified unspecified unspecified unspecified  	O	null
7 הפכה הפך הפכה verb feminine singular unspecified 3 past  	O	null
8 ל ל למרצה preposition unspecified unspecified unspecified unspecified unspecified 0 
8 מרץ מרץ למרצה noun masculine singular absolute unspecified unspecified  
8 ה ה למרצה possessive feminine singular unspecified 3 unspecified 0 	O	null
9 ו ו ולחוקרת conjunction unspecified unspecified unspecified unspecified unspecified 0 
9 ל ל ולחוקרת preposition unspecified unspecified unspecified unspecified unspecified 0 
9 ה ה ולחוקרת definiteArticle unspecified unspecified unspecified unspecified unspecified 0 
9 החוקרת חוקר ולחוקרת noun feminine singular absolute unspecified unspecified  	O	null
10 של של של shel-preposition unspecified unspecified unspecified unspecified unspecified  	O	null
11 ספרות ספרות ספרות noun feminine singular absolute unspecified unspecified  	O	null
12 הונגרית הונגרי הונגרית adjective feminine singular absolute unspecified unspecified  	O	null
13 ב ב באוניברסיטה preposition unspecified unspecified unspecified unspecified unspecified 0 
13 ה ה באוניברסיטה definiteArticle unspecified unspecified unspecified unspecified unspecified 0 
13 האוניברסיטה אוניברסיטה באוניברסיטה noun feminine singular absolute unspecified unspecified  	O	null
14 ה ה העברית definiteArticle unspecified unspecified unspecified unspecified unspecified 0 
14 העברית עברי העברית adjective feminine singular absolute unspecified unspecified  	O	null
15 ב ב בירושלים preposition unspecified unspecified unspecified unspecified unspecified 0 
15 ירושלים ירושלים בירושלים properName unspecified unspecified unspecified unspecified unspecified  	I_LOC	null
16 . . . punctuation unspecified unspecified unspecified unspecified unspecified  	O	null

0 למד למד למד verb masculine singular unspecified 3 past  	O	null
1 ב ב בתיכון preposition unspecified unspecified unspecified unspecified unspecified 0 
1 תיכון תיכון בתיכון noun masculine singular absolute unspecified unspecified  	O	null
2 ע"ש ע"ש ע"ש preposition unspecified unspecified unspecified unspecified unspecified  	O	null
3 תלמה תלמה תלמה properName unspecified unspecified unspecified unspecified unspecified  	I_PERS	null
4 ילין ילין ילין properName unspecified unspecified unspecified unspecified unspecified  	I_PERS	null
5 ו ו והשלים conjunction unspecified unspecified unspecified unspecified unspecified 0 
5 השלים השלים והשלים verb masculine singular unspecified 3 past  	O	null
6 את את את at-preposition unspecified unspecified unspecified unspecified unspecified  	O	null
7 השכלת השכלה השכלתו noun feminine singular absolute unspecified unspecified  
7 ו ו השכלתו possessive masculine singular unspecified 3 unspecified 0 	O	null
8 ב ב באופן preposition unspecified unspecified unspecified unspecified unspecified 0 
8 אופן אופן באופן noun masculine singular absolute unspecified unspecified  	O	null
9 פרטי פרטי פרטי adjective masculine singular absolute unspecified unspecified  	O	null
10 אצל אצל אצל preposition unspecified unspecified unspecified unspecified unspecified  	O	null
11 מורה מורה מורה noun masculine singular absolute unspecified unspecified  	O	null
12 ל ל לקומפוזיציה preposition unspecified unspecified unspecified unspecified unspecified 0 
12 ה ה לקומפוזיציה definiteArticle unspecified unspecified unspecified unspecified unspecified 0 
12 הקומפוזיציה קומפוזיציה לקומפוזיציה noun feminine singular absolute unspecified unspecified  	O	null
13 . . . punctuation unspecified unspecified unspecified unspecified unspecified  	O	null

0 אחר אחר אחר preposition unspecified unspecified unspecified unspecified unspecified  	O	null
1 כך כך כך pronoun unspecified unspecified unspecified unspecified unspecified  	O	null
2 למד למד למד verb masculine singular unspecified 3 past  	O	null
3 ב ב בחוג preposition unspecified unspecified unspecified unspecified unspecified 0 
3 ה ה בחוג definiteArticle unspecified unspecified unspecified unspecified unspecified 0 
3 החוג חוג בחוג noun masculine singular absolute unspecified unspecified  	O	null
4 ל ל לקולנוע preposition unspecified unspecified unspecified unspecified unspecified 0 
4 ה ה לקולנוע definiteArticle unspecified unspecified unspecified unspecified unspecified 0 
4 הקולנוע קולנוע לקולנוע noun masculine singular absolute unspecified unspecified  	O	null
5 ו ו וטלוויזיה conjunction unspecified unspecified unspecified unspecified unspecified 0 
5 טלוויזיה טלוויזיה וטלוויזיה noun feminine singular absolute unspecified unspecified  	O	null
6 ב ב באוניברסיטת preposition unspecified unspecified unspecified unspecified unspecified 0 
6 אוניברסיטת אוניברסיטה באוניברסיטת noun feminine singular construct unspecified unspecified  	I_ORG	null
7 תלאביב תלאביב תלאביב properName unspecified unspecified unspecified unspecified unspecified  	I_ORG	null
8 . . . punctuation unspecified unspecified unspecified unspecified unspecified  	O	null

0 ב ב ב preposition unspecified unspecified unspecified unspecified unspecified 0 	O	null
1 - - - punctuation unspecified unspecified unspecified unspecified unspecified  	O	null
2 ###NUMBER### ###NUMBER### ###NUMBER### numeral unspecified unspecified unspecified unspecified unspecified  	I_DATE	null
3 החל החל החל verb masculine singular unspecified 3 past  	O	null
4 לפרסם פרסם לפרסם verb unspecified unspecified unspecified unspecified infinitive  	O	null
5 תרגומים תרגום תרגומים noun masculine plural absolute unspecified unspecified  	O	null
6 ו ו וביקורות conjunction unspecified unspecified unspecified unspecified unspecified 0 
6 ביקורות ביקורת וביקורות noun feminine plural absolute unspecified unspecified  	O	null
7 ב ב בעיתונים preposition unspecified unspecified unspecified unspecified unspecified 0 
7 עיתונים עיתון בעיתונים noun masculine plural absolute unspecified unspecified  	O	null
8 שונים שונה שונים adjective masculine plural absolute unspecified unspecified  	O	null
9 כ כ כעתון preposition unspecified unspecified unspecified unspecified unspecified 0 
9 ה ה כעתון definiteArticle unspecified unspecified unspecified unspecified unspecified 0 
9 העתון עיתון כעתון noun masculine singular absolute unspecified unspecified  	O	null
10 , , , punctuation unspecified unspecified unspecified unspecified unspecified  	O	null
11 ###NUMBER### ###NUMBER### ###NUMBER### numeral unspecified unspecified unspecified unspecified unspecified  	O	null
12 ידיעות ידיעה ידיעות noun feminine plural absolute unspecified unspecified  	I_ORG	null
13 אחרונות אחרון אחרונות adjective feminine plural absolute unspecified unspecified  	I_ORG	null
14 ו ו וטיים conjunction unspecified unspecified unspecified unspecified unspecified 0 
14 טיים טיים וטיים noun masculine singular absolute unspecified unspecified  	I_ORG	null
15 אאוט אאוט אאוט properName unspecified unspecified unspecified unspecified unspecified  	I_PERS	null
16 . . . punctuation unspecified unspecified unspecified unspecified unspecified  	O	null

0 ב ב ב preposition unspecified unspecified unspecified unspecified unspecified 0 	I_ORG	null
1 - - - punctuation unspecified unspecified unspecified unspecified unspecified  	I_ORG	null
2 ###NUMBER### ###NUMBER### ###NUMBER### numeral unspecified unspecified unspecified unspecified unspecified  	I_DATE	null
3 ראה ראה ראה verb masculine singular unspecified 3 past  	O	null
4 אור אור אור noun masculine singular construct unspecified unspecified  	O	null
5 ספר ספר ספרו noun masculine singular absolute unspecified unspecified  
5 ו ו ספרו possessive masculine singular unspecified 3 unspecified 0 	O	null
6 ה ה הראשון definiteArticle unspecified unspecified unspecified unspecified unspecified 0 
6 הראשון ORD1 הראשון numeral masculine singular absolute unspecified unspecified  	O	null
7 , , , punctuation unspecified unspecified unspecified unspecified unspecified  	O	null
8 אדוניס אדוניס אדוניס properName unspecified unspecified unspecified unspecified unspecified  	O	null
9 ( ( ( punctuation unspecified unspecified unspecified unspecified unspecified  	O	null
10 גוונים גוון גוונים noun masculine plural absolute unspecified unspecified  	O	null
11 ) ) ) punctuation unspecified unspecified unspecified unspecified unspecified  	O	null
12 , , , punctuation unspecified unspecified unspecified unspecified unspecified  	O	null
13 ש ש שנכתב relativizer/subordinatingConjunction unspecified unspecified unspecified unspecified unspecified 0 
13 נכתב נכתב שנכתב verb masculine singular unspecified 3 past  	O	null
14 ב ב במקורו preposition unspecified unspecified unspecified unspecified unspecified 0 
14 מקור מקור במקורו noun masculine singular absolute unspecified unspecified  
14 ו ו במקורו possessive masculine singular unspecified 3 unspecified 0 	O	null
15 כ כ כתסריט preposition unspecified unspecified unspecified unspecified unspecified 0 
15 ה ה כתסריט definiteArticle unspecified unspecified unspecified unspecified unspecified 0 
15 התסריט תסריט כתסריט noun masculine singular absolute unspecified unspecified  	O	null
16 ל ל לחוג preposition unspecified unspecified unspecified unspecified unspecified 0 
16 ה ה לחוג definiteArticle unspecified unspecified unspecified unspecified unspecified 0 
16 החוג חוג לחוג noun masculine singular absolute unspecified unspecified  	O	null
17 ל ל לקולנוע preposition unspecified unspecified unspecified unspecified unspecified 0 
17 ה ה לקולנוע definiteArticle unspecified unspecified unspecified unspecified unspecified 0 
17 הקולנוע קולנוע לקולנוע noun masculine singular absolute unspecified unspecified  	O	null
18 . . . punctuation unspecified unspecified unspecified unspecified unspecified  	O	null

0 ב ב בספר preposition unspecified unspecified unspecified unspecified unspecified 0 
0 ספר ספר בספר noun masculine singular construct unspecified unspecified  	O	null
1 חמישה CARD5 חמישה numeral masculine plural absolute unspecified unspecified  	O	null
2 סיפורים סיפור סיפורים noun masculine plural absolute unspecified unspecified  	O	null
3 ה ה המתרחשים definiteArticle unspecified unspecified unspecified unspecified unspecified 0 
3 המתרחשים התרחש המתרחשים participle masculine plural absolute any unspecified  	O	null
4 ב ב בתקופות preposition unspecified unspecified unspecified unspecified unspecified 0 
4 תקופות תקופה בתקופות noun feminine plural absolute unspecified unspecified  	O	null
5 שונות שונה שונות adjective feminine plural absolute unspecified unspecified  	O	null
6 , , , punctuation unspecified unspecified unspecified unspecified unspecified  	O	null
7 אך אך אך conjunction unspecified unspecified unspecified unspecified unspecified  	O	null
8 כולם כולם כולם pronoun masculine plural unspecified 3 unspecified  	O	null
9 מתארים תיאר מתארים verb masculine plural unspecified any beinoni  	O	null
10 מפגש מפגש מפגש noun masculine singular absolute unspecified unspecified  	O	null
11 ה ה המתקיים definiteArticle unspecified unspecified unspecified unspecified unspecified 0 
11 המתקיים התקיים המתקיים participle masculine singular absolute any unspecified  	O	null
12 ב ב באותו preposition unspecified unspecified unspecified unspecified unspecified 0 
12 אותו אותו באותו quantifier unspecified unspecified construct unspecified unspecified  	O	null
13 ה ה האתר definiteArticle unspecified unspecified unspecified unspecified unspecified 0 
13 האתר אתר האתר noun masculine singular absolute unspecified unspecified  	O	null
14 : : : punctuation unspecified unspecified unspecified unspecified unspecified  	O	null
15 טירה טירה טירה noun feminine singular absolute unspecified unspecified  	O	null
16 עתיקה עתיק עתיקה adjective feminine singular absolute unspecified unspecified  	O	null
17 ב ב בצרפת preposition unspecified unspecified unspecified unspecified unspecified 0 
17 צרפת צרפת בצרפת properName unspecified unspecified unspecified unspecified unspecified  	I_LOC	null
18 , , , punctuation unspecified unspecified unspecified unspecified unspecified  	O	null
19 על על על preposition unspecified unspecified unspecified unspecified unspecified  	O	null
20 גבול גבול גבול noun masculine singular construct unspecified unspecified  	O	null
21 בלגיה בלגיה בלגיה properName unspecified unspecified unspecified unspecified unspecified  	I_LOC	null
22 . . . punctuation unspecified unspecified unspecified unspecified unspecified  	O	null

0 נושא נושא נושאו noun masculine singular absolute unspecified unspecified  
0 ו ו נושאו possessive masculine singular unspecified 3 unspecified 0 	O	null
1 ה ה הסמוי definiteArticle unspecified unspecified unspecified unspecified unspecified 0 
1 הסמוי סמוי הסמוי adjective masculine singular absolute unspecified unspecified  	O	null
2 של של של shel-preposition unspecified unspecified unspecified unspecified unspecified  	O	null
3 ה ה הספר definiteArticle unspecified unspecified unspecified unspecified unspecified 0 
3 הספר ספר הספר noun masculine singular absolute unspecified unspecified  	O	null
4 הוא הוא הוא pronoun masculine singular unspecified 3 unspecified  	O	null
5 מוזיקה מוזיקה מוזיקה noun feminine singular absolute unspecified unspecified  	O	null
6 : : : punctuation unspecified unspecified unspecified unspecified unspecified  	O	null
7 חמשת חמשה חמשת noun feminine singular construct unspecified unspecified  	O	null
8 ה ה הסיפורים definiteArticle unspecified unspecified unspecified unspecified unspecified 0 
8 הסיפורים סיפור הסיפורים noun masculine plural absolute unspecified unspecified  	O	null
9 שומרים שמר שומרים verb masculine plural unspecified any beinoni  	O	null
10 על על על preposition unspecified unspecified unspecified unspecified unspecified  	O	null
11 עצמאות עצמאות עצמאותם noun feminine singular absolute unspecified unspecified  
11 ם ם עצמאותם possessive masculine plural unspecified 3 unspecified 0 	O	null
12 אך אך אך conjunction unspecified unspecified unspecified unspecified unspecified  	O	null
13 נקשרים נקשר נקשרים verb masculine plural unspecified any beinoni  	O	null
14 זה זה זה pronoun masculine singular unspecified 3 unspecified  	O	null
15 ל ל לזה preposition unspecified unspecified unspecified unspecified unspecified 0 
15 זה זה לזה pronoun masculine singular unspecified 3 unspecified  	O	null
16 באמצעות באמצעות באמצעות preposition unspecified unspecified unspecified unspecified unspecified  	O	null
17 יצירה יצירה יצירה noun feminine singular absolute unspecified unspecified  	O	null
18 מוזיקלית מוזיקלי מוזיקלית adjective feminine singular absolute unspecified unspecified  	O	null
19 ש ש שאבדה relativizer/subordinatingConjunction unspecified unspecified unspecified unspecified unspecified 0 
19 אבדה אבד שאבדה verb feminine singular unspecified 3 past  	O	null
20 ו ו ונמצאה conjunction unspecified unspecified unspecified unspecified unspecified 0 
20 נמצאה נמצא ונמצאה verb feminine singular unspecified 3 past  	O	null
21 כעבור כעבור כעבור preposition unspecified unspecified unspecified unspecified unspecified  	O	null
22 זמן זמן זמן noun masculine singular absolute unspecified unspecified  	O	null
23 . . . punctuation unspecified unspecified unspecified unspecified unspecified  	O	null

0 ה ה הרומן definiteArticle unspecified unspecified unspecified unspecified unspecified 0 
0 הרומן רומן הרומן noun masculine singular absolute unspecified unspecified  	O	null
1 תורגם תורגם תורגם verb masculine singular unspecified 3 past  	O	null
2 ל ל להונגרית preposition unspecified unspecified unspecified unspecified unspecified 0 
2 הונגרית הונגרית להונגרית properName feminine singular unspecified unspecified unspecified  	I_PERS	null
3 ו ו וזכה conjunction unspecified unspecified unspecified unspecified unspecified 0 
3 זכה זכה וזכה verb masculine singular unspecified 3 past  	O	null
4 ל ל להצלחה preposition unspecified unspecified unspecified unspecified unspecified 0 
4 הצלחה הצלחה להצלחה noun feminine singular absolute unspecified unspecified  	O	null
5 ו ו ולביקורות conjunction unspecified unspecified unspecified unspecified unspecified 0 
5 ל ל ולביקורות preposition unspecified unspecified unspecified unspecified unspecified 0 
5 ביקורות ביקורת ולביקורות noun feminine plural absolute unspecified unspecified  	O	null
6 אוהדות אוהד אוהדות adjective feminine plural absolute unspecified unspecified  	O	null
7 ב ב בהונגריה preposition unspecified unspecified unspecified unspecified unspecified 0 
7 הונגריה הונגריה בהונגריה properName unspecified unspecified unspecified unspecified unspecified  	I_LOC	null
8 , , , punctuation unspecified unspecified unspecified unspecified unspecified  	O	null
9 אך אך אך conjunction unspecified unspecified unspecified unspecified unspecified  	O	null
10 ב ב בישראל preposition unspecified unspecified unspecified unspecified unspecified 0 
10 ישראל ישראל בישראל properName unspecified unspecified unspecified unspecified unspecified  	I_LOC	null
11 לא לא לא negation unspecified unspecified unspecified unspecified unspecified  	O	null
12 נכתבה נכתב נכתבה verb feminine singular unspecified 3 past  	O	null
13 על על עליו preposition unspecified unspecified unspecified unspecified unspecified  
13 ו ו עליו pronomial masculine singular unspecified 3 unspecified 0 	O	null
14 ו ו ולו conjunction unspecified unspecified unspecified unspecified unspecified 0 
14 לו לו ולו conjunction unspecified unspecified unspecified unspecified unspecified  	O	null
15 רשימת רשימה רשימת noun feminine singular construct unspecified unspecified  	O	null
16 ביקורת ביקורת ביקורת noun feminine singular absolute unspecified unspecified  	O	null
17 אחת CARD1 אחת numeral feminine singular absolute unspecified unspecified  	O	null
18 . . . punctuation unspecified unspecified unspecified unspecified unspecified  	O	null

0 ה ה הרומן definiteArticle unspecified unspecified unspecified unspecified unspecified 0 
0 הרומן רומן הרומן noun masculine singular absolute unspecified unspecified  	O	null
1 הבא,סטלקר הבא,סטלקר הבא,סטלקר properName unspecified unspecified unspecified unspecified unspecified  	I_ORG	null
2 ( ( ( punctuation unspecified unspecified unspecified unspecified unspecified  	O	null
3 ) ) ) punctuation unspecified unspecified unspecified unspecified unspecified  	O	null
4 , , , punctuation unspecified unspecified unspecified unspecified unspecified  	O	null
5 יצא יצא יצא verb masculine singular unspecified 3 past  	O	null
6 ###NUMBER### ###NUMBER### ###NUMBER### numeral unspecified unspecified unspecified unspecified unspecified  	I_DATE	null
7 ל ל לאור preposition unspecified unspecified unspecified unspecified unspecified 0 
7 אור אור לאור noun masculine singular absolute unspecified unspecified  	O	null
8 ב ב בישראלובהונגריה preposition unspecified unspecified unspecified unspecified unspecified 0 
8 ישראלובהונגריה ישראלובהונגריה בישראלובהונגריה properName unspecified unspecified unspecified unspecified unspecified  	I_PERS	null
9 בובזמן בובזמן בובזמן properName unspecified unspecified unspecified unspecified unspecified  	I_PERS	null
10 , , , punctuation unspecified unspecified unspecified unspecified unspecified  	O	null
11 ו ו ופורסם conjunction unspecified unspecified unspecified unspecified unspecified 0 
11 פורסם פורסם ופורסם verb masculine singular unspecified 3 past  	O	null
12 שם שם שם adverb unspecified unspecified unspecified unspecified unspecified  	O	null
13 ב ב בחגיגיות preposition unspecified unspecified unspecified unspecified unspecified 0 
13 חגיגיות חגיגיות בחגיגיות noun feminine singular absolute unspecified unspecified  	O	null
14 רבה רב רבה adjective feminine singular absolute unspecified unspecified  	O	null
15 ב ב במסגרת preposition unspecified unspecified unspecified unspecified unspecified 0 
15 מסגרת מסגרת במסגרת noun feminine singular construct unspecified unspecified  	O	null
16 פסטיבל פסטיבל פסטיבל noun masculine singular absolute unspecified unspecified  	O	null
17 בינלאומי בינלאומי בינלאומי adjective masculine singular absolute unspecified unspecified  	O	null
18 ל ל לספרות preposition unspecified unspecified unspecified unspecified unspecified 0 
18 ה ה לספרות definiteArticle unspecified unspecified unspecified unspecified unspecified 0 
18 הספרות ספרות לספרות noun feminine singular absolute unspecified unspecified  	O	null
19 . . . punctuation unspecified unspecified unspecified unspecified unspecified  	O	null

0 הפעם הפעם הפעם adverb unspecified unspecified unspecified unspecified unspecified  	O	null
1 זכה זכה זכה verb masculine singular unspecified 3 past  	O	null
2 ה ה הספר definiteArticle unspecified unspecified unspecified unspecified unspecified 0 
2 הספר ספר הספר noun masculine singular absolute unspecified unspecified  	O	null
3 גם גם גם conjunction unspecified unspecified unspecified unspecified unspecified  	O	null
4 כאן כאן כאן adverb unspecified unspecified unspecified unspecified unspecified  	O	null
5 ל ל לביקורות preposition unspecified unspecified unspecified unspecified unspecified 0 
5 ביקורות ביקורת לביקורות noun feminine plural absolute unspecified unspecified  	O	null
6 , , , punctuation unspecified unspecified unspecified unspecified unspecified  	O	null
7 ו ו וב conjunction unspecified unspecified unspecified unspecified unspecified 0 
7 ב ב וב preposition unspecified unspecified unspecified unspecified unspecified 0 	O	null
8 - - - punctuation unspecified unspecified unspecified unspecified unspecified  	O	null
9 ###NUMBER### ###NUMBER### ###NUMBER### numeral unspecified unspecified unspecified unspecified unspecified  	I_DATE	null
10 זכה זכה זכה verb masculine singular unspecified 3 past  	O	null
11 מ מ מחברו preposition unspecified unspecified unspecified unspecified unspecified 0 
11 חבר חבר מחברו noun masculine singular absolute unspecified unspecified  
11 ו ו מחברו possessive masculine singular unspecified 3 unspecified 0 	O	null
12 ב ב בפרס preposition unspecified unspecified unspecified unspecified unspecified 0 
12 פרס פרס בפרס noun masculine singular construct unspecified unspecified  	O	null
13 נשיא נשיא נשיא noun masculine singular construct unspecified unspecified  	O	null
14 ה ה המדינה definiteArticle unspecified unspecified unspecified unspecified unspecified 0 
14 המדינה מדינה המדינה noun feminine singular absolute unspecified unspecified  	O	null
15 ל ל לספרות preposition unspecified unspecified unspecified unspecified unspecified 0 
15 ספרות ספרות לספרות noun feminine singular absolute unspecified unspecified  	O	null
16 ב ב בשיתוף preposition unspecified unspecified unspecified unspecified unspecified 0 
16 שיתוף שיתוף בשיתוף noun masculine singular construct unspecified unspecified  	O	null
17 עם עם עם noun masculine singular construct unspecified unspecified  	O	null
18 ה ה האוניברסיטה definiteArticle unspecified unspecified unspecified unspecified unspecified 0 
18 האוניברסיטה אוניברסיטה האוניברסיטה noun feminine singular absolute unspecified unspecified  	I_ORG	null
19 ה ה העברית definiteArticle unspecified unspecified unspecified unspecified unspecified 0 
19 העברית עברי העברית adjective feminine singular absolute unspecified unspecified  	I_ORG	null
20 . . . punctuation unspecified unspecified unspecified unspecified unspecified  	O	null

0 סטלקר סטלקר סטלקר properName unspecified unspecified unspecified unspecified unspecified  	I_PERS	null
1 עוסק עסק עוסק verb masculine singular unspecified any beinoni  	O	null
2 ב ב בילד preposition unspecified unspecified unspecified unspecified unspecified 0 
2 ה ה בילד definiteArticle unspecified unspecified unspecified unspecified unspecified 0 
2 הילד ילד בילד noun masculine singular absolute unspecified unspecified  	O	null
3 בן בן בן properName unspecified unspecified unspecified unspecified unspecified  	I_PERS	null
4 בלי בלי בלי conjunction unspecified unspecified unspecified unspecified unspecified  	O	null
5 שם שם שם adverb unspecified unspecified unspecified unspecified unspecified  	O	null
6 , , , punctuation unspecified unspecified unspecified unspecified unspecified  	O	null
7 ה ה המתגורר definiteArticle unspecified unspecified unspecified unspecified unspecified 0 
7 המתגורר התגורר המתגורר participle masculine singular absolute any unspecified  	O	null
8 ב ב במקום preposition unspecified unspecified unspecified unspecified unspecified 0 
8 מקום מקום במקום noun masculine singular absolute unspecified unspecified  	O	null
9 ש ש שאינו relativizer/subordinatingConjunction unspecified unspecified unspecified unspecified unspecified 0 
9 אינו הוא שאינו copula masculine singular unspecified 3 beinoni  	O	null
10 מוגדר מוגדר מוגדר adjective masculine singular absolute unspecified unspecified  	O	null
11 , , , punctuation unspecified unspecified unspecified unspecified unspecified  	O	null
12 כנראה כנראה כנראה adverb unspecified unspecified unspecified unspecified unspecified  	O	null
13 ב ב במזרח preposition unspecified unspecified unspecified unspecified unspecified 0 
13 מזרח מזרח במזרח noun masculine singular construct unspecified unspecified  	O	null
14 - - - punctuation unspecified unspecified unspecified unspecified unspecified  	I_LOC	null
15 אירופה אירופה אירופה properName unspecified unspecified unspecified unspecified unspecified  	I_LOC	null
16 . . . punctuation unspecified unspecified unspecified unspecified unspecified  	O	null

0 ה ה הילד definiteArticle unspecified unspecified unspecified unspecified unspecified 0 
0 הילד ילד הילד noun masculine singular absolute unspecified unspecified  	O	null
1 משוחח שוחח משוחח verb masculine singular unspecified any beinoni  	O	null
2 עם עם עם preposition unspecified unspecified unspecified unspecified unspecified  	O	null
3 עצמו עצמו עצמו pronoun unspecified unspecified unspecified unspecified unspecified  
3 ו ו עצמו pronomial masculine singular unspecified 3 unspecified 0 	O	null
4 ו ו ועם conjunction unspecified unspecified unspecified unspecified unspecified 0 
4 עם עם ועם preposition unspecified unspecified unspecified unspecified unspecified  	O	null
5 תחליף תחליף תחליף noun masculine singular construct unspecified unspecified  	O	null
6 ה ה האב definiteArticle unspecified unspecified unspecified unspecified unspecified 0 
6 האב אב האב noun masculine singular absolute unspecified unspecified  	O	null
7 של של שלו shel-preposition unspecified unspecified unspecified unspecified unspecified  
7 ו ו שלו pronomial masculine singular unspecified 3 unspecified 0 	O	null
8 , , , punctuation unspecified unspecified unspecified unspecified unspecified  	O	null
9 ו ו וחולם conjunction unspecified unspecified unspecified unspecified unspecified 0 
9 חולם חלם וחולם verb masculine singular unspecified any beinoni  	O	null
10 ל ל להיות preposition unspecified unspecified unspecified unspecified unspecified 0 
10 היות היות להיות noun masculine singular construct unspecified unspecified  	O	null
11 " " " punctuation unspecified unspecified unspecified unspecified unspecified  	O	null
12 סטלקר סטלקר סטלקר properName unspecified unspecified unspecified unspecified unspecified  	I_ORG	null
13 " " " punctuation unspecified unspecified unspecified unspecified unspecified  	O	null
14 – – – punctuation unspecified unspecified unspecified unspecified unspecified  	O	null
15 מדריך מדריך מדריך noun masculine singular absolute unspecified unspecified  	O	null
16 ו ו ומושיע conjunction unspecified unspecified unspecified unspecified unspecified 0 
16 מושיע מושיע ומושיע noun masculine singular absolute unspecified unspecified  	O	null
17 ל ל לתושבים preposition unspecified unspecified unspecified unspecified unspecified 0 
17 ה ה לתושבים definiteArticle unspecified unspecified unspecified unspecified unspecified 0 
17 התושבים תושב לתושבים noun masculine plural absolute unspecified unspecified  	O	null
18 ה ה האחרים definiteArticle unspecified unspecified unspecified unspecified unspecified 0 
18 האחרים אחר האחרים adjective masculine plural absolute unspecified unspecified  	O	null
19 ב ב במקום preposition unspecified unspecified unspecified unspecified unspecified 0 
19 ה ה במקום definiteArticle unspecified unspecified unspecified unspecified unspecified 0 
19 המקום מקום במקום noun masculine singular absolute unspecified unspecified  	O	null
20 . . . punctuation unspecified unspecified unspecified unspecified unspecified  	O	null

0 בתוך בתוך בתוך preposition unspecified unspecified unspecified unspecified unspecified  	O	null
1 כך כך כך pronoun unspecified unspecified unspecified unspecified unspecified  	O	null
2 מתאר תיאר מתאר verb masculine singular unspecified any beinoni  	O	null
3 טרבאי טרבאי טרבאי noun masculine singular construct unspecified unspecified  	O	null
4 תהליך תהליך תהליך noun masculine singular absolute unspecified unspecified  	O	null
5 של של של shel-preposition unspecified unspecified unspecified unspecified unspecified  	O	null
6 מעבר מעבר מעבר noun masculine singular absolute unspecified unspecified  	O	null
7 מ מ מילדות preposition unspecified unspecified unspecified unspecified unspecified 0 
7 ילדות ילדות מילדות noun feminine singular absolute unspecified unspecified  	O	null
8 ל ל לבגרות preposition unspecified unspecified unspecified unspecified unspecified 0 
8 ה ה לבגרות definiteArticle unspecified unspecified unspecified unspecified unspecified 0 
8 הבגרות בגרות לבגרות noun feminine singular absolute unspecified unspecified  	O	null
9 , , , punctuation unspecified unspecified unspecified unspecified unspecified  	O	null
10 מעבדות מעבדה מעבדות noun feminine plural absolute unspecified unspecified  	O	null
11 ל ל לחירות preposition unspecified unspecified unspecified unspecified unspecified 0 
11 ה ה לחירות definiteArticle unspecified unspecified unspecified unspecified unspecified 0 
11 החירות חירות לחירות noun feminine singular absolute unspecified unspecified  	O	null
12 , , , punctuation unspecified unspecified unspecified unspecified unspecified  	O	null
13 מ מ מחלומות preposition unspecified unspecified unspecified unspecified unspecified 0 
13 חלומות חלום מחלומות noun masculine plural absolute unspecified unspecified  	O	null
14 של של של shel-preposition unspecified unspecified unspecified unspecified unspecified  	O	null
15 ילד ילד ילד noun masculine singular absolute unspecified unspecified  	O	null
16 ל ל למימוש preposition unspecified unspecified unspecified unspecified unspecified 0 
16 מימוש מימוש למימוש noun masculine singular absolute unspecified unspecified  	O	null
17 עצמי עצמי עצמי adjective masculine singular absolute unspecified unspecified  	O	null
18 של של של shel-preposition unspecified unspecified unspecified unspecified unspecified  	O	null
19 מבוגר מבוגר מבוגר noun masculine singular absolute unspecified unspecified  	O	null
20 , , , punctuation unspecified unspecified unspecified unspecified unspecified  	O	null
21 ו ו ובודק conjunction unspecified unspecified unspecified unspecified unspecified 0 
21 בודק בדק ובודק verb masculine singular unspecified any beinoni  	O	null
22 כמה כמה כמה quantifier unspecified unspecified construct unspecified unspecified  	O	null
23 שאלות שאלה שאלות noun feminine plural absolute unspecified unspecified  	O	null
24 מכריעות מכריע מכריעות adjective feminine plural absolute unspecified unspecified  	O	null
25 , , , punctuation unspecified unspecified unspecified unspecified unspecified  	O	null
26 ב ב בהן preposition unspecified unspecified unspecified unspecified unspecified  
26 הן הן בהן pronomial feminine plural unspecified 3 unspecified 0 	O	null
27 באיזו באיזו באיזו preposition unspecified unspecified unspecified unspecified unspecified  	O	null
28 מידה מידה מידה noun feminine singular absolute unspecified unspecified  	O	null
29 יכול יכול יכול modal masculine singular unspecified any beinoni  	O	null
30 ה ה הפרט definiteArticle unspecified unspecified unspecified unspecified unspecified 0 
30 הפרט פרט הפרט noun masculine singular absolute unspecified unspecified  	O	null
31 להגיע הגיע להגיע verb unspecified unspecified unspecified unspecified infinitive  	O	null
32 ל ל להגשמה preposition unspecified unspecified unspecified unspecified unspecified 0 
32 הגשמה הגשמה להגשמה noun feminine singular absolute unspecified unspecified  	O	null
33 עצמית עצמי עצמית adjective feminine singular absolute unspecified unspecified  	O	null
34 כש כש כשהוא temporalSubConj unspecified unspecified unspecified unspecified unspecified 0 
34 הוא הוא כשהוא pronoun masculine singular unspecified 3 unspecified  	O	null
35 נמצא נמצא נמצא verb masculine singular unspecified any beinoni  	O	null
36 ב ב בסביבה preposition unspecified unspecified unspecified unspecified unspecified 0 
36 ה ה בסביבה definiteArticle unspecified unspecified unspecified unspecified unspecified 0 
36 הסביבה סביבה בסביבה noun feminine singular absolute unspecified unspecified  	O	null
37 מדכאת דיכא מדכאת verb feminine singular unspecified any beinoni  	O	null
38 . . . punctuation unspecified unspecified unspecified unspecified unspecified  	O	null

0 ה ה הספר definiteArticle unspecified unspecified unspecified unspecified unspecified 0 
0 הספר ספר הספר noun masculine singular absolute unspecified unspecified  	O	null
1 מספק סיפק מספק verb masculine singular unspecified any beinoni  	O	null
2 ל ל לקורא preposition unspecified unspecified unspecified unspecified unspecified 0 
2 קורא קורא לקורא noun masculine singular construct unspecified unspecified  	O	null
3 מפתחות מפתח מפתחות noun masculine plural absolute unspecified unspecified  	O	null
4 שונים שונה שונים adjective masculine plural absolute unspecified unspecified  	O	null
5 ל ל להבנת preposition unspecified unspecified unspecified unspecified unspecified 0 
5 הבנת הבנה להבנת noun feminine singular construct unspecified unspecified  	O	null
6 ה ה המארג definiteArticle unspecified unspecified unspecified unspecified unspecified 0 
6 המארג מארג המארג noun masculine singular absolute unspecified unspecified  	O	null
7 ה ה הקושר definiteArticle unspecified unspecified unspecified unspecified unspecified 0 
7 הקושר קשר הקושר participle masculine singular absolute any unspecified  	O	null
8 את את את at-preposition unspecified unspecified unspecified unspecified unspecified  	O	null
9 חלקי חלק חלקיו noun masculine plural absolute unspecified unspecified  
9 ו ו חלקיו possessive masculine singular unspecified 3 unspecified 0 	O	null
10 ה ה הפנימיים definiteArticle unspecified unspecified unspecified unspecified unspecified 0 
10 הפנימיים פנימי הפנימיים adjective masculine plural absolute unspecified unspecified  	O	null
11 ; ; ; punctuation unspecified unspecified unspecified unspecified unspecified  	O	null
12 דרך דרך דרך noun feminine singular construct unspecified unspecified  	O	null
13 יצירות יצירה יצירות noun feminine plural absolute unspecified unspecified  	O	null
14 מוזיקליות מוזיקלי מוזיקליות adjective feminine plural absolute unspecified unspecified  	O	null
15 , , , punctuation unspecified unspecified unspecified unspecified unspecified  	O	null
16 סיפורי סיפור סיפורי noun masculine plural construct unspecified unspecified  	O	null
17 מיתולוגיה מיתולוגיה מיתולוגיה noun feminine singular absolute unspecified unspecified  	O	null
18 ו ו וסרט conjunction unspecified unspecified unspecified unspecified unspecified 0 
18 סרט סרט וסרט noun masculine singular construct unspecified unspecified  	O	null
19 ה ה הקולנוע definiteArticle unspecified unspecified unspecified unspecified unspecified 0 
19 הקולנוע קולנוע הקולנוע noun masculine singular absolute unspecified unspecified  	O	null
20 של של של shel-preposition unspecified unspecified unspecified unspecified unspecified  	O	null
21 אנדריי אנדריי אנדריי properName unspecified unspecified unspecified unspecified unspecified  	I_PERS	null
22 טרקובסקי טרקובסקי טרקובסקי properName unspecified unspecified unspecified unspecified unspecified  	I_PERS	null
23 סטלקר סטלקר סטלקר properName unspecified unspecified unspecified unspecified unspecified  	I_PERS	null
24 . . . punctuation unspecified unspecified unspecified unspecified unspecified  	O	null

0 ספר ספר ספרו noun masculine singular absolute unspecified unspecified  
0 ו ו ספרו possessive masculine singular unspecified 3 unspecified 0 	O	null
1 ה ה הקיסרים definiteArticle unspecified unspecified unspecified unspecified unspecified 0 
1 הקיסרים קיסר הקיסרים noun masculine plural absolute unspecified unspecified  	O	null
2 חולמים חלם חולמים verb masculine plural unspecified any beinoni  	O	null
3 ראה ראה ראה verb masculine singular unspecified 3 past  	O	null
4 אור אור אור noun masculine singular absolute unspecified unspecified  	O	null
5 ב ב ב preposition unspecified unspecified unspecified unspecified unspecified 0 	I_ORG	null
6 - - - punctuation unspecified unspecified unspecified unspecified unspecified  	I_ORG	null
7 ###NUMBER### ###NUMBER### ###NUMBER### numeral unspecified unspecified unspecified unspecified unspecified  	I_DATE	null
8 . . . punctuation unspecified unspecified unspecified unspecified unspecified  	O	null

0 תירגם תרגם תירגם verb masculine singular unspecified 3 past  	O	null
1 כמה כמה כמה quantifier unspecified unspecified construct unspecified unspecified  	O	null
2 ספרים ספר ספרים noun masculine plural absolute unspecified unspecified  	O	null
3 מ מ מהונגרית preposition unspecified unspecified unspecified unspecified unspecified 0 
3 הונגרית הונגרית מהונגרית properName feminine singular unspecified unspecified unspecified  	O	null
4 : : : punctuation unspecified unspecified unspecified unspecified unspecified  	O	null
5 סיפור סיפור סיפורו noun masculine singular absolute unspecified unspecified  
5 ו ו סיפורו possessive masculine singular unspecified 3 unspecified 0 	O	null
6 של של של shel-preposition unspecified unspecified unspecified unspecified unspecified  	O	null
7 כבוד כבוד כבוד noun masculine singular absolute unspecified unspecified  	O	null
8 עצמי עצמי עצמי adjective masculine singular absolute unspecified unspecified  	O	null
9 – – – punctuation unspecified unspecified unspecified unspecified unspecified  	O	null
10 אנדור נדר אנדור verb masculine-and-feminine singular unspecified 1 future  	O	null
11 אנדרה אנדרה אנדרה properName unspecified unspecified unspecified unspecified unspecified  	I_PERS	null
12 גלרי גלרי גלרי properName unspecified unspecified unspecified unspecified unspecified  	I_PERS	null
13 ) ) ) punctuation unspecified unspecified unspecified unspecified unspecified  	O	null
14 ; ; ; punctuation unspecified unspecified unspecified unspecified unspecified  	O	null
15 ###NUMBER### ###NUMBER### ###NUMBER### numeral unspecified unspecified unspecified unspecified unspecified  	I_DATE	null
16 ה ה הסוף definiteArticle unspecified unspecified unspecified unspecified unspecified 0 
16 הסוף סוף הסוף noun masculine singular absolute unspecified unspecified  	O	null
17 ש ש שלרומן relativizer/subordinatingConjunction unspecified unspecified unspecified unspecified unspecified 0 
17 ל ל שלרומן preposition unspecified unspecified unspecified unspecified unspecified 0 
17 רומן רומן שלרומן noun masculine singular construct unspecified unspecified  	O	null
18 משפחה משפחה משפחה noun feminine singular absolute unspecified unspecified  	O	null
19 מאת מאת מאת preposition unspecified unspecified unspecified unspecified unspecified  	O	null
20 פטר פטר פטר noun masculine singular construct unspecified unspecified  	O	null
21 נדש נדש נדש noun feminine singular construct unspecified unspecified  	O	null
22 ) ) ) punctuation unspecified unspecified unspecified unspecified unspecified  	O	null
23 ; ; ; punctuation unspecified unspecified unspecified unspecified unspecified  	O	null
24 ###NUMBER### ###NUMBER### ###NUMBER### numeral unspecified unspecified unspecified unspecified unspecified  	I_DATE	null
25 שעשועים שעשוע שעשועים noun masculine plural absolute unspecified unspecified  	O	null
26 ב ב בשאול preposition unspecified unspecified unspecified unspecified unspecified 0 
26 שאול שאול בשאול properName masculine singular unspecified unspecified unspecified  	I_PERS	null
27 – – – punctuation unspecified unspecified unspecified unspecified unspecified  	O	null
28 שתי CARD2 שתי numeral feminine dual construct unspecified unspecified  	O	null
29 נובלות נובלה נובלות noun feminine plural absolute unspecified unspecified  	O	null
30 מאת מאת מאת preposition unspecified unspecified unspecified unspecified unspecified  	O	null
31 טיבור טיבור טיבור noun masculine singular construct unspecified unspecified  	O	null
32 דרי דר דרי participle masculine plural construct any unspecified  	O	null
33 ( ( ( punctuation unspecified unspecified unspecified unspecified unspecified  	O	null
34 ###NUMBER### ###NUMBER### ###NUMBER### numeral unspecified unspecified unspecified unspecified unspecified  	I_DATE	null
35 ) ) ) punctuation unspecified unspecified unspecified unspecified unspecified  	O	null
36 ו ו ועוד conjunction unspecified unspecified unspecified unspecified unspecified 0 
36 עוד עוד ועוד adverb unspecified unspecified unspecified unspecified unspecified  	O	null
37 . . . punctuation unspecified unspecified unspecified unspecified unspecified  	O	null

0 References References References foreign unspecified unspecified unspecified unspecified unspecified  	O	null
1 : : : punctuation unspecified unspecified unspecified unspecified unspecified  	O	null
2 סער סער סערי noun masculine singular absolute unspecified unspecified  
2 י י סערי possessive masculine-and-feminine singular unspecified 1 unspecified 0 	O	null
3 , , , punctuation unspecified unspecified unspecified unspecified unspecified  	O	null
4 רמי רמי רמי properName unspecified unspecified unspecified unspecified unspecified  	I_PERS	null
5 . . . punctuation unspecified unspecified unspecified unspecified unspecified  	O	null

0 " " " punctuation unspecified unspecified unspecified unspecified unspecified  	O	null
1 לא לא לא negation unspecified unspecified unspecified unspecified unspecified  	O	null
2 ל ל לקוראים preposition unspecified unspecified unspecified unspecified unspecified 0 
2 קוראים קורא לקוראים noun masculine plural absolute unspecified unspecified  	O	null
3 קצרי קצר קצרי noun masculine plural construct unspecified unspecified  	O	null
4 רוח רוח רוח noun feminine singular absolute unspecified unspecified  	O	null
5 " " " punctuation unspecified unspecified unspecified unspecified unspecified  	O	null
6 . . . punctuation unspecified unspecified unspecified unspecified unspecified  	O	null

0 ה ה הארץ definiteArticle unspecified unspecified unspecified unspecified unspecified 0 
0 הארץ ארץ הארץ noun feminine singular absolute unspecified unspecified  	O	null
1 תרבות תרבות תרבות noun feminine singular absolute unspecified unspecified  	O	null
2 ו ו וספרות conjunction unspecified unspecified unspecified unspecified unspecified 0 
2 ספרות ספרות וספרות noun feminine singular absolute unspecified unspecified  	O	null
3 . . . punctuation unspecified unspecified unspecified unspecified unspecified  	O	null

0 ###NUMEXP### ###NUMEXP### ###NUMEXP### numberExpression unspecified unspecified unspecified unspecified unspecified  	I_DATE	null
1 . . . punctuation unspecified unspecified unspecified unspecified unspecified  	O	null

0 ; ; ; punctuation unspecified unspecified unspecified unspecified unspecified  	O	null
1 ###NUMBER### ###NUMBER### ###NUMBER### numeral unspecified unspecified unspecified unspecified unspecified  	O	null
2 רות רות רות properName unspecified unspecified unspecified unspecified unspecified  	I_PERS	null
3 , , , punctuation unspecified unspecified unspecified unspecified unspecified  	O	null
4 אביבית אביבית אביבית properName unspecified unspecified unspecified unspecified unspecified  	I_PERS	null
5 . . . punctuation unspecified unspecified unspecified unspecified unspecified  	O	null

0 " " " punctuation unspecified unspecified unspecified unspecified unspecified  	O	null
1 במקום במקום במקום preposition unspecified unspecified unspecified unspecified unspecified  	O	null
2 ש ש שהוא relativizer/subordinatingConjunction unspecified unspecified unspecified unspecified unspecified 0 
2 הוא הוא שהוא pronoun masculine singular unspecified 3 unspecified  	O	null
3 לא לא לא negation unspecified unspecified unspecified unspecified unspecified  	O	null
4 מקום מקום מקום noun masculine singular absolute unspecified unspecified  	O	null
5 " " " punctuation unspecified unspecified unspecified unspecified unspecified  	O	null
6 . . . punctuation unspecified unspecified unspecified unspecified unspecified  	O	null

0 עתון עיתון עתון noun masculine singular construct unspecified unspecified  	O	null
1 ###NUMBER### ###NUMBER### ###NUMBER### numeral unspecified unspecified unspecified unspecified unspecified  	O	null
2 ###NUMBER### ###NUMBER### ###NUMBER### numeral unspecified unspecified unspecified unspecified unspecified  	O	null
3 . . . punctuation unspecified unspecified unspecified unspecified unspecified  	O	null

0 ###NUMBER### ###NUMBER### ###NUMBER### numeral unspecified unspecified unspecified unspecified unspecified  	I_DATE	null
1 . . . punctuation unspecified unspecified unspecified unspecified unspecified  	O	null

0 ###NUMBER### ###NUMBER### ###NUMBER### numeral unspecified unspecified unspecified unspecified unspecified  	O	null
1 . . . punctuation unspecified unspecified unspecified unspecified unspecified  	O	null

