0 Name Name Name foreign unspecified unspecified unspecified unspecified unspecified  	O	null
1 : : : punctuation unspecified unspecified unspecified unspecified unspecified  	O	null
2 יגלין יגלין יגלין properName unspecified unspecified unspecified unspecified unspecified  	I_ORG	null
3 , , , punctuation unspecified unspecified unspecified unspecified unspecified  	O	null
4 עפרה עפרה עפרה properName unspecified unspecified unspecified unspecified unspecified  	I_PERS	null
5 Birth Birth Birth foreign unspecified unspecified unspecified unspecified unspecified  	O	null
6 Year Year Year foreign unspecified unspecified unspecified unspecified unspecified  	O	null
7 : : : punctuation unspecified unspecified unspecified unspecified unspecified  	O	null
8 ###NUMBER### ###NUMBER### ###NUMBER### numeral unspecified unspecified unspecified unspecified unspecified  	I_DATE	null
9 Birth Birth Birth foreign unspecified unspecified unspecified unspecified unspecified  	O	null
10 Place Place Place foreign unspecified unspecified unspecified unspecified unspecified  	O	null
11 : : : punctuation unspecified unspecified unspecified unspecified unspecified  	O	null
12 דלהבחולון דלהבחולון דלהבחולון properName unspecified unspecified unspecified unspecified unspecified  	I_PERS	null
13 ו ו והיתה conjunction unspecified unspecified unspecified unspecified unspecified 0 
13 היתה הוא והיתה copula feminine singular unspecified 3 past  	O	null
14 חניכת חניכה חניכת noun feminine singular construct unspecified unspecified  	O	null
15 Occupation Occupation Occupation foreign unspecified unspecified unspecified unspecified unspecified  	O	null
16 : : : punctuation unspecified unspecified unspecified unspecified unspecified  	O	null
17 חוקרת חקר חוקרת verb feminine singular unspecified any beinoni  	O	null
18 ספרות ספרות ספרות noun feminine singular construct unspecified unspecified  	O	null
19 Entry Entry Entry foreign unspecified unspecified unspecified unspecified unspecified  	O	null
20 writer writer writer foreign unspecified unspecified unspecified unspecified unspecified  	O	null
21 : : : punctuation unspecified unspecified unspecified unspecified unspecified  	O	null
22 אורי אורי אורי properName unspecified unspecified unspecified unspecified unspecified  	I_PERS	null
23 הולנדר הולנדר הולנדר properName unspecified unspecified unspecified unspecified unspecified  	I_PERS	null
24 Entry Entry Entry foreign unspecified unspecified unspecified unspecified unspecified  	O	null
25 Value Value Value foreign unspecified unspecified unspecified unspecified unspecified  	O	null
26 : : : punctuation unspecified unspecified unspecified unspecified unspecified  	O	null
27 נולדהביפולאבניצולשואהולאםצברית נולדהביפולאבניצולשואהולאםצברית נולדהביפולאבניצולשואהולאםצברית verb feminine singular unspecified 2 past  	O	null
28 . . . punctuation unspecified unspecified unspecified unspecified unspecified  	O	null

0 גדלהבחולון גדלהבחולון גדלהבחולון properName unspecified unspecified unspecified unspecified unspecified  	I_PERS	null
1 ו ו והיתה conjunction unspecified unspecified unspecified unspecified unspecified 0 
1 היתה הוא והיתה copula feminine singular unspecified 3 past  	O	null
2 חניכת חניכה חניכת noun feminine singular construct unspecified unspecified  	O	null
3 " " " punctuation unspecified unspecified unspecified unspecified unspecified  	O	null
4 השומר שומר השומר properName unspecified unspecified unspecified unspecified unspecified  	I_ORG	null
5 ה ה הצעיר definiteArticle unspecified unspecified unspecified unspecified unspecified 0 
5 הצעיר צעיר הצעיר adjective masculine singular absolute unspecified unspecified  	O	null
6 " " " punctuation unspecified unspecified unspecified unspecified unspecified  	O	null
7 . . . punctuation unspecified unspecified unspecified unspecified unspecified  	O	null

0 את את את at-preposition unspecified unspecified unspecified unspecified unspecified  	O	null
1 שירות שירות שירותה noun masculine singular absolute unspecified unspecified  
1 ה ה שירותה possessive feminine singular unspecified 3 unspecified 0 	O	null
2 ה ה הצבאי definiteArticle unspecified unspecified unspecified unspecified unspecified 0 
2 הצבאי צבאי הצבאי adjective masculine singular absolute unspecified unspecified  	O	null
3 עשתה עשה עשתה verb feminine singular unspecified 3 past  	O	null
4 ב ב בנח"ל preposition unspecified unspecified unspecified unspecified unspecified 0 
4 ה ה בנח"ל definiteArticle unspecified unspecified unspecified unspecified unspecified 0 
4 הנח"ל נח"ל בנח"ל noun masculine singular absolute unspecified unspecified  	O	null
5 ב ב בכמה preposition unspecified unspecified unspecified unspecified unspecified 0 
5 כמה כמה בכמה quantifier unspecified unspecified construct unspecified unspecified  	O	null
6 תפקידים תפקיד תפקידים noun masculine plural absolute unspecified unspecified  	O	null
7 פיקודיים פיקודי פיקודיים adjective masculine plural absolute unspecified unspecified  	O	null
8 . . . punctuation unspecified unspecified unspecified unspecified unspecified  	O	null

0 ב ב ב preposition unspecified unspecified unspecified unspecified unspecified 0 	O	null
1 - - - punctuation unspecified unspecified unspecified unspecified unspecified  	O	null
2 ###NUMBER### ###NUMBER### ###NUMBER### numeral unspecified unspecified unspecified unspecified unspecified  	I_DATE	null
3 סיימה סיים סיימה verb feminine singular unspecified 3 past  	O	null
4 את את את at-preposition unspecified unspecified unspecified unspecified unspecified  	O	null
5 לימודי לימוד לימודי noun masculine plural construct unspecified unspecified  	O	null
6 ה ה התואר definiteArticle unspecified unspecified unspecified unspecified unspecified 0 
6 התואר תואר התואר noun masculine singular absolute unspecified unspecified  	O	null
7 ה ה הראשון definiteArticle unspecified unspecified unspecified unspecified unspecified 0 
7 הראשון ORD1 הראשון numeral masculine singular absolute unspecified unspecified  	O	null
8 ב ב בספרות preposition unspecified unspecified unspecified unspecified unspecified 0 
8 ספרות ספרות בספרות noun feminine singular construct unspecified unspecified  	O	null
9 עברית עברית עברית properName feminine singular unspecified unspecified unspecified  	I_LOC	null
10 , , , punctuation unspecified unspecified unspecified unspecified unspecified  	O	null
11 היסטוריה היסטוריה היסטוריה noun feminine singular absolute unspecified unspecified  	O	null
12 ו ו ולימודים conjunction unspecified unspecified unspecified unspecified unspecified 0 
12 לימודים לימוד ולימודים noun masculine plural absolute unspecified unspecified  	O	null
13 כלליים כללי כלליים adjective masculine plural absolute unspecified unspecified  	O	null
14 ב ב באוניברסיטת preposition unspecified unspecified unspecified unspecified unspecified 0 
14 אוניברסיטת אוניברסיטה באוניברסיטת noun feminine singular construct unspecified unspecified  	I_ORG	null
15 תל תל תל properName unspecified unspecified unspecified unspecified unspecified  	I_ORG	null
16 אביב אביב אביב properName unspecified unspecified unspecified unspecified unspecified  	I_ORG	null
17 . . . punctuation unspecified unspecified unspecified unspecified unspecified  	O	null

0 ה ה המשיכה definiteArticle unspecified unspecified unspecified unspecified unspecified 0 
0 המשיכה משיכה המשיכה noun feminine singular absolute unspecified unspecified  	O	null
1 ב ב בחוג preposition unspecified unspecified unspecified unspecified unspecified 0 
1 ה ה בחוג definiteArticle unspecified unspecified unspecified unspecified unspecified 0 
1 החוג חוג בחוג noun masculine singular absolute unspecified unspecified  	O	null
2 ל ל לספרות preposition unspecified unspecified unspecified unspecified unspecified 0 
2 ספרות ספרות לספרות noun feminine singular absolute unspecified unspecified  	O	null
3 עברית עברי עברית adjective feminine singular absolute unspecified unspecified  	O	null
4 ל ל לתואר preposition unspecified unspecified unspecified unspecified unspecified 0 
4 תואר תואר לתואר noun masculine singular construct unspecified unspecified  	O	null
5 שני שני שני noun masculine singular absolute unspecified unspecified  	I_DATE	null
6 ו ו ושלישי conjunction unspecified unspecified unspecified unspecified unspecified 0 
6 שלישי ORD3 ושלישי numeral masculine singular absolute unspecified unspecified  	I_DATE	null
7 . . . punctuation unspecified unspecified unspecified unspecified unspecified  	O	null

0 שימשה שימש שימשה verb feminine singular unspecified 3 past  	O	null
1 כ כ כמרצה preposition unspecified unspecified unspecified unspecified unspecified 0 
1 מרץ מרץ כמרצה noun masculine singular absolute unspecified unspecified  
1 ה ה כמרצה possessive feminine singular unspecified 3 unspecified 0 	O	null
2 ב ב בכמה preposition unspecified unspecified unspecified unspecified unspecified 0 
2 כמה כמה בכמה quantifier unspecified unspecified construct unspecified unspecified  	O	null
3 אוניברסיטאות אוניברסיטה אוניברסיטאות noun feminine plural absolute unspecified unspecified  	O	null
4 , , , punctuation unspecified unspecified unspecified unspecified unspecified  	O	null
5 ו ו ובשנים conjunction unspecified unspecified unspecified unspecified unspecified 0 
5 ב ב ובשנים preposition unspecified unspecified unspecified unspecified unspecified 0 
5 שנים שנה ובשנים noun feminine plural absolute unspecified unspecified  	O	null
6 ###NUMBER### ###NUMBER### ###NUMBER### numeral unspecified unspecified unspecified unspecified unspecified  	I_DATE	null
7 - - - punctuation unspecified unspecified unspecified unspecified unspecified  	O	null
8 ###NUMBER### ###NUMBER### ###NUMBER### numeral unspecified unspecified unspecified unspecified unspecified  	I_DATE	null
9 עבדה עבד עבדה verb feminine singular unspecified 3 past  	O	null
10 כ כ כמרצה preposition unspecified unspecified unspecified unspecified unspecified 0 
10 מרץ מרץ כמרצה noun masculine singular absolute unspecified unspecified  
10 ה ה כמרצה possessive feminine singular unspecified 3 unspecified 0 	O	null
11 בכירה בכיר בכירה adjective feminine singular absolute unspecified unspecified  	O	null
12 ב ב בסגל preposition unspecified unspecified unspecified unspecified unspecified 0 
12 סגל סגל בסגל noun masculine singular construct unspecified unspecified  	O	null
13 ה ה המחלקה definiteArticle unspecified unspecified unspecified unspecified unspecified 0 
13 המחלקה מחלקה המחלקה noun feminine singular absolute unspecified unspecified  	O	null
14 ל ל לספרות preposition unspecified unspecified unspecified unspecified unspecified 0 
14 ספרות ספרות לספרות noun feminine singular absolute unspecified unspecified  	O	null
15 עברית עברי עברית adjective feminine singular absolute unspecified unspecified  	O	null
16 ב ב באוניברסיטת preposition unspecified unspecified unspecified unspecified unspecified 0 
16 אוניברסיטת אוניברסיטה באוניברסיטת noun feminine singular construct unspecified unspecified  	I_ORG	null
17 תל תל תל properName unspecified unspecified unspecified unspecified unspecified  	I_ORG	null
18 אביב אביב אביב properName unspecified unspecified unspecified unspecified unspecified  	I_ORG	null
19 . . . punctuation unspecified unspecified unspecified unspecified unspecified  	O	null

0 ב ב ב preposition unspecified unspecified unspecified unspecified unspecified 0 	O	null
1 - - - punctuation unspecified unspecified unspecified unspecified unspecified  	O	null
2 ###NUMBER### ###NUMBER### ###NUMBER### numeral unspecified unspecified unspecified unspecified unspecified  	I_DATE	null
3 עברה עבר עברה verb feminine singular unspecified 3 past  	O	null
4 ל ל לאוניברסיטת preposition unspecified unspecified unspecified unspecified unspecified 0 
4 אוניברסיטת אוניברסיטה לאוניברסיטת noun feminine singular construct unspecified unspecified  	O	null
5 אמורי אמורי אמורי noun masculine singular absolute unspecified unspecified  	O	null
6 , , , punctuation unspecified unspecified unspecified unspecified unspecified  	O	null
7 שם שם שם adverb unspecified unspecified unspecified unspecified unspecified  	O	null
8 היא הוא היא pronoun feminine singular unspecified 3 unspecified  	O	null
9 משמשת שימש משמשת verb feminine singular unspecified any beinoni  	O	null
10 כ כ כפרופסור preposition unspecified unspecified unspecified unspecified unspecified 0 
10 פרופסור פרופסור כפרופסור noun masculine singular absolute unspecified unspecified  	O	null
11 ל ל לספרות preposition unspecified unspecified unspecified unspecified unspecified 0 
11 ספרות ספרות לספרות noun feminine singular absolute unspecified unspecified  	O	null
12 עברית עברי עברית adjective feminine singular absolute unspecified unspecified  	O	null
13 , , , punctuation unspecified unspecified unspecified unspecified unspecified  	O	null
14 ספרות ספרות ספרות noun feminine singular absolute unspecified unspecified  	O	null
15 ו ו ותרבות conjunction unspecified unspecified unspecified unspecified unspecified 0 
15 תרבות תרבות ותרבות noun feminine singular absolute unspecified unspecified  	O	null
16 ב ב במחלקה preposition unspecified unspecified unspecified unspecified unspecified 0 
16 ה ה במחלקה definiteArticle unspecified unspecified unspecified unspecified unspecified 0 
16 המחלקה מחלקה במחלקה noun feminine singular absolute unspecified unspecified  	O	null
17 ל ל ללימודי preposition unspecified unspecified unspecified unspecified unspecified 0 
17 לימודי לימוד ללימודי noun masculine plural construct unspecified unspecified  	O	null
18 ה ה המזרח definiteArticle unspecified unspecified unspecified unspecified unspecified 0 
18 המזרח מזרח המזרח noun masculine singular absolute unspecified unspecified  	I_LOC	null
19 ה ה התיכון definiteArticle unspecified unspecified unspecified unspecified unspecified 0 
19 התיכון תיכון התיכון adjective masculine singular absolute unspecified unspecified  	I_LOC	null
20 ו ו ודרום conjunction unspecified unspecified unspecified unspecified unspecified 0 
20 דרום דרום ודרום noun masculine singular construct unspecified unspecified  	O	null
21 - - - punctuation unspecified unspecified unspecified unspecified unspecified  	I_LOC	null
22 אסיה אסיה אסיה properName unspecified unspecified unspecified unspecified unspecified  	I_LOC	null
23 . . . punctuation unspecified unspecified unspecified unspecified unspecified  	O	null

0 משמשת שימש משמשת verb feminine singular unspecified any beinoni  	O	null
1 גם גם גם conjunction unspecified unspecified unspecified unspecified unspecified  	O	null
2 כ כ כחברת preposition unspecified unspecified unspecified unspecified unspecified 0 
2 חברת חבר כחברת noun feminine singular construct unspecified unspecified  	O	null
3 סגל סגל סגל noun masculine singular absolute unspecified unspecified  	O	null
4 ב ב במכון preposition unspecified unspecified unspecified unspecified unspecified 0 
4 ה ה במכון definiteArticle unspecified unspecified unspecified unspecified unspecified 0 
4 המכון מיכון במכון noun masculine singular absolute unspecified unspecified  	O	null
5 ל ל ללימודי preposition unspecified unspecified unspecified unspecified unspecified 0 
5 לימודי לימוד ללימודי noun masculine plural construct unspecified unspecified  	O	null
6 ה ה היהדות definiteArticle unspecified unspecified unspecified unspecified unspecified 0 
6 היהדות יהדות היהדות noun feminine singular absolute unspecified unspecified  	I_ORG	null
7 ב ב באוניברסיטת preposition unspecified unspecified unspecified unspecified unspecified 0 
7 אוניברסיטת אוניברסיטה באוניברסיטת noun feminine singular construct unspecified unspecified  	I_ORG	null
8 אמורי אמורי אמורי noun masculine singular absolute unspecified unspecified  	I_ORG	null
9 . . . punctuation unspecified unspecified unspecified unspecified unspecified  	O	null

0 ב ב ב preposition unspecified unspecified unspecified unspecified unspecified 0 	I_ORG	null
1 - - - punctuation unspecified unspecified unspecified unspecified unspecified  	I_ORG	null
2 ###NUMBER### ###NUMBER### ###NUMBER### numeral unspecified unspecified unspecified unspecified unspecified  	I_DATE	null
3 הפכה הפך הפכה verb feminine singular unspecified 3 past  	O	null
4 ל ל לפרופסור preposition unspecified unspecified unspecified unspecified unspecified 0 
4 פרופסור פרופסור לפרופסור noun masculine singular construct unspecified unspecified  	O	null
5 - - - punctuation unspecified unspecified unspecified unspecified unspecified  	O	null
6 חבר חיבר חבר verb masculine singular unspecified 2 imperative  	O	null
7 . . . punctuation unspecified unspecified unspecified unspecified unspecified  	O	null

0 מתגוררת התגורר מתגוררת verb feminine singular unspecified any beinoni  	O	null
1 עם עם עם preposition unspecified unspecified unspecified unspecified unspecified  	O	null
2 בן בן בנה noun masculine singular absolute unspecified unspecified  
2 ה ה בנה possessive feminine singular unspecified 3 unspecified 0 	O	null
3 ב ב באטלנטה preposition unspecified unspecified unspecified unspecified unspecified 0 
3 אטלנטה אטאלנטה באטלנטה properName unspecified unspecified unspecified unspecified unspecified  	I_LOC	null
4 . . . punctuation unspecified unspecified unspecified unspecified unspecified  	O	null

0 מחקר מחקר מחקרה noun masculine singular absolute unspecified unspecified  
0 ה ה מחקרה possessive feminine singular unspecified 3 unspecified 0 	O	null
1 נסב הסב נסב verb masculine-and-feminine plural unspecified 1 future  	O	null
2 בעיקר בעיקר בעיקר adverb unspecified unspecified unspecified unspecified unspecified  	O	null
3 על על על preposition unspecified unspecified unspecified unspecified unspecified  	O	null
4 שירה שירה שירה noun feminine singular absolute unspecified unspecified  	O	null
5 ישראלית ישראלי ישראלית adjective feminine singular absolute unspecified unspecified  	O	null
6 מודרנית מודרני מודרנית adjective feminine singular absolute unspecified unspecified  	O	null
7 . . . punctuation unspecified unspecified unspecified unspecified unspecified  	O	null

0 היא הוא היא pronoun feminine singular unspecified 3 unspecified  	O	null
1 חוקרת חקר חוקרת verb feminine singular unspecified any beinoni  	O	null
2 את את את at-preposition unspecified unspecified unspecified unspecified unspecified  	O	null
3 ה ה הקשר definiteArticle unspecified unspecified unspecified unspecified unspecified 0 
3 הקשר קשר הקשר noun masculine singular absolute unspecified unspecified  	O	null
4 בין בין בין preposition unspecified unspecified unspecified unspecified unspecified  	O	null
5 ספרות ספרות ספרות noun feminine singular absolute unspecified unspecified  	O	null
6 ל ל לאקלים preposition unspecified unspecified unspecified unspecified unspecified 0 
6 אקלים אקלים לאקלים noun masculine singular absolute unspecified unspecified  	O	null
7 תרבותי תרבותי תרבותי adjective masculine singular absolute unspecified unspecified  	O	null
8 ו ו וחברתי conjunction unspecified unspecified unspecified unspecified unspecified 0 
8 חברתי חברתי וחברתי adjective masculine singular absolute unspecified unspecified  	O	null
9 , , , punctuation unspecified unspecified unspecified unspecified unspecified  	O	null
10 ו ו ובחיבוריה conjunction unspecified unspecified unspecified unspecified unspecified 0 
10 ב ב ובחיבוריה preposition unspecified unspecified unspecified unspecified unspecified 0 
10 חיבורי חיבור ובחיבוריה noun masculine plural absolute unspecified unspecified  
10 ה ה ובחיבוריה possessive feminine singular unspecified 3 unspecified 0 	O	null
11 היא הוא היא pronoun feminine singular unspecified 3 unspecified  	O	null
12 מתייחסת התייחס מתייחסת verb feminine singular unspecified any beinoni  	O	null
13 ל ל למגוון preposition unspecified unspecified unspecified unspecified unspecified 0 
13 מגוון מגוון למגוון noun masculine singular absolute unspecified unspecified  	O	null
14 רחב רחב רחב adjective masculine singular absolute unspecified unspecified  	O	null
15 של של של shel-preposition unspecified unspecified unspecified unspecified unspecified  	O	null
16 יוצרים יוצר יוצרים noun masculine plural absolute unspecified unspecified  	O	null
17 ישראליים ישראלי ישראליים adjective masculine plural absolute unspecified unspecified  	O	null
18 . . . punctuation unspecified unspecified unspecified unspecified unspecified  	O	null

0 מ מ ממושאי preposition unspecified unspecified unspecified unspecified unspecified 0 
0 מושאי מושא ממושאי noun masculine plural construct unspecified unspecified  	O	null
1 חקירת חקירה חקירתה noun feminine singular absolute unspecified unspecified  
1 ה ה חקירתה possessive feminine singular unspecified 3 unspecified 0 	O	null
2 : : : punctuation unspecified unspecified unspecified unspecified unspecified  	O	null
3 דליה דליה דליה properName unspecified unspecified unspecified unspecified unspecified  	I_PERS	null
4 רביקוביץ רביקוביץ רביקוביץ properName unspecified unspecified unspecified unspecified unspecified  	I_PERS	null
5 , , , punctuation unspecified unspecified unspecified unspecified unspecified  	O	null
6 דוד דוד דוד properName unspecified unspecified unspecified unspecified unspecified  	I_PERS	null
7 אבידן אבידן אבידן properName unspecified unspecified unspecified unspecified unspecified  	I_PERS	null
8 , , , punctuation unspecified unspecified unspecified unspecified unspecified  	O	null
9 נתן נתן נתן properName unspecified unspecified unspecified unspecified unspecified  	I_PERS	null
10 זך זך זך adjective masculine singular absolute unspecified unspecified  	O	null
11 , , , punctuation unspecified unspecified unspecified unspecified unspecified  	O	null
12 לאה לאה לאה properName unspecified unspecified unspecified unspecified unspecified  	I_PERS	null
13 גולדברג גולדברג גולדברג properName unspecified unspecified unspecified unspecified unspecified  	I_PERS	null
14 , , , punctuation unspecified unspecified unspecified unspecified unspecified  	O	null
15 אבא אבא אבא properName unspecified unspecified unspecified unspecified unspecified  	I_PERS	null
16 קובנר קובנר קובנר properName unspecified unspecified unspecified unspecified unspecified  	I_PERS	null
17 ו ו ועוד conjunction unspecified unspecified unspecified unspecified unspecified 0 
17 עוד עוד ועוד adverb unspecified unspecified unspecified unspecified unspecified  	I_LOC	null
18 . . . punctuation unspecified unspecified unspecified unspecified unspecified  	O	null

0 עבודת עבודה עבודת noun feminine singular construct unspecified unspecified  	O	null
1 ה ה התזה definiteArticle unspecified unspecified unspecified unspecified unspecified 0 
1 התזה תזה התזה noun feminine singular absolute unspecified unspecified  	O	null
2 של של שלה shel-preposition unspecified unspecified unspecified unspecified unspecified  
2 ה ה שלה pronomial feminine singular unspecified 3 unspecified 0 	O	null
3 , , , punctuation unspecified unspecified unspecified unspecified unspecified  	O	null
4 קווים קו קווים noun masculine plural absolute unspecified unspecified  	O	null
5 ל ל לסגנונם preposition unspecified unspecified unspecified unspecified unspecified 0 
5 סגנון סגנון לסגנונם noun masculine singular absolute unspecified unspecified  
5 ם ם לסגנונם possessive masculine plural unspecified 3 unspecified 0 	O	null
6 ה ה הפרוזודי definiteArticle unspecified unspecified unspecified unspecified unspecified 0 
6 הפרוזודי הפרוזודי הפרוזודי noun feminine plural absolute unspecified unspecified  	O	null
7 ה ה המוקדם definiteArticle unspecified unspecified unspecified unspecified unspecified 0 
7 המוקדם מוקדם המוקדם adjective masculine singular absolute unspecified unspecified  	O	null
8 של של של shel-preposition unspecified unspecified unspecified unspecified unspecified  	O	null
9 נתן נתן נתן properName masculine singular unspecified unspecified unspecified  	I_PERS	null
10 זך זך זך adjective masculine singular absolute unspecified unspecified  	O	null
11 , , , punctuation unspecified unspecified unspecified unspecified unspecified  	O	null
12 יהודה יהודה יהודה properName unspecified unspecified unspecified unspecified unspecified  	I_PERS	null
13 עמיחי עמיחי עמיחי properName unspecified unspecified unspecified unspecified unspecified  	I_PERS	null
14 ו ו ודוד conjunction unspecified unspecified unspecified unspecified unspecified 0 
14 דוד דוד ודוד properName unspecified unspecified unspecified unspecified unspecified  	B_PERS	null
15 אבידן אבידן אבידן properName unspecified unspecified unspecified unspecified unspecified  	I_PERS	null
16 , , , punctuation unspecified unspecified unspecified unspecified unspecified  	O	null
17 פורסמה פורסם פורסמה verb feminine singular unspecified 3 past  	O	null
18 ב ב ב preposition unspecified unspecified unspecified unspecified unspecified 0 	O	null
19 - - - punctuation unspecified unspecified unspecified unspecified unspecified  	O	null
20 ###NUMBER### ###NUMBER### ###NUMBER### numeral unspecified unspecified unspecified unspecified unspecified  	I_DATE	null
21 ( ( ( punctuation unspecified unspecified unspecified unspecified unspecified  	O	null
22 אוניברסיטת אוניברסיטה אוניברסיטת noun feminine singular construct unspecified unspecified  	I_ORG	null
23 תל תל תל properName unspecified unspecified unspecified unspecified unspecified  	I_ORG	null
24 אביב אביב אביב properName unspecified unspecified unspecified unspecified unspecified  	I_ORG	null
25 ) ) ) punctuation unspecified unspecified unspecified unspecified unspecified  	O	null
26 . . . punctuation unspecified unspecified unspecified unspecified unspecified  	O	null

0 ב ב ב preposition unspecified unspecified unspecified unspecified unspecified 0 	I_ORG	null
1 - - - punctuation unspecified unspecified unspecified unspecified unspecified  	I_ORG	null
2 ###NUMBER### ###NUMBER### ###NUMBER### numeral unspecified unspecified unspecified unspecified unspecified  	I_DATE	null
3 יצא יצא יצא verb masculine singular unspecified 3 past  	O	null
4 לאור לאור לאור preposition unspecified unspecified unspecified unspecified unspecified  	O	null
5 ספר ספר ספרה noun masculine singular absolute unspecified unspecified  
5 ה ה ספרה possessive feminine singular unspecified 3 unspecified 0 	O	null
6 אולי אולי אולי adverb unspecified unspecified unspecified unspecified unspecified  	O	null
7 מבט מבט מבט noun masculine singular absolute unspecified unspecified  	O	null
8 אחר אחר אחר adjective masculine singular absolute unspecified unspecified  	O	null
9 : : : punctuation unspecified unspecified unspecified unspecified unspecified  	O	null
10 קלאסיות קלאסי קלאסיות adjective feminine plural absolute unspecified unspecified  	O	null
11 מודרנית מודרני מודרנית adjective feminine singular absolute unspecified unspecified  	O	null
12 ו ו ומודרניזם conjunction unspecified unspecified unspecified unspecified unspecified 0 
12 מודרניזם מודרניזם ומודרניזם noun masculine singular absolute unspecified unspecified  	O	null
13 קלאסי קלאסי קלאסי adjective masculine singular absolute unspecified unspecified  	O	null
14 ב ב בשירת preposition unspecified unspecified unspecified unspecified unspecified 0 
14 שירת שירה בשירת noun feminine singular construct unspecified unspecified  	O	null
15 לאה לאה לאה properName unspecified unspecified unspecified unspecified unspecified  	I_PERS	null
16 גולדברג גולדברג גולדברג properName unspecified unspecified unspecified unspecified unspecified  	I_PERS	null
17 ( ( ( punctuation unspecified unspecified unspecified unspecified unspecified  	O	null
18 ה ה הקיבוץ definiteArticle unspecified unspecified unspecified unspecified unspecified 0 
18 הקיבוץ קיבוץ הקיבוץ noun masculine singular absolute unspecified unspecified  	O	null
19 ה ה המאוחד definiteArticle unspecified unspecified unspecified unspecified unspecified 0 
19 המאוחד מאוחד המאוחד adjective masculine singular absolute unspecified unspecified  	O	null
20 ) ) ) punctuation unspecified unspecified unspecified unspecified unspecified  	O	null
21 , , , punctuation unspecified unspecified unspecified unspecified unspecified  	O	null
22 ה ה המבוסס definiteArticle unspecified unspecified unspecified unspecified unspecified 0 
22 המבוסס בוסס המבוסס participle masculine singular absolute any unspecified  	O	null
23 על על על preposition unspecified unspecified unspecified unspecified unspecified  	O	null
24 עבודת עבודה עבודת noun feminine singular construct unspecified unspecified  	O	null
25 ה ה הדוקטור definiteArticle unspecified unspecified unspecified unspecified unspecified 0 
25 הדוקטור דוקטור הדוקטור noun masculine singular absolute unspecified unspecified  	O	null
26 של של שלה shel-preposition unspecified unspecified unspecified unspecified unspecified  
26 ה ה שלה pronomial feminine singular unspecified 3 unspecified 0 	O	null
27 . . . punctuation unspecified unspecified unspecified unspecified unspecified  	O	null

0 זהו זהו זהו pronoun masculine singular unspecified 3 unspecified  	O	null
1 ספר ספר ספר noun masculine singular absolute unspecified unspecified  	O	null
2 מרכזי מרכזי מרכזי adjective masculine singular absolute unspecified unspecified  	O	null
3 ב ב במחקר preposition unspecified unspecified unspecified unspecified unspecified 0 
3 ה ה במחקר definiteArticle unspecified unspecified unspecified unspecified unspecified 0 
3 המחקר מחקר במחקר noun masculine singular absolute unspecified unspecified  	O	null
4 על על על preposition unspecified unspecified unspecified unspecified unspecified  	O	null
5 לאה לאה לאה properName unspecified unspecified unspecified unspecified unspecified  	I_PERS	null
6 גולדברג גולדברג גולדברג properName unspecified unspecified unspecified unspecified unspecified  	I_PERS	null
7 , , , punctuation unspecified unspecified unspecified unspecified unspecified  	O	null
8 ה ה המסמן definiteArticle unspecified unspecified unspecified unspecified unspecified 0 
8 המסמן סימן המסמן participle masculine singular absolute any unspecified  	O	null
9 את את את at-preposition unspecified unspecified unspecified unspecified unspecified  	O	null
10 אחד CARD1 אחד numeral masculine singular absolute unspecified unspecified  	O	null
11 ה ה השלבים definiteArticle unspecified unspecified unspecified unspecified unspecified 0 
11 השלבים שלב השלבים noun masculine plural absolute unspecified unspecified  	O	null
12 ב ב בשינוי preposition unspecified unspecified unspecified unspecified unspecified 0 
12 שינוי שינוי בשינוי noun masculine singular construct unspecified unspecified  	O	null
13 תפישת תפישה תפישת noun feminine singular construct unspecified unspecified  	O	null
14 ה ה הביקורת definiteArticle unspecified unspecified unspecified unspecified unspecified 0 
14 הביקורת ביקורת הביקורת noun feminine singular absolute unspecified unspecified  	O	null
15 את את את at-preposition unspecified unspecified unspecified unspecified unspecified  	O	null
16 יצירת יצירה יצירתה noun feminine singular absolute unspecified unspecified  
16 ה ה יצירתה possessive feminine singular unspecified 3 unspecified 0 	O	null
17 . . . punctuation unspecified unspecified unspecified unspecified unspecified  	O	null

0 ב ב ב preposition unspecified unspecified unspecified unspecified unspecified 0 	O	null
1 - - - punctuation unspecified unspecified unspecified unspecified unspecified  	O	null
2 , , , punctuation unspecified unspecified unspecified unspecified unspecified  	O	null
3 ###NUMBER### ###NUMBER### ###NUMBER### numeral unspecified unspecified unspecified unspecified unspecified  	I_DATE	null
4 ב ב בשיתוף preposition unspecified unspecified unspecified unspecified unspecified 0 
4 שיתוף שיתוף בשיתוף noun masculine singular construct unspecified unspecified  	O	null
5 גדעון גדעון גדעון properName unspecified unspecified unspecified unspecified unspecified  	I_PERS	null
6 טיקוצקי טיקוצקי טיקוצקי properName unspecified unspecified unspecified unspecified unspecified  	I_PERS	null
7 , , , punctuation unspecified unspecified unspecified unspecified unspecified  	O	null
8 פירסמה פרסם פירסמה verb feminine singular unspecified 3 past  	O	null
9 ספר ספר ספר noun masculine singular construct unspecified unspecified  	O	null
10 סונטות סונטה סונטות noun feminine plural absolute unspecified unspecified  	O	null
11 של של של shel-preposition unspecified unspecified unspecified unspecified unspecified  	O	null
12 לאה לאה לאה properName unspecified unspecified unspecified unspecified unspecified  	I_PERS	null
13 גולדברג גולדברג גולדברג properName unspecified unspecified unspecified unspecified unspecified  	I_PERS	null
14 . . . punctuation unspecified unspecified unspecified unspecified unspecified  	O	null

0 ה ה הספר definiteArticle unspecified unspecified unspecified unspecified unspecified 0 
0 הספר ספר הספר noun masculine singular absolute unspecified unspecified  	O	null
1 , , , punctuation unspecified unspecified unspecified unspecified unspecified  	O	null
2 שירי שיר שירי noun masculine plural construct unspecified unspecified  	O	null
3 אהב"ה אהב"ה אהב"ה properName unspecified unspecified unspecified unspecified unspecified  	I_PERS	null
4 ו ו וזה"ב conjunction unspecified unspecified unspecified unspecified unspecified 0 
4 זה"ב זה"ב וזה"ב properName unspecified unspecified unspecified unspecified unspecified  	I_PERS	null
5 : : : punctuation unspecified unspecified unspecified unspecified unspecified  	O	null
6 ה ה הסונטות definiteArticle unspecified unspecified unspecified unspecified unspecified 0 
6 הסונטות סונטה הסונטות noun feminine plural absolute unspecified unspecified  	O	null
7 של של של shel-preposition unspecified unspecified unspecified unspecified unspecified  	O	null
8 לאה לאה לאה properName unspecified unspecified unspecified unspecified unspecified  	I_PERS	null
9 גולדברג גולדברג גולדברג properName unspecified unspecified unspecified unspecified unspecified  	I_PERS	null
10 , , , punctuation unspecified unspecified unspecified unspecified unspecified  	O	null
11 כולל כלל כולל verb masculine singular unspecified any beinoni  	O	null
12 את את את at-preposition unspecified unspecified unspecified unspecified unspecified  	O	null
13 כל כול כל quantifier unspecified unspecified construct unspecified unspecified  	O	null
14 ה ה הסונטות definiteArticle unspecified unspecified unspecified unspecified unspecified 0 
14 הסונטות סונטה הסונטות noun feminine plural absolute unspecified unspecified  	O	null
15 של של של shel-preposition unspecified unspecified unspecified unspecified unspecified  	O	null
16 ה ה המשוררת definiteArticle unspecified unspecified unspecified unspecified unspecified 0 
16 המשוררת משורר המשוררת noun feminine singular absolute unspecified unspecified  	O	null
17 , , , punctuation unspecified unspecified unspecified unspecified unspecified  	O	null
18 ו ו ובכללן conjunction unspecified unspecified unspecified unspecified unspecified 0 
18 בכלל בכלל ובכללן preposition unspecified unspecified unspecified unspecified unspecified  
18 הן הן ובכללן pronomial feminine plural unspecified 3 unspecified 0 	O	null
19 סונטות סונטה סונטות noun feminine plural absolute unspecified unspecified  	O	null
20 גנוזות גנוז גנוזות adjective feminine plural absolute unspecified unspecified  	O	null
21 ו ו וטיוטות conjunction unspecified unspecified unspecified unspecified unspecified 0 
21 טיוטות טיוטה וטיוטות noun feminine plural absolute unspecified unspecified  	O	null
22 ב ב בכתב preposition unspecified unspecified unspecified unspecified unspecified 0 
22 כתב כתב בכתב noun masculine singular construct unspecified unspecified  	O	null
23 יד יד ידה noun feminine singular absolute unspecified unspecified  
23 ה ה ידה possessive feminine singular unspecified 3 unspecified 0 	O	null
24 . . . punctuation unspecified unspecified unspecified unspecified unspecified  	O	null

0 References References References foreign unspecified unspecified unspecified unspecified unspecified  	O	null
1 : : : punctuation unspecified unspecified unspecified unspecified unspecified  	O	null

