0 Name Name Name foreign unspecified unspecified unspecified unspecified unspecified  	O	null
1 : : : punctuation unspecified unspecified unspecified unspecified unspecified  	O	null
2 יסעור יסעור יסעור properName unspecified unspecified unspecified unspecified unspecified  	I_PERS	null
3 , , , punctuation unspecified unspecified unspecified unspecified unspecified  	O	null
4 פנחס פנחס פנחס properName unspecified unspecified unspecified unspecified unspecified  	I_PERS	null
5 Birth Birth Birth foreign unspecified unspecified unspecified unspecified unspecified  	O	null
6 Year Year Year foreign unspecified unspecified unspecified unspecified unspecified  	O	null
7 : : : punctuation unspecified unspecified unspecified unspecified unspecified  	O	null
8 ###NUMBER### ###NUMBER### ###NUMBER### numeral unspecified unspecified unspecified unspecified unspecified  	I_DATE	null
9 Death Death Death foreign unspecified unspecified unspecified unspecified unspecified  	O	null
10 Year Year Year foreign unspecified unspecified unspecified unspecified unspecified  	O	null
11 : : : punctuation unspecified unspecified unspecified unspecified unspecified  	O	null
12 ###NUMBER### ###NUMBER### ###NUMBER### numeral unspecified unspecified unspecified unspecified unspecified  	I_DATE	null
13 Birth Birth Birth foreign unspecified unspecified unspecified unspecified unspecified  	O	null
14 Place Place Place foreign unspecified unspecified unspecified unspecified unspecified  	O	null
15 : : : punctuation unspecified unspecified unspecified unspecified unspecified  	O	null
16 גרמניה גרמני גרמניה properName unspecified unspecified unspecified unspecified unspecified  	I_LOC	null
17 ו ו ועלה conjunction unspecified unspecified unspecified unspecified unspecified 0 
17 עלה עלה ועלה verb masculine singular unspecified 3 past  	O	null
18 ל ל לארץ preposition unspecified unspecified unspecified unspecified unspecified 0 
18 ארץ ארץ לארץ noun feminine singular construct unspecified unspecified  	O	null
19 Occupation Occupation Occupation foreign unspecified unspecified unspecified unspecified unspecified  	O	null
20 : : : punctuation unspecified unspecified unspecified unspecified unspecified  	O	null
21 משורר משורר משורר noun masculine singular absolute unspecified unspecified  	O	null
22 Entry Entry Entry foreign unspecified unspecified unspecified unspecified unspecified  	O	null
23 writer writer writer foreign unspecified unspecified unspecified unspecified unspecified  	O	null
24 : : : punctuation unspecified unspecified unspecified unspecified unspecified  	O	null
25 דקל דקל דקל noun masculine singular construct unspecified unspecified  	O	null
26 שי שי שי properName unspecified unspecified unspecified unspecified unspecified  	I_PERS	null
27 ש ש שחורי relativizer/subordinatingConjunction unspecified unspecified unspecified unspecified unspecified 0 
27 חורי חור שחורי noun masculine plural construct unspecified unspecified  	O	null
28 Entry Entry Entry foreign unspecified unspecified unspecified unspecified unspecified  	O	null
29 Value Value Value foreign unspecified unspecified unspecified unspecified unspecified  	O	null
30 : : : punctuation unspecified unspecified unspecified unspecified unspecified  	O	null
31 נולד נולד נולד verb masculine singular unspecified 3 past  	O	null
32 ב ב בגרמניה preposition unspecified unspecified unspecified unspecified unspecified 0 
32 גרמניה גרמני בגרמניה properName unspecified unspecified unspecified unspecified unspecified  	I_LOC	null
33 ו ו ועלה conjunction unspecified unspecified unspecified unspecified unspecified 0 
33 עלה עלה ועלה verb masculine singular unspecified 3 past  	O	null
34 ל ל לארץ preposition unspecified unspecified unspecified unspecified unspecified 0 
34 ה ה לארץ definiteArticle unspecified unspecified unspecified unspecified unspecified 0 
34 הארץ ארץ לארץ noun feminine singular absolute unspecified unspecified  	O	null
35 ב ב בגיל preposition unspecified unspecified unspecified unspecified unspecified 0 
35 גיל גיל בגיל noun masculine singular construct unspecified unspecified  	O	null
36 חמש CARD5 חמש numeral feminine singular absolute unspecified unspecified  	O	null
37 - - - punctuation unspecified unspecified unspecified unspecified unspecified  	O	null
38 עשרה CARD10 עשרה numeral masculine plural absolute unspecified unspecified  	O	null
39 ב ב ב preposition unspecified unspecified unspecified unspecified unspecified 0 	O	null
40 " " " punctuation unspecified unspecified unspecified unspecified unspecified  	O	null
41 עליית עלייה עליית noun feminine singular construct unspecified unspecified  	O	null
42 ה ה הנוער definiteArticle unspecified unspecified unspecified unspecified unspecified 0 
42 הנוער נוער הנוער noun masculine singular absolute unspecified unspecified  	O	null
43 " " " punctuation unspecified unspecified unspecified unspecified unspecified  	O	null
44 ) ) ) punctuation unspecified unspecified unspecified unspecified unspecified  	O	null
45 . . . punctuation unspecified unspecified unspecified unspecified unspecified  	O	null
46 ###NUMBER### ###NUMBER### ###NUMBER### numeral unspecified unspecified unspecified unspecified unspecified  	I_DATE	null
47 היה הוא היה copula masculine singular unspecified 3 past  	O	null
48 מ מ ממקימי preposition unspecified unspecified unspecified unspecified unspecified 0 
48 מקימי הקים ממקימי participle masculine plural construct any unspecified  	O	null
49 קיבוץ קיבוץ קיבוץ noun masculine singular construct unspecified unspecified  	I_LOC	null
50 חולתה חולתה חולתה properName masculine singular unspecified unspecified unspecified  	I_LOC	null
51 ב ב בעמק preposition unspecified unspecified unspecified unspecified unspecified 0 
51 עמק עמק בעמק noun masculine singular construct unspecified unspecified  	B_LOC	null
52 החולה החולה החולה properName unspecified unspecified unspecified unspecified unspecified  	I_LOC	null
53 . . . punctuation unspecified unspecified unspecified unspecified unspecified  	O	null

0 ב ב במלחמת preposition unspecified unspecified unspecified unspecified unspecified 0 
0 מלחמת מלחמה במלחמת noun feminine singular construct unspecified unspecified  	O	null
1 ה ה העולם definiteArticle unspecified unspecified unspecified unspecified unspecified 0 
1 העולם עולם העולם noun masculine singular absolute unspecified unspecified  	O	null
2 ה ה השנייה definiteArticle unspecified unspecified unspecified unspecified unspecified 0 
2 השנייה ORD2 השנייה numeral feminine singular absolute unspecified unspecified  	O	null
3 שירת שירת שירת verb masculine singular unspecified 3 past  	O	null
4 ב ב בצבא preposition unspecified unspecified unspecified unspecified unspecified 0 
4 ה ה בצבא definiteArticle unspecified unspecified unspecified unspecified unspecified 0 
4 הצבא צבא בצבא noun masculine singular absolute unspecified unspecified  	O	null
5 ה ה הבריטי definiteArticle unspecified unspecified unspecified unspecified unspecified 0 
5 הבריטי בריטי הבריטי adjective masculine singular absolute unspecified unspecified  	O	null
6 , , , punctuation unspecified unspecified unspecified unspecified unspecified  	O	null
7 ו ו ולאחר conjunction unspecified unspecified unspecified unspecified unspecified 0 
7 לאחר לאחר ולאחר conjunction unspecified unspecified unspecified unspecified unspecified  	O	null
8 מכן מיכן מכן verb masculine singular unspecified 2 imperative  	O	null
9 היה הוא היה copula masculine singular unspecified 3 past  	O	null
10 מ מ ממייסדי preposition unspecified unspecified unspecified unspecified unspecified 0 
10 מייסדי מייסד ממייסדי noun masculine plural construct unspecified unspecified  	O	null
11 אגף אגף אגף noun masculine singular construct unspecified unspecified  	O	null
12 ה ה השיקום definiteArticle unspecified unspecified unspecified unspecified unspecified 0 
12 השיקום שיקום השיקום noun masculine singular absolute unspecified unspecified  	O	null
13 של של של shel-preposition unspecified unspecified unspecified unspecified unspecified  	O	null
14 משרד משרד משרד noun masculine singular construct unspecified unspecified  	I_ORG	null
15 ה ה הביטחון definiteArticle unspecified unspecified unspecified unspecified unspecified 0 
15 הביטחון ביטחון הביטחון noun masculine singular absolute unspecified unspecified  	I_ORG	null
16 . . . punctuation unspecified unspecified unspecified unspecified unspecified  	O	null

0 במקביל במקביל במקביל adverb unspecified unspecified unspecified unspecified unspecified  	O	null
1 עסק עסק עסק verb masculine singular unspecified 3 past  	O	null
2 ב ב במפעלי preposition unspecified unspecified unspecified unspecified unspecified 0 
2 מפעלי מפעל במפעלי noun masculine plural construct unspecified unspecified  	O	null
3 התנדבות התנדבות התנדבות noun feminine singular absolute unspecified unspecified  	O	null
4 ו ו וסייע conjunction unspecified unspecified unspecified unspecified unspecified 0 
4 סייע סייע וסייע verb masculine singular unspecified 3 past  	O	null
5 רבות רבות רבות adverb unspecified unspecified unspecified unspecified unspecified  	O	null
6 ל ל לקשישים preposition unspecified unspecified unspecified unspecified unspecified 0 
6 ה ה לקשישים definiteArticle unspecified unspecified unspecified unspecified unspecified 0 
6 הקשישים קשיש לקשישים noun masculine plural absolute unspecified unspecified  	O	null
7 . . . punctuation unspecified unspecified unspecified unspecified unspecified  	O	null

0 פירסם פרסם פירסם verb masculine singular unspecified 3 past  	O	null
1 שישה CARD6 שישה numeral masculine plural absolute unspecified unspecified  	O	null
2 ספרי ספר ספרי noun masculine plural construct unspecified unspecified  	O	null
3 שירה שירה שירה noun feminine singular absolute unspecified unspecified  	O	null
4 ב ב בשנות preposition unspecified unspecified unspecified unspecified unspecified 0 
4 שנות שנה בשנות noun feminine plural construct unspecified unspecified  	O	null
5 ה ה השבעים definiteArticle unspecified unspecified unspecified unspecified unspecified 0 
5 השבעים ORD-CARD70 השבעים numeral masculine-and-feminine plural absolute unspecified unspecified  	O	null
6 ו ו והשמונים conjunction unspecified unspecified unspecified unspecified unspecified 0 
6 ה ה והשמונים definiteArticle unspecified unspecified unspecified unspecified unspecified 0 
6 השמונים ORD-CARD80 והשמונים numeral masculine-and-feminine plural absolute unspecified unspecified  	O	null
7 , , , punctuation unspecified unspecified unspecified unspecified unspecified  	O	null
8 רוב רוב רובם noun masculine singular absolute unspecified unspecified  
8 ם ם רובם possessive masculine plural unspecified 3 unspecified 0 	O	null
9 ב ב בהוצאת preposition unspecified unspecified unspecified unspecified unspecified 0 
9 הוצאת הוצאה בהוצאת noun feminine singular construct unspecified unspecified  	O	null
10 עקד עקד עקד verb masculine singular unspecified 3 past  	O	null
11 ל ל לשירה preposition unspecified unspecified unspecified unspecified unspecified 0 
11 שירה שירה לשירה noun feminine singular absolute unspecified unspecified  	O	null
12 . . . punctuation unspecified unspecified unspecified unspecified unspecified  	O	null

0 ספר ספר ספרו noun masculine singular absolute unspecified unspecified  
0 ו ו ספרו possessive masculine singular unspecified 3 unspecified 0 	O	null
1 ה ה הראשון definiteArticle unspecified unspecified unspecified unspecified unspecified 0 
1 הראשון ORD1 הראשון numeral masculine singular absolute unspecified unspecified  	O	null
2 , , , punctuation unspecified unspecified unspecified unspecified unspecified  	O	null
3 הלא הלא הלא conjunction unspecified unspecified unspecified unspecified unspecified  	O	null
4 ב ב בזרועותייך preposition unspecified unspecified unspecified unspecified unspecified 0 
4 זרועותי זרוע בזרועותייך noun feminine plural absolute unspecified unspecified  
4 ך ך בזרועותייך possessive feminine singular unspecified 2 unspecified 0 	O	null
5 היה הוא היה copula masculine singular unspecified 3 past  	O	null
6 ( ( ( punctuation unspecified unspecified unspecified unspecified unspecified  	O	null
7 עקד עקד עקד verb masculine singular unspecified 3 past  	O	null
8 , , , punctuation unspecified unspecified unspecified unspecified unspecified  	O	null
9 ) ) ) punctuation unspecified unspecified unspecified unspecified unspecified  	O	null
10 , , , punctuation unspecified unspecified unspecified unspecified unspecified  	O	null
11 פורסם פורסם פורסם verb masculine singular unspecified 3 past  	O	null
12 ###NUMBER### ###NUMBER### ###NUMBER### numeral unspecified unspecified unspecified unspecified unspecified  	I_DATE	null
13 כש כש כשהיה temporalSubConj unspecified unspecified unspecified unspecified unspecified 0 
13 היה הוא כשהיה copula masculine singular unspecified 3 past  	O	null
14 בן בן בן noun masculine singular construct unspecified unspecified  	O	null
15 חמישים ORD-CARD50 חמישים numeral masculine plural absolute unspecified unspecified  	O	null
16 ו ו ושתיים conjunction unspecified unspecified unspecified unspecified unspecified 0 
16 שתיים CARD2 ושתיים numeral feminine singular absolute unspecified unspecified  	O	null
17 , , , punctuation unspecified unspecified unspecified unspecified unspecified  	O	null
18 ב ב בעידודו preposition unspecified unspecified unspecified unspecified unspecified 0 
18 עידוד עידוד בעידודו noun masculine singular absolute unspecified unspecified  
18 ו ו בעידודו possessive masculine singular unspecified 3 unspecified 0 	O	null
19 של של של shel-preposition unspecified unspecified unspecified unspecified unspecified  	O	null
20 ש ש שלמה relativizer/subordinatingConjunction unspecified unspecified unspecified unspecified unspecified 0 
20 ל ל שלמה preposition unspecified unspecified unspecified unspecified unspecified 0 
20 מה מה שלמה interrogative unspecified unspecified unspecified unspecified unspecified  	O	null
21 גרודז'נסקי גרודז'נסקי גרודז'נסקי properName unspecified unspecified unspecified unspecified unspecified  	I_PERS	null
22 , , , punctuation unspecified unspecified unspecified unspecified unspecified  	O	null
23 ו ו וספרו conjunction unspecified unspecified unspecified unspecified unspecified 0 
23 ספר ספר וספרו noun masculine singular absolute unspecified unspecified  
23 ו ו וספרו possessive masculine singular unspecified 3 unspecified 0 	O	null
24 ה ה האחרון definiteArticle unspecified unspecified unspecified unspecified unspecified 0 
24 האחרון אחרון האחרון adjective masculine singular absolute unspecified unspecified  	O	null
25 , , , punctuation unspecified unspecified unspecified unspecified unspecified  	O	null
26 לחם לחם לחם noun masculine singular absolute unspecified unspecified  	O	null
27 סתרים סתר סתרים noun masculine plural absolute unspecified unspecified  	O	null
28 , , , punctuation unspecified unspecified unspecified unspecified unspecified  	O	null
29 ראה ראה ראה verb masculine singular unspecified 3 past  	O	null
30 אור אור אור noun masculine singular absolute unspecified unspecified  	O	null
31 ב ב ב preposition unspecified unspecified unspecified unspecified unspecified 0 	O	null
32 - - - punctuation unspecified unspecified unspecified unspecified unspecified  	O	null
33 ###NUMBER### ###NUMBER### ###NUMBER### numeral unspecified unspecified unspecified unspecified unspecified  	I_DATE	null
34 . . . punctuation unspecified unspecified unspecified unspecified unspecified  	O	null

0 קובץ קובץ קובץ noun masculine singular absolute unspecified unspecified  	O	null
1 מ מ משיריו preposition unspecified unspecified unspecified unspecified unspecified 0 
1 שירי שיר משיריו noun masculine plural absolute unspecified unspecified  
1 ו ו משיריו possessive masculine singular unspecified 3 unspecified 0 	O	null
2 ראה ראה ראה verb masculine singular unspecified 3 past  	O	null
3 אור אור אור noun masculine singular absolute unspecified unspecified  	O	null
4 ב ב בתרגום preposition unspecified unspecified unspecified unspecified unspecified 0 
4 תרגום תרגום בתרגום noun masculine singular absolute unspecified unspecified  	O	null
5 ל ל לאנגלית preposition unspecified unspecified unspecified unspecified unspecified 0 
5 אנגלית אנגלית לאנגלית properName feminine singular unspecified unspecified unspecified  	O	null
6 ב ב ב preposition unspecified unspecified unspecified unspecified unspecified 0 	O	null
7 - - - punctuation unspecified unspecified unspecified unspecified unspecified  	O	null
8 ###NUMBER### ###NUMBER### ###NUMBER### numeral unspecified unspecified unspecified unspecified unspecified  	I_DATE	null
9 . . . punctuation unspecified unspecified unspecified unspecified unspecified  	O	null

0 עיבוד עיבוד עיבוד noun masculine singular absolute unspecified unspecified  	O	null
1 ש ש שיצרה relativizer/subordinatingConjunction unspecified unspecified unspecified unspecified unspecified 0 
1 יצרה יצר שיצרה verb feminine singular unspecified 3 past  	O	null
2 ל ל להרכב preposition unspecified unspecified unspecified unspecified unspecified 0 
2 הרכב הרכב להרכב noun masculine singular absolute unspecified unspecified  	O	null
3 קאמרי קאמרי קאמרי adjective masculine singular absolute unspecified unspecified  	O	null
4 אלה אל אלה noun feminine singular absolute unspecified unspecified  	O	null
5 שריף שריף שריף properName unspecified unspecified unspecified unspecified unspecified  	I_PERS	null
6 על על על preposition unspecified unspecified unspecified unspecified unspecified  	O	null
7 בסיס בסיס בסיס noun masculine singular absolute unspecified unspecified  	O	null
8 ש ש שירו relativizer/subordinatingConjunction unspecified unspecified unspecified unspecified unspecified 0 
8 ירו ירה שירו verb masculine-and-feminine plural unspecified 3 past  	O	null
9 " " " punctuation unspecified unspecified unspecified unspecified unspecified  	O	null
10 הלאה הלאה הלאה adverb unspecified unspecified unspecified unspecified unspecified  	O	null
11 " " " punctuation unspecified unspecified unspecified unspecified unspecified  	O	null
12 זכה זכה זכה verb masculine singular unspecified 3 past  	O	null
13 ל ל לביצועים preposition unspecified unspecified unspecified unspecified unspecified 0 
13 ה ה לביצועים definiteArticle unspecified unspecified unspecified unspecified unspecified 0 
13 הביצועים ביצוע לביצועים noun masculine plural absolute unspecified unspecified  	O	null
14 ב ב בארץ preposition unspecified unspecified unspecified unspecified unspecified 0 
14 ה ה בארץ definiteArticle unspecified unspecified unspecified unspecified unspecified 0 
14 הארץ ארץ בארץ noun feminine singular absolute unspecified unspecified  	O	null
15 ו ו ובעולם conjunction unspecified unspecified unspecified unspecified unspecified 0 
15 ב ב ובעולם preposition unspecified unspecified unspecified unspecified unspecified 0 
15 ה ה ובעולם definiteArticle unspecified unspecified unspecified unspecified unspecified 0 
15 העולם עולם ובעולם noun masculine singular absolute unspecified unspecified  	O	null
16 . . . punctuation unspecified unspecified unspecified unspecified unspecified  	O	null

0 ב ב בשיריו preposition unspecified unspecified unspecified unspecified unspecified 0 
0 שירי שיר בשיריו noun masculine plural absolute unspecified unspecified  
0 ו ו בשיריו possessive masculine singular unspecified 3 unspecified 0 	O	null
1 בולטת בלט בולטת verb feminine singular unspecified any beinoni  	O	null
2 יניקה יניקה יניקה noun feminine singular absolute unspecified unspecified  	O	null
3 מן מן מן preposition unspecified unspecified unspecified unspecified unspecified  	O	null
4 ה ה המקורות definiteArticle unspecified unspecified unspecified unspecified unspecified 0 
4 המקורות מקור המקורות noun masculine plural absolute unspecified unspecified  	O	null
5 ה ה היהודיים definiteArticle unspecified unspecified unspecified unspecified unspecified 0 
5 היהודיים יהודי היהודיים adjective masculine plural absolute unspecified unspecified  	O	null
6 , , , punctuation unspecified unspecified unspecified unspecified unspecified  	O	null
7 ה ה המקנה definiteArticle unspecified unspecified unspecified unspecified unspecified 0 
7 המקנה הקנה המקנה participle masculine singular absolute any unspecified  	O	null
8 גם גם גם conjunction unspecified unspecified unspecified unspecified unspecified  	O	null
9 ל ל לשירים preposition unspecified unspecified unspecified unspecified unspecified 0 
9 שירים שיר לשירים noun masculine plural absolute unspecified unspecified  	O	null
10 ש ש שנושאם relativizer/subordinatingConjunction unspecified unspecified unspecified unspecified unspecified 0 
10 נושא נושא שנושאם noun masculine singular absolute unspecified unspecified  
10 ם ם שנושאם possessive masculine plural unspecified 3 unspecified 0 	O	null
11 ה ה המרכזי definiteArticle unspecified unspecified unspecified unspecified unspecified 0 
11 המרכזי מרכזי המרכזי adjective masculine singular absolute unspecified unspecified  	O	null
12 אחר אחר אחר adjective masculine singular absolute unspecified unspecified  	O	null
13 , , , punctuation unspecified unspecified unspecified unspecified unspecified  	O	null
14 למשל למשל למשל conjunction unspecified unspecified unspecified unspecified unspecified  	O	null
15 אהבה אהבה אהבה noun feminine singular absolute unspecified unspecified  	O	null
16 , , , punctuation unspecified unspecified unspecified unspecified unspecified  	O	null
17 אופי אופי אופי noun masculine singular absolute unspecified unspecified  	O	null
18 רליגיוזי רליגיוזי רליגיוזי properName unspecified unspecified unspecified unspecified unspecified  	I_PERS	null
19 . . . punctuation unspecified unspecified unspecified unspecified unspecified  	O	null

0 מוטיב מוטיב מוטיב noun masculine singular absolute unspecified unspecified  	O	null
1 חוזר חוזר חוזר adjective masculine singular absolute unspecified unspecified  	O	null
2 שליט שליט שליט noun masculine singular absolute unspecified unspecified  	O	null
3 ב ב בספריו preposition unspecified unspecified unspecified unspecified unspecified 0 
3 ספרי ספר בספריו noun masculine plural absolute unspecified unspecified  
3 ו ו בספריו possessive masculine singular unspecified 3 unspecified 0 	O	null
4 הוא הוא הוא pronoun masculine singular unspecified 3 unspecified  	O	null
5 ה ה המוות definiteArticle unspecified unspecified unspecified unspecified unspecified 0 
5 המוות מוות המוות noun masculine singular absolute unspecified unspecified  	O	null
6 . . . punctuation unspecified unspecified unspecified unspecified unspecified  	O	null

0 ידידות ידידות ידידותו noun feminine singular absolute unspecified unspecified  
0 ו ו ידידותו possessive masculine singular unspecified 3 unspecified 0 	O	null
1 ה ה הקרובה definiteArticle unspecified unspecified unspecified unspecified unspecified 0 
1 הקרובה קרוב הקרובה adjective feminine singular absolute unspecified unspecified  	O	null
2 עם עם עם preposition unspecified unspecified unspecified unspecified unspecified  	O	null
3 ה ה המשוררת definiteArticle unspecified unspecified unspecified unspecified unspecified 0 
3 המשוררת משורר המשוררת noun feminine singular absolute unspecified unspecified  	O	null
4 זלדה זלדה זלדה properName unspecified unspecified unspecified unspecified unspecified  	I_PERS	null
5 באה בא באה verb feminine singular unspecified 3 past  	O	null
6 ל ל לידי preposition unspecified unspecified unspecified unspecified unspecified 0 
6 ידי יד לידי noun feminine plural construct unspecified unspecified  	O	null
7 ביטוי ביטוי ביטוי noun masculine singular absolute unspecified unspecified  	O	null
8 ב ב בכמה preposition unspecified unspecified unspecified unspecified unspecified 0 
8 כמה כמה בכמה quantifier unspecified unspecified construct unspecified unspecified  	O	null
9 מ מ משיריו preposition unspecified unspecified unspecified unspecified unspecified 0 
9 שירי שיר משיריו noun masculine plural absolute unspecified unspecified  
9 ו ו משיריו possessive masculine singular unspecified 3 unspecified 0 	O	null
10 ב ב בספרו preposition unspecified unspecified unspecified unspecified unspecified 0 
10 ספר ספר בספרו noun masculine singular absolute unspecified unspecified  
10 ו ו בספרו possessive masculine singular unspecified 3 unspecified 0 	O	null
11 לחם לחם לחם noun masculine singular absolute unspecified unspecified  	O	null
12 סתרים סתר סתרים noun masculine plural absolute unspecified unspecified  	O	null
13 . . . punctuation unspecified unspecified unspecified unspecified unspecified  	O	null

0 רגולנט רגולנט רגולנט properName unspecified unspecified unspecified unspecified unspecified  	I_PERS	null
1 ) ) ) punctuation unspecified unspecified unspecified unspecified unspecified  	O	null
2 כתב כתב כתב verb masculine singular unspecified 3 past  	O	null
3 ###NUMBER### ###NUMBER### ###NUMBER### numeral unspecified unspecified unspecified unspecified unspecified  	I_DATE	null
4 כי כי כי conjunction unspecified unspecified unspecified unspecified unspecified  	O	null
5 שירת שירה שירתו noun feminine singular absolute unspecified unspecified  
5 ו ו שירתו possessive masculine singular unspecified 3 unspecified 0 	O	null
6 של של של shel-preposition unspecified unspecified unspecified unspecified unspecified  	O	null
7 יסעור יסעור יסעור properName unspecified unspecified unspecified unspecified unspecified  	I_PERS	null
8 היא הוא היא pronoun feminine singular unspecified 3 unspecified  	O	null
9 שירה שירה שירה noun feminine singular absolute unspecified unspecified  	O	null
10 לירית לירי לירית adjective feminine singular absolute unspecified unspecified  	O	null
11 , , , punctuation unspecified unspecified unspecified unspecified unspecified  	O	null
12 רליגיוזית רליגיוזית רליגיוזית adjective feminine singular absolute unspecified unspecified  	O	null
13 מ מ מעיקרה preposition unspecified unspecified unspecified unspecified unspecified 0 
13 עיקר עיקר מעיקרה noun masculine singular absolute unspecified unspecified  
13 ה ה מעיקרה possessive feminine singular unspecified 3 unspecified 0 	O	null
14 , , , punctuation unspecified unspecified unspecified unspecified unspecified  	O	null
15 ה ה הרוויה definiteArticle unspecified unspecified unspecified unspecified unspecified 0 
15 הרוויה רווה הרוויה participle feminine singular absolute any unspecified  	O	null
16 ב ב בסמלים preposition unspecified unspecified unspecified unspecified unspecified 0 
16 סמלים סמל בסמלים noun masculine plural absolute unspecified unspecified  	O	null
17 ו ו ובמטפוריקה conjunction unspecified unspecified unspecified unspecified unspecified 0 
17 ב ב ובמטפוריקה preposition unspecified unspecified unspecified unspecified unspecified 0 
17 מטפוריקה מטפוריקה ובמטפוריקה noun feminine singular absolute unspecified unspecified  	O	null
18 מ מ מעולם preposition unspecified unspecified unspecified unspecified unspecified 0 
18 עולם עולם מעולם noun masculine singular construct unspecified unspecified  	O	null
19 ה ה האמונה definiteArticle unspecified unspecified unspecified unspecified unspecified 0 
19 האמונה אמונה האמונה noun feminine singular absolute unspecified unspecified  	O	null
20 , , , punctuation unspecified unspecified unspecified unspecified unspecified  	O	null
21 אך אך אך conjunction unspecified unspecified unspecified unspecified unspecified  	O	null
22 " " " punctuation unspecified unspecified unspecified unspecified unspecified  	O	null
23 ה ה המשורר definiteArticle unspecified unspecified unspecified unspecified unspecified 0 
23 המשורר משורר המשורר noun masculine singular absolute unspecified unspecified  	O	null
24 בא בא בא verb masculine singular unspecified 3 past  	O	null
25 אל אל אל preposition unspecified unspecified unspecified unspecified unspecified  	O	null
26 ה ה הדת definiteArticle unspecified unspecified unspecified unspecified unspecified 0 
26 הדת דת הדת noun feminine singular absolute unspecified unspecified  	O	null
27 מ מ מעולם preposition unspecified unspecified unspecified unspecified unspecified 0 
27 עולם עולם מעולם noun masculine singular absolute unspecified unspecified  	O	null
28 ש ש שכולו relativizer/subordinatingConjunction unspecified unspecified unspecified unspecified unspecified 0 
28 כול כול שכולו quantifier unspecified unspecified unspecified unspecified unspecified  
28 ו ו שכולו pronomial masculine singular unspecified 3 unspecified 0 	O	null
29 חולין חול חולין noun masculine plural absolute unspecified unspecified  	O	null
30 " " " punctuation unspecified unspecified unspecified unspecified unspecified  	O	null
31 . . . punctuation unspecified unspecified unspecified unspecified unspecified  	O	null

0 References References References foreign unspecified unspecified unspecified unspecified unspecified  	O	null
1 : : : punctuation unspecified unspecified unspecified unspecified unspecified  	O	null
2 ל ל לנדר preposition unspecified unspecified unspecified unspecified unspecified 0 
2 נדר נדר לנדר noun masculine singular absolute unspecified unspecified  	O	null
3 , , , punctuation unspecified unspecified unspecified unspecified unspecified  	O	null
4 פנחס פנחס פנחס properName unspecified unspecified unspecified unspecified unspecified  	I_PERS	null
5 . . . punctuation unspecified unspecified unspecified unspecified unspecified  	O	null

0 " " " punctuation unspecified unspecified unspecified unspecified unspecified  	O	null
1 ש ש שירהאפופהמסתורין relativizer/subordinatingConjunction unspecified unspecified unspecified unspecified unspecified 0 
1 ירהאפופהמסתורין ירהאפופהמסתורין שירהאפופהמסתורין adjective masculine singular construct unspecified unspecified  	O	null
2 " " " punctuation unspecified unspecified unspecified unspecified unspecified  	O	null
3 . . . punctuation unspecified unspecified unspecified unspecified unspecified  	O	null

0 מאזניים מאזניים מאזניים noun masculine plural absolute unspecified unspecified  	O	null
1 נ"א נ"א נ"א properName unspecified unspecified unspecified unspecified unspecified  	I_ORG	null
2 ( ( ( punctuation unspecified unspecified unspecified unspecified unspecified  	O	null
3 ) ) ) punctuation unspecified unspecified unspecified unspecified unspecified  	O	null
4 . . . punctuation unspecified unspecified unspecified unspecified unspecified  	O	null
5 ###NUMBER### ###NUMBER### ###NUMBER### numeral unspecified unspecified unspecified unspecified unspecified  	I_DATE	null
6 אוקטובר אוקטובר אוקטובר properName unspecified unspecified unspecified unspecified unspecified  	I_DATE	null
7 ###NUMBER### ###NUMBER### ###NUMBER### numeral unspecified unspecified unspecified unspecified unspecified  	I_DATE	null
8 . . . punctuation unspecified unspecified unspecified unspecified unspecified  	O	null

0 - - - punctuation unspecified unspecified unspecified unspecified unspecified  	O	null
1 ###NUMBER### ###NUMBER### ###NUMBER### numeral unspecified unspecified unspecified unspecified unspecified  	O	null
2 ; ; ; punctuation unspecified unspecified unspecified unspecified unspecified  	O	null
3 ###NUMBER### ###NUMBER### ###NUMBER### numeral unspecified unspecified unspecified unspecified unspecified  	O	null
4 רגולנט רגולנט רגולנט properName unspecified unspecified unspecified unspecified unspecified  	O	null
5 , , , punctuation unspecified unspecified unspecified unspecified unspecified  	O	null
6 שמואל שמואל שמואל properName unspecified unspecified unspecified unspecified unspecified  	I_PERS	null
7 . . . punctuation unspecified unspecified unspecified unspecified unspecified  	O	null

0 " " " punctuation unspecified unspecified unspecified unspecified unspecified  	O	null
1 דרך דרך דרך noun feminine singular construct unspecified unspecified  	O	null
2 ה ה החתחתים definiteArticle unspecified unspecified unspecified unspecified unspecified 0 
2 החתחתים חתחת החתחתים noun masculine plural absolute unspecified unspecified  	O	null
3 אל אל אל preposition unspecified unspecified unspecified unspecified unspecified  	O	null
4 אמונה אמונה אמונה noun feminine singular absolute unspecified unspecified  	O	null
5 " " " punctuation unspecified unspecified unspecified unspecified unspecified  	O	null
6 . . . punctuation unspecified unspecified unspecified unspecified unspecified  	O	null

0 עתון עיתון עתון noun masculine singular construct unspecified unspecified  	O	null
1 ###NUMBER### ###NUMBER### ###NUMBER### numeral unspecified unspecified unspecified unspecified unspecified  	O	null
2 ###NUMBER### ###NUMBER### ###NUMBER### numeral unspecified unspecified unspecified unspecified unspecified  	O	null
3 . . . punctuation unspecified unspecified unspecified unspecified unspecified  	O	null

0 ###NUMBER### ###NUMBER### ###NUMBER### numeral unspecified unspecified unspecified unspecified unspecified  	I_DATE	null
1 . . . punctuation unspecified unspecified unspecified unspecified unspecified  	O	null

0 ###NUMBER### ###NUMBER### ###NUMBER### numeral unspecified unspecified unspecified unspecified unspecified  	O	null
1 . . . punctuation unspecified unspecified unspecified unspecified unspecified  	O	null

