0 Name Name Name foreign unspecified unspecified unspecified unspecified unspecified  	O	null
1 : : : punctuation unspecified unspecified unspecified unspecified unspecified  	O	null
2 כ כ כגן preposition unspecified unspecified unspecified unspecified unspecified 0 
2 גן גן כגן noun masculine singular absolute unspecified unspecified  	O	null
3 , , , punctuation unspecified unspecified unspecified unspecified unspecified  	O	null
4 אליעזר אליעזר אליעזר properName unspecified unspecified unspecified unspecified unspecified  	I_PERS	null
5 Birth Birth Birth foreign unspecified unspecified unspecified unspecified unspecified  	O	null
6 Year Year Year foreign unspecified unspecified unspecified unspecified unspecified  	O	null
7 : : : punctuation unspecified unspecified unspecified unspecified unspecified  	O	null
8 ###NUMBER### ###NUMBER### ###NUMBER### numeral unspecified unspecified unspecified unspecified unspecified  	I_DATE	null
9 Death Death Death foreign unspecified unspecified unspecified unspecified unspecified  	O	null
10 Year Year Year foreign unspecified unspecified unspecified unspecified unspecified  	O	null
11 : : : punctuation unspecified unspecified unspecified unspecified unspecified  	O	null
12 ###NUMBER### ###NUMBER### ###NUMBER### numeral unspecified unspecified unspecified unspecified unspecified  	I_DATE	null
13 Birth Birth Birth foreign unspecified unspecified unspecified unspecified unspecified  	O	null
14 Place Place Place foreign unspecified unspecified unspecified unspecified unspecified  	O	null
15 : : : punctuation unspecified unspecified unspecified unspecified unspecified  	O	null
16 סויסלוץ' סויסלוץ' סויסלוץ' properName unspecified unspecified unspecified unspecified unspecified  	I_ORG	null
17 , , , punctuation unspecified unspecified unspecified unspecified unspecified  	O	null
18 עיירה עיירה עיירה noun feminine singular absolute unspecified unspecified  	O	null
19 ב ב ברוסיה preposition unspecified unspecified unspecified unspecified unspecified 0 
19 רוסיה רוסי ברוסיה properName unspecified unspecified unspecified unspecified unspecified  	I_LOC	null
20 Occupation Occupation Occupation foreign unspecified unspecified unspecified unspecified unspecified  	O	null
21 : : : punctuation unspecified unspecified unspecified unspecified unspecified  	O	null
22 משורר משורר משורר noun masculine singular absolute unspecified unspecified  	O	null
23 , , , punctuation unspecified unspecified unspecified unspecified unspecified  	O	null
24 מתרגם מתרגם מתרגם noun masculine singular absolute unspecified unspecified  	O	null
25 ו ו וחוקר conjunction unspecified unspecified unspecified unspecified unspecified 0 
25 חוקר חוקר וחוקר noun masculine singular absolute unspecified unspecified  	O	null
26 Entry Entry Entry foreign unspecified unspecified unspecified unspecified unspecified  	O	null
27 writer writer writer foreign unspecified unspecified unspecified unspecified unspecified  	O	null
28 : : : punctuation unspecified unspecified unspecified unspecified unspecified  	O	null
29 עירית עירייה עירית properName unspecified unspecified unspecified unspecified unspecified  	I_PERS	null
30 רונן רונן רונן properName unspecified unspecified unspecified unspecified unspecified  	I_PERS	null
31 Entry Entry Entry foreign unspecified unspecified unspecified unspecified unspecified  	O	null
32 Value Value Value foreign unspecified unspecified unspecified unspecified unspecified  	O	null
33 : : : punctuation unspecified unspecified unspecified unspecified unspecified  	O	null
34 נולד נולד נולד verb masculine singular unspecified 3 past  	O	null
35 בסויסלוץ' בסויסלוץ' בסויסלוץ' properName unspecified unspecified unspecified unspecified unspecified  	I_PERS	null
36 , , , punctuation unspecified unspecified unspecified unspecified unspecified  	O	null
37 עיירה עיירה עיירה noun feminine singular absolute unspecified unspecified  	O	null
38 ב ב ברוסיה preposition unspecified unspecified unspecified unspecified unspecified 0 
38 רוסיה רוסי ברוסיה properName unspecified unspecified unspecified unspecified unspecified  	I_LOC	null
39 ה ה הלבנה definiteArticle unspecified unspecified unspecified unspecified unspecified 0 
39 הלבנה לבן הלבנה adjective feminine singular absolute unspecified unspecified  	O	null
40 , , , punctuation unspecified unspecified unspecified unspecified unspecified  	O	null
41 ו ו ומשם conjunction unspecified unspecified unspecified unspecified unspecified 0 
41 משם משם ומשם adverb unspecified unspecified unspecified unspecified unspecified  	O	null
42 עבר עבר עבר verb masculine singular unspecified 3 past  	O	null
43 ל ל לבריסק preposition unspecified unspecified unspecified unspecified unspecified 0 
43 בריסק בריסק לבריסק noun feminine singular absolute unspecified unspecified  	O	null
44 דליטא דליטא דליטא properName unspecified unspecified unspecified unspecified unspecified  	I_LOC	null
45 עם עם עם preposition unspecified unspecified unspecified unspecified unspecified  	O	null
46 משפחת משפחה משפחתו noun feminine singular absolute unspecified unspecified  
46 ו ו משפחתו possessive masculine singular unspecified 3 unspecified 0 	O	null
47 . . . punctuation unspecified unspecified unspecified unspecified unspecified  	O	null

0 שירת שירת שירת verb masculine singular unspecified 3 past  	O	null
1 ב ב בצבא preposition unspecified unspecified unspecified unspecified unspecified 0 
1 ה ה בצבא definiteArticle unspecified unspecified unspecified unspecified unspecified 0 
1 הצבא צבא בצבא noun masculine singular absolute unspecified unspecified  	O	null
2 ה ה הפולני definiteArticle unspecified unspecified unspecified unspecified unspecified 0 
2 הפולני פולני הפולני adjective masculine singular absolute unspecified unspecified  	O	null
3 כ כ כקצין preposition unspecified unspecified unspecified unspecified unspecified 0 
3 ה ה כקצין definiteArticle unspecified unspecified unspecified unspecified unspecified 0 
3 הקצין קצין כקצין noun masculine singular absolute unspecified unspecified  	O	null
4 . . . punctuation unspecified unspecified unspecified unspecified unspecified  	O	null

0 ב ב בסוף preposition unspecified unspecified unspecified unspecified unspecified 0 
0 סוף סוף בסוף noun masculine singular construct unspecified unspecified  	O	null
1 ###NUMBER### ###NUMBER### ###NUMBER### numeral unspecified unspecified unspecified unspecified unspecified  	I_DATE	null
2 עלה עלה עלה verb masculine singular unspecified 3 past  	O	null
3 ל ל לארץ preposition unspecified unspecified unspecified unspecified unspecified 0 
3 ה ה לארץ definiteArticle unspecified unspecified unspecified unspecified unspecified 0 
3 הארץ ארץ לארץ noun feminine singular absolute unspecified unspecified  	O	null
4 ו ו ולמד conjunction unspecified unspecified unspecified unspecified unspecified 0 
4 למד למד ולמד verb masculine singular unspecified 3 past  	O	null
5 ב ב באוניברסיטה preposition unspecified unspecified unspecified unspecified unspecified 0 
5 ה ה באוניברסיטה definiteArticle unspecified unspecified unspecified unspecified unspecified 0 
5 האוניברסיטה אוניברסיטה באוניברסיטה noun feminine singular absolute unspecified unspecified  	O	null
6 ה ה העברית definiteArticle unspecified unspecified unspecified unspecified unspecified 0 
6 העברית עברי העברית adjective feminine singular absolute unspecified unspecified  	O	null
7 ב ב בירושלים preposition unspecified unspecified unspecified unspecified unspecified 0 
7 ירושלים ירושלים בירושלים properName unspecified unspecified unspecified unspecified unspecified  	I_LOC	null
8 . . . punctuation unspecified unspecified unspecified unspecified unspecified  	O	null

0 עם עם עם preposition unspecified unspecified unspecified unspecified unspecified  	O	null
1 פרוץ פרץ פרוץ verb masculine singular unspecified 2 imperative  	O	null
2 מלחמת מלחמה מלחמת noun feminine singular construct unspecified unspecified  	O	null
3 ה ה העולם definiteArticle unspecified unspecified unspecified unspecified unspecified 0 
3 העולם עולם העולם noun masculine singular absolute unspecified unspecified  	O	null
4 ה ה השנייה definiteArticle unspecified unspecified unspecified unspecified unspecified 0 
4 השנייה ORD2 השנייה numeral feminine singular absolute unspecified unspecified  	O	null
5 התגייס התגייס התגייס verb masculine singular unspecified 3 past  	O	null
6 ל ל למשטרה preposition unspecified unspecified unspecified unspecified unspecified 0 
6 ה ה למשטרה definiteArticle unspecified unspecified unspecified unspecified unspecified 0 
6 המשטרה משטרה למשטרה noun feminine singular absolute unspecified unspecified  	O	null
7 ה ה המנדטורית definiteArticle unspecified unspecified unspecified unspecified unspecified 0 
7 המנדטורית מנדטורי המנדטורית adjective feminine singular absolute unspecified unspecified  	O	null
8 ו ו ושירת conjunction unspecified unspecified unspecified unspecified unspecified 0 
8 שירת שירת ושירת verb masculine singular unspecified 3 past  	O	null
9 ב ב בה preposition unspecified unspecified unspecified unspecified unspecified  
9 ה ה בה pronomial feminine singular unspecified 3 unspecified 0 	O	null
10 עד עד עד preposition unspecified unspecified unspecified unspecified unspecified  	O	null
11 ###NUMBER### ###NUMBER### ###NUMBER### numeral unspecified unspecified unspecified unspecified unspecified  	I_DATE	null
12 . . . punctuation unspecified unspecified unspecified unspecified unspecified  	O	null

0 בעל בעל בעל noun masculine singular construct unspecified unspecified  	O	null
1 תואר תואר תואר noun masculine singular construct unspecified unspecified  	O	null
2 שני שני שני noun masculine singular absolute unspecified unspecified  	O	null
3 ב ב בספרות preposition unspecified unspecified unspecified unspecified unspecified 0 
3 ספרות ספרות בספרות noun feminine singular absolute unspecified unspecified  	O	null
4 עברית עברי עברית adjective feminine singular absolute unspecified unspecified  	O	null
5 , , , punctuation unspecified unspecified unspecified unspecified unspecified  	O	null
6 לשון לשון לשון noun feminine singular construct unspecified unspecified  	O	null
7 עברית עברית עברית properName feminine singular unspecified unspecified unspecified  	O	null
8 ו ו ופילוסופיה conjunction unspecified unspecified unspecified unspecified unspecified 0 
8 פילוסופיה פילוסופיה ופילוסופיה noun feminine singular absolute unspecified unspecified  	O	null
9 . . . punctuation unspecified unspecified unspecified unspecified unspecified  	O	null

0 עסק עסק עסק verb masculine singular unspecified 3 past  	O	null
1 ב ב בהוראה preposition unspecified unspecified unspecified unspecified unspecified 0 
1 הוראה הוראה בהוראה noun feminine singular absolute unspecified unspecified  	O	null
2 ב ב בגבעת preposition unspecified unspecified unspecified unspecified unspecified 0 
2 גבעת גבעה בגבעת noun feminine singular construct unspecified unspecified  	O	null
3 ה ה המורה definiteArticle unspecified unspecified unspecified unspecified unspecified 0 
3 המורה מורה המורה noun masculine singular absolute unspecified unspecified  	O	null
4 ו ו וניהל conjunction unspecified unspecified unspecified unspecified unspecified 0 
4 ניהל ניהל וניהל verb masculine singular unspecified 3 past  	O	null
5 את את את at-preposition unspecified unspecified unspecified unspecified unspecified  	O	null
6 בית בית בית noun masculine singular construct unspecified unspecified  	O	null
7 ה ה הספר definiteArticle unspecified unspecified unspecified unspecified unspecified 0 
7 הספר ספר הספר noun masculine singular absolute unspecified unspecified  	O	null
8 . . . punctuation unspecified unspecified unspecified unspecified unspecified  	O	null

0 פעל פעל פעל verb masculine singular unspecified 3 past  	O	null
1 להנהיג הנהיג להנהיג verb unspecified unspecified unspecified unspecified infinitive  	O	null
2 לימודי לימוד לימודי noun masculine plural construct unspecified unspecified  	O	null
3 יידיש יידיש יידיש properName feminine singular unspecified unspecified unspecified  	O	null
4 ב ב בבתי preposition unspecified unspecified unspecified unspecified unspecified 0 
4 בתי בית בבתי noun masculine plural construct unspecified unspecified  	O	null
5 ספר ספר ספר noun masculine singular absolute unspecified unspecified  	O	null
6 תיכוניים תיכוני תיכוניים adjective masculine plural absolute unspecified unspecified  	O	null
7 . . . punctuation unspecified unspecified unspecified unspecified unspecified  	O	null

0 ב ב ב preposition unspecified unspecified unspecified unspecified unspecified 0 	I_ORG	null
1 - - - punctuation unspecified unspecified unspecified unspecified unspecified  	I_ORG	null
2 ###NUMBER### ###NUMBER### ###NUMBER### numeral unspecified unspecified unspecified unspecified unspecified  	I_DATE	null
3 התחיל התחיל התחיל verb masculine singular unspecified 3 past  	O	null
4 את את את at-preposition unspecified unspecified unspecified unspecified unspecified  	O	null
5 תפקיד תפקיד תפקידו noun masculine singular absolute unspecified unspecified  
5 ו ו תפקידו possessive masculine singular unspecified 3 unspecified 0 	O	null
6 כ כ כמנהל preposition unspecified unspecified unspecified unspecified unspecified 0 
6 מנהל מנהל כמנהל noun masculine singular construct unspecified unspecified  	O	null
7 בית בית בית noun masculine singular construct unspecified unspecified  	O	null
8 ה ה הספר definiteArticle unspecified unspecified unspecified unspecified unspecified 0 
8 הספר ספר הספר noun masculine singular absolute unspecified unspecified  	O	null
9 ה ה התיכון definiteArticle unspecified unspecified unspecified unspecified unspecified 0 
9 התיכון תיכון התיכון adjective masculine singular absolute unspecified unspecified  	O	null
10 קרייתחיים קרייתחיים קרייתחיים properName unspecified unspecified unspecified unspecified unspecified  	I_PERS	null
11 , , , punctuation unspecified unspecified unspecified unspecified unspecified  	O	null
12 ש ש שבו relativizer/subordinatingConjunction unspecified unspecified unspecified unspecified unspecified 0 
12 ב ב שבו preposition unspecified unspecified unspecified unspecified unspecified  
12 ו ו שבו pronomial masculine singular unspecified 3 unspecified 0 	O	null
13 כיהן כיהן כיהן verb masculine singular unspecified 3 past  	O	null
14 עשרים ORD-CARD20 עשרים numeral masculine-and-feminine plural construct unspecified unspecified  	O	null
15 ו ו ושמונה conjunction unspecified unspecified unspecified unspecified unspecified 0 
15 שמונה CARD8 ושמונה numeral masculine plural absolute unspecified unspecified  	O	null
16 שנים שנה שנים noun feminine plural absolute unspecified unspecified  	O	null
17 . . . punctuation unspecified unspecified unspecified unspecified unspecified  	O	null

0 ב ב ב preposition unspecified unspecified unspecified unspecified unspecified 0 	O	null
1 - - - punctuation unspecified unspecified unspecified unspecified unspecified  	O	null
2 ###NUMBER### ###NUMBER### ###NUMBER### numeral unspecified unspecified unspecified unspecified unspecified  	I_DATE	null
3 הוסמך הוסמך הוסמך verb masculine singular unspecified 3 past  	O	null
4 כ כ כדוקטור preposition unspecified unspecified unspecified unspecified unspecified 0 
4 דוקטור דוקטור כדוקטור noun masculine singular absolute unspecified unspecified  	O	null
5 ( ( ( punctuation unspecified unspecified unspecified unspecified unspecified  	O	null
6 כתב כתב כתב verb masculine singular unspecified 3 past  	O	null
7 על על על preposition unspecified unspecified unspecified unspecified unspecified  	O	null
8 מראות מראה מראות noun masculine plural construct unspecified unspecified  	O	null
9 שתייה שתייה שתייה noun feminine singular absolute unspecified unspecified  	O	null
10 ב ב בשירת preposition unspecified unspecified unspecified unspecified unspecified 0 
10 שירת שירה בשירת noun feminine singular construct unspecified unspecified  	O	null
11 ביאליק ביאליק ביאליק properName unspecified unspecified unspecified unspecified unspecified  	I_PERS	null
12 ) ) ) punctuation unspecified unspecified unspecified unspecified unspecified  	O	null
13 ו ו והתחיל conjunction unspecified unspecified unspecified unspecified unspecified 0 
13 התחיל התחיל והתחיל verb masculine singular unspecified 3 past  	O	null
14 ללמד לימד ללמד verb unspecified unspecified unspecified unspecified infinitive  	O	null
15 ספרות ספרות ספרות noun feminine singular absolute unspecified unspecified  	O	null
16 עברית עברי עברית adjective feminine singular absolute unspecified unspecified  	O	null
17 ב ב בבית preposition unspecified unspecified unspecified unspecified unspecified 0 
17 בית בית בבית noun masculine singular construct unspecified unspecified  	O	null
18 ה ה הספר definiteArticle unspecified unspecified unspecified unspecified unspecified 0 
18 הספר ספר הספר noun masculine singular absolute unspecified unspecified  	O	null
19 ה ה הגבוה definiteArticle unspecified unspecified unspecified unspecified unspecified 0 
19 הגבוה גבוה הגבוה adjective masculine singular absolute unspecified unspecified  	O	null
20 ל ל למדעי preposition unspecified unspecified unspecified unspecified unspecified 0 
20 מדעי מדע למדעי noun masculine plural construct unspecified unspecified  	O	null
21 ה ה היהדות definiteArticle unspecified unspecified unspecified unspecified unspecified 0 
21 היהדות יהדות היהדות noun feminine singular absolute unspecified unspecified  	I_ORG	null
22 ו ו והחברה conjunction unspecified unspecified unspecified unspecified unspecified 0 
22 החברה חבר והחברה properName unspecified unspecified unspecified unspecified unspecified  	I_ORG	null
23 ב ב בחיפה preposition unspecified unspecified unspecified unspecified unspecified 0 
23 חיפה חיפה בחיפה properName unspecified unspecified unspecified unspecified unspecified  	I_LOC	null
24 , , , punctuation unspecified unspecified unspecified unspecified unspecified  	O	null
25 ו ו ועם conjunction unspecified unspecified unspecified unspecified unspecified 0 
25 עם עם ועם preposition unspecified unspecified unspecified unspecified unspecified  	O	null
26 ייסוד ייסוד ייסוד noun masculine singular construct unspecified unspecified  	O	null
27 ה ה האוניברסיטה definiteArticle unspecified unspecified unspecified unspecified unspecified 0 
27 האוניברסיטה אוניברסיטה האוניברסיטה noun feminine singular absolute unspecified unspecified  	O	null
28 עבד עבד עבד verb masculine singular unspecified 3 past  	O	null
29 שם שם שם adverb unspecified unspecified unspecified unspecified unspecified  	O	null
30 ב ב במשרה preposition unspecified unspecified unspecified unspecified unspecified 0 
30 משרה משרה במשרה noun feminine singular absolute unspecified unspecified  	O	null
31 חלקית חלקי חלקית adjective feminine singular absolute unspecified unspecified  	O	null
32 ב ב בחוג preposition unspecified unspecified unspecified unspecified unspecified 0 
32 ה ה בחוג definiteArticle unspecified unspecified unspecified unspecified unspecified 0 
32 החוג חוג בחוג noun masculine singular absolute unspecified unspecified  	O	null
33 ל ל לספרות preposition unspecified unspecified unspecified unspecified unspecified 0 
33 ספרות ספרות לספרות noun feminine singular construct unspecified unspecified  	O	null
34 עברית עברית עברית properName feminine singular unspecified unspecified unspecified  	I_LOC	null
35 . . . punctuation unspecified unspecified unspecified unspecified unspecified  	O	null

0 היה הוא היה copula masculine singular unspecified 3 past  	O	null
1 פעיל פעיל פעיל adjective masculine singular absolute unspecified unspecified  	O	null
2 ב ב במוסדות preposition unspecified unspecified unspecified unspecified unspecified 0 
2 מוסדות מוסד במוסדות noun masculine plural construct unspecified unspecified  	O	null
3 אגודת אגודה אגודת noun feminine singular construct unspecified unspecified  	O	null
4 ה ה הסופרים definiteArticle unspecified unspecified unspecified unspecified unspecified 0 
4 הסופרים סופר הסופרים noun masculine plural absolute unspecified unspecified  	O	null
5 ה ה המרכזית definiteArticle unspecified unspecified unspecified unspecified unspecified 0 
5 המרכזית מרכזי המרכזית adjective feminine singular absolute unspecified unspecified  	O	null
6 . . . punctuation unspecified unspecified unspecified unspecified unspecified  	O	null

0 עסק עסק עסק verb masculine singular unspecified 3 past  	O	null
1 רבות רבות רבות adverb unspecified unspecified unspecified unspecified unspecified  	O	null
2 ב ב בספרות preposition unspecified unspecified unspecified unspecified unspecified 0 
2 ספרות ספרות בספרות noun feminine singular construct unspecified unspecified  	O	null
3 ה ה ההשכלה definiteArticle unspecified unspecified unspecified unspecified unspecified 0 
3 ההשכלה השכלה ההשכלה noun feminine singular absolute unspecified unspecified  	O	null
4 ו ו ובתורת conjunction unspecified unspecified unspecified unspecified unspecified 0 
4 ב ב ובתורת preposition unspecified unspecified unspecified unspecified unspecified 0 
4 תורת תורה ובתורת noun feminine singular construct unspecified unspecified  	O	null
5 ה ה המשקל definiteArticle unspecified unspecified unspecified unspecified unspecified 0 
5 המשקל משקל המשקל noun masculine singular absolute unspecified unspecified  	I_ORG	null
6 ו ו והחרוז conjunction unspecified unspecified unspecified unspecified unspecified 0 
6 ה ה והחרוז definiteArticle unspecified unspecified unspecified unspecified unspecified 0 
6 החרוז חרוז והחרוז noun masculine singular absolute unspecified unspecified  	O	null
7 , , , punctuation unspecified unspecified unspecified unspecified unspecified  	O	null
8 ו ו ואף conjunction unspecified unspecified unspecified unspecified unspecified 0 
8 אף אף ואף conjunction unspecified unspecified unspecified unspecified unspecified  	O	null
9 פירסם פרסם פירסם verb masculine singular unspecified 3 past  	O	null
10 את את את at-preposition unspecified unspecified unspecified unspecified unspecified  	O	null
11 ה ה הספר definiteArticle unspecified unspecified unspecified unspecified unspecified 0 
11 הספר ספר הספר noun masculine singular absolute unspecified unspecified  	O	null
12 ה ה המשקל definiteArticle unspecified unspecified unspecified unspecified unspecified 0 
12 המשקל משקל המשקל noun masculine singular absolute unspecified unspecified  	I_MONEY	null
13 ו ו והחרוז conjunction unspecified unspecified unspecified unspecified unspecified 0 
13 ה ה והחרוז definiteArticle unspecified unspecified unspecified unspecified unspecified 0 
13 החרוז חרוז והחרוז noun masculine singular absolute unspecified unspecified  	O	null
14 ב ב בשירה preposition unspecified unspecified unspecified unspecified unspecified 0 
14 ה ה בשירה definiteArticle unspecified unspecified unspecified unspecified unspecified 0 
14 השירה שירה בשירה noun feminine singular absolute unspecified unspecified  	O	null
15 ה ה העברית definiteArticle unspecified unspecified unspecified unspecified unspecified 0 
15 העברית עברי העברית adjective feminine singular absolute unspecified unspecified  	O	null
16 ה ה החדשה definiteArticle unspecified unspecified unspecified unspecified unspecified 0 
16 החדשה חדש החדשה adjective feminine singular absolute unspecified unspecified  	O	null
17 . . . punctuation unspecified unspecified unspecified unspecified unspecified  	O	null

0 כמו כמו כמו conjunction unspecified unspecified unspecified unspecified unspecified  	O	null
1 כן כן כן conjunction unspecified unspecified unspecified unspecified unspecified  	O	null
2 ערך ערך ערך verb masculine singular unspecified 3 past  	O	null
3 את את את at-preposition unspecified unspecified unspecified unspecified unspecified  	O	null
4 צפון צפון צפון noun masculine singular construct unspecified unspecified  	O	null
5 , , , punctuation unspecified unspecified unspecified unspecified unspecified  	O	null
6 שנתון שנתון שנתון noun masculine singular absolute unspecified unspecified  	O	null
7 ל ל לספרות preposition unspecified unspecified unspecified unspecified unspecified 0 
7 ה ה לספרות definiteArticle unspecified unspecified unspecified unspecified unspecified 0 
7 הספרות ספרות לספרות noun feminine singular absolute unspecified unspecified  	O	null
8 ו ו ולאמנות conjunction unspecified unspecified unspecified unspecified unspecified 0 
8 ל ל ולאמנות preposition unspecified unspecified unspecified unspecified unspecified 0 
8 אמנות אמנות ולאמנות noun feminine singular absolute unspecified unspecified  	O	null
9 . . . punctuation unspecified unspecified unspecified unspecified unspecified  	O	null

0 הקדיש הקדיש הקדיש verb masculine singular unspecified 3 past  	O	null
1 שנים שנה שנים noun feminine plural absolute unspecified unspecified  	O	null
2 רבות רב רבות adjective feminine plural absolute unspecified unspecified  	O	null
3 ל ל לתרגום preposition unspecified unspecified unspecified unspecified unspecified 0 
3 ה ה לתרגום definiteArticle unspecified unspecified unspecified unspecified unspecified 0 
3 התרגום תרגום לתרגום noun masculine singular absolute unspecified unspecified  	O	null
4 ה ה המונומנטלי definiteArticle unspecified unspecified unspecified unspecified unspecified 0 
4 המונומנטלי מונומנטלי המונומנטלי adjective masculine singular absolute unspecified unspecified  	O	null
5 , , , punctuation unspecified unspecified unspecified unspecified unspecified  	O	null
6 ה ה המונה definiteArticle unspecified unspecified unspecified unspecified unspecified 0 
6 המונה מנה המונה participle masculine singular absolute any unspecified  	O	null
7 חמישה CARD5 חמישה numeral masculine plural absolute unspecified unspecified  	O	null
8 כרכים כרך כרכים noun masculine plural absolute unspecified unspecified  	O	null
9 , , , punctuation unspecified unspecified unspecified unspecified unspecified  	O	null
10 של של של shel-preposition unspecified unspecified unspecified unspecified unspecified  	O	null
11 השאהנאמה השאהנאמה השאהנאמה verb masculine-and-feminine singular unspecified 1 future  	O	null
12 , , , punctuation unspecified unspecified unspecified unspecified unspecified  	O	null
13 ספר ספר ספר noun masculine singular construct unspecified unspecified  	O	null
14 ה ה המלכים definiteArticle unspecified unspecified unspecified unspecified unspecified 0 
14 המלכים מלך המלכים noun masculine plural absolute unspecified unspecified  	O	null
15 של של של shel-preposition unspecified unspecified unspecified unspecified unspecified  	O	null
16 ה ה המשורר definiteArticle unspecified unspecified unspecified unspecified unspecified 0 
16 המשורר משורר המשורר noun masculine singular absolute unspecified unspecified  	O	null
17 מ מ מנצור preposition unspecified unspecified unspecified unspecified unspecified 0 
17 נצור נצר מנצור participle masculine singular absolute any unspecified  	I_ORG	null
18 אלקסאם אלקסאם אלקסאם properName unspecified unspecified unspecified unspecified unspecified  	I_PERS	null
19 , , , punctuation unspecified unspecified unspecified unspecified unspecified  	O	null
20 הוא הוא הוא pronoun masculine singular unspecified 3 unspecified  	O	null
21 פירדוסי פירדוסי פירדוסי adjective masculine singular absolute unspecified unspecified  	O	null
22 – – – punctuation unspecified unspecified unspecified unspecified unspecified  	O	null
23 ש ש שעליו relativizer/subordinatingConjunction unspecified unspecified unspecified unspecified unspecified 0 
23 על על שעליו preposition unspecified unspecified unspecified unspecified unspecified  
23 ו ו שעליו pronomial masculine singular unspecified 3 unspecified 0 	O	null
24 זכה זכה זכה verb masculine singular unspecified 3 past  	O	null
25 ב ב בפרס preposition unspecified unspecified unspecified unspecified unspecified 0 
25 פרס פרס בפרס noun masculine singular absolute unspecified unspecified  	O	null
26 טשרניחובסקי טשרניחובסקי טשרניחובסקי properName unspecified unspecified unspecified unspecified unspecified  	I_PERS	null
27 ל ל לתרגומי preposition unspecified unspecified unspecified unspecified unspecified 0 
27 תרגומי תרגום לתרגומי noun masculine plural construct unspecified unspecified  	O	null
28 מופת מופת מופת noun feminine singular absolute unspecified unspecified  	O	null
29 ) ) ) punctuation unspecified unspecified unspecified unspecified unspecified  	O	null
30 . . . punctuation unspecified unspecified unspecified unspecified unspecified  	O	null
31 ###NUMBER### ###NUMBER### ###NUMBER### numeral unspecified unspecified unspecified unspecified unspecified  	I_DATE	null
32 השאהנאמה השאהנאמה השאהנאמה verb masculine-and-feminine singular unspecified 1 future  	O	null
33 היא הוא היא copula feminine singular unspecified 3 beinoni  	O	null
34 שירה שירה שירה noun feminine singular absolute unspecified unspecified  	O	null
35 אפית אפה אפית verb feminine singular unspecified 2 past  	O	null
36 , , , punctuation unspecified unspecified unspecified unspecified unspecified  	O	null
37 ה ה המציגה definiteArticle unspecified unspecified unspecified unspecified unspecified 0 
37 המציגה הציג המציגה participle feminine singular absolute any unspecified  	O	null
38 את את את at-preposition unspecified unspecified unspecified unspecified unspecified  	O	null
39 ה ה ההיסטוריה definiteArticle unspecified unspecified unspecified unspecified unspecified 0 
39 ההיסטוריה היסטוריה ההיסטוריה noun feminine singular absolute unspecified unspecified  	O	null
40 של של של shel-preposition unspecified unspecified unspecified unspecified unspecified  	O	null
41 פרס פרס פרס properName unspecified unspecified unspecified unspecified unspecified  	I_PERS	null
42 מ מ מבריאת preposition unspecified unspecified unspecified unspecified unspecified 0 
42 בריאת בריאה מבריאת noun feminine singular construct unspecified unspecified  	O	null
43 ה ה העולם definiteArticle unspecified unspecified unspecified unspecified unspecified 0 
43 העולם עולם העולם noun masculine singular absolute unspecified unspecified  	O	null
44 ו ו ועד conjunction unspecified unspecified unspecified unspecified unspecified 0 
44 עד עד ועד preposition unspecified unspecified unspecified unspecified unspecified  	O	null
45 כניעת כניעה כניעת noun feminine singular construct unspecified unspecified  	O	null
46 ה ה הפרסים definiteArticle unspecified unspecified unspecified unspecified unspecified 0 
46 הפרסים פרס הפרסים noun masculine plural absolute unspecified unspecified  	O	null
47 ל ל לשליטים preposition unspecified unspecified unspecified unspecified unspecified 0 
47 ה ה לשליטים definiteArticle unspecified unspecified unspecified unspecified unspecified 0 
47 השליטים שליט לשליטים noun masculine plural absolute unspecified unspecified  	O	null
48 ה ה הערבים definiteArticle unspecified unspecified unspecified unspecified unspecified 0 
48 הערבים ערב הערבים adjective masculine plural absolute unspecified unspecified  	O	null
49 ב ב ב preposition unspecified unspecified unspecified unspecified unspecified 0 	O	null
50 - - - punctuation unspecified unspecified unspecified unspecified unspecified  	O	null
51 ###NUMBER### ###NUMBER### ###NUMBER### numeral unspecified unspecified unspecified unspecified unspecified  	O	null
52 ל ל לספירה preposition unspecified unspecified unspecified unspecified unspecified 0 
52 ה ה לספירה definiteArticle unspecified unspecified unspecified unspecified unspecified 0 
52 הספירה ספירה לספירה noun feminine singular absolute unspecified unspecified  	O	null
53 . . . punctuation unspecified unspecified unspecified unspecified unspecified  	O	null

0 ה ה היצירה definiteArticle unspecified unspecified unspecified unspecified unspecified 0 
0 היצירה יצירה היצירה noun feminine singular absolute unspecified unspecified  	O	null
1 היא הוא היא copula feminine singular unspecified 3 beinoni  	O	null
2 מסורת מסורת מסורת noun feminine singular absolute unspecified unspecified  	O	null
3 עתיקה עתיק עתיקה adjective feminine singular absolute unspecified unspecified  	O	null
4 של של של shel-preposition unspecified unspecified unspecified unspecified unspecified  	O	null
5 סיפורים סיפור סיפורים noun masculine plural absolute unspecified unspecified  	O	null
6 טרגיים טרגי טרגיים adjective masculine plural absolute unspecified unspecified  	O	null
7 . . . punctuation unspecified unspecified unspecified unspecified unspecified  	O	null

0 ה ה התרגום definiteArticle unspecified unspecified unspecified unspecified unspecified 0 
0 התרגום תרגום התרגום noun masculine singular absolute unspecified unspecified  	O	null
1 זכה זכה זכה verb masculine singular unspecified 3 past  	O	null
2 ל ל לשבחי preposition unspecified unspecified unspecified unspecified unspecified 0 
2 שבחי שבח לשבחי noun masculine plural construct unspecified unspecified  	O	null
3 ה ה הביקורת definiteArticle unspecified unspecified unspecified unspecified unspecified 0 
3 הביקורת ביקורת הביקורת noun feminine singular absolute unspecified unspecified  	O	null
4 . . . punctuation unspecified unspecified unspecified unspecified unspecified  	O	null

0 ה ה המבקרים definiteArticle unspecified unspecified unspecified unspecified unspecified 0 
0 המבקרים מבקר המבקרים noun masculine plural absolute unspecified unspecified  	O	null
1 ציינו ציין ציינו verb masculine-and-feminine plural unspecified 3 past  	O	null
2 כי כי כי conjunction unspecified unspecified unspecified unspecified unspecified  	O	null
3 ה ה התרגום definiteArticle unspecified unspecified unspecified unspecified unspecified 0 
3 התרגום תרגום התרגום noun masculine singular absolute unspecified unspecified  	O	null
4 מאופיין אופיין מאופיין verb masculine singular unspecified any beinoni  	O	null
5 ב ב בלשון preposition unspecified unspecified unspecified unspecified unspecified 0 
5 לשון לשון בלשון noun feminine singular absolute unspecified unspecified  	O	null
6 מקראית מקראי מקראית adjective feminine singular absolute unspecified unspecified  	O	null
7 תוססת תוסס תוססת adjective feminine singular absolute unspecified unspecified  	O	null
8 , , , punctuation unspecified unspecified unspecified unspecified unspecified  	O	null
9 ש ש שנשמר relativizer/subordinatingConjunction unspecified unspecified unspecified unspecified unspecified 0 
9 נשמר נשמר שנשמר verb masculine singular unspecified 3 past  	O	null
10 ב ב בה preposition unspecified unspecified unspecified unspecified unspecified  
10 ה ה בה pronomial feminine singular unspecified 3 unspecified 0 	O	null
11 ה ה המשקל definiteArticle unspecified unspecified unspecified unspecified unspecified 0 
11 המשקל משקל המשקל noun masculine singular absolute unspecified unspecified  	I_MONEY	null
12 ה ה התורם definiteArticle unspecified unspecified unspecified unspecified unspecified 0 
12 התורם תרם התורם participle masculine singular absolute any unspecified  	O	null
13 ל ל לאופי preposition unspecified unspecified unspecified unspecified unspecified 0 
13 ה ה לאופי definiteArticle unspecified unspecified unspecified unspecified unspecified 0 
13 האופי אופי לאופי noun masculine singular absolute unspecified unspecified  	O	null
14 ה ה הפיוטי definiteArticle unspecified unspecified unspecified unspecified unspecified 0 
14 הפיוטי פיוטי הפיוטי adjective masculine singular absolute unspecified unspecified  	O	null
15 של של של shel-preposition unspecified unspecified unspecified unspecified unspecified  	O	null
16 ה ה השירה definiteArticle unspecified unspecified unspecified unspecified unspecified 0 
16 השירה שירה השירה noun feminine singular absolute unspecified unspecified  	O	null
17 ה ה האפית definiteArticle unspecified unspecified unspecified unspecified unspecified 0 
17 האפית האפית האפית adjective feminine singular absolute unspecified unspecified  	O	null
18 ו ו ולקצב conjunction unspecified unspecified unspecified unspecified unspecified 0 
18 ל ל ולקצב preposition unspecified unspecified unspecified unspecified unspecified 0 
18 קצב קצב ולקצב noun masculine singular construct unspecified unspecified  	O	null
19 לשון לשון לשון noun feminine singular construct unspecified unspecified  	O	null
20 ה ה התרגום definiteArticle unspecified unspecified unspecified unspecified unspecified 0 
20 התרגום תרגום התרגום noun masculine singular absolute unspecified unspecified  	O	null
21 . . . punctuation unspecified unspecified unspecified unspecified unspecified  	O	null

0 פירסם פרסם פירסם verb masculine singular unspecified 3 past  	O	null
1 אחד CARD1 אחד numeral masculine singular absolute unspecified unspecified  	O	null
2 - - - punctuation unspecified unspecified unspecified unspecified unspecified  	O	null
3 עשר CARD10 עשר numeral feminine singular absolute unspecified unspecified  	O	null
4 ספרי ספר ספרי noun masculine plural construct unspecified unspecified  	O	null
5 שירה שירה שירה noun feminine singular absolute unspecified unspecified  	O	null
6 . . . punctuation unspecified unspecified unspecified unspecified unspecified  	O	null

0 אף אף אף conjunction unspecified unspecified unspecified unspecified unspecified  	O	null
1 על על על preposition unspecified unspecified unspecified unspecified unspecified  	O	null
2 פי פה פי noun masculine singular construct unspecified unspecified  	O	null
3 ש ש שלא relativizer/subordinatingConjunction unspecified unspecified unspecified unspecified unspecified 0 
3 לא לא שלא negation unspecified unspecified unspecified unspecified unspecified  	O	null
4 זכה זכה זכה verb masculine singular unspecified 3 past  	O	null
5 ל ל לפרסום preposition unspecified unspecified unspecified unspecified unspecified 0 
5 פרסום פרסום לפרסום noun masculine singular absolute unspecified unspecified  	O	null
6 רחב רחב רחב adjective masculine singular absolute unspecified unspecified  	O	null
7 ב ב בציבור preposition unspecified unspecified unspecified unspecified unspecified 0 
7 ה ה בציבור definiteArticle unspecified unspecified unspecified unspecified unspecified 0 
7 הציבור ציבור בציבור noun masculine singular absolute unspecified unspecified  	O	null
8 , , , punctuation unspecified unspecified unspecified unspecified unspecified  	O	null
9 משוררים משורר משוררים noun masculine plural absolute unspecified unspecified  	O	null
10 ו ו ומבקרים conjunction unspecified unspecified unspecified unspecified unspecified 0 
10 מבקרים מבקר ומבקרים noun masculine plural absolute unspecified unspecified  	O	null
11 ראו ראה ראו verb masculine-and-feminine plural unspecified 3 past  	O	null
12 ב ב בו preposition unspecified unspecified unspecified unspecified unspecified  
12 ו ו בו pronomial masculine singular unspecified 3 unspecified 0 	O	null
13 משורר משורר משורר noun masculine singular absolute unspecified unspecified  	O	null
14 עם עם עם preposition unspecified unspecified unspecified unspecified unspecified  	O	null
15 קול קול קול noun masculine singular absolute unspecified unspecified  	O	null
16 פיוטי פיוטי פיוטי adjective masculine singular absolute unspecified unspecified  	O	null
17 עצמאי עצמאי עצמאי adjective masculine singular absolute unspecified unspecified  	O	null
18 . . . punctuation unspecified unspecified unspecified unspecified unspecified  	O	null

0 שירת שירה שירתו noun feminine singular absolute unspecified unspecified  
0 ו ו שירתו possessive masculine singular unspecified 3 unspecified 0 	O	null
1 הוגדרה הוגדר הוגדרה verb feminine singular unspecified 3 past  	O	null
2 כ כ כשירה preposition unspecified unspecified unspecified unspecified unspecified 0 
2 שירה שירה כשירה noun feminine singular absolute unspecified unspecified  	O	null
3 של של של shel-preposition unspecified unspecified unspecified unspecified unspecified  	O	null
4 " " " punctuation unspecified unspecified unspecified unspecified unspecified  	O	null
5 עולם עולם עולם noun masculine singular absolute unspecified unspecified  	O	null
6 קטן קטן קטן adjective masculine singular absolute unspecified unspecified  	O	null
7 " " " punctuation unspecified unspecified unspecified unspecified unspecified  	O	null
8 , , , punctuation unspecified unspecified unspecified unspecified unspecified  	O	null
9 ו ו וככזו conjunction unspecified unspecified unspecified unspecified unspecified 0 
9 ככזו ככזו וככזו adverb unspecified unspecified unspecified unspecified unspecified  	O	null
10 נותנת נתן נותנת verb feminine singular unspecified any beinoni  	O	null
11 כבוד כבוד כבוד noun masculine singular absolute unspecified unspecified  	O	null
12 ל ל לאדם preposition unspecified unspecified unspecified unspecified unspecified 0 
12 אדם אדם לאדם noun masculine singular absolute unspecified unspecified  	O	null
13 , , , punctuation unspecified unspecified unspecified unspecified unspecified  	O	null
14 על על על preposition unspecified unspecified unspecified unspecified unspecified  	O	null
15 דלות דלות דלותו noun feminine singular absolute unspecified unspecified  
15 ו ו דלותו possessive masculine singular unspecified 3 unspecified 0 	O	null
16 , , , punctuation unspecified unspecified unspecified unspecified unspecified  	O	null
17 על על על preposition unspecified unspecified unspecified unspecified unspecified  	O	null
18 ה ה הבנאליות definiteArticle unspecified unspecified unspecified unspecified unspecified 0 
18 הבנאליות הבנאליות הבנאליות noun feminine singular absolute unspecified unspecified  	O	null
19 ה ה האפורה definiteArticle unspecified unspecified unspecified unspecified unspecified 0 
19 האפורה אפור האפורה adjective feminine singular absolute unspecified unspecified  	O	null
20 של של שלו shel-preposition unspecified unspecified unspecified unspecified unspecified  
20 ו ו שלו pronomial masculine singular unspecified 3 unspecified 0 	O	null
21 ו ו ופשטותו conjunction unspecified unspecified unspecified unspecified unspecified 0 
21 פשטות פשטות ופשטותו noun feminine singular absolute unspecified unspecified  
21 ו ו ופשטותו possessive masculine singular unspecified 3 unspecified 0 	O	null
22 . . . punctuation unspecified unspecified unspecified unspecified unspecified  	O	null

0 ה ה העברית definiteArticle unspecified unspecified unspecified unspecified unspecified 0 
0 העברית עברי העברית adjective feminine singular absolute unspecified unspecified  	O	null
1 ב ב בשיריו preposition unspecified unspecified unspecified unspecified unspecified 0 
1 שירי שיר בשיריו noun masculine plural absolute unspecified unspecified  
1 ו ו בשיריו possessive masculine singular unspecified 3 unspecified 0 	O	null
2 עשירת עשיר עשירת adjective feminine singular construct unspecified unspecified  	O	null
3 מבע מבע מבע noun masculine singular absolute unspecified unspecified  	O	null
4 ו ו ורבת conjunction unspecified unspecified unspecified unspecified unspecified 0 
4 רבת רב ורבת noun feminine singular construct unspecified unspecified  	O	null
5 - - - punctuation unspecified unspecified unspecified unspecified unspecified  	O	null
6 רבדים רובד רבדים noun masculine plural absolute unspecified unspecified  	O	null
7 . . . punctuation unspecified unspecified unspecified unspecified unspecified  	O	null

0 אפשר אפשר אפשר modal unspecified unspecified unspecified unspecified unspecified  	O	null
1 לראות ראה לראות verb unspecified unspecified unspecified unspecified infinitive  	O	null
2 ב ב בשירתו preposition unspecified unspecified unspecified unspecified unspecified 0 
2 שירת שירה בשירתו noun feminine singular absolute unspecified unspecified  
2 ו ו בשירתו possessive masculine singular unspecified 3 unspecified 0 	O	null
3 ביטוי ביטוי ביטוי noun masculine singular absolute unspecified unspecified  	O	null
4 ל ל למתחים preposition unspecified unspecified unspecified unspecified unspecified 0 
4 מתחים מתח למתחים noun masculine plural absolute unspecified unspecified  	O	null
5 ש ש שביסוד relativizer/subordinatingConjunction unspecified unspecified unspecified unspecified unspecified 0 
5 ב ב שביסוד preposition unspecified unspecified unspecified unspecified unspecified 0 
5 יסוד יסוד שביסוד noun masculine singular construct unspecified unspecified  	O	null
6 ה ה החוויה definiteArticle unspecified unspecified unspecified unspecified unspecified 0 
6 החוויה חוויה החוויה noun feminine singular absolute unspecified unspecified  	O	null
7 ה ה האנושית definiteArticle unspecified unspecified unspecified unspecified unspecified 0 
7 האנושית אנושי האנושית adjective feminine singular absolute unspecified unspecified  	O	null
8 ה ה המודרנית definiteArticle unspecified unspecified unspecified unspecified unspecified 0 
8 המודרנית מודרני המודרנית adjective feminine singular absolute unspecified unspecified  	O	null
9 , , , punctuation unspecified unspecified unspecified unspecified unspecified  	O	null
10 ה ה הניכרים definiteArticle unspecified unspecified unspecified unspecified unspecified 0 
10 הניכרים ניכר הניכרים adjective masculine plural absolute unspecified unspecified  	O	null
11 גם גם גם conjunction unspecified unspecified unspecified unspecified unspecified  	O	null
12 ב ב בזיקות preposition unspecified unspecified unspecified unspecified unspecified 0 
12 ה ה בזיקות definiteArticle unspecified unspecified unspecified unspecified unspecified 0 
12 הזיקות זיקה בזיקות noun feminine plural absolute unspecified unspecified  	O	null
13 ה ה המתוחות definiteArticle unspecified unspecified unspecified unspecified unspecified 0 
13 המתוחות מתוח המתוחות adjective feminine plural absolute unspecified unspecified  	O	null
14 בין בין בין preposition unspecified unspecified unspecified unspecified unspecified  	O	null
15 צורות צורה צורות noun feminine plural absolute unspecified unspecified  	O	null
16 מבניות מבני מבניות adjective feminine plural absolute unspecified unspecified  	O	null
17 קלאסיות קלאסי קלאסיות adjective feminine plural absolute unspecified unspecified  	O	null
18 סדורות סדור סדורות adjective feminine plural absolute unspecified unspecified  	O	null
19 ל ל לתכנים preposition unspecified unspecified unspecified unspecified unspecified 0 
19 תכנים תוכן לתכנים noun masculine plural absolute unspecified unspecified  	O	null
20 ו ו ולפיגורטיביות conjunction unspecified unspecified unspecified unspecified unspecified 0 
20 ל ל ולפיגורטיביות preposition unspecified unspecified unspecified unspecified unspecified 0 
20 פיגורטיביות פיגורטיביות ולפיגורטיביות noun feminine singular construct unspecified unspecified  	O	null
21 ה ה הנדמים definiteArticle unspecified unspecified unspecified unspecified unspecified 0 
21 הנדמים נדמה הנדמים participle masculine plural absolute any unspecified  	O	null
22 כ כ כזעקה preposition unspecified unspecified unspecified unspecified unspecified 0 
22 ה ה כזעקה definiteArticle unspecified unspecified unspecified unspecified unspecified 0 
22 הזעקה זעקה כזעקה noun feminine singular absolute unspecified unspecified  	O	null
23 . . . punctuation unspecified unspecified unspecified unspecified unspecified  	O	null

0 References References References foreign unspecified unspecified unspecified unspecified unspecified  	O	null
1 : : : punctuation unspecified unspecified unspecified unspecified unspecified  	O	null
2 גורי גור גורי noun masculine plural construct unspecified unspecified  	O	null
3 , , , punctuation unspecified unspecified unspecified unspecified unspecified  	O	null
4 חיים חיים חיים noun masculine plural absolute unspecified unspecified  	O	null
5 . . . punctuation unspecified unspecified unspecified unspecified unspecified  	O	null

0 " " " punctuation unspecified unspecified unspecified unspecified unspecified  	O	null
1 שלום שלום שלום noun masculine singular absolute unspecified unspecified  	O	null
2 , , , punctuation unspecified unspecified unspecified unspecified unspecified  	O	null
3 רכסי רכס רכסי noun masculine plural construct unspecified unspecified  	O	null
4 כפתורי כפתור כפתורי noun masculine plural construct unspecified unspecified  	O	null
5 ה ה המעיל definiteArticle unspecified unspecified unspecified unspecified unspecified 0 
5 המעיל מעיל המעיל noun masculine singular absolute unspecified unspecified  	O	null
6 " " " punctuation unspecified unspecified unspecified unspecified unspecified  	O	null
7 . . . punctuation unspecified unspecified unspecified unspecified unspecified  	O	null

0 מאזניים מאזניים מאזניים noun masculine plural absolute unspecified unspecified  	O	null
1 ס"ח ס"ח ס"ח noun masculine singular absolute unspecified unspecified  	O	null
2 ) ) ) punctuation unspecified unspecified unspecified unspecified unspecified  	O	null
3 . . . punctuation unspecified unspecified unspecified unspecified unspecified  	O	null
4 ###NUMBER### ###NUMBER### ###NUMBER### numeral unspecified unspecified unspecified unspecified unspecified  	O	null
5 ###NUMBER### ###NUMBER### ###NUMBER### numeral unspecified unspecified unspecified unspecified unspecified  	I_DATE	null
6 . . . punctuation unspecified unspecified unspecified unspecified unspecified  	O	null

0 - - - punctuation unspecified unspecified unspecified unspecified unspecified  	O	null
1 ###NUMBER### ###NUMBER### ###NUMBER### numeral unspecified unspecified unspecified unspecified unspecified  	O	null
2 ; ; ; punctuation unspecified unspecified unspecified unspecified unspecified  	O	null
3 ###NUMBER### ###NUMBER### ###NUMBER### numeral unspecified unspecified unspecified unspecified unspecified  	O	null
4 ליפסקר ליפסקר ליפסקר properName unspecified unspecified unspecified unspecified unspecified  	O	null
5 , , , punctuation unspecified unspecified unspecified unspecified unspecified  	O	null
6 אבידב אבידב אבידב properName unspecified unspecified unspecified unspecified unspecified  	I_PERS	null
7 . . . punctuation unspecified unspecified unspecified unspecified unspecified  	O	null

0 " " " punctuation unspecified unspecified unspecified unspecified unspecified  	O	null
1 ברכת בריכה ברכת noun feminine singular construct unspecified unspecified  	O	null
2 ה ה השכחה definiteArticle unspecified unspecified unspecified unspecified unspecified 0 
2 השכחה שכחה השכחה noun feminine singular absolute unspecified unspecified  	O	null
3 ה ה הסולחת definiteArticle unspecified unspecified unspecified unspecified unspecified 0 
3 הסולחת סלח הסולחת participle feminine singular absolute any unspecified  	O	null
4 : : : punctuation unspecified unspecified unspecified unspecified unspecified  	O	null
5 על על על preposition unspecified unspecified unspecified unspecified unspecified  	O	null
6 שירת שירה שירת noun feminine singular construct unspecified unspecified  	O	null
7 אליעזר אליעזר אליעזר properName unspecified unspecified unspecified unspecified unspecified  	I_PERS	null
8 כ כ כגן preposition unspecified unspecified unspecified unspecified unspecified 0 
8 גן גן כגן noun masculine singular absolute unspecified unspecified  	O	null
9 " " " punctuation unspecified unspecified unspecified unspecified unspecified  	O	null
10 . . . punctuation unspecified unspecified unspecified unspecified unspecified  	O	null

0 צפון צפון צפון noun masculine singular construct unspecified unspecified  	O	null
1 ו ו ו conjunction unspecified unspecified unspecified unspecified unspecified  	O	null
2 ' ' ' punctuation unspecified unspecified unspecified unspecified unspecified  	O	null
3 . . . punctuation unspecified unspecified unspecified unspecified unspecified  	O	null
4 ###NUMBER### ###NUMBER### ###NUMBER### numeral unspecified unspecified unspecified unspecified unspecified  	I_DATE	null
5 . . . punctuation unspecified unspecified unspecified unspecified unspecified  	O	null

0 - - - punctuation unspecified unspecified unspecified unspecified unspecified  	O	null
1 ###NUMBER### ###NUMBER### ###NUMBER### numeral unspecified unspecified unspecified unspecified unspecified  	O	null
2 ; ; ; punctuation unspecified unspecified unspecified unspecified unspecified  	O	null
3 ###NUMBER### ###NUMBER### ###NUMBER### numeral unspecified unspecified unspecified unspecified unspecified  	O	null
4 שקד שקד שקד properName unspecified unspecified unspecified unspecified unspecified  	I_PERS	null
5 , , , punctuation unspecified unspecified unspecified unspecified unspecified  	O	null
6 שאול שאול שאול properName unspecified unspecified unspecified unspecified unspecified  	I_PERS	null
7 . . . punctuation unspecified unspecified unspecified unspecified unspecified  	O	null

0 " " " punctuation unspecified unspecified unspecified unspecified unspecified  	O	null
1 אליעזר אליעזר אליעזר properName unspecified unspecified unspecified unspecified unspecified  	I_PERS	null
2 כ כ כגן preposition unspecified unspecified unspecified unspecified unspecified 0 
2 גן גן כגן noun masculine singular absolute unspecified unspecified  	O	null
3 , , , punctuation unspecified unspecified unspecified unspecified unspecified  	O	null
4 מתרגם תרגם מתרגם verb masculine singular unspecified any beinoni  	O	null
5 השאהנאמה השאהנאמה השאהנאמה verb masculine-and-feminine singular unspecified 1 future  	O	null
6 " " " punctuation unspecified unspecified unspecified unspecified unspecified  	O	null
7 . . . punctuation unspecified unspecified unspecified unspecified unspecified  	O	null

0 צפון צפון צפון noun masculine singular construct unspecified unspecified  	O	null
1 ז' ז' ז' properName unspecified unspecified unspecified unspecified unspecified  	I_LOC	null
2 . . . punctuation unspecified unspecified unspecified unspecified unspecified  	O	null

0 ###NUMBER### ###NUMBER### ###NUMBER### numeral unspecified unspecified unspecified unspecified unspecified  	I_DATE	null
1 . . . punctuation unspecified unspecified unspecified unspecified unspecified  	O	null

0 ###NUMBER### ###NUMBER### ###NUMBER### numeral unspecified unspecified unspecified unspecified unspecified  	O	null
1 - - - punctuation unspecified unspecified unspecified unspecified unspecified  	O	null
2 ###NUMBER### ###NUMBER### ###NUMBER### numeral unspecified unspecified unspecified unspecified unspecified  	O	null
3 . . . punctuation unspecified unspecified unspecified unspecified unspecified  	O	null

