0 Name Name Name foreign unspecified unspecified unspecified unspecified unspecified  	O	null
1 : : : punctuation unspecified unspecified unspecified unspecified unspecified  	O	null
2 לרנר לרנר לרנר properName unspecified unspecified unspecified unspecified unspecified  	I_PERS	null
3 , , , punctuation unspecified unspecified unspecified unspecified unspecified  	O	null
4 מוטי מוטי מוטי properName unspecified unspecified unspecified unspecified unspecified  	I_PERS	null
5 Birth Birth Birth foreign unspecified unspecified unspecified unspecified unspecified  	O	null
6 Year Year Year foreign unspecified unspecified unspecified unspecified unspecified  	O	null
7 : : : punctuation unspecified unspecified unspecified unspecified unspecified  	O	null
8 ###NUMBER### ###NUMBER### ###NUMBER### numeral unspecified unspecified unspecified unspecified unspecified  	I_DATE	null
9 Birth Birth Birth foreign unspecified unspecified unspecified unspecified unspecified  	O	null
10 Place Place Place foreign unspecified unspecified unspecified unspecified unspecified  	O	null
11 : : : punctuation unspecified unspecified unspecified unspecified unspecified  	O	null
12 עקב עקב עקב preposition unspecified unspecified unspecified unspecified unspecified  	O	null
13 , , , punctuation unspecified unspecified unspecified unspecified unspecified  	O	null
14 דור דור דור noun masculine singular absolute unspecified unspecified  	O	null
15 חמישי ORD5 חמישי numeral masculine singular absolute unspecified unspecified  	O	null
16 Occupation Occupation Occupation foreign unspecified unspecified unspecified unspecified unspecified  	O	null
17 : : : punctuation unspecified unspecified unspecified unspecified unspecified  	O	null
18 מחזאי מחזאי מחזאי noun masculine singular absolute unspecified unspecified  	O	null
19 ותסריטאי ותסריטאי ותסריטאי properName unspecified unspecified unspecified unspecified unspecified  	O	null
20 Entry Entry Entry foreign unspecified unspecified unspecified unspecified unspecified  	O	null
21 writer writer writer foreign unspecified unspecified unspecified unspecified unspecified  	O	null
22 : : : punctuation unspecified unspecified unspecified unspecified unspecified  	O	null
23 חיים חיים חיים noun masculine plural absolute unspecified unspecified  	O	null
24 נגיד נגיד נגיד properName unspecified unspecified unspecified unspecified unspecified  	I_PERS	null
25 Entry Entry Entry foreign unspecified unspecified unspecified unspecified unspecified  	O	null
26 Value Value Value foreign unspecified unspecified unspecified unspecified unspecified  	O	null
27 : : : punctuation unspecified unspecified unspecified unspecified unspecified  	O	null
28 נולדבזכרון נולדבזכרון נולדבזכרון properName unspecified unspecified unspecified unspecified unspecified  	I_PERS	null
29 יעקב יעקב יעקב properName unspecified unspecified unspecified unspecified unspecified  	I_PERS	null
30 , , , punctuation unspecified unspecified unspecified unspecified unspecified  	O	null
31 דור דור דור noun masculine singular absolute unspecified unspecified  	O	null
32 חמישי ORD5 חמישי numeral masculine singular absolute unspecified unspecified  	O	null
33 ב ב בארץ preposition unspecified unspecified unspecified unspecified unspecified 0 
33 ה ה בארץ definiteArticle unspecified unspecified unspecified unspecified unspecified 0 
33 הארץ ארץ בארץ noun feminine singular absolute unspecified unspecified  	O	null
34 . . . punctuation unspecified unspecified unspecified unspecified unspecified  	O	null

0 סיים סיים סיים verb masculine singular unspecified 3 past  	O	null
1 לימודי לימוד לימודי noun masculine plural construct unspecified unspecified  	O	null
2 תואר תואר תואר noun masculine singular absolute unspecified unspecified  	O	null
3 ראשון ORD1 ראשון numeral masculine singular absolute unspecified unspecified  	O	null
4 ב ב במתמטיקה preposition unspecified unspecified unspecified unspecified unspecified 0 
4 מתמטיקה מתמטיקה במתמטיקה noun feminine singular absolute unspecified unspecified  	O	null
5 ו ו ובפיזיקה conjunction unspecified unspecified unspecified unspecified unspecified 0 
5 ב ב ובפיזיקה preposition unspecified unspecified unspecified unspecified unspecified 0 
5 פיזיקה פיזיקה ובפיזיקה noun feminine singular absolute unspecified unspecified  	O	null
6 ב ב באוניברסיטה preposition unspecified unspecified unspecified unspecified unspecified 0 
6 ה ה באוניברסיטה definiteArticle unspecified unspecified unspecified unspecified unspecified 0 
6 האוניברסיטה אוניברסיטה באוניברסיטה noun feminine singular absolute unspecified unspecified  	O	null
7 ה ה העברית definiteArticle unspecified unspecified unspecified unspecified unspecified 0 
7 העברית עברי העברית adjective feminine singular absolute unspecified unspecified  	O	null
8 ב ב בירושלים preposition unspecified unspecified unspecified unspecified unspecified 0 
8 ירושלים ירושלים בירושלים properName unspecified unspecified unspecified unspecified unspecified  	I_LOC	null
9 ו ו והתכוון conjunction unspecified unspecified unspecified unspecified unspecified 0 
9 התכוון התכוון והתכוון verb masculine singular unspecified 3 past  	O	null
10 ל ל להיות preposition unspecified unspecified unspecified unspecified unspecified 0 
10 היות היות להיות noun masculine singular construct unspecified unspecified  	O	null
11 מתמטיקאי מתמטיקאי מתמטיקאי noun masculine singular absolute unspecified unspecified  	O	null
12 , , , punctuation unspecified unspecified unspecified unspecified unspecified  	O	null
13 אךבמלחמת אךבמלחמת אךבמלחמת noun masculine-and-feminine singular absolute unspecified unspecified  	I_DATE	null
14 יום יום יום noun masculine singular construct unspecified unspecified  	I_DATE	null
15 ה ה הכיפורים definiteArticle unspecified unspecified unspecified unspecified unspecified 0 
15 הכיפורים כיפור הכיפורים noun masculine plural absolute unspecified unspecified  	I_DATE	null
16 ב ב ב preposition unspecified unspecified unspecified unspecified unspecified 0 	O	null
17 - - - punctuation unspecified unspecified unspecified unspecified unspecified  	O	null
18 ###NUMBER### ###NUMBER### ###NUMBER### numeral unspecified unspecified unspecified unspecified unspecified  	I_DATE	null
19 הצטרף הצטרף הצטרף verb masculine singular unspecified 3 past  	O	null
20 ל ל למחאה preposition unspecified unspecified unspecified unspecified unspecified 0 
20 ה ה למחאה definiteArticle unspecified unspecified unspecified unspecified unspecified 0 
20 המחאה מחאה למחאה noun feminine singular absolute unspecified unspecified  	O	null
21 ה ה הציבורית definiteArticle unspecified unspecified unspecified unspecified unspecified 0 
21 הציבורית ציבורי הציבורית adjective feminine singular absolute unspecified unspecified  	O	null
22 נגד נגד נגד preposition unspecified unspecified unspecified unspecified unspecified  	O	null
23 ממשלת ממשלה ממשלת noun feminine singular construct unspecified unspecified  	O	null
24 גולדה גולדה גולדה properName unspecified unspecified unspecified unspecified unspecified  	I_PERS	null
25 מאיר מאיר מאיר properName unspecified unspecified unspecified unspecified unspecified  	I_PERS	null
26 ו ו ומשה conjunction unspecified unspecified unspecified unspecified unspecified 0 
26 משה משה ומשה properName unspecified unspecified unspecified unspecified unspecified  	B_PERS	null
27 דיין דיין דיין properName unspecified unspecified unspecified unspecified unspecified  	I_PERS	null
28 , , , punctuation unspecified unspecified unspecified unspecified unspecified  	O	null
29 ו ו והחליט conjunction unspecified unspecified unspecified unspecified unspecified 0 
29 החליט החליט והחליט verb masculine singular unspecified 3 past  	O	null
30 לפרוש פרש לפרוש verb unspecified unspecified unspecified unspecified infinitive  	O	null
31 מ מ מלימודי preposition unspecified unspecified unspecified unspecified unspecified 0 
31 לימודי לימוד מלימודי noun masculine plural construct unspecified unspecified  	O	null
32 ה ה התואר definiteArticle unspecified unspecified unspecified unspecified unspecified 0 
32 התואר תואר התואר noun masculine singular absolute unspecified unspecified  	O	null
33 ה ה השני definiteArticle unspecified unspecified unspecified unspecified unspecified 0 
33 השני ORD2 השני numeral masculine singular absolute unspecified unspecified  	O	null
34 ו ו ולעבור conjunction unspecified unspecified unspecified unspecified unspecified 0 
34 לעבור עבר ולעבור verb unspecified unspecified unspecified unspecified infinitive  	O	null
35 ל ל לעיסוק preposition unspecified unspecified unspecified unspecified unspecified 0 
35 ה ה לעיסוק definiteArticle unspecified unspecified unspecified unspecified unspecified 0 
35 העיסוק עיסוק לעיסוק noun masculine singular absolute unspecified unspecified  	O	null
36 ב ב בתיאטרון preposition unspecified unspecified unspecified unspecified unspecified 0 
36 ה ה בתיאטרון definiteArticle unspecified unspecified unspecified unspecified unspecified 0 
36 התיאטרון תיאטרון בתיאטרון noun masculine singular absolute unspecified unspecified  	O	null
37 , , , punctuation unspecified unspecified unspecified unspecified unspecified  	O	null
38 לאחר לאחר לאחר conjunction unspecified unspecified unspecified unspecified unspecified  	O	null
39 ש ש שהשתכנע relativizer/subordinatingConjunction unspecified unspecified unspecified unspecified unspecified 0 
39 השתכנע השתכנע שהשתכנע verb masculine singular unspecified 3 past  	O	null
40 ש ש שניתן relativizer/subordinatingConjunction unspecified unspecified unspecified unspecified unspecified 0 
40 ניתן ניתן שניתן modal masculine singular unspecified any unspecified  	O	null
41 להשפיע השפיע להשפיע verb unspecified unspecified unspecified unspecified infinitive  	O	null
42 באמצעות באמצעות באמצעותו preposition unspecified unspecified unspecified unspecified unspecified  
42 ו ו באמצעותו pronomial masculine singular unspecified 3 unspecified 0 	O	null
43 על על על preposition unspecified unspecified unspecified unspecified unspecified  	O	null
44 ה ה הפוליטיקה definiteArticle unspecified unspecified unspecified unspecified unspecified 0 
44 הפוליטיקה פוליטיקה הפוליטיקה noun feminine singular absolute unspecified unspecified  	O	null
45 ו ו והחברה conjunction unspecified unspecified unspecified unspecified unspecified 0 
45 החברה חבר והחברה properName unspecified unspecified unspecified unspecified unspecified  	I_LOC	null
46 . . . punctuation unspecified unspecified unspecified unspecified unspecified  	O	null

0 ב ב ב preposition unspecified unspecified unspecified unspecified unspecified 0 	O	null
1 - - - punctuation unspecified unspecified unspecified unspecified unspecified  	O	null
2 ###NUMBER### ###NUMBER### ###NUMBER### numeral unspecified unspecified unspecified unspecified unspecified  	I_DATE	null
3 השתלם השתלם השתלם verb masculine singular unspecified 3 past  	O	null
4 ב ב בבתי preposition unspecified unspecified unspecified unspecified unspecified 0 
4 בתי בית בבתי noun masculine plural construct unspecified unspecified  	O	null
5 ספר ספר ספר noun masculine singular absolute unspecified unspecified  	O	null
6 ל ל לתיאטרון preposition unspecified unspecified unspecified unspecified unspecified 0 
6 ה ה לתיאטרון definiteArticle unspecified unspecified unspecified unspecified unspecified 0 
6 התיאטרון תיאטרון לתיאטרון noun masculine singular absolute unspecified unspecified  	O	null
7 ב ב באנגליהובארצותהברית preposition unspecified unspecified unspecified unspecified unspecified 0 
7 ה ה באנגליהובארצותהברית definiteArticle unspecified unspecified unspecified unspecified unspecified 0 
7 האנגליהובארצותהברית האנגליהובארצותהברית באנגליהובארצותהברית adjective feminine singular absolute unspecified unspecified  	O	null
8 , , , punctuation unspecified unspecified unspecified unspecified unspecified  	O	null
9 ו ו וב conjunction unspecified unspecified unspecified unspecified unspecified 0 
9 ב ב וב preposition unspecified unspecified unspecified unspecified unspecified 0 	O	null
10 - - - punctuation unspecified unspecified unspecified unspecified unspecified  	O	null
11 ###NUMBER### ###NUMBER### ###NUMBER### numeral unspecified unspecified unspecified unspecified unspecified  	I_DATE	null
12 העלה העלה העלה verb masculine singular unspecified 3 past  	O	null
13 את את את at-preposition unspecified unspecified unspecified unspecified unspecified  	O	null
14 יצירת יצירה יצירתו noun feminine singular absolute unspecified unspecified  
14 ו ו יצירתו possessive masculine singular unspecified 3 unspecified 0 	O	null
15 ה ה הראשונה definiteArticle unspecified unspecified unspecified unspecified unspecified 0 
15 הראשונה ORD1 הראשונה numeral feminine singular absolute unspecified unspecified  	O	null
16 ל ל לתיאטרון preposition unspecified unspecified unspecified unspecified unspecified 0 
16 ה ה לתיאטרון definiteArticle unspecified unspecified unspecified unspecified unspecified 0 
16 התיאטרון תיאטרון לתיאטרון noun masculine singular absolute unspecified unspecified  	O	null
17 : : : punctuation unspecified unspecified unspecified unspecified unspecified  	O	null
18 דונים דון דונים noun masculine plural absolute unspecified unspecified  	O	null
19 ( ( ( punctuation unspecified unspecified unspecified unspecified unspecified  	O	null
20 תרכובת תרכובת תרכובת noun feminine singular absolute unspecified unspecified  	O	null
21 משובשת משובש משובשת adjective feminine singular absolute unspecified unspecified  	O	null
22 של של של shel-preposition unspecified unspecified unspecified unspecified unspecified  	O	null
23 ה ה המילים definiteArticle unspecified unspecified unspecified unspecified unspecified 0 
23 המילים מיל המילים noun masculine plural absolute unspecified unspecified  	O	null
24 אדונים אדון אדונים noun masculine plural absolute unspecified unspecified  	O	null
25 ו ו ונידונים conjunction unspecified unspecified unspecified unspecified unspecified 0 
25 נידונים נידון ונידונים verb masculine plural unspecified any beinoni  	O	null
26 ) ) ) punctuation unspecified unspecified unspecified unspecified unspecified  	O	null
27 , , , punctuation unspecified unspecified unspecified unspecified unspecified  	O	null
28 הצגת הצגה הצגת noun feminine singular construct unspecified unspecified  	O	null
29 רחוב רחוב רחוב noun masculine singular absolute unspecified unspecified  	O	null
30 ניסיונית ניסיוני ניסיונית adjective feminine singular absolute unspecified unspecified  	O	null
31 ש ש שהועלתה relativizer/subordinatingConjunction unspecified unspecified unspecified unspecified unspecified 0 
31 הועלתה הועלה שהועלתה verb feminine singular unspecified 3 past  	O	null
32 על על על preposition unspecified unspecified unspecified unspecified unspecified  	O	null
33 ידי יד ידי noun feminine plural construct unspecified unspecified  	O	null
34 ה ה הקבוצה definiteArticle unspecified unspecified unspecified unspecified unspecified 0 
34 הקבוצה קבוצה הקבוצה noun feminine singular absolute unspecified unspecified  	O	null
35 ה ה העצמאית definiteArticle unspecified unspecified unspecified unspecified unspecified 0 
35 העצמאית עצמאי העצמאית adjective feminine singular absolute unspecified unspecified  	O	null
36 " " " punctuation unspecified unspecified unspecified unspecified unspecified  	O	null
37 מ מ מדוגה preposition unspecified unspecified unspecified unspecified unspecified 0 
37 דוגה דוגה מדוגה properName unspecified unspecified unspecified unspecified unspecified  	I_ORG	null
38 " " " punctuation unspecified unspecified unspecified unspecified unspecified  	O	null
39 , , , punctuation unspecified unspecified unspecified unspecified unspecified  	O	null
40 ש ש שהקים relativizer/subordinatingConjunction unspecified unspecified unspecified unspecified unspecified 0 
40 הקים הקים שהקים verb masculine singular unspecified 3 past  	I_LOC	null
41 ב ב בחסות preposition unspecified unspecified unspecified unspecified unspecified 0 
41 חסות חסות בחסות noun feminine singular construct unspecified unspecified  	I_LOC	null
42 תיאטרון תיאטרון תיאטרון properName unspecified unspecified unspecified unspecified unspecified  	I_ORG	null
43 ירושלים ירושלים ירושלים properName unspecified unspecified unspecified unspecified unspecified  	I_LOC	null
44 . . . punctuation unspecified unspecified unspecified unspecified unspecified  	O	null

0 עם עם עם preposition unspecified unspecified unspecified unspecified unspecified  	O	null
1 את את אותה at-preposition unspecified unspecified unspecified unspecified unspecified  
1 ה ה אותה pronomial feminine singular unspecified 3 unspecified 0 	O	null
2 קבוצה קבוצה קבוצה noun feminine singular absolute unspecified unspecified  	O	null
3 הפיק הפיק הפיק verb masculine singular unspecified 3 past  	O	null
4 ו ו וביים conjunction unspecified unspecified unspecified unspecified unspecified 0 
4 ביים ביים וביים verb masculine singular unspecified 3 past  	O	null
5 עד עד עד preposition unspecified unspecified unspecified unspecified unspecified  	O	null
6 ###NUMBER### ###NUMBER### ###NUMBER### numeral unspecified unspecified unspecified unspecified unspecified  	I_DATE	null
7 עוד עוד עוד noun masculine singular construct unspecified unspecified  	O	null
8 שתי CARD2 שתי numeral feminine dual construct unspecified unspecified  	O	null
9 הצגות הצגה הצגות noun feminine plural absolute unspecified unspecified  	O	null
10 רחוב רחוב רחוב noun masculine singular absolute unspecified unspecified  	I_LOC	null
11 , , , punctuation unspecified unspecified unspecified unspecified unspecified  	I_LOC	null
12 ש ש שבעיקרן relativizer/subordinatingConjunction unspecified unspecified unspecified unspecified unspecified 0 
12 ב ב שבעיקרן preposition unspecified unspecified unspecified unspecified unspecified 0 
12 עיקר עיקר שבעיקרן noun masculine singular absolute unspecified unspecified  
12 ן ן שבעיקרן possessive feminine plural unspecified 3 unspecified 0 	I_LOC	null
13 היו הוא היו copula masculine plural unspecified 2 imperative  	O	null
14 אנטי אנטי אנטי wPrefix unspecified unspecified unspecified unspecified unspecified  	I_ORG	null
15 - - - punctuation unspecified unspecified unspecified unspecified unspecified  	I_ORG	null
16 מלחמתיות מלחמתי מלחמתיות adjective feminine plural absolute unspecified unspecified  	I_ORG	null
17 . . . punctuation unspecified unspecified unspecified unspecified unspecified  	O	null

0 ב ב בהמשך preposition unspecified unspecified unspecified unspecified unspecified 0 
0 המשך המשך בהמשך noun masculine singular absolute unspecified unspecified  	O	null
1 ( ( ( punctuation unspecified unspecified unspecified unspecified unspecified  	O	null
2 ###NUMBER### ###NUMBER### ###NUMBER### numeral unspecified unspecified unspecified unspecified unspecified  	I_DATE	null
3 - - - punctuation unspecified unspecified unspecified unspecified unspecified  	O	null
4 ###NUMBER### ###NUMBER### ###NUMBER### numeral unspecified unspecified unspecified unspecified unspecified  	I_DATE	null
5 ) ) ) punctuation unspecified unspecified unspecified unspecified unspecified  	O	null
6 היה הוא היה copula masculine singular unspecified 3 past  	O	null
7 במאי במאי במאי noun masculine singular absolute unspecified unspecified  	O	null
8 ודרמטורג ודרמטורג ודרמטורג properName unspecified unspecified unspecified unspecified unspecified  	O	null
9 ב ב בתיאטרון preposition unspecified unspecified unspecified unspecified unspecified 0 
9 ה ה בתיאטרון definiteArticle unspecified unspecified unspecified unspecified unspecified 0 
9 התיאטרון תיאטרון בתיאטרון noun masculine singular absolute unspecified unspecified  	O	null
10 " " " punctuation unspecified unspecified unspecified unspecified unspecified  	O	null
11 ה ה החאן definiteArticle unspecified unspecified unspecified unspecified unspecified 0 
11 החאן ח'אן החאן noun masculine singular absolute unspecified unspecified  	O	null
12 " " " punctuation unspecified unspecified unspecified unspecified unspecified  	O	null
13 ה ה הירושלמי definiteArticle unspecified unspecified unspecified unspecified unspecified 0 
13 הירושלמי ירושלמי הירושלמי adjective masculine singular absolute unspecified unspecified  	O	null
14 , , , punctuation unspecified unspecified unspecified unspecified unspecified  	O	null
15 שם שם שם adverb unspecified unspecified unspecified unspecified unspecified  	O	null
16 ביים ביים ביים verb masculine singular unspecified 3 past  	O	null
17 את את את at-preposition unspecified unspecified unspecified unspecified unspecified  	O	null
18 צהריים צהריים צהריים noun masculine plural absolute unspecified unspecified  	O	null
19 קסומים קסום קסומים adjective masculine plural absolute unspecified unspecified  	O	null
20 ו ו ולפוצץ conjunction unspecified unspecified unspecified unspecified unspecified 0 
20 לפוצץ פוצץ ולפוצץ verb unspecified unspecified unspecified unspecified infinitive  	O	null
21 את את אותם at-preposition unspecified unspecified unspecified unspecified unspecified  
21 הם הם אותם pronomial masculine plural unspecified 3 unspecified 0 	O	null
22 , , , punctuation unspecified unspecified unspecified unspecified unspecified  	O	null
23 ו ו ואף conjunction unspecified unspecified unspecified unspecified unspecified 0 
23 אף אף ואף conjunction unspecified unspecified unspecified unspecified unspecified  	O	null
24 כתב כתב כתב verb masculine singular unspecified 3 past  	O	null
25 ו ו וביים conjunction unspecified unspecified unspecified unspecified unspecified 0 
25 ביים ביים וביים verb masculine singular unspecified 3 past  	O	null
26 ל ל לנוער preposition unspecified unspecified unspecified unspecified unspecified 0 
26 ה ה לנוער definiteArticle unspecified unspecified unspecified unspecified unspecified 0 
26 הנוער נוער לנוער noun masculine singular absolute unspecified unspecified  	O	null
27 את את את at-preposition unspecified unspecified unspecified unspecified unspecified  	O	null
28 אגדת אגדה אגדת noun feminine singular construct unspecified unspecified  	O	null
29 שלושה CARD3 שלושה numeral masculine plural absolute unspecified unspecified  	O	null
30 ו ו וארבעה conjunction unspecified unspecified unspecified unspecified unspecified 0 
30 ארבעה CARD4 וארבעה numeral masculine plural absolute unspecified unspecified  	O	null
31 ( ( ( punctuation unspecified unspecified unspecified unspecified unspecified  	O	null
32 על על על preposition unspecified unspecified unspecified unspecified unspecified  	O	null
33 פי פה פי noun masculine singular construct unspecified unspecified  	O	null
34 ח"נ ח"נ ח"נ properName unspecified unspecified unspecified unspecified unspecified  	I_PERS	null
35 ביאליק ביאליק ביאליק properName unspecified unspecified unspecified unspecified unspecified  	I_PERS	null
36 ) ) ) punctuation unspecified unspecified unspecified unspecified unspecified  	O	null
37 . . . punctuation unspecified unspecified unspecified unspecified unspecified  	O	null

0 עם עם עם preposition unspecified unspecified unspecified unspecified unspecified  	O	null
1 הצגת הצגה הצגת noun feminine singular construct unspecified unspecified  	O	null
2 מחזה מחזה מחזהו noun masculine singular absolute unspecified unspecified  
2 ו ו מחזהו possessive masculine singular unspecified 3 unspecified 0 	O	null
3 ה ה הראשון definiteArticle unspecified unspecified unspecified unspecified unspecified 0 
3 הראשון ORD1 הראשון numeral masculine singular absolute unspecified unspecified  	O	null
4 , , , punctuation unspecified unspecified unspecified unspecified unspecified  	O	null
5 קסטנר קסטנר קסטנר properName unspecified unspecified unspecified unspecified unspecified  	I_PERS	null
6 , , , punctuation unspecified unspecified unspecified unspecified unspecified  	O	null
7 ב ב בתיאטרון preposition unspecified unspecified unspecified unspecified unspecified 0 
7 ה ה בתיאטרון definiteArticle unspecified unspecified unspecified unspecified unspecified 0 
7 התיאטרון תיאטרון בתיאטרון noun masculine singular absolute unspecified unspecified  	O	null
8 " " " punctuation unspecified unspecified unspecified unspecified unspecified  	O	null
9 ה ה הקאמרי definiteArticle unspecified unspecified unspecified unspecified unspecified 0 
9 הקאמרי קאמרי הקאמרי adjective masculine singular absolute unspecified unspecified  	O	null
10 " " " punctuation unspecified unspecified unspecified unspecified unspecified  	O	null
11 ב ב ב preposition unspecified unspecified unspecified unspecified unspecified 0 	O	null
12 - - - punctuation unspecified unspecified unspecified unspecified unspecified  	O	null
13 ###NUMBER### ###NUMBER### ###NUMBER### numeral unspecified unspecified unspecified unspecified unspecified  	I_DATE	null
14 הגיע הגיע הגיע verb masculine singular unspecified 3 past  	O	null
15 ל ל למודעות preposition unspecified unspecified unspecified unspecified unspecified 0 
15 מודעות מודעות למודעות noun feminine singular absolute unspecified unspecified  	O	null
16 ציבורית ציבורי ציבורית adjective feminine singular absolute unspecified unspecified  	O	null
17 . . . punctuation unspecified unspecified unspecified unspecified unspecified  	O	null

0 ה ה המחזה definiteArticle unspecified unspecified unspecified unspecified unspecified 0 
0 המחזה מחזה המחזה noun masculine singular absolute unspecified unspecified  	O	null
1 , , , punctuation unspecified unspecified unspecified unspecified unspecified  	O	null
2 ב ב בבימויו preposition unspecified unspecified unspecified unspecified unspecified 0 
2 בימוי בימוי בבימויו noun masculine singular absolute unspecified unspecified  
2 ו ו בבימויו possessive masculine singular unspecified 3 unspecified 0 	O	null
3 של של של shel-preposition unspecified unspecified unspecified unspecified unspecified  	O	null
4 אילן אילן אילן properName unspecified unspecified unspecified unspecified unspecified  	I_PERS	null
5 רונן רונן רונן properName unspecified unspecified unspecified unspecified unspecified  	I_PERS	null
6 , , , punctuation unspecified unspecified unspecified unspecified unspecified  	O	null
7 ניסה ניסה ניסה verb masculine singular unspecified 3 past  	O	null
8 לערער ערער לערער verb unspecified unspecified unspecified unspecified infinitive  	O	null
9 על על על preposition unspecified unspecified unspecified unspecified unspecified  	O	null
10 ה ה הדימוי definiteArticle unspecified unspecified unspecified unspecified unspecified 0 
10 הדימוי דימוי הדימוי noun masculine singular absolute unspecified unspecified  	O	null
11 ה ה הציבורי definiteArticle unspecified unspecified unspecified unspecified unspecified 0 
11 הציבורי ציבורי הציבורי adjective masculine singular absolute unspecified unspecified  	O	null
12 של של של shel-preposition unspecified unspecified unspecified unspecified unspecified  	O	null
13 רודולף רודולף רודולף properName unspecified unspecified unspecified unspecified unspecified  	I_PERS	null
14 קסטנר קסטנר קסטנר properName unspecified unspecified unspecified unspecified unspecified  	I_PERS	null
15 , , , punctuation unspecified unspecified unspecified unspecified unspecified  	O	null
16 עסקן עסקן עסקן noun masculine singular absolute unspecified unspecified  	O	null
17 ציוני ציוני ציוני adjective masculine singular absolute unspecified unspecified  	O	null
18 ב ב בהונגריה preposition unspecified unspecified unspecified unspecified unspecified 0 
18 הונגריה הונגריה בהונגריה properName unspecified unspecified unspecified unspecified unspecified  	I_LOC	null
19 ה ה הכבושה definiteArticle unspecified unspecified unspecified unspecified unspecified 0 
19 הכבושה כבוש הכבושה adjective feminine singular absolute unspecified unspecified  	O	null
20 , , , punctuation unspecified unspecified unspecified unspecified unspecified  	O	null
21 ש ש שניהל relativizer/subordinatingConjunction unspecified unspecified unspecified unspecified unspecified 0 
21 ניהל ניהל שניהל verb masculine singular unspecified 3 past  	O	null
22 מגעים מגע מגעים noun masculine plural absolute unspecified unspecified  	O	null
23 עם עם עם preposition unspecified unspecified unspecified unspecified unspecified  	O	null
24 ה ה הנאצים definiteArticle unspecified unspecified unspecified unspecified unspecified 0 
24 הנאצים נאצי הנאצים noun masculine plural absolute unspecified unspecified  	O	null
25 כדי כדי כדי conjunction unspecified unspecified unspecified unspecified unspecified  	O	null
26 להציל הציל להציל verb unspecified unspecified unspecified unspecified infinitive  	O	null
27 יהודים יהודי יהודים noun masculine plural absolute unspecified unspecified  	O	null
28 ו ו והואשם conjunction unspecified unspecified unspecified unspecified unspecified 0 
28 הואשם הואשם והואשם verb masculine singular unspecified 3 past  	O	null
29 כ כ כמשתף preposition unspecified unspecified unspecified unspecified unspecified 0 
29 משתף שיתף כמשתף participle masculine singular construct any unspecified  	O	null
30 פעולה פעולה פעולה noun feminine singular absolute unspecified unspecified  	O	null
31 . . . punctuation unspecified unspecified unspecified unspecified unspecified  	O	null

0 ב ב במחזהו preposition unspecified unspecified unspecified unspecified unspecified 0 
0 מחזה מחזה במחזהו noun masculine singular absolute unspecified unspecified  
0 ו ו במחזהו possessive masculine singular unspecified 3 unspecified 0 	O	null
1 של של של shel-preposition unspecified unspecified unspecified unspecified unspecified  	O	null
2 לרנר לרנר לרנר properName unspecified unspecified unspecified unspecified unspecified  	I_PERS	null
3 , , , punctuation unspecified unspecified unspecified unspecified unspecified  	O	null
4 קסטנר קסטנר קסטנר properName unspecified unspecified unspecified unspecified unspecified  	I_PERS	null
5 הוצג הוצג הוצג verb masculine singular unspecified 3 past  	O	null
6 כ כ כגיבור preposition unspecified unspecified unspecified unspecified unspecified 0 
6 גיבור גיבור כגיבור noun masculine singular absolute unspecified unspecified  	O	null
7 היסטורי היסטורי היסטורי adjective masculine singular absolute unspecified unspecified  	O	null
8 , , , punctuation unspecified unspecified unspecified unspecified unspecified  	O	null
9 ו ו וליתר conjunction unspecified unspecified unspecified unspecified unspecified 0 
9 ל ל וליתר preposition unspecified unspecified unspecified unspecified unspecified 0 
9 יתר יתר וליתר noun masculine singular construct unspecified unspecified  	O	null
10 דיוק דיוק דיוק noun masculine singular absolute unspecified unspecified  	O	null
11 – – – punctuation unspecified unspecified unspecified unspecified unspecified  	O	null
12 כ כ כגיבור preposition unspecified unspecified unspecified unspecified unspecified 0 
12 גיבור גיבור כגיבור noun masculine singular absolute unspecified unspecified  	O	null
13 טרגי טרגי טרגי adjective masculine singular absolute unspecified unspecified  	O	null
14 . . . punctuation unspecified unspecified unspecified unspecified unspecified  	O	null

0 פגיעה פגיעה פגיעה noun feminine singular absolute unspecified unspecified  	O	null
1 זו זו זו pronoun feminine singular unspecified 3 unspecified  	O	null
2 ב ב במוסכמות preposition unspecified unspecified unspecified unspecified unspecified 0 
2 ה ה במוסכמות definiteArticle unspecified unspecified unspecified unspecified unspecified 0 
2 המוסכמות מוסכמה במוסכמות noun feminine plural absolute unspecified unspecified  	O	null
3 נתקלה נתקל נתקלה verb feminine singular unspecified 3 past  	O	null
4 ב ב בתגובות preposition unspecified unspecified unspecified unspecified unspecified 0 
4 תגובות תגובה בתגובות noun feminine plural absolute unspecified unspecified  	O	null
5 של של של shel-preposition unspecified unspecified unspecified unspecified unspecified  	O	null
6 אי אי אי noun masculine singular construct unspecified unspecified  	O	null
7 - - - punctuation unspecified unspecified unspecified unspecified unspecified  	O	null
8 הסכמה הסכמה הסכמה noun feminine singular absolute unspecified unspecified  	O	null
9 , , , punctuation unspecified unspecified unspecified unspecified unspecified  	O	null
10 אולם אולם אולם conjunction unspecified unspecified unspecified unspecified unspecified  	O	null
11 ה ה ההצגה definiteArticle unspecified unspecified unspecified unspecified unspecified 0 
11 ההצגה הצגה ההצגה noun feminine singular absolute unspecified unspecified  	O	null
12 עצמה עצם עצמה verb feminine singular unspecified 3 past  	O	null
13 הועלתה הועלה הועלתה verb feminine singular unspecified 3 past  	O	null
14 פעמים פעם פעמים noun feminine plural absolute unspecified unspecified  	O	null
15 רבות רב רבות adjective feminine plural absolute unspecified unspecified  	O	null
16 ו ו והיתה conjunction unspecified unspecified unspecified unspecified unspecified 0 
16 היתה הוא והיתה copula feminine singular unspecified 3 past  	O	null
17 אחת CARD1 אחת numeral feminine singular absolute unspecified unspecified  	O	null
18 ה ה הבולטות definiteArticle unspecified unspecified unspecified unspecified unspecified 0 
18 הבולטות בולט הבולטות adjective feminine plural absolute unspecified unspecified  	O	null
19 ב ב באותו preposition unspecified unspecified unspecified unspecified unspecified 0 
19 אותו אותו באותו quantifier unspecified unspecified construct unspecified unspecified  	O	null
20 עשור עשור עשור noun masculine singular absolute unspecified unspecified  	O	null
21 . . . punctuation unspecified unspecified unspecified unspecified unspecified  	O	null

0 לרנר לרנר לרנר properName unspecified unspecified unspecified unspecified unspecified  	I_PERS	null
1 הרחיב הרחיב הרחיב verb masculine singular unspecified 3 past  	O	null
2 את את את at-preposition unspecified unspecified unspecified unspecified unspecified  	O	null
3 ה ה היריעה definiteArticle unspecified unspecified unspecified unspecified unspecified 0 
3 היריעה יריעה היריעה noun feminine singular absolute unspecified unspecified  	O	null
4 כעבור כעבור כעבור preposition unspecified unspecified unspecified unspecified unspecified  	O	null
5 עשור עשור עשור noun masculine singular absolute unspecified unspecified  	O	null
6 ב ב בדרמת preposition unspecified unspecified unspecified unspecified unspecified 0 
6 דרמת דרמה בדרמת noun feminine singular construct unspecified unspecified  	O	null
7 ה ה הטלוויזיה definiteArticle unspecified unspecified unspecified unspecified unspecified 0 
7 הטלוויזיה טלוויזיה הטלוויזיה noun feminine singular absolute unspecified unspecified  	O	null
8 " " " punctuation unspecified unspecified unspecified unspecified unspecified  	O	null
9 משפט משפט משפט noun masculine singular absolute unspecified unspecified  	O	null
10 קסטנר קסטנר קסטנר properName unspecified unspecified unspecified unspecified unspecified  	I_PERS	null
11 " " " punctuation unspecified unspecified unspecified unspecified unspecified  	O	null
12 , , , punctuation unspecified unspecified unspecified unspecified unspecified  	O	null
13 שבה שבה שבה verb masculine singular unspecified 3 past  	O	null
14 עסק עסק עסק noun masculine singular absolute unspecified unspecified  	O	null
15 ב ב ביחסה preposition unspecified unspecified unspecified unspecified unspecified 0 
15 יחס יחס ביחסה noun masculine singular absolute unspecified unspecified  
15 ה ה ביחסה possessive feminine singular unspecified 3 unspecified 0 	O	null
16 של של של shel-preposition unspecified unspecified unspecified unspecified unspecified  	O	null
17 ה ה החברה definiteArticle unspecified unspecified unspecified unspecified unspecified 0 
17 החברה חבר החברה noun feminine singular absolute unspecified unspecified  	O	null
18 ה ה הישראלית definiteArticle unspecified unspecified unspecified unspecified unspecified 0 
18 הישראלית ישראלי הישראלית adjective feminine singular absolute unspecified unspecified  	O	null
19 ל ל לשואה preposition unspecified unspecified unspecified unspecified unspecified 0 
19 ה ה לשואה definiteArticle unspecified unspecified unspecified unspecified unspecified 0 
19 השואה שואה לשואה noun feminine singular absolute unspecified unspecified  	O	null
20 ו ו ולניצוליה conjunction unspecified unspecified unspecified unspecified unspecified 0 
20 ל ל ולניצוליה preposition unspecified unspecified unspecified unspecified unspecified 0 
20 ניצולי ניצול ולניצוליה noun masculine plural absolute unspecified unspecified  
20 ה ה ולניצוליה possessive feminine singular unspecified 3 unspecified 0 	O	null
21 . . . punctuation unspecified unspecified unspecified unspecified unspecified  	O	null

0 בין בין בין preposition unspecified unspecified unspecified unspecified unspecified  	O	null
1 ה ה השאר definiteArticle unspecified unspecified unspecified unspecified unspecified 0 
1 השאר שאר השאר noun masculine singular absolute unspecified unspecified  	O	null
2 הוצגה הוצג הוצגה verb feminine singular unspecified 3 past  	O	null
3 ב ב בסדרה preposition unspecified unspecified unspecified unspecified unspecified 0 
3 ה ה בסדרה definiteArticle unspecified unspecified unspecified unspecified unspecified 0 
3 הסדרה סדרה בסדרה noun feminine singular absolute unspecified unspecified  	O	null
4 חנה חנה חנה properName unspecified unspecified unspecified unspecified unspecified  	I_PERS	null
5 סנש סנש סנש properName unspecified unspecified unspecified unspecified unspecified  	I_PERS	null
6 , , , punctuation unspecified unspecified unspecified unspecified unspecified  	O	null
7 ה ה הגיבורה definiteArticle unspecified unspecified unspecified unspecified unspecified 0 
7 הגיבורה גיבור הגיבורה noun feminine singular absolute unspecified unspecified  	O	null
8 ה ה הלאומית definiteArticle unspecified unspecified unspecified unspecified unspecified 0 
8 הלאומית לאומי הלאומית adjective feminine singular absolute unspecified unspecified  	O	null
9 , , , punctuation unspecified unspecified unspecified unspecified unspecified  	O	null
10 כ כ כמי preposition unspecified unspecified unspecified unspecified unspecified 0 
10 מי מי כמי interrogative unspecified unspecified unspecified unspecified unspecified  	O	null
11 ש ש שנכנעה relativizer/subordinatingConjunction unspecified unspecified unspecified unspecified unspecified 0 
11 נכנעה נכנע שנכנעה verb feminine singular unspecified 3 past  	O	null
12 ל ל לעינויי preposition unspecified unspecified unspecified unspecified unspecified 0 
12 עינויי עינוי לעינויי noun masculine plural construct unspecified unspecified  	O	null
13 ה ה הנאצים definiteArticle unspecified unspecified unspecified unspecified unspecified 0 
13 הנאצים נאצי הנאצים noun masculine plural absolute unspecified unspecified  	O	null
14 ו ו והסגירה conjunction unspecified unspecified unspecified unspecified unspecified 0 
14 הסגירה הסגיר והסגירה verb feminine singular unspecified 3 past  	O	null
15 את את את at-preposition unspecified unspecified unspecified unspecified unspecified  	O	null
16 שני שני שני noun masculine singular construct unspecified unspecified  	O	null
17 ה ה הצנחנים definiteArticle unspecified unspecified unspecified unspecified unspecified 0 
17 הצנחנים צנחן הצנחנים noun masculine plural absolute unspecified unspecified  	O	null
18 ש ש שאיתם relativizer/subordinatingConjunction unspecified unspecified unspecified unspecified unspecified 0 
18 את את שאיתם at-preposition unspecified unspecified unspecified unspecified unspecified  
18 הם הם שאיתם pronomial masculine plural unspecified 3 unspecified 0 	O	null
19 יצאה יצא יצאה verb feminine singular unspecified 3 past  	O	null
20 ל ל לשליחותה preposition unspecified unspecified unspecified unspecified unspecified 0 
20 שליחות שליחות לשליחותה noun feminine singular absolute unspecified unspecified  
20 ה ה לשליחותה possessive feminine singular unspecified 3 unspecified 0 	O	null
21 . . . punctuation unspecified unspecified unspecified unspecified unspecified  	O	null

0 ה ה הז'אנר definiteArticle unspecified unspecified unspecified unspecified unspecified 0 
0 הז'אנר ז'אנר הז'אנר noun masculine singular absolute unspecified unspecified  	O	null
1 שבו ישב שבו verb masculine-and-feminine plural unspecified 2 imperative  	O	null
2 נוצרו נוצר נוצרו verb masculine-and-feminine plural unspecified 3 past  	O	null
3 יצירות יצירה יצירות noun feminine plural absolute unspecified unspecified  	O	null
4 אלה אלה אלה pronoun masculine-and-feminine plural unspecified 3 unspecified  	O	null
5 היה הוא היה copula masculine singular unspecified 3 past  	O	null
6 תערובת תערובת תערובת noun feminine singular absolute unspecified unspecified  	O	null
7 של של של shel-preposition unspecified unspecified unspecified unspecified unspecified  	O	null
8 ב ב בדיון preposition unspecified unspecified unspecified unspecified unspecified 0 
8 דיון דיון בדיון noun masculine singular absolute unspecified unspecified  	O	null
9 ו ו ועובדה conjunction unspecified unspecified unspecified unspecified unspecified 0 
9 עובדה עובדה ועובדה noun feminine singular absolute unspecified unspecified  	O	null
10 היסטורית היסטורי היסטורית adjective feminine singular absolute unspecified unspecified  	O	null
11 , , , punctuation unspecified unspecified unspecified unspecified unspecified  	O	null
12 ו ו והגבול conjunction unspecified unspecified unspecified unspecified unspecified 0 
12 ה ה והגבול definiteArticle unspecified unspecified unspecified unspecified unspecified 0 
12 הגבול גבול והגבול noun masculine singular absolute unspecified unspecified  	O	null
13 בין בין בין preposition unspecified unspecified unspecified unspecified unspecified  	O	null
14 יצירת יצירה יצירת noun feminine singular construct unspecified unspecified  	O	null
15 ה ה הדמיון definiteArticle unspecified unspecified unspecified unspecified unspecified 0 
15 הדמיון דמיון הדמיון noun masculine singular absolute unspecified unspecified  	O	null
16 של של של shel-preposition unspecified unspecified unspecified unspecified unspecified  	O	null
17 ה ה המחבר definiteArticle unspecified unspecified unspecified unspecified unspecified 0 
17 המחבר מחבר המחבר noun masculine singular absolute unspecified unspecified  	O	null
18 ל ל לנתונים preposition unspecified unspecified unspecified unspecified unspecified 0 
18 ה ה לנתונים definiteArticle unspecified unspecified unspecified unspecified unspecified 0 
18 הנתונים נתון לנתונים noun masculine plural absolute unspecified unspecified  	O	null
19 ה ה העובדתיים definiteArticle unspecified unspecified unspecified unspecified unspecified 0 
19 העובדתיים עובדתי העובדתיים adjective masculine plural absolute unspecified unspecified  	O	null
20 לא לא לא negation unspecified unspecified unspecified unspecified unspecified  	O	null
21 היה הוא היה copula masculine singular unspecified 3 past  	O	null
22 ברור ברור ברור adjective masculine singular absolute unspecified unspecified  	O	null
23 תמיד תמיד תמיד adverb unspecified unspecified unspecified unspecified unspecified  	O	null
24 . . . punctuation unspecified unspecified unspecified unspecified unspecified  	O	null

0 מסיבה מסיבה מסיבה noun feminine singular absolute unspecified unspecified  	O	null
1 זו זו זו pronoun feminine singular unspecified 3 unspecified  	O	null
2 הוגשה הוגש הוגשה verb feminine singular unspecified 3 past  	O	null
3 על על על preposition unspecified unspecified unspecified unspecified unspecified  	O	null
4 ידי יד ידי noun feminine plural construct unspecified unspecified  	O	null
5 אחי אח אחיה noun masculine plural absolute unspecified unspecified  
5 ה ה אחיה possessive feminine singular unspecified 3 unspecified 0 	I_LOC	null
6 של של של shel-preposition unspecified unspecified unspecified unspecified unspecified  	O	null
7 חנה חנה חנה properName unspecified unspecified unspecified unspecified unspecified  	I_PERS	null
8 סנש סנש סנש properName unspecified unspecified unspecified unspecified unspecified  	I_PERS	null
9 ו ו ובניו conjunction unspecified unspecified unspecified unspecified unspecified 0 
9 בני בן ובניו noun masculine plural absolute unspecified unspecified  
9 ו ו ובניו possessive masculine singular unspecified 3 unspecified 0 	O	null
10 ו ו ועמותת conjunction unspecified unspecified unspecified unspecified unspecified 0 
10 עמותת עמותה ועמותת noun feminine singular construct unspecified unspecified  	O	null
11 " " " punctuation unspecified unspecified unspecified unspecified unspecified  	O	null
12 ה ה הנשים definiteArticle unspecified unspecified unspecified unspecified unspecified 0 
12 הנשים איש הנשים noun feminine plural absolute unspecified unspecified  	O	null
13 למען למען למען preposition unspecified unspecified unspecified unspecified unspecified  	O	null
14 עתיד עתיד עתיד noun masculine singular construct unspecified unspecified  	O	null
15 ישראל ישראל ישראל properName unspecified unspecified unspecified unspecified unspecified  	I_LOC	null
16 " " " punctuation unspecified unspecified unspecified unspecified unspecified  	O	null
17 של של של shel-preposition unspecified unspecified unspecified unspecified unspecified  	O	null
18 נדי נד נדיה participle masculine plural unspecified any unspecified  
18 ה ה נדיה possessive feminine singular unspecified 3 unspecified 0 	O	null
19 מטר מטר מטר noun masculine singular absolute unspecified unspecified  	I_ORG	null
20 ל ל לבית preposition unspecified unspecified unspecified unspecified unspecified 0 
20 בית בית לבית noun masculine singular construct unspecified unspecified  	I_ORG	null
21 ה ה המשפט definiteArticle unspecified unspecified unspecified unspecified unspecified 0 
21 המשפט משפט המשפט noun masculine singular absolute unspecified unspecified  	I_ORG	null
22 ה ה העליון definiteArticle unspecified unspecified unspecified unspecified unspecified 0 
22 העליון עליון העליון adjective masculine singular absolute unspecified unspecified  	I_ORG	null
23 בקשה בקשה בקשה noun feminine singular absolute unspecified unspecified  	O	null
24 ש ש שלא relativizer/subordinatingConjunction unspecified unspecified unspecified unspecified unspecified 0 
24 לא לא שלא negation unspecified unspecified unspecified unspecified unspecified  	O	null
25 לשדר שידר לשדר verb unspecified unspecified unspecified unspecified infinitive  	O	null
26 ב ב בטלוויזיה preposition unspecified unspecified unspecified unspecified unspecified 0 
26 ה ה בטלוויזיה definiteArticle unspecified unspecified unspecified unspecified unspecified 0 
26 הטלוויזיה טלוויזיה בטלוויזיה noun feminine singular absolute unspecified unspecified  	O	null
27 את את את at-preposition unspecified unspecified unspecified unspecified unspecified  	O	null
28 ה ה הפרק definiteArticle unspecified unspecified unspecified unspecified unspecified 0 
28 הפרק פארק הפרק noun masculine singular absolute unspecified unspecified  	O	null
29 שבו ישב שבו verb masculine-and-feminine plural unspecified 2 imperative  	O	null
30 מטיח הטיח מטיח verb masculine singular unspecified any beinoni  	O	null
31 קסטנר קסטנר קסטנר verb unspecified unspecified unspecified unspecified infinitive  	O	null
32 דברים דבר דברים noun masculine plural absolute unspecified unspecified  	O	null
33 ב ב ברוח preposition unspecified unspecified unspecified unspecified unspecified 0 
33 רוח רוח ברוח noun feminine singular absolute unspecified unspecified  	O	null
34 זו זו זו pronoun feminine singular unspecified 3 unspecified  	O	null
35 ב ב באמה preposition unspecified unspecified unspecified unspecified unspecified 0 
35 אם אם באמה noun feminine singular absolute unspecified unspecified  
35 ה ה באמה possessive feminine singular unspecified 3 unspecified 0 	O	null
36 של של של shel-preposition unspecified unspecified unspecified unspecified unspecified  	O	null
37 חנה חנה חנה properName unspecified unspecified unspecified unspecified unspecified  	I_PERS	null
38 סנש סנש סנש properName unspecified unspecified unspecified unspecified unspecified  	I_PERS	null
39 . . . punctuation unspecified unspecified unspecified unspecified unspecified  	O	null

0 ה ה השופטים definiteArticle unspecified unspecified unspecified unspecified unspecified 0 
0 השופטים שופט השופטים noun masculine plural absolute unspecified unspecified  	O	null
1 דחו דחה דחו verb masculine-and-feminine plural unspecified 3 past  	O	null
2 את את את at-preposition unspecified unspecified unspecified unspecified unspecified  	O	null
3 ה ה הפנייה definiteArticle unspecified unspecified unspecified unspecified unspecified 0 
3 הפנייה פנייה הפנייה noun feminine singular absolute unspecified unspecified  	O	null
4 ב ב בנימוק preposition unspecified unspecified unspecified unspecified unspecified 0 
4 ה ה בנימוק definiteArticle unspecified unspecified unspecified unspecified unspecified 0 
4 הנימוק נימוק בנימוק noun masculine singular absolute unspecified unspecified  	O	null
5 ש ש שהתוספות relativizer/subordinatingConjunction unspecified unspecified unspecified unspecified unspecified 0 
5 ה ה שהתוספות definiteArticle unspecified unspecified unspecified unspecified unspecified 0 
5 התוספות תוספת שהתוספות noun feminine plural absolute unspecified unspecified  	O	null
6 ה ה הדמיוניות definiteArticle unspecified unspecified unspecified unspecified unspecified 0 
6 הדמיוניות דמיוני הדמיוניות adjective feminine plural absolute unspecified unspecified  	O	null
7 הן הן הן conjunction unspecified unspecified unspecified unspecified unspecified  	O	null
8 ב ב בגדר preposition unspecified unspecified unspecified unspecified unspecified 0 
8 גדר גדר בגדר noun feminine singular construct unspecified unspecified  	O	null
9 חופש חופש חופש noun masculine singular construct unspecified unspecified  	O	null
10 ה ה הביטוי definiteArticle unspecified unspecified unspecified unspecified unspecified 0 
10 הביטוי ביטוי הביטוי noun masculine singular absolute unspecified unspecified  	O	null
11 ו ו ושום conjunction unspecified unspecified unspecified unspecified unspecified 0 
11 שום שום ושום quantifier unspecified unspecified construct unspecified unspecified  	O	null
12 ב ב בדיון preposition unspecified unspecified unspecified unspecified unspecified 0 
12 דיון דיון בדיון noun masculine singular absolute unspecified unspecified  	O	null
13 אמנותי אמנותי אמנותי adjective masculine singular absolute unspecified unspecified  	O	null
14 אינו הוא אינו copula masculine singular unspecified 3 beinoni  	O	null
15 יכול יכול יכול modal masculine singular unspecified any beinoni  	O	null
16 לפגוע פגע לפגוע verb unspecified unspecified unspecified unspecified infinitive  	O	null
17 ב ב בדמותה preposition unspecified unspecified unspecified unspecified unspecified 0 
17 דמות דמות בדמותה noun feminine singular absolute unspecified unspecified  
17 ה ה בדמותה possessive feminine singular unspecified 3 unspecified 0 	O	null
18 ה ה ההיסטורית definiteArticle unspecified unspecified unspecified unspecified unspecified 0 
18 ההיסטורית היסטורי ההיסטורית adjective feminine singular absolute unspecified unspecified  	O	null
19 של של של shel-preposition unspecified unspecified unspecified unspecified unspecified  	O	null
20 חנה חנה חנה properName unspecified unspecified unspecified unspecified unspecified  	I_PERS	null
21 סנש סנש סנש properName unspecified unspecified unspecified unspecified unspecified  	I_PERS	null
22 . . . punctuation unspecified unspecified unspecified unspecified unspecified  	O	null

0 לרנר לרנר לרנר properName unspecified unspecified unspecified unspecified unspecified  	I_PERS	null
1 , , , punctuation unspecified unspecified unspecified unspecified unspecified  	O	null
2 מצד מצד מצדו noun masculine singular absolute unspecified unspecified  
2 ו ו מצדו possessive masculine singular unspecified 3 unspecified 0 	O	null
3 , , , punctuation unspecified unspecified unspecified unspecified unspecified  	O	null
4 הסתייג הסתייג הסתייג verb masculine singular unspecified 3 past  	O	null
5 מ מ מנימוקי preposition unspecified unspecified unspecified unspecified unspecified 0 
5 נימוקי נימוק מנימוקי noun masculine plural construct unspecified unspecified  	O	null
6 ה ה השופטים definiteArticle unspecified unspecified unspecified unspecified unspecified 0 
6 השופטים שופט השופטים noun masculine plural absolute unspecified unspecified  	O	null
7 ו ו וטען conjunction unspecified unspecified unspecified unspecified unspecified 0 
7 טען טען וטען verb masculine singular unspecified 3 past  	O	null
8 כי כי כי conjunction unspecified unspecified unspecified unspecified unspecified  	O	null
9 מה מה מה interrogative unspecified unspecified unspecified unspecified unspecified  	O	null
10 ש ש שכתב relativizer/subordinatingConjunction unspecified unspecified unspecified unspecified unspecified 0 
10 כתב כתב שכתב verb masculine singular unspecified 3 past  	O	null
11 ב ב בתסריט preposition unspecified unspecified unspecified unspecified unspecified 0 
11 תסריט תסריט בתסריט noun masculine singular absolute unspecified unspecified  	O	null
12 מבוסס מבוסס מבוסס adjective masculine singular absolute unspecified unspecified  	O	null
13 ב ב בדייקנות preposition unspecified unspecified unspecified unspecified unspecified 0 
13 דייקנות דייקנות בדייקנות noun feminine singular absolute unspecified unspecified  	O	null
14 על על על preposition unspecified unspecified unspecified unspecified unspecified  	O	null
15 ה ה הכתוב definiteArticle unspecified unspecified unspecified unspecified unspecified 0 
15 הכתוב כתוב הכתוב noun masculine singular absolute unspecified unspecified  	O	null
16 ב ב בספרם preposition unspecified unspecified unspecified unspecified unspecified 0 
16 ספר ספר בספרם noun masculine singular absolute unspecified unspecified  
16 ם ם בספרם possessive masculine plural unspecified 3 unspecified 0 	O	null
17 ה ה התיעודי definiteArticle unspecified unspecified unspecified unspecified unspecified 0 
17 התיעודי תיעודי התיעודי adjective masculine singular absolute unspecified unspecified  	O	null
18 ה ה השטן definiteArticle unspecified unspecified unspecified unspecified unspecified 0 
18 השטן שטן השטן noun masculine singular absolute unspecified unspecified  	O	null
19 ו ו והנפש conjunction unspecified unspecified unspecified unspecified unspecified 0 
19 ה ה והנפש definiteArticle unspecified unspecified unspecified unspecified unspecified 0 
19 הנפש נפש והנפש noun feminine singular absolute unspecified unspecified  	O	null
20 של של של shel-preposition unspecified unspecified unspecified unspecified unspecified  	O	null
21 יואל יואל יואל properName unspecified unspecified unspecified unspecified unspecified  	I_PERS	null
22 ו ו והנזי conjunction unspecified unspecified unspecified unspecified unspecified 0 
22 הנזי הנזי והנזי properName unspecified unspecified unspecified unspecified unspecified  	I_PERS	null
23 בראנד בראנד בראנד properName unspecified unspecified unspecified unspecified unspecified  	I_PERS	null
24 , , , punctuation unspecified unspecified unspecified unspecified unspecified  	O	null
25 שותפי שותף שותפיו noun masculine plural absolute unspecified unspecified  
25 ו ו שותפיו possessive masculine singular unspecified 3 unspecified 0 	O	null
26 של של של shel-preposition unspecified unspecified unspecified unspecified unspecified  	O	null
27 קסטנר קסטנר קסטנר properName unspecified unspecified unspecified unspecified unspecified  	I_PERS	null
28 ל ל לוועדת preposition unspecified unspecified unspecified unspecified unspecified 0 
28 וועדת ועדה לוועדת noun feminine singular construct unspecified unspecified  	O	null
29 ה ה ההצלה definiteArticle unspecified unspecified unspecified unspecified unspecified 0 
29 ההצלה הצלה ההצלה noun feminine singular absolute unspecified unspecified  	O	null
30 ה ה הציונית definiteArticle unspecified unspecified unspecified unspecified unspecified 0 
30 הציונית ציוני הציונית adjective feminine singular absolute unspecified unspecified  	O	null
31 ב ב בבודפשט preposition unspecified unspecified unspecified unspecified unspecified 0 
31 בודפשט בודפשט בבודפשט properName unspecified unspecified unspecified unspecified unspecified  	I_LOC	null
32 . . . punctuation unspecified unspecified unspecified unspecified unspecified  	O	null

0 ב ב בחבלי preposition unspecified unspecified unspecified unspecified unspecified 0 
0 חבלי חבל בחבלי noun masculine plural construct unspecified unspecified  	O	null
1 משיח משיח משיח noun masculine singular absolute unspecified unspecified  	O	null
2 , , , punctuation unspecified unspecified unspecified unspecified unspecified  	O	null
3 ש ש שהוצג relativizer/subordinatingConjunction unspecified unspecified unspecified unspecified unspecified 0 
3 הוצג הוצג שהוצג verb masculine singular unspecified 3 past  	O	null
4 כעבור כעבור כעבור preposition unspecified unspecified unspecified unspecified unspecified  	O	null
5 שנתיים שנתי שנתיים adjective masculine plural absolute unspecified unspecified  	O	null
6 ) ) ) punctuation unspecified unspecified unspecified unspecified unspecified  	O	null
7 , , , punctuation unspecified unspecified unspecified unspecified unspecified  	O	null
8 ###NUMBER### ###NUMBER### ###NUMBER### numeral unspecified unspecified unspecified unspecified unspecified  	I_DATE	null
9 חקר חקר חקר verb masculine singular unspecified 3 past  	O	null
10 את את את at-preposition unspecified unspecified unspecified unspecified unspecified  	O	null
11 ה ה התהליכים definiteArticle unspecified unspecified unspecified unspecified unspecified 0 
11 התהליכים תהליך התהליכים noun masculine plural absolute unspecified unspecified  	O	null
12 ה ה העוברים definiteArticle unspecified unspecified unspecified unspecified unspecified 0 
12 העוברים עבר העוברים participle masculine plural absolute any unspecified  	O	null
13 על על על preposition unspecified unspecified unspecified unspecified unspecified  	O	null
14 אנשי איש אנשי noun masculine plural construct unspecified unspecified  	O	null
15 התנחלות התנחלות התנחלות noun feminine singular absolute unspecified unspecified  	O	null
16 ב ב בשומרון preposition unspecified unspecified unspecified unspecified unspecified 0 
16 שומרון שומרון בשומרון properName unspecified unspecified unspecified unspecified unspecified  	I_LOC	null
17 עם עם עם preposition unspecified unspecified unspecified unspecified unspecified  	O	null
18 חתימת חתימה חתימתו noun feminine singular absolute unspecified unspecified  
18 ו ו חתימתו possessive masculine singular unspecified 3 unspecified 0 	O	null
19 של של של shel-preposition unspecified unspecified unspecified unspecified unspecified  	O	null
20 הסכם הסכם הסכם noun masculine singular construct unspecified unspecified  	O	null
21 שלום שלום שלום noun masculine singular absolute unspecified unspecified  	O	null
22 עתידי עתידי עתידי adjective masculine singular absolute unspecified unspecified  	O	null
23 בין בין בין preposition unspecified unspecified unspecified unspecified unspecified  	O	null
24 ישראל ישראל ישראל properName unspecified unspecified unspecified unspecified unspecified  	I_PERS	null
25 ל ל לירדן preposition unspecified unspecified unspecified unspecified unspecified 0 
25 ירדן ירדן לירדן properName unspecified unspecified unspecified unspecified unspecified  	I_PERS	null
26 , , , punctuation unspecified unspecified unspecified unspecified unspecified  	O	null
27 כאשר כאשר כאשר conjunction unspecified unspecified unspecified unspecified unspecified  	O	null
28 כמה כמה כמה quantifier unspecified unspecified construct unspecified unspecified  	O	null
29 קנאים קנאי קנאים adjective masculine plural absolute unspecified unspecified  	O	null
30 בין בין בין preposition unspecified unspecified unspecified unspecified unspecified  	O	null
31 ה ה המתנחלים definiteArticle unspecified unspecified unspecified unspecified unspecified 0 
31 המתנחלים מתנחל המתנחלים noun masculine plural absolute unspecified unspecified  	O	null
32 מפוצצים פוצץ מפוצצים verb masculine plural unspecified any beinoni  	O	null
33 את את את at-preposition unspecified unspecified unspecified unspecified unspecified  	O	null
34 ה ה המסגדים definiteArticle unspecified unspecified unspecified unspecified unspecified 0 
34 המסגדים מסגד המסגדים noun masculine plural absolute unspecified unspecified  	O	null
35 ש ש שעל relativizer/subordinatingConjunction unspecified unspecified unspecified unspecified unspecified 0 
35 על על שעל preposition unspecified unspecified unspecified unspecified unspecified  	O	null
36 הר הר הר properName unspecified unspecified unspecified unspecified unspecified  	I_PERS	null
37 הבית בית הבית properName unspecified unspecified unspecified unspecified unspecified  	I_PERS	null
38 כדי כדי כדי conjunction unspecified unspecified unspecified unspecified unspecified  	O	null
39 למנוע מנע למנוע verb unspecified unspecified unspecified unspecified infinitive  	O	null
40 את את את at-preposition unspecified unspecified unspecified unspecified unspecified  	O	null
41 מימוש מימוש מימוש noun masculine singular construct unspecified unspecified  	O	null
42 ה ה ההסכם definiteArticle unspecified unspecified unspecified unspecified unspecified 0 
42 ההסכם הסכם ההסכם noun masculine singular absolute unspecified unspecified  	O	null
43 . . . punctuation unspecified unspecified unspecified unspecified unspecified  	O	null

0 ב ב במחזה preposition unspecified unspecified unspecified unspecified unspecified 0 
0 ה ה במחזה definiteArticle unspecified unspecified unspecified unspecified unspecified 0 
0 המחזה מחזה במחזה noun masculine singular absolute unspecified unspecified  	O	null
1 פולארד פולארד פולארד properName unspecified unspecified unspecified unspecified unspecified  	I_ORG	null
2 ( ( ( punctuation unspecified unspecified unspecified unspecified unspecified  	O	null
3 ) ) ) punctuation unspecified unspecified unspecified unspecified unspecified  	O	null
4 , , , punctuation unspecified unspecified unspecified unspecified unspecified  	O	null
5 ש ש שהועלה relativizer/subordinatingConjunction unspecified unspecified unspecified unspecified unspecified 0 
5 הועלה הועלה שהועלה verb masculine singular unspecified 3 past  	O	null
6 ###NUMBER### ###NUMBER### ###NUMBER### numeral unspecified unspecified unspecified unspecified unspecified  	I_DATE	null
7 ב ב בתיאטרון preposition unspecified unspecified unspecified unspecified unspecified 0 
7 ה ה בתיאטרון definiteArticle unspecified unspecified unspecified unspecified unspecified 0 
7 התיאטרון תיאטרון בתיאטרון noun masculine singular absolute unspecified unspecified  	O	null
8 " " " punctuation unspecified unspecified unspecified unspecified unspecified  	O	null
9 ה ה הקאמרי definiteArticle unspecified unspecified unspecified unspecified unspecified 0 
9 הקאמרי קאמרי הקאמרי adjective masculine singular absolute unspecified unspecified  	O	null
10 " " " punctuation unspecified unspecified unspecified unspecified unspecified  	O	null
11 , , , punctuation unspecified unspecified unspecified unspecified unspecified  	O	null
12 העמיד העמיד העמיד verb masculine singular unspecified 3 past  	O	null
13 ב ב במרכז preposition unspecified unspecified unspecified unspecified unspecified 0 
13 ה ה במרכז definiteArticle unspecified unspecified unspecified unspecified unspecified 0 
13 המרכז מרכז במרכז noun masculine singular absolute unspecified unspecified  	O	null
14 את את את at-preposition unspecified unspecified unspecified unspecified unspecified  	O	null
15 ה ה היהודי definiteArticle unspecified unspecified unspecified unspecified unspecified 0 
15 היהודי יהודי היהודי noun masculine singular absolute unspecified unspecified  	O	null
16 ה ה האמריקני definiteArticle unspecified unspecified unspecified unspecified unspecified 0 
16 האמריקני אמריקני האמריקני adjective masculine singular absolute unspecified unspecified  	O	null
17 ג'ונתן ג'ונתן ג'ונתן properName unspecified unspecified unspecified unspecified unspecified  	I_PERS	null
18 פולארד פולארד פולארד properName unspecified unspecified unspecified unspecified unspecified  	I_PERS	null
19 ש ש שהורשע relativizer/subordinatingConjunction unspecified unspecified unspecified unspecified unspecified 0 
19 הורשע הורשע שהורשע verb masculine singular unspecified 3 past  	O	null
20 ב ב בריגול preposition unspecified unspecified unspecified unspecified unspecified 0 
20 ריגול ריגול בריגול noun masculine singular absolute unspecified unspecified  	O	null
21 למען למען למען preposition unspecified unspecified unspecified unspecified unspecified  	O	null
22 ישראל ישראל ישראל properName unspecified unspecified unspecified unspecified unspecified  	I_LOC	null
23 , , , punctuation unspecified unspecified unspecified unspecified unspecified  	O	null
24 אך אך אך conjunction unspecified unspecified unspecified unspecified unspecified  	O	null
25 לבד לבד לבד adverb unspecified unspecified unspecified unspecified unspecified  	O	null
26 מן מן מן preposition unspecified unspecified unspecified unspecified unspecified  	O	null
27 ה ה העובדות definiteArticle unspecified unspecified unspecified unspecified unspecified 0 
27 העובדות עובד העובדות noun feminine plural absolute unspecified unspecified  	O	null
28 ה ה הבסיסיות definiteArticle unspecified unspecified unspecified unspecified unspecified 0 
28 הבסיסיות בסיסי הבסיסיות adjective feminine plural absolute unspecified unspecified  	O	null
29 לא לא לא negation unspecified unspecified unspecified unspecified unspecified  	O	null
30 היתה הוא היתה copula feminine singular unspecified 3 past  	O	null
31 ב ב בו preposition unspecified unspecified unspecified unspecified unspecified  
31 ו ו בו pronomial masculine singular unspecified 3 unspecified 0 	O	null
32 אף אף אף conjunction unspecified unspecified unspecified unspecified unspecified  	O	null
33 לא לא לא negation unspecified unspecified unspecified unspecified unspecified  	O	null
34 שורה שורה שורה noun feminine singular absolute unspecified unspecified  	O	null
35 אחת CARD1 אחת numeral feminine singular absolute unspecified unspecified  	O	null
36 ה ה המבוססת definiteArticle unspecified unspecified unspecified unspecified unspecified 0 
36 המבוססת בוסס המבוססת participle feminine singular absolute any unspecified  	O	null
37 על על על preposition unspecified unspecified unspecified unspecified unspecified  	O	null
38 שחזור שחזור שחזור noun masculine singular construct unspecified unspecified  	O	null
39 שיחות שיחה שיחותיהם noun feminine plural absolute unspecified unspecified  
39 הם הם שיחותיהם possessive masculine plural unspecified 3 unspecified 0 	O	null
40 של של של shel-preposition unspecified unspecified unspecified unspecified unspecified  	O	null
41 פולארד פולארד פולארד properName unspecified unspecified unspecified unspecified unspecified  	I_PERS	null
42 או או או conjunction unspecified unspecified unspecified unspecified unspecified  	O	null
43 של של של shel-preposition unspecified unspecified unspecified unspecified unspecified  	O	null
44 מפעילי מפעיל מפעיליו noun masculine plural absolute unspecified unspecified  
44 ו ו מפעיליו possessive masculine singular unspecified 3 unspecified 0 	O	null
45 . . . punctuation unspecified unspecified unspecified unspecified unspecified  	O	null

0 עם עם עם preposition unspecified unspecified unspecified unspecified unspecified  	O	null
1 זאת זאת זאת pronoun feminine singular unspecified 3 unspecified  	O	null
2 נתקלה נתקל נתקלה verb feminine singular unspecified 3 past  	O	null
3 ה ה ההצגה definiteArticle unspecified unspecified unspecified unspecified unspecified 0 
3 ההצגה הצגה ההצגה noun feminine singular absolute unspecified unspecified  	O	null
4 ב ב בהתנגדותם preposition unspecified unspecified unspecified unspecified unspecified 0 
4 התנגדות התנגדות בהתנגדותם noun feminine singular absolute unspecified unspecified  
4 ם ם בהתנגדותם possessive masculine plural unspecified 3 unspecified 0 	O	null
5 של של של shel-preposition unspecified unspecified unspecified unspecified unspecified  	O	null
6 ה ה הישראלים definiteArticle unspecified unspecified unspecified unspecified unspecified 0 
6 הישראלים ישראלי הישראלים noun masculine plural absolute unspecified unspecified  	O	null
7 ה ה המעורבים definiteArticle unspecified unspecified unspecified unspecified unspecified 0 
7 המעורבים מעורב המעורבים adjective masculine plural absolute unspecified unspecified  	O	null
8 ב ב בפרשה preposition unspecified unspecified unspecified unspecified unspecified 0 
8 ה ה בפרשה definiteArticle unspecified unspecified unspecified unspecified unspecified 0 
8 הפרשה פרשה בפרשה noun feminine singular absolute unspecified unspecified  	O	null
9 , , , punctuation unspecified unspecified unspecified unspecified unspecified  	O	null
10 מחשש חישש מחשש verb masculine singular unspecified any beinoni  	O	null
11 ש ש שייפגעו relativizer/subordinatingConjunction unspecified unspecified unspecified unspecified unspecified 0 
11 ייפגעו נפגע שייפגעו verb masculine-and-feminine plural unspecified 3 future  	O	null
12 , , , punctuation unspecified unspecified unspecified unspecified unspecified  	O	null
13 ו ו וכך conjunction unspecified unspecified unspecified unspecified unspecified 0 
13 כך כך וכך adverb unspecified unspecified unspecified unspecified unspecified  	I_ORG	null
14 התנהלו התנהל התנהלו verb masculine-and-feminine plural unspecified 3 past  	O	null
15 מגעים מגע מגעים noun masculine plural absolute unspecified unspecified  	O	null
16 עם עם עם preposition unspecified unspecified unspecified unspecified unspecified  	O	null
17 נציגי נציג נציגיהם noun masculine plural absolute unspecified unspecified  
17 הם הם נציגיהם possessive masculine plural unspecified 3 unspecified 0 	O	null
18 של של של shel-preposition unspecified unspecified unspecified unspecified unspecified  	O	null
19 ה ה האישים definiteArticle unspecified unspecified unspecified unspecified unspecified 0 
19 האישים אישים האישים noun masculine plural absolute unspecified unspecified  	O	null
20 הללו הללו הללו pronoun masculine plural unspecified 3 unspecified  	O	null
21 , , , punctuation unspecified unspecified unspecified unspecified unspecified  	O	null
22 ש ש שהציעו relativizer/subordinatingConjunction unspecified unspecified unspecified unspecified unspecified 0 
22 הציעו הציע שהציעו verb masculine-and-feminine plural unspecified 3 past  	O	null
23 לממן מימן לממן verb unspecified unspecified unspecified unspecified infinitive  	O	null
24 את את את at-preposition unspecified unspecified unspecified unspecified unspecified  	O	null
25 ה ה העלויות definiteArticle unspecified unspecified unspecified unspecified unspecified 0 
25 העלויות עלות העלויות noun feminine plural absolute unspecified unspecified  	O	null
26 ש ש שהושקעו relativizer/subordinatingConjunction unspecified unspecified unspecified unspecified unspecified 0 
26 הושקעו הושקע שהושקעו verb masculine-and-feminine plural unspecified 3 past  	O	null
27 בהפקהכדי בהפקהכדי בהפקהכדי adjective masculine singular construct unspecified unspecified  	O	null
28 ל ל לבטל preposition unspecified unspecified unspecified unspecified unspecified 0 
28 בטל בטל לבטל adjective masculine singular absolute unspecified unspecified  	O	null
29 את את אותה at-preposition unspecified unspecified unspecified unspecified unspecified  
29 ה ה אותה pronomial feminine singular unspecified 3 unspecified 0 	O	null
30 . . . punctuation unspecified unspecified unspecified unspecified unspecified  	O	null

0 ה ה ההצגה definiteArticle unspecified unspecified unspecified unspecified unspecified 0 
0 ההצגה הצגה ההצגה noun feminine singular absolute unspecified unspecified  	O	null
1 אמנם אמנם אמנם adverb unspecified unspecified unspecified unspecified unspecified  	O	null
2 הועלתה הועלה הועלתה verb feminine singular unspecified 3 past  	O	null
3 , , , punctuation unspecified unspecified unspecified unspecified unspecified  	O	null
4 אך אך אך conjunction unspecified unspecified unspecified unspecified unspecified  	O	null
5 לא לא לא negation unspecified unspecified unspecified unspecified unspecified  	O	null
6 זכתה זכה זכתה verb feminine singular unspecified 3 past  	O	null
7 ל ל לאותה preposition unspecified unspecified unspecified unspecified unspecified 0 
7 אותו אותו לאותה quantifier unspecified unspecified unspecified unspecified unspecified  
7 ה ה לאותה pronomial feminine singular unspecified 3 unspecified 0 	O	null
8 הצלחה הצלחה הצלחה noun feminine singular absolute unspecified unspecified  	O	null
9 כמו כמו כמו preposition unspecified unspecified unspecified unspecified unspecified  	O	null
10 קסטנר קסטנר קסטנר properName unspecified unspecified unspecified unspecified unspecified  	I_PERS	null
11 , , , punctuation unspecified unspecified unspecified unspecified unspecified  	O	null
12 אולי אולי אולי adverb unspecified unspecified unspecified unspecified unspecified  	O	null
13 מפני מפני מפני conjunction unspecified unspecified unspecified unspecified unspecified  	O	null
14 ש ש שהעניין relativizer/subordinatingConjunction unspecified unspecified unspecified unspecified unspecified 0 
14 ה ה שהעניין definiteArticle unspecified unspecified unspecified unspecified unspecified 0 
14 העניין עניין שהעניין noun masculine singular absolute unspecified unspecified  	O	null
15 של של של shel-preposition unspecified unspecified unspecified unspecified unspecified  	O	null
16 קהל קהל קהל noun masculine singular construct unspecified unspecified  	O	null
17 ה ה התיאטרון definiteArticle unspecified unspecified unspecified unspecified unspecified 0 
17 התיאטרון תיאטרון התיאטרון noun masculine singular absolute unspecified unspecified  	O	null
18 ה ה הישראלי definiteArticle unspecified unspecified unspecified unspecified unspecified 0 
18 הישראלי ישראלי הישראלי adjective masculine singular absolute unspecified unspecified  	O	null
19 ב ב בנושאים preposition unspecified unspecified unspecified unspecified unspecified 0 
19 נושאים נושא בנושאים noun masculine plural absolute unspecified unspecified  	O	null
20 פוליטיים פוליטי פוליטיים adjective masculine plural absolute unspecified unspecified  	O	null
21 הלך הלך הלך verb masculine singular unspecified 3 past  	O	null
22 ו ו ודעך conjunction unspecified unspecified unspecified unspecified unspecified 0 
22 דעך דעך ודעך verb masculine singular unspecified 3 past  	O	null
23 ב ב באותה preposition unspecified unspecified unspecified unspecified unspecified 0 
23 אותו אותו באותה quantifier unspecified unspecified unspecified unspecified unspecified  
23 ה ה באותה pronomial feminine singular unspecified 3 unspecified 0 	O	null
24 עת עת עת noun feminine singular absolute unspecified unspecified  	O	null
25 . . . punctuation unspecified unspecified unspecified unspecified unspecified  	O	null

0 לאחר לאחר לאחר preposition unspecified unspecified unspecified unspecified unspecified  	O	null
1 רצח רצח רצח noun masculine singular construct unspecified unspecified  	O	null
2 יצחק יצחק יצחק properName unspecified unspecified unspecified unspecified unspecified  	I_PERS	null
3 רבין רבין רבין properName unspecified unspecified unspecified unspecified unspecified  	I_PERS	null
4 הזמין הזמין הזמין verb masculine singular unspecified 3 past  	O	null
5 ה ה התיאטרון definiteArticle unspecified unspecified unspecified unspecified unspecified 0 
5 התיאטרון תיאטרון התיאטרון noun masculine singular absolute unspecified unspecified  	O	null
6 " " " punctuation unspecified unspecified unspecified unspecified unspecified  	O	null
7 ה ה הקאמרי definiteArticle unspecified unspecified unspecified unspecified unspecified 0 
7 הקאמרי קאמרי הקאמרי adjective masculine singular absolute unspecified unspecified  	O	null
8 " " " punctuation unspecified unspecified unspecified unspecified unspecified  	O	null
9 מ מ מלרנר preposition unspecified unspecified unspecified unspecified unspecified 0 
9 לרנר לרנר מלרנר properName unspecified unspecified unspecified unspecified unspecified  	O	null
10 מחזה מחזה מחזה noun masculine singular absolute unspecified unspecified  	O	null
11 על על על preposition unspecified unspecified unspecified unspecified unspecified  	O	null
12 ה ה הרצח definiteArticle unspecified unspecified unspecified unspecified unspecified 0 
12 הרצח רצח הרצח noun masculine singular absolute unspecified unspecified  	O	null
13 ו ו וסיבותיו conjunction unspecified unspecified unspecified unspecified unspecified 0 
13 סיבות סיבה וסיבותיו noun feminine plural absolute unspecified unspecified  
13 ו ו וסיבותיו possessive masculine singular unspecified 3 unspecified 0 	O	null
14 , , , punctuation unspecified unspecified unspecified unspecified unspecified  	O	null
15 אך אך אך conjunction unspecified unspecified unspecified unspecified unspecified  	O	null
16 ב ב בסופו preposition unspecified unspecified unspecified unspecified unspecified 0 
16 סוף סוף בסופו noun masculine singular absolute unspecified unspecified  
16 ו ו בסופו possessive masculine singular unspecified 3 unspecified 0 	O	null
17 של של של shel-preposition unspecified unspecified unspecified unspecified unspecified  	O	null
18 דבר דבר דבר noun masculine singular absolute unspecified unspecified  	O	null
19 החליט החליט החליט verb masculine singular unspecified 3 past  	O	null
20 ה ה התיאטרון definiteArticle unspecified unspecified unspecified unspecified unspecified 0 
20 התיאטרון תיאטרון התיאטרון noun masculine singular absolute unspecified unspecified  	O	null
21 ש ש שלא relativizer/subordinatingConjunction unspecified unspecified unspecified unspecified unspecified 0 
21 לא לא שלא negation unspecified unspecified unspecified unspecified unspecified  	O	null
22 להפיק הפיק להפיק verb unspecified unspecified unspecified unspecified infinitive  	O	null
23 את את אותו at-preposition unspecified unspecified unspecified unspecified unspecified  
23 ו ו אותו pronomial masculine singular unspecified 3 unspecified 0 	O	null
24 . . . punctuation unspecified unspecified unspecified unspecified unspecified  	O	null

0 ה ה המחזה definiteArticle unspecified unspecified unspecified unspecified unspecified 0 
0 המחזה מחזה המחזה noun masculine singular absolute unspecified unspecified  	O	null
1 הועלה הועלה הועלה verb masculine singular unspecified 3 past  	O	null
2 ב ב בהיילבורן preposition unspecified unspecified unspecified unspecified unspecified 0 
2 היילבורן היילבורן בהיילבורן noun feminine singular absolute unspecified unspecified  	O	null
3 , , , punctuation unspecified unspecified unspecified unspecified unspecified  	O	null
4 גרמניה גרמני גרמניה properName unspecified unspecified unspecified unspecified unspecified  	I_LOC	null
5 ( ( ( punctuation unspecified unspecified unspecified unspecified unspecified  	O	null
6 ###NUMBER### ###NUMBER### ###NUMBER### numeral unspecified unspecified unspecified unspecified unspecified  	I_DATE	null
7 ) ) ) punctuation unspecified unspecified unspecified unspecified unspecified  	O	null
8 ו ו ואחר conjunction unspecified unspecified unspecified unspecified unspecified 0 
8 אחר אחר ואחר preposition unspecified unspecified unspecified unspecified unspecified  	O	null
9 כך כך כך pronoun unspecified unspecified unspecified unspecified unspecified  	O	null
10 ב ב בארצות preposition unspecified unspecified unspecified unspecified unspecified 0 
10 ארצות ארץ בארצות properName unspecified unspecified unspecified unspecified unspecified  	I_LOC	null
11 הברית ברית הברית properName unspecified unspecified unspecified unspecified unspecified  	I_LOC	null
12 ( ( ( punctuation unspecified unspecified unspecified unspecified unspecified  	O	null
13 ###NUMBER### ###NUMBER### ###NUMBER### numeral unspecified unspecified unspecified unspecified unspecified  	I_DATE	null
14 ) ) ) punctuation unspecified unspecified unspecified unspecified unspecified  	O	null
15 ו ו ועורר conjunction unspecified unspecified unspecified unspecified unspecified 0 
15 עורר עורר ועורר verb masculine singular unspecified 3 past  	O	null
16 תגובות תגובה תגובות noun feminine plural absolute unspecified unspecified  	O	null
17 חריפות חריף חריפות adjective feminine plural absolute unspecified unspecified  	O	null
18 של של של shel-preposition unspecified unspecified unspecified unspecified unspecified  	O	null
19 גולשים גולש גולשים noun masculine plural absolute unspecified unspecified  	O	null
20 ב ב באינטרנט preposition unspecified unspecified unspecified unspecified unspecified 0 
20 ה ה באינטרנט definiteArticle unspecified unspecified unspecified unspecified unspecified 0 
20 האינטרנט אינטרנט באינטרנט noun masculine singular absolute unspecified unspecified  	O	null
21 , , , punctuation unspecified unspecified unspecified unspecified unspecified  	O	null
22 ש ש שלא relativizer/subordinatingConjunction unspecified unspecified unspecified unspecified unspecified 0 
22 לא לא שלא negation unspecified unspecified unspecified unspecified unspecified  	O	null
23 צפו צף צפו verb masculine-and-feminine plural unspecified 3 past  	O	null
24 ב ב בו preposition unspecified unspecified unspecified unspecified unspecified  
24 ו ו בו pronomial masculine singular unspecified 3 unspecified 0 	O	null
25 אך אך אך conjunction unspecified unspecified unspecified unspecified unspecified  	O	null
26 קראו קרא קראו verb masculine-and-feminine plural unspecified 3 past  	O	null
27 על על עליו preposition unspecified unspecified unspecified unspecified unspecified  
27 ו ו עליו pronomial masculine singular unspecified 3 unspecified 0 	O	null
28 . . . punctuation unspecified unspecified unspecified unspecified unspecified  	O	null

0 גם גם גם conjunction unspecified unspecified unspecified unspecified unspecified  	O	null
1 מחזהוההודאה מחזהוההודאה מחזהוההודאה properName unspecified unspecified unspecified unspecified unspecified  	I_PERS	null
2 , , , punctuation unspecified unspecified unspecified unspecified unspecified  	O	null
3 ש ש שדן relativizer/subordinatingConjunction unspecified unspecified unspecified unspecified unspecified 0 
3 דן דן שדן verb masculine singular unspecified 3 past  	O	null
4 ב ב בגירוש preposition unspecified unspecified unspecified unspecified unspecified 0 
4 גירוש גירוש בגירוש noun masculine singular construct unspecified unspecified  	O	null
5 ערבים ערב ערבים noun masculine plural absolute unspecified unspecified  	O	null
6 מן מן מן preposition unspecified unspecified unspecified unspecified unspecified  	O	null
7 ה ה הארץ definiteArticle unspecified unspecified unspecified unspecified unspecified 0 
7 הארץ ארץ הארץ noun feminine singular absolute unspecified unspecified  	O	null
8 ב ב ב preposition unspecified unspecified unspecified unspecified unspecified 0 	O	null
9 - - - punctuation unspecified unspecified unspecified unspecified unspecified  	O	null
10 ' ' ' punctuation unspecified unspecified unspecified unspecified unspecified  	O	null
11 , , , punctuation unspecified unspecified unspecified unspecified unspecified  	O	null
12 ###NUMBER### ###NUMBER### ###NUMBER### numeral unspecified unspecified unspecified unspecified unspecified  	O	null
13 אמור אמור אמור modal masculine singular unspecified any unspecified  	O	null
14 היה הוא היה copula masculine singular unspecified 3 past  	O	null
15 לעלות עלה לעלות verb unspecified unspecified unspecified unspecified infinitive  	O	null
16 ב ב בתיאטרון preposition unspecified unspecified unspecified unspecified unspecified 0 
16 תיאטרון תיאטרון בתיאטרון properName unspecified unspecified unspecified unspecified unspecified  	I_ORG	null
17 חיפה חיפה חיפה properName unspecified unspecified unspecified unspecified unspecified  	I_LOC	null
18 ו ו ואחר conjunction unspecified unspecified unspecified unspecified unspecified 0 
18 אחר אחר ואחר preposition unspecified unspecified unspecified unspecified unspecified  	O	null
19 כך כך כך pronoun unspecified unspecified unspecified unspecified unspecified  	O	null
20 ב ב בתיאטרון preposition unspecified unspecified unspecified unspecified unspecified 0 
20 ה ה בתיאטרון definiteArticle unspecified unspecified unspecified unspecified unspecified 0 
20 התיאטרון תיאטרון בתיאטרון noun masculine singular absolute unspecified unspecified  	O	null
21 " " " punctuation unspecified unspecified unspecified unspecified unspecified  	O	null
22 ה ה הקאמרי definiteArticle unspecified unspecified unspecified unspecified unspecified 0 
22 הקאמרי קאמרי הקאמרי adjective masculine singular absolute unspecified unspecified  	O	null
23 " " " punctuation unspecified unspecified unspecified unspecified unspecified  	O	null
24 , , , punctuation unspecified unspecified unspecified unspecified unspecified  	O	null
25 אך אך אך conjunction unspecified unspecified unspecified unspecified unspecified  	O	null
26 שני CARD2 שני numeral masculine dual construct unspecified unspecified  	O	null
27 ה ה התיאטרונים definiteArticle unspecified unspecified unspecified unspecified unspecified 0 
27 התיאטרונים תיאטרון התיאטרונים noun masculine plural absolute unspecified unspecified  	O	null
28 ביטלו ביטל ביטלו verb masculine-and-feminine plural unspecified 3 past  	O	null
29 את את את at-preposition unspecified unspecified unspecified unspecified unspecified  	O	null
30 ה ה ההפקה definiteArticle unspecified unspecified unspecified unspecified unspecified 0 
30 ההפקה הפקה ההפקה noun feminine singular absolute unspecified unspecified  	O	null
31 . . . punctuation unspecified unspecified unspecified unspecified unspecified  	O	null

0 חבלי חבל חבלי noun masculine plural construct unspecified unspecified  	O	null
1 משיח משיח משיח noun masculine singular absolute unspecified unspecified  	O	null
2 שב שב שב verb masculine singular unspecified 3 past  	O	null
3 ו ו והועלה conjunction unspecified unspecified unspecified unspecified unspecified 0 
3 הועלה הועלה והועלה verb masculine singular unspecified 3 past  	O	null
4 ב ב ב preposition unspecified unspecified unspecified unspecified unspecified 0 	O	null
5 - - - punctuation unspecified unspecified unspecified unspecified unspecified  	O	null
6 ###NUMBER### ###NUMBER### ###NUMBER### numeral unspecified unspecified unspecified unspecified unspecified  	I_DATE	null
7 ב ב בתיאטרון preposition unspecified unspecified unspecified unspecified unspecified 0 
7 תיאטרון תיאטרון בתיאטרון noun masculine singular construct unspecified unspecified  	O	null
8 J J J foreign unspecified unspecified unspecified unspecified unspecified  	I_LOC	null
9 ב ב בוושינגטון preposition unspecified unspecified unspecified unspecified unspecified 0 
9 וושינגטון ושינגטון בוושינגטון properName unspecified unspecified unspecified unspecified unspecified  	I_LOC	null
10 ב ב בגרסה preposition unspecified unspecified unspecified unspecified unspecified 0 
10 גרסה גרסה בגרסה noun feminine singular absolute unspecified unspecified  	O	null
11 חדשה חדש חדשה adjective feminine singular absolute unspecified unspecified  	O	null
12 , , , punctuation unspecified unspecified unspecified unspecified unspecified  	O	null
13 שבה שב שבה verb feminine singular unspecified 3 past  	O	null
14 ה ה העלילה definiteArticle unspecified unspecified unspecified unspecified unspecified 0 
14 העלילה עלילה העלילה noun feminine singular absolute unspecified unspecified  	O	null
15 מתרחשת התרחש מתרחשת verb feminine singular unspecified any beinoni  	O	null
16 לאחר לאחר לאחר conjunction unspecified unspecified unspecified unspecified unspecified  	O	null
17 ה ה ההתנתקות definiteArticle unspecified unspecified unspecified unspecified unspecified 0 
17 ההתנתקות התנתקות ההתנתקות noun feminine singular absolute unspecified unspecified  	O	null
18 מ מ מעזה preposition unspecified unspecified unspecified unspecified unspecified 0 
18 עזה עזה מעזה properName unspecified unspecified unspecified unspecified unspecified  	I_LOC	null
19 , , , punctuation unspecified unspecified unspecified unspecified unspecified  	O	null
20 זכה זכה זכה verb masculine singular unspecified 3 past  	O	null
21 ל ל לביקורות preposition unspecified unspecified unspecified unspecified unspecified 0 
21 ביקורות ביקורת לביקורות noun feminine plural absolute unspecified unspecified  	O	null
22 נלהבות נלהב נלהבות verb feminine plural unspecified any beinoni  	O	null
23 ו ו ואף conjunction unspecified unspecified unspecified unspecified unspecified 0 
23 אף אף ואף conjunction unspecified unspecified unspecified unspecified unspecified  	O	null
24 היה הוא היה copula masculine singular unspecified 3 past  	O	null
25 מועמד מועמד מועמד noun masculine singular absolute unspecified unspecified  	O	null
26 ל ל לפרס preposition unspecified unspecified unspecified unspecified unspecified 0 
26 פרס פרס לפרס properName unspecified unspecified unspecified unspecified unspecified  	I_LOC	null
27 הלן הלן הלן properName unspecified unspecified unspecified unspecified unspecified  	I_PERS	null
28 הייס הייס הייס verb masculine singular unspecified 3 past  	O	null
29 כ כ כמחזה preposition unspecified unspecified unspecified unspecified unspecified 0 
29 ה ה כמחזה definiteArticle unspecified unspecified unspecified unspecified unspecified 0 
29 המחזה מחזה כמחזה noun masculine singular absolute unspecified unspecified  	O	null
30 ה ה הטוב definiteArticle unspecified unspecified unspecified unspecified unspecified 0 
30 הטוב טוב הטוב adjective masculine singular absolute unspecified unspecified  	O	null
31 ביותר ביותר ביותר adverb unspecified unspecified unspecified unspecified unspecified  	O	null
32 . . . punctuation unspecified unspecified unspecified unspecified unspecified  	O	null

0 ב ב ב preposition unspecified unspecified unspecified unspecified unspecified 0 	I_ORG	null
1 - - - punctuation unspecified unspecified unspecified unspecified unspecified  	I_ORG	null
2 ###NUMBER### ###NUMBER### ###NUMBER### numeral unspecified unspecified unspecified unspecified unspecified  	I_DATE	null
3 הועלה הועלה הועלה verb masculine singular unspecified 3 past  	O	null
4 ב ב בתיאטרון preposition unspecified unspecified unspecified unspecified unspecified 0 
4 תיאטרון תיאטרון בתיאטרון noun masculine singular construct unspecified unspecified  	O	null
5 Goldenthread Goldenthread Goldenthread foreign unspecified unspecified unspecified unspecified unspecified  	I_ORG	null
6 בסן בסן בסן properName unspecified unspecified unspecified unspecified unspecified  	I_ORG	null
7 פרנסיסקו פרנסיסקו פרנסיסקו properName unspecified unspecified unspecified unspecified unspecified  	I_ORG	null
8 ה ה המחזהבנדיקטוס definiteArticle unspecified unspecified unspecified unspecified unspecified 0 
8 המחזהבנדיקטוס המחזהבנדיקטוס המחזהבנדיקטוס participle masculine singular absolute any unspecified  	I_ORG	null
9 , , , punctuation unspecified unspecified unspecified unspecified unspecified  	O	null
10 ה ה המתרחש definiteArticle unspecified unspecified unspecified unspecified unspecified 0 
10 המתרחש התרחש המתרחש participle masculine singular absolute any unspecified  	O	null
11 ערב ערב ערב noun masculine singular construct unspecified unspecified  	O	null
12 התקפה התקפה התקפה noun feminine singular absolute unspecified unspecified  	O	null
13 אמריקנית אמריקני אמריקנית adjective feminine singular absolute unspecified unspecified  	O	null
14 על על על preposition unspecified unspecified unspecified unspecified unspecified  	O	null
15 מתקני מתקן מתקני noun masculine plural construct unspecified unspecified  	O	null
16 ה ה הגרעין definiteArticle unspecified unspecified unspecified unspecified unspecified 0 
16 הגרעין גרעין הגרעין noun masculine singular absolute unspecified unspecified  	O	null
17 ב ב באיראן preposition unspecified unspecified unspecified unspecified unspecified 0 
17 איראן איראן באיראן properName unspecified unspecified unspecified unspecified unspecified  	I_LOC	null
18 . . . punctuation unspecified unspecified unspecified unspecified unspecified  	O	null

0 ה ה המחזה definiteArticle unspecified unspecified unspecified unspecified unspecified 0 
0 המחזה מחזה המחזה noun masculine singular absolute unspecified unspecified  	O	null
1 חייל חייל חייל noun masculine singular construct unspecified unspecified  	O	null
2 שב שב שב verb masculine singular unspecified 3 past  	O	null
3 הביתה הביתה הביתה adverb unspecified unspecified unspecified unspecified unspecified  	O	null
4 , , , punctuation unspecified unspecified unspecified unspecified unspecified  	O	null
5 ש ש שתיאר relativizer/subordinatingConjunction unspecified unspecified unspecified unspecified unspecified 0 
5 תיאר תיאר שתיאר verb masculine singular unspecified 3 past  	O	null
6 את את את at-preposition unspecified unspecified unspecified unspecified unspecified  	O	null
7 קורות קורה קורותיו noun feminine plural absolute unspecified unspecified  
7 ו ו קורותיו possessive masculine singular unspecified 3 unspecified 0 	O	null
8 של של של shel-preposition unspecified unspecified unspecified unspecified unspecified  	O	null
9 חייל חייל חייל noun masculine singular construct unspecified unspecified  	O	null
10 ש ש שהיה relativizer/subordinatingConjunction unspecified unspecified unspecified unspecified unspecified 0 
10 היה הוא שהיה copula masculine singular unspecified 3 past  	O	null
11 מ מ מעורב preposition unspecified unspecified unspecified unspecified unspecified 0 
11 עורב ערב מעורב participle masculine singular absolute any unspecified  	O	null
12 ב ב ברצח preposition unspecified unspecified unspecified unspecified unspecified 0 
12 רצח רצח ברצח noun masculine singular construct unspecified unspecified  	O	null
13 פלסטינאים פלסטינאים פלסטינאים adjective masculine plural absolute unspecified unspecified  	O	null
14 , , , punctuation unspecified unspecified unspecified unspecified unspecified  	O	null
15 הועלה הועלה הועלה verb masculine singular unspecified 3 past  	O	null
16 בסן בסן בסן properName unspecified unspecified unspecified unspecified unspecified  	I_LOC	null
17 פרנסיסקו פרנסיסקו פרנסיסקו properName unspecified unspecified unspecified unspecified unspecified  	I_LOC	null
18 ( ( ( punctuation unspecified unspecified unspecified unspecified unspecified  	O	null
19 ###NUMBER### ###NUMBER### ###NUMBER### numeral unspecified unspecified unspecified unspecified unspecified  	I_DATE	null
20 ) ) ) punctuation unspecified unspecified unspecified unspecified unspecified  	O	null
21 לאחר לאחר לאחר conjunction unspecified unspecified unspecified unspecified unspecified  	O	null
22 ש ש שהוצג relativizer/subordinatingConjunction unspecified unspecified unspecified unspecified unspecified 0 
22 הוצג הוצג שהוצג verb masculine singular unspecified 3 past  	O	null
23 ב ב בישראל preposition unspecified unspecified unspecified unspecified unspecified 0 
23 ישראל ישראל בישראל properName unspecified unspecified unspecified unspecified unspecified  	I_LOC	null
24 ב ב ב preposition unspecified unspecified unspecified unspecified unspecified 0 	I_ORG	null
25 " " " punctuation unspecified unspecified unspecified unspecified unspecified  	I_ORG	null
26 צוותא צוותא צוותא properName unspecified unspecified unspecified unspecified unspecified  	I_ORG	null
27 " " " punctuation unspecified unspecified unspecified unspecified unspecified  	O	null
28 ) ) ) punctuation unspecified unspecified unspecified unspecified unspecified  	O	null
29 . . . punctuation unspecified unspecified unspecified unspecified unspecified  	O	null
30 ###NUMBER### ###NUMBER### ###NUMBER### numeral unspecified unspecified unspecified unspecified unspecified  	I_DATE	null
31 ה ה המחזה definiteArticle unspecified unspecified unspecified unspecified unspecified 0 
31 המחזה מחזה המחזה noun masculine singular absolute unspecified unspecified  	O	null
32 ה ה הנאהבים definiteArticle unspecified unspecified unspecified unspecified unspecified 0 
32 הנאהבים נאהב הנאהבים participle masculine plural absolute any unspecified  	I_ORG	null
33 ו ו והנעימים conjunction unspecified unspecified unspecified unspecified unspecified 0 
33 ה ה והנעימים definiteArticle unspecified unspecified unspecified unspecified unspecified 0 
33 הנעימים נעים והנעימים adjective masculine plural absolute unspecified unspecified  	I_ORG	null
34 , , , punctuation unspecified unspecified unspecified unspecified unspecified  	O	null
35 ש ש שנכתב relativizer/subordinatingConjunction unspecified unspecified unspecified unspecified unspecified 0 
35 נכתב נכתב שנכתב verb masculine singular unspecified 3 past  	O	null
36 על על על preposition unspecified unspecified unspecified unspecified unspecified  	O	null
37 פי פי פי adverb unspecified unspecified unspecified unspecified unspecified  	O	null
38 סיפור סיפור סיפור noun masculine singular construct unspecified unspecified  	O	null
39 של של של shel-preposition unspecified unspecified unspecified unspecified unspecified  	O	null
40 י' י' י' properName unspecified unspecified unspecified unspecified unspecified  	I_PERS	null
41 ב ב בשביס preposition unspecified unspecified unspecified unspecified unspecified 0 
41 שביס שביס בשביס noun masculine singular construct unspecified unspecified  	O	null
42 - - - properName unspecified unspecified unspecified unspecified unspecified  	I_LOC	null
43 זינגר זינגר זינגר properName unspecified unspecified unspecified unspecified unspecified  	I_LOC	null
44 ב ב בשיתוף preposition unspecified unspecified unspecified unspecified unspecified 0 
44 שיתוף שיתוף בשיתוף noun masculine singular construct unspecified unspecified  	O	null
45 עם עם עם preposition unspecified unspecified unspecified unspecified unspecified  	I_ORG	null
46 ישראל ישראל ישראל properName unspecified unspecified unspecified unspecified unspecified  	I_ORG	null
47 זמיר זמיר זמיר properName unspecified unspecified unspecified unspecified unspecified  	I_PERS	null
48 , , , punctuation unspecified unspecified unspecified unspecified unspecified  	O	null
49 ה ה המגולל definiteArticle unspecified unspecified unspecified unspecified unspecified 0 
49 המגולל גולל המגולל participle masculine singular absolute any unspecified  	O	null
50 את את את at-preposition unspecified unspecified unspecified unspecified unspecified  	O	null
51 סיפור סיפור סיפורם noun masculine singular absolute unspecified unspecified  
51 ם ם סיפורם possessive masculine plural unspecified 3 unspecified 0 	O	null
52 של של של shel-preposition unspecified unspecified unspecified unspecified unspecified  	O	null
53 שני שני שני noun masculine singular construct unspecified unspecified  	O	null
54 תלמידי תלמיד תלמידי noun masculine plural construct unspecified unspecified  	O	null
55 ישיבה ישיבה ישיבה noun feminine singular absolute unspecified unspecified  	O	null
56 ש ש שאינם relativizer/subordinatingConjunction unspecified unspecified unspecified unspecified unspecified 0 
56 אינם הוא שאינם copula masculine plural unspecified 3 beinoni  	O	null
57 מצליחים הצליח מצליחים verb masculine plural unspecified any beinoni  	O	null
58 לממש מימש לממש verb unspecified unspecified unspecified unspecified infinitive  	O	null
59 את את את at-preposition unspecified unspecified unspecified unspecified unspecified  	O	null
60 אהבתם אהב אהבתם verb masculine plural unspecified 2 past  	O	null
61 ה ה האסורה definiteArticle unspecified unspecified unspecified unspecified unspecified 0 
61 האסורה אסר האסורה participle feminine singular absolute any unspecified  	O	null
62 , , , punctuation unspecified unspecified unspecified unspecified unspecified  	O	null
63 הועלה הועלה הועלה verb masculine singular unspecified 3 past  	O	null
64 ב ב בוושינגטון preposition unspecified unspecified unspecified unspecified unspecified 0 
64 וושינגטון ושינגטון בוושינגטון properName unspecified unspecified unspecified unspecified unspecified  	I_LOC	null
65 ( ( ( punctuation unspecified unspecified unspecified unspecified unspecified  	O	null
66 ###NUMBER### ###NUMBER### ###NUMBER### numeral unspecified unspecified unspecified unspecified unspecified  	I_DATE	null
67 ) ) ) punctuation unspecified unspecified unspecified unspecified unspecified  	O	null
68 לאחר לאחר לאחר conjunction unspecified unspecified unspecified unspecified unspecified  	O	null
69 בכורת כרת בכורתו verb unspecified unspecified unspecified unspecified infinitive  
69 ו ו בכורתו accusative-or-nominative masculine singular unspecified 3 unspecified 0 	O	null
70 ב ב בישראל preposition unspecified unspecified unspecified unspecified unspecified 0 
70 ישראל ישראל בישראל properName unspecified unspecified unspecified unspecified unspecified  	I_PERS	null
71 ב ב בתיאטרון preposition unspecified unspecified unspecified unspecified unspecified 0 
71 תיאטרון תיאטרון בתיאטרון properName unspecified unspecified unspecified unspecified unspecified  	I_ORG	null
72 " " " punctuation unspecified unspecified unspecified unspecified unspecified  	O	null
73 ה ה הבימה definiteArticle unspecified unspecified unspecified unspecified unspecified 0 
73 הבימה בימה הבימה noun feminine singular absolute unspecified unspecified  	I_ORG	null
74 " " " punctuation unspecified unspecified unspecified unspecified unspecified  	O	null
75 ) ) ) punctuation unspecified unspecified unspecified unspecified unspecified  	O	null
76 . . . punctuation unspecified unspecified unspecified unspecified unspecified  	O	null
77 ###NUMBER### ###NUMBER### ###NUMBER### numeral unspecified unspecified unspecified unspecified unspecified  	I_DATE	null
78 אך אך אך conjunction unspecified unspecified unspecified unspecified unspecified  	O	null
79 בעוד בעוד בעוד conjunction unspecified unspecified unspecified unspecified unspecified  	O	null
80 ש ש שבחו"ל relativizer/subordinatingConjunction unspecified unspecified unspecified unspecified unspecified 0 
80 ב ב שבחו"ל preposition unspecified unspecified unspecified unspecified unspecified 0 
80 חו"ל חו"ל שבחו"ל noun masculine singular absolute unspecified unspecified  	O	null
81 מועלים הועלה מועלים verb masculine plural unspecified any beinoni  	O	null
82 מחזות מחזה מחזות noun masculine plural construct unspecified unspecified  	O	null
83 חדשים חדש חדשים adjective masculine plural absolute unspecified unspecified  	O	null
84 של של שלו shel-preposition unspecified unspecified unspecified unspecified unspecified  
84 ו ו שלו pronomial masculine singular unspecified 3 unspecified 0 	O	null
85 , , , punctuation unspecified unspecified unspecified unspecified unspecified  	I_LOC	null
86 ב ב בישראל preposition unspecified unspecified unspecified unspecified unspecified 0 
86 ישראל ישראל בישראל properName unspecified unspecified unspecified unspecified unspecified  	I_LOC	null
87 לא לא לא negation unspecified unspecified unspecified unspecified unspecified  	O	null
88 הוצג הוצג הוצג verb masculine singular unspecified 3 past  	O	null
89 שום שום שום properName unspecified unspecified unspecified unspecified unspecified  	I_PERS	null
90 מ מ מחזה preposition unspecified unspecified unspecified unspecified unspecified 0 
90 חזה חזה מחזה properName unspecified unspecified unspecified unspecified unspecified  	I_PERS	null
91 של של של shel-preposition unspecified unspecified unspecified unspecified unspecified  	I_DATE	null
92 לרנר לרנר לרנר properName unspecified unspecified unspecified unspecified unspecified  	I_PERS	null
93 ב ב בשנים preposition unspecified unspecified unspecified unspecified unspecified 0 
93 ה ה בשנים definiteArticle unspecified unspecified unspecified unspecified unspecified 0 
93 השנים שנה בשנים noun feminine plural absolute unspecified unspecified  	O	null
94 ###NUMBER### ###NUMBER### ###NUMBER### numeral unspecified unspecified unspecified unspecified unspecified  	I_DATE	null
95 - - - punctuation unspecified unspecified unspecified unspecified unspecified  	O	null
96 ###NUMBER### ###NUMBER### ###NUMBER### numeral unspecified unspecified unspecified unspecified unspecified  	I_DATE	null
97 . . . punctuation unspecified unspecified unspecified unspecified unspecified  	O	null

0 במקביל במקביל במקביל adverb unspecified unspecified unspecified unspecified unspecified  	O	null
1 ל ל לכתיבת preposition unspecified unspecified unspecified unspecified unspecified 0 
1 כתיבת כתיבה לכתיבת noun feminine singular construct unspecified unspecified  	O	null
2 דרמה דרמה דרמה noun feminine singular absolute unspecified unspecified  	O	null
3 ל ל לתיאטרון preposition unspecified unspecified unspecified unspecified unspecified 0 
3 ה ה לתיאטרון definiteArticle unspecified unspecified unspecified unspecified unspecified 0 
3 התיאטרון תיאטרון לתיאטרון noun masculine singular absolute unspecified unspecified  	O	null
4 עוסק עסק עוסק verb masculine singular unspecified any beinoni  	O	null
5 לרנר לרנר לרנר properName unspecified unspecified unspecified unspecified unspecified  	I_PERS	null
6 ב ב בכתיבה preposition unspecified unspecified unspecified unspecified unspecified 0 
6 כתיבה כתיבה בכתיבה noun feminine singular absolute unspecified unspecified  	O	null
7 ל ל לקולנוע preposition unspecified unspecified unspecified unspecified unspecified 0 
7 ה ה לקולנוע definiteArticle unspecified unspecified unspecified unspecified unspecified 0 
7 הקולנוע קולנוע לקולנוע noun masculine singular absolute unspecified unspecified  	O	null
8 ו ו ולטלוויזיה conjunction unspecified unspecified unspecified unspecified unspecified 0 
8 ל ל ולטלוויזיה preposition unspecified unspecified unspecified unspecified unspecified 0 
8 ה ה ולטלוויזיה definiteArticle unspecified unspecified unspecified unspecified unspecified 0 
8 הטלוויזיה טלוויזיה ולטלוויזיה noun feminine singular absolute unspecified unspecified  	O	null
9 ו ו ומשמש conjunction unspecified unspecified unspecified unspecified unspecified 0 
9 משמש משמש ומשמש verb masculine singular unspecified 3 past  	O	null
10 כ כ כמרצה preposition unspecified unspecified unspecified unspecified unspecified 0 
10 מרץ מרץ כמרצה noun masculine singular absolute unspecified unspecified  
10 ה ה כמרצה possessive feminine singular unspecified 3 unspecified 0 	O	null
11 ל ל לכתיבת preposition unspecified unspecified unspecified unspecified unspecified 0 
11 כתיבת כתיבה לכתיבת noun feminine singular construct unspecified unspecified  	O	null
12 דרמה דרמה דרמה noun feminine singular absolute unspecified unspecified  	O	null
13 ב ב ב preposition unspecified unspecified unspecified unspecified unspecified 0 	O	null
14 " " " punctuation unspecified unspecified unspecified unspecified unspecified  	O	null
15 סמינר סמינר סמינר noun masculine singular construct unspecified unspecified  	O	null
16 ה ה הקיבוצים definiteArticle unspecified unspecified unspecified unspecified unspecified 0 
16 הקיבוצים קיבוץ הקיבוצים noun masculine plural absolute unspecified unspecified  	O	null
17 " " " punctuation unspecified unspecified unspecified unspecified unspecified  	O	null
18 ו ו ובאוניברסיטת conjunction unspecified unspecified unspecified unspecified unspecified 0 
18 ב ב ובאוניברסיטת preposition unspecified unspecified unspecified unspecified unspecified 0 
18 אוניברסיטת אוניברסיטה ובאוניברסיטת noun feminine singular construct unspecified unspecified  	I_ORG	null
19 תל תל תל properName unspecified unspecified unspecified unspecified unspecified  	I_ORG	null
20 אביב אביב אביב properName unspecified unspecified unspecified unspecified unspecified  	I_ORG	null
21 . . . punctuation unspecified unspecified unspecified unspecified unspecified  	O	null

0 יצר ייצר יצר verb masculine singular unspecified 3 past  	O	null
1 גם גם גם conjunction unspecified unspecified unspecified unspecified unspecified  	O	null
2 את את את at-preposition unspecified unspecified unspecified unspecified unspecified  	O	null
3 קו קו קו noun masculine singular construct unspecified unspecified  	O	null
4 , , , punctuation unspecified unspecified unspecified unspecified unspecified  	O	null
5 ###NUMBER### ###NUMBER### ###NUMBER### numeral unspecified unspecified unspecified unspecified unspecified  	O	null
6 מיני מין מיני noun masculine plural construct unspecified unspecified  	O	null
7 - - - punctuation unspecified unspecified unspecified unspecified unspecified  	O	null
8 סדרה סידר סדרה verb feminine singular unspecified 3 past  	O	null
9 בת בת בת noun feminine singular construct unspecified unspecified  	O	null
10 חמישה CARD5 חמישה numeral masculine plural absolute unspecified unspecified  	O	null
11 פרקים פרק פרקים noun masculine plural absolute unspecified unspecified  	O	null
12 ה ה העוסקת definiteArticle unspecified unspecified unspecified unspecified unspecified 0 
12 העוסקת עסק העוסקת participle feminine singular absolute any unspecified  	O	null
13 ב ב בפרשת preposition unspecified unspecified unspecified unspecified unspecified 0 
13 פרשת פרשה בפרשת noun feminine singular construct unspecified unspecified  	O	null
14 ה ה ההריגה definiteArticle unspecified unspecified unspecified unspecified unspecified 0 
14 ההריגה הריגה ההריגה noun feminine singular absolute unspecified unspecified  	O	null
15 של של של shel-preposition unspecified unspecified unspecified unspecified unspecified  	O	null
16 ה ה המחבלים definiteArticle unspecified unspecified unspecified unspecified unspecified 0 
16 המחבלים מחבל המחבלים noun masculine plural absolute unspecified unspecified  	O	null
17 ש ש שהשתלטו relativizer/subordinatingConjunction unspecified unspecified unspecified unspecified unspecified 0 
17 השתלטו השתלט שהשתלטו verb masculine-and-feminine plural unspecified 3 past  	O	null
18 על על על preposition unspecified unspecified unspecified unspecified unspecified  	O	null
19 אוטובוס אוטובוס אוטובוס noun masculine singular construct unspecified unspecified  	O	null
20 קו קו קו noun masculine singular construct unspecified unspecified  	O	null
21 ###NUMBER### ###NUMBER### ###NUMBER### numeral unspecified unspecified unspecified unspecified unspecified  	O	null
22 ב ב בידי preposition unspecified unspecified unspecified unspecified unspecified 0 
22 ידי יד בידי noun feminine plural construct unspecified unspecified  	O	null
23 השב"כ שב"כ השב"כ properName unspecified unspecified unspecified unspecified unspecified  	I_ORG	null
24 ) ) ) punctuation unspecified unspecified unspecified unspecified unspecified  	O	null
25 , , , punctuation unspecified unspecified unspecified unspecified unspecified  	O	null
26 ###NUMBER### ###NUMBER### ###NUMBER### numeral unspecified unspecified unspecified unspecified unspecified  	I_DATE	null
27 ו ו ואת conjunction unspecified unspecified unspecified unspecified unspecified 0 
27 את את ואת at-preposition unspecified unspecified unspecified unspecified unspecified  	O	null
28 ה ה המכון definiteArticle unspecified unspecified unspecified unspecified unspecified 0 
28 המכון מכון המכון noun masculine singular absolute unspecified unspecified  	O	null
29 – – – punctuation unspecified unspecified unspecified unspecified unspecified  	O	null
30 סדרת סדרה סדרת noun feminine singular construct unspecified unspecified  	O	null
31 דרמה דרמה דרמה noun feminine singular absolute unspecified unspecified  	O	null
32 בת בת בת noun feminine singular construct unspecified unspecified  	O	null
33 שנים שנה שנים noun feminine plural absolute unspecified unspecified  	O	null
34 - - - punctuation unspecified unspecified unspecified unspecified unspecified  	O	null
35 עשר עישר עשר verb masculine singular unspecified 3 past  	O	null
36 פרקים פרק פרקים noun masculine plural absolute unspecified unspecified  	O	null
37 ה ה המתרחשת definiteArticle unspecified unspecified unspecified unspecified unspecified 0 
37 המתרחשת התרחש המתרחשת participle feminine singular absolute any unspecified  	O	null
38 ב ב במכון preposition unspecified unspecified unspecified unspecified unspecified 0 
38 מכון מכון במכון noun masculine singular construct unspecified unspecified  	O	null
39 ל ל לטיפול preposition unspecified unspecified unspecified unspecified unspecified 0 
39 טיפול טיפול לטיפול noun masculine singular construct unspecified unspecified  	O	null
40 פסיכולוגי פסיכולוג פסיכולוגי noun masculine plural construct unspecified unspecified  	O	null
41 ו ו ומתמקדת conjunction unspecified unspecified unspecified unspecified unspecified 0 
41 מתמקדת התמקד ומתמקדת verb feminine singular unspecified any beinoni  	O	null
42 ב ב במטפלים preposition unspecified unspecified unspecified unspecified unspecified 0 
42 ה ה במטפלים definiteArticle unspecified unspecified unspecified unspecified unspecified 0 
42 המטפלים מטפל במטפלים noun masculine plural absolute unspecified unspecified  	O	null
43 , , , punctuation unspecified unspecified unspecified unspecified unspecified  	O	null
44 מ מ משפחותיהם preposition unspecified unspecified unspecified unspecified unspecified 0 
44 שפחות שפחה משפחותיהם noun feminine plural absolute unspecified unspecified  
44 הם הם משפחותיהם possessive masculine plural unspecified 3 unspecified 0 	O	null
45 , , , punctuation unspecified unspecified unspecified unspecified unspecified  	O	null
46 מ מ מטופליהם preposition unspecified unspecified unspecified unspecified unspecified 0 
46 טופלי טפל מטופליהם participle masculine plural unspecified any unspecified  
46 הם הם מטופליהם possessive masculine plural unspecified 3 unspecified 0 	O	null
47 , , , punctuation unspecified unspecified unspecified unspecified unspecified  	O	null
48 ו ו וביחסיהם conjunction unspecified unspecified unspecified unspecified unspecified 0 
48 ב ב וביחסיהם preposition unspecified unspecified unspecified unspecified unspecified 0 
48 יחסי יחס וביחסיהם noun masculine plural absolute unspecified unspecified  
48 הם הם וביחסיהם possessive masculine plural unspecified 3 unspecified 0 	O	null
49 עם עם עם preposition unspecified unspecified unspecified unspecified unspecified  	O	null
50 מ מ מטופליהם preposition unspecified unspecified unspecified unspecified unspecified 0 
50 טופלי טפל מטופליהם participle masculine plural unspecified any unspecified  
50 הם הם מטופליהם possessive masculine plural unspecified 3 unspecified 0 	O	null
51 ( ( ( punctuation unspecified unspecified unspecified unspecified unspecified  	O	null
52 ) ) ) punctuation unspecified unspecified unspecified unspecified unspecified  	O	null
53 . . . punctuation unspecified unspecified unspecified unspecified unspecified  	O	null
54 ###NUMBER### ###NUMBER### ###NUMBER### numeral unspecified unspecified unspecified unspecified unspecified  	I_DATE	null
55 ב ב ב preposition unspecified unspecified unspecified unspecified unspecified 0 	I_ORG	null
56 - - - punctuation unspecified unspecified unspecified unspecified unspecified  	I_ORG	null
57 ###NUMBER### ###NUMBER### ###NUMBER### numeral unspecified unspecified unspecified unspecified unspecified  	I_DATE	null
58 הושלמו הושלם הושלמו verb masculine-and-feminine plural unspecified 3 past  	O	null
59 שני שני שני noun masculine singular construct unspecified unspecified  	O	null
60 סרטים סרט סרטים noun masculine plural absolute unspecified unspecified  	O	null
61 נוספים נוסף נוספים verb masculine plural unspecified any beinoni  	O	null
62 שכתב שכתב שכתב verb masculine singular unspecified 3 past  	O	null
63 : : : punctuation unspecified unspecified unspecified unspecified unspecified  	O	null
64 אביב אביב אביב properName masculine-and-feminine singular unspecified unspecified unspecified  	I_DATE	null
65 ###NUMBER### ###NUMBER### ###NUMBER### numeral unspecified unspecified unspecified unspecified unspecified  	I_DATE	null
66 ה ה העוסק definiteArticle unspecified unspecified unspecified unspecified unspecified 0 
66 העוסק עוסק העוסק noun masculine singular absolute unspecified unspecified  	O	null
67 ב ב בקורותיה preposition unspecified unspecified unspecified unspecified unspecified 0 
67 קורות קרה בקורותיה participle feminine plural unspecified any unspecified  
67 ה ה בקורותיה possessive feminine singular unspecified 3 unspecified 0 	O	null
68 של של של shel-preposition unspecified unspecified unspecified unspecified unspecified  	O	null
69 משפחה משפחה משפחה noun feminine singular absolute unspecified unspecified  	O	null
70 יהודית יהודי יהודית adjective feminine singular absolute unspecified unspecified  	O	null
71 ה ה המסתתרת definiteArticle unspecified unspecified unspecified unspecified unspecified 0 
71 המסתתרת הסתתר המסתתרת participle feminine singular absolute any unspecified  	O	null
72 מ מ מפני preposition unspecified unspecified unspecified unspecified unspecified 0 
72 פני פני מפני noun masculine singular absolute unspecified unspecified  	O	null
73 ה ה הנאצים definiteArticle unspecified unspecified unspecified unspecified unspecified 0 
73 הנאצים נאצי הנאצים noun masculine plural absolute unspecified unspecified  	O	null
74 ב ב בכפר preposition unspecified unspecified unspecified unspecified unspecified 0 
74 כפר כפר בכפר noun masculine singular construct unspecified unspecified  	I_LOC	null
75 ב ב בפולין preposition unspecified unspecified unspecified unspecified unspecified 0 
75 פולין פולין בפולין properName unspecified unspecified unspecified unspecified unspecified  	I_LOC	null
76 , , , punctuation unspecified unspecified unspecified unspecified unspecified  	O	null
77 ו ו והסרט conjunction unspecified unspecified unspecified unspecified unspecified 0 
77 ה ה והסרט definiteArticle unspecified unspecified unspecified unspecified unspecified 0 
77 הסרט סרט והסרט noun masculine singular absolute unspecified unspecified  	O	null
78 אלטלנה אלטלנה אלטלנה properName feminine singular unspecified unspecified unspecified  	I_PERS	null
79 ה ה העוסק definiteArticle unspecified unspecified unspecified unspecified unspecified 0 
79 העוסק עוסק העוסק noun masculine singular absolute unspecified unspecified  	O	null
80 ב ב בפרשת preposition unspecified unspecified unspecified unspecified unspecified 0 
80 פרשת פרשה בפרשת noun feminine singular construct unspecified unspecified  	O	null
81 אוניית אונייה אוניית noun feminine singular construct unspecified unspecified  	O	null
82 ה ה הנשק definiteArticle unspecified unspecified unspecified unspecified unspecified 0 
82 הנשק נשק הנשק noun masculine singular absolute unspecified unspecified  	O	null
83 של של של shel-preposition unspecified unspecified unspecified unspecified unspecified  	O	null
84 אצ"ל אצ"ל אצ"ל properName unspecified unspecified unspecified unspecified unspecified  	I_PERS	null
85 ש ש שהוטבעה relativizer/subordinatingConjunction unspecified unspecified unspecified unspecified unspecified 0 
85 הוטבעה הוטבע שהוטבעה verb feminine singular unspecified 3 past  	O	null
86 על על על preposition unspecified unspecified unspecified unspecified unspecified  	O	null
87 ידי יד ידי noun feminine plural construct unspecified unspecified  	O	null
88 כוחות כוח כוחות noun masculine plural construct unspecified unspecified  	I_ORG	null
89 צה"ל צה"ל צה"ל properName unspecified unspecified unspecified unspecified unspecified  	I_ORG	null
90 ב ב בפקודת preposition unspecified unspecified unspecified unspecified unspecified 0 
90 פקודת פקודה בפקודת noun feminine singular construct unspecified unspecified  	O	null
91 ב ב בן preposition unspecified unspecified unspecified unspecified unspecified  
91 הן הן בן pronomial feminine plural unspecified 3 unspecified 0 	O	null
92 - - - properName unspecified unspecified unspecified unspecified unspecified  	I_ORG	null
93 גוריון גוריון גוריון properName unspecified unspecified unspecified unspecified unspecified  	I_ORG	null
94 בעיצום בעיצום בעיצומה preposition unspecified unspecified unspecified unspecified unspecified  
94 ה ה בעיצומה pronomial feminine singular unspecified 3 unspecified 0 	O	null
95 של של של shel-preposition unspecified unspecified unspecified unspecified unspecified  	O	null
96 מלחמת מלחמה מלחמת noun feminine singular construct unspecified unspecified  	O	null
97 ה ה העצמאות definiteArticle unspecified unspecified unspecified unspecified unspecified 0 
97 העצמאות עצמאות העצמאות noun feminine singular absolute unspecified unspecified  	O	null
98 . . . punctuation unspecified unspecified unspecified unspecified unspecified  	O	null

0 לרנר לרנר לרנר properName unspecified unspecified unspecified unspecified unspecified  	I_PERS	null
1 הוא הוא הוא pronoun masculine singular unspecified 3 unspecified  	O	null
2 מ מ מהמובילים preposition unspecified unspecified unspecified unspecified unspecified 0 
2 ה ה מהמובילים definiteArticle unspecified unspecified unspecified unspecified unspecified 0 
2 המובילים מוביל מהמובילים noun masculine plural absolute unspecified unspecified  	O	null
3 ב ב ביצירת preposition unspecified unspecified unspecified unspecified unspecified 0 
3 יצירת יצירה ביצירת noun feminine singular construct unspecified unspecified  	O	null
4 ה ה המחזאות definiteArticle unspecified unspecified unspecified unspecified unspecified 0 
4 המחזאות המחזאות המחזאות noun feminine singular absolute unspecified unspecified  	O	null
5 ה ה התיעודית definiteArticle unspecified unspecified unspecified unspecified unspecified 0 
5 התיעודית תיעודי התיעודית adjective feminine singular absolute unspecified unspecified  	O	null
6 ה ה הישראלית definiteArticle unspecified unspecified unspecified unspecified unspecified 0 
6 הישראלית ישראלי הישראלית adjective feminine singular absolute unspecified unspecified  	O	null
7 ו ו וממובילי conjunction unspecified unspecified unspecified unspecified unspecified 0 
7 מ מ וממובילי preposition unspecified unspecified unspecified unspecified unspecified 0 
7 מובילי מוביל וממובילי noun masculine plural construct unspecified unspecified  	O	null
8 ה ה המגמה definiteArticle unspecified unspecified unspecified unspecified unspecified 0 
8 המגמה מגמה המגמה noun feminine singular absolute unspecified unspecified  	O	null
9 ל ל ליצירת preposition unspecified unspecified unspecified unspecified unspecified 0 
9 יצירת יצירה ליצירת noun feminine singular construct unspecified unspecified  	O	null
10 מסורת מסורת מסורת noun feminine singular absolute unspecified unspecified  	O	null
11 של של של shel-preposition unspecified unspecified unspecified unspecified unspecified  	O	null
12 תיאטרון תיאטרון תיאטרון properName unspecified unspecified unspecified unspecified unspecified  	I_ORG	null
13 פוליטי פוליטי פוליטי adjective masculine singular absolute unspecified unspecified  	O	null
14 רדיקלי רדיקלי רדיקלי adjective masculine singular absolute unspecified unspecified  	O	null
15 ב ב בישראל preposition unspecified unspecified unspecified unspecified unspecified 0 
15 ישראל ישראל בישראל properName unspecified unspecified unspecified unspecified unspecified  	I_LOC	null
16 . . . punctuation unspecified unspecified unspecified unspecified unspecified  	O	null

0 מחזותי מחזה מחזותיו noun masculine plural absolute unspecified unspecified  
0 ו ו מחזותיו possessive masculine singular unspecified 3 unspecified 0 	O	null
1 ו ו ותסריטיו conjunction unspecified unspecified unspecified unspecified unspecified 0 
1 תסריטי תסריט ותסריטיו noun masculine plural absolute unspecified unspecified  
1 ו ו ותסריטיו possessive masculine singular unspecified 3 unspecified 0 	O	null
2 מייצגים ייצג מייצגים verb masculine plural unspecified any beinoni  	O	null
3 תופעה תופעה תופעה noun feminine singular absolute unspecified unspecified  	O	null
4 ייחודית ייחודי ייחודית adjective feminine singular absolute unspecified unspecified  	O	null
5 ב ב בנוף preposition unspecified unspecified unspecified unspecified unspecified 0 
5 נוף נוף בנוף noun masculine singular construct unspecified unspecified  	O	null
6 ה ה האמנות definiteArticle unspecified unspecified unspecified unspecified unspecified 0 
6 האמנות אמנות האמנות noun feminine singular absolute unspecified unspecified  	O	null
7 ה ה הישראלי definiteArticle unspecified unspecified unspecified unspecified unspecified 0 
7 הישראלי ישראלי הישראלי adjective masculine singular absolute unspecified unspecified  	O	null
8 : : : punctuation unspecified unspecified unspecified unspecified unspecified  	O	null
9 דרמה דרמה דרמה noun feminine singular absolute unspecified unspecified  	O	null
10 חברתית חברתי חברתית adjective feminine singular absolute unspecified unspecified  	O	null
11 פוליטית פוליטי פוליטית adjective feminine singular absolute unspecified unspecified  	O	null
12 , , , punctuation unspecified unspecified unspecified unspecified unspecified  	O	null
13 ב ב בעידן preposition unspecified unspecified unspecified unspecified unspecified 0 
13 ה ה בעידן definiteArticle unspecified unspecified unspecified unspecified unspecified 0 
13 העידן עידן בעידן noun masculine singular absolute unspecified unspecified  	O	null
14 שבו ישב שבו verb masculine-and-feminine plural unspecified 2 imperative  	O	null
15 רוב רוב רוב noun masculine singular construct unspecified unspecified  	O	null
16 ה ה היצירה definiteArticle unspecified unspecified unspecified unspecified unspecified 0 
16 היצירה יצירה היצירה noun feminine singular absolute unspecified unspecified  	O	null
17 ה ה התיאטרונית definiteArticle unspecified unspecified unspecified unspecified unspecified 0 
17 התיאטרונית התיאטרונית התיאטרונית adjective feminine singular absolute unspecified unspecified  	O	null
18 ו ו והקולנועית conjunction unspecified unspecified unspecified unspecified unspecified 0 
18 ה ה והקולנועית definiteArticle unspecified unspecified unspecified unspecified unspecified 0 
18 הקולנועית קולנועי והקולנועית adjective feminine singular absolute unspecified unspecified  	O	null
19 מתחברת התחבר מתחברת verb feminine singular unspecified any beinoni  	O	null
20 אל אל אל preposition unspecified unspecified unspecified unspecified unspecified  	O	null
21 ה ה הקונצנזוס definiteArticle unspecified unspecified unspecified unspecified unspecified 0 
21 הקונצנזוס קונצנזוס הקונצנזוס noun masculine singular absolute unspecified unspecified  	O	null
22 ה ה הפוליטי definiteArticle unspecified unspecified unspecified unspecified unspecified 0 
22 הפוליטי פוליטי הפוליטי adjective masculine singular absolute unspecified unspecified  	O	null
23 ו ו ומתחמקת conjunction unspecified unspecified unspecified unspecified unspecified 0 
23 מתחמקת התחמק ומתחמקת verb feminine singular unspecified any beinoni  	O	null
24 מ מ מלערער preposition unspecified unspecified unspecified unspecified unspecified 0 
24 לערער ערער מלערער verb unspecified unspecified unspecified unspecified infinitive  	O	null
25 על על על preposition unspecified unspecified unspecified unspecified unspecified  	O	null
26 הנחות הנחה הנחות noun feminine plural construct unspecified unspecified  	O	null
27 ה ה היסוד definiteArticle unspecified unspecified unspecified unspecified unspecified 0 
27 היסוד יסוד היסוד noun masculine singular absolute unspecified unspecified  	O	null
28 של של שלו shel-preposition unspecified unspecified unspecified unspecified unspecified  
28 ו ו שלו pronomial masculine singular unspecified 3 unspecified 0 	O	null
29 . . . punctuation unspecified unspecified unspecified unspecified unspecified  	O	null

0 References References References foreign unspecified unspecified unspecified unspecified unspecified  	O	null
1 : : : punctuation unspecified unspecified unspecified unspecified unspecified  	O	null
2 גילולה גילולה גילולה properName unspecified unspecified unspecified unspecified unspecified  	I_ORG	null
3 , , , punctuation unspecified unspecified unspecified unspecified unspecified  	O	null
4 לאה לאה לאה properName feminine singular unspecified unspecified unspecified  	I_PERS	null
5 . . . punctuation unspecified unspecified unspecified unspecified unspecified  	O	null

0 " " " punctuation unspecified unspecified unspecified unspecified unspecified  	O	null
1 רצח רצח רצח noun masculine singular construct unspecified unspecified  	O	null
2 רבי רבי רבין noun masculine singular absolute unspecified unspecified  
2 ן ן רבין possessive feminine plural unspecified 3 unspecified 0 	O	null
3 – – – punctuation unspecified unspecified unspecified unspecified unspecified  	O	null
4 ניסוי ניסוי ניסוי noun masculine singular absolute unspecified unspecified  	O	null
5 ו ו וטעייה conjunction unspecified unspecified unspecified unspecified unspecified 0 
5 טעייה טעייה וטעייה noun feminine singular absolute unspecified unspecified  	O	null
6 : : : punctuation unspecified unspecified unspecified unspecified unspecified  	O	null
7 על על על preposition unspecified unspecified unspecified unspecified unspecified  	O	null
8 ' ' ' punctuation unspecified unspecified unspecified unspecified unspecified  	O	null
9 רצח רצח רצח noun masculine singular construct unspecified unspecified  	O	null
10 יצחק יצחק יצחק properName unspecified unspecified unspecified unspecified unspecified  	O	null
11 ' ' ' punctuation unspecified unspecified unspecified unspecified unspecified  	O	null
12 מאת מאת מאת preposition unspecified unspecified unspecified unspecified unspecified  	O	null
13 מוטי מוטי מוטי properName unspecified unspecified unspecified unspecified unspecified  	I_PERS	null
14 לרנר לרנר לרנר properName unspecified unspecified unspecified unspecified unspecified  	I_PERS	null
15 " " " punctuation unspecified unspecified unspecified unspecified unspecified  	O	null
16 . . . punctuation unspecified unspecified unspecified unspecified unspecified  	O	null

0 ב ב במות preposition unspecified unspecified unspecified unspecified unspecified 0 
0 מות מוות במות noun masculine singular construct unspecified unspecified  	O	null
1 ו ו ומסך conjunction unspecified unspecified unspecified unspecified unspecified 0 
1 מ מ ומסך preposition unspecified unspecified unspecified unspecified unspecified 0 
1 סך סך ומסך noun masculine singular construct unspecified unspecified  	O	null
2 ###NUMBER### ###NUMBER### ###NUMBER### numeral unspecified unspecified unspecified unspecified unspecified  	O	null
3 . . . punctuation unspecified unspecified unspecified unspecified unspecified  	O	null

0 ###NUMBER### ###NUMBER### ###NUMBER### numeral unspecified unspecified unspecified unspecified unspecified  	I_DATE	null
1 . . . punctuation unspecified unspecified unspecified unspecified unspecified  	O	null

0 - - - punctuation unspecified unspecified unspecified unspecified unspecified  	O	null
1 ###NUMBER### ###NUMBER### ###NUMBER### numeral unspecified unspecified unspecified unspecified unspecified  	O	null
2 ; ; ; punctuation unspecified unspecified unspecified unspecified unspecified  	O	null
3 ###NUMBER### ###NUMBER### ###NUMBER### numeral unspecified unspecified unspecified unspecified unspecified  	O	null
4 קינר קינר קינר properName unspecified unspecified unspecified unspecified unspecified  	I_PERS	null
5 , , , punctuation unspecified unspecified unspecified unspecified unspecified  	O	null
6 גד גד גד properName unspecified unspecified unspecified unspecified unspecified  	I_PERS	null
7 . . . punctuation unspecified unspecified unspecified unspecified unspecified  	O	null

0 " " " punctuation unspecified unspecified unspecified unspecified unspecified  	O	null
1 ' ' ' punctuation unspecified unspecified unspecified unspecified unspecified  	O	null
2 ה ה האשליה definiteArticle unspecified unspecified unspecified unspecified unspecified 0 
2 האשליה אשליה האשליה noun feminine singular absolute unspecified unspecified  	O	null
3 ש ש שניתן relativizer/subordinatingConjunction unspecified unspecified unspecified unspecified unspecified 0 
3 ניתן ניתן שניתן modal masculine singular unspecified any unspecified  	O	null
4 לגאול גאל לגאול verb unspecified unspecified unspecified unspecified infinitive  	O	null
5 את את את at-preposition unspecified unspecified unspecified unspecified unspecified  	O	null
6 ה ה העולם definiteArticle unspecified unspecified unspecified unspecified unspecified 0 
6 העולם עולם העולם noun masculine singular absolute unspecified unspecified  	O	null
7 ב ב בכתיבה preposition unspecified unspecified unspecified unspecified unspecified 0 
7 ה ה בכתיבה definiteArticle unspecified unspecified unspecified unspecified unspecified 0 
7 הכתיבה כתיבה בכתיבה noun feminine singular absolute unspecified unspecified  	O	null
8 , , , punctuation unspecified unspecified unspecified unspecified unspecified  	O	null
9 היא הוא היא pronoun feminine singular unspecified 3 unspecified  	O	null
10 מרכיב מרכיב מרכיב noun masculine singular absolute unspecified unspecified  	O	null
11 הכרחי הכרחי הכרחי adjective masculine singular absolute unspecified unspecified  	O	null
12 ב ב בדחף preposition unspecified unspecified unspecified unspecified unspecified 0 
12 דחף דחף בדחף noun masculine singular absolute unspecified unspecified  	O	null
13 ל ל לכתוב preposition unspecified unspecified unspecified unspecified unspecified 0 
13 כתוב כתוב לכתוב noun masculine singular absolute unspecified unspecified  	O	null
14 ' ' ' punctuation unspecified unspecified unspecified unspecified unspecified  	O	null
15 : : : punctuation unspecified unspecified unspecified unspecified unspecified  	O	null
16 על על על preposition unspecified unspecified unspecified unspecified unspecified  	O	null
17 יצירת יצירה יצירת noun feminine singular construct unspecified unspecified  	O	null
18 מוטי מוטי מוטי properName unspecified unspecified unspecified unspecified unspecified  	I_PERS	null
19 לרנר לרנר לרנר properName unspecified unspecified unspecified unspecified unspecified  	I_PERS	null
20 , , , punctuation unspecified unspecified unspecified unspecified unspecified  	O	null
21 עם עם עם preposition unspecified unspecified unspecified unspecified unspecified  	O	null
22 פרסום פרסום פרסום noun masculine singular construct unspecified unspecified  	O	null
23 ה ה הספר definiteArticle unspecified unspecified unspecified unspecified unspecified 0 
23 הספר ספר הספר noun masculine singular absolute unspecified unspecified  	O	null
24 ' ' ' punctuation unspecified unspecified unspecified unspecified unspecified  	O	null
25 שבעה CARD7 שבעה numeral masculine plural absolute unspecified unspecified  	O	null
26 מחזות מחזות מחזות' noun masculine plural absolute unspecified unspecified  
26 ו ו מחזות' possessive masculine singular unspecified 3 unspecified 0 	O	null
27 " " " punctuation unspecified unspecified unspecified unspecified unspecified  	O	null
28 . . . punctuation unspecified unspecified unspecified unspecified unspecified  	O	null

0 תיאטרון תיאטרון תיאטרון properName unspecified unspecified unspecified unspecified unspecified  	I_ORG	null
1 ###NUMBER### ###NUMBER### ###NUMBER### numeral unspecified unspecified unspecified unspecified unspecified  	O	null
2 . . . punctuation unspecified unspecified unspecified unspecified unspecified  	O	null

0 ###NUMBER### ###NUMBER### ###NUMBER### numeral unspecified unspecified unspecified unspecified unspecified  	I_DATE	null
1 . . . punctuation unspecified unspecified unspecified unspecified unspecified  	O	null

0 ###NUMBER### ###NUMBER### ###NUMBER### numeral unspecified unspecified unspecified unspecified unspecified  	O	null
1 - - - punctuation unspecified unspecified unspecified unspecified unspecified  	O	null
2 ###NUMBER### ###NUMBER### ###NUMBER### numeral unspecified unspecified unspecified unspecified unspecified  	O	null
3 . . . punctuation unspecified unspecified unspecified unspecified unspecified  	O	null

