0 Name Name Name foreign unspecified unspecified unspecified unspecified unspecified  	O	null
1 : : : punctuation unspecified unspecified unspecified unspecified unspecified  	O	null
2 מזרחי מזרחי מזרחי properName unspecified unspecified unspecified unspecified unspecified  	I_PERS	null
3 , , , punctuation unspecified unspecified unspecified unspecified unspecified  	O	null
4 שי שי שי properName unspecified unspecified unspecified unspecified unspecified  	I_PERS	null
5 - - - punctuation unspecified unspecified unspecified unspecified unspecified  	O	null
6 אריה אריה אריה properName unspecified unspecified unspecified unspecified unspecified  	O	null
7 Birth Birth Birth foreign unspecified unspecified unspecified unspecified unspecified  	O	null
8 Year Year Year foreign unspecified unspecified unspecified unspecified unspecified  	O	null
9 : : : punctuation unspecified unspecified unspecified unspecified unspecified  	O	null
10 ###NUMBER### ###NUMBER### ###NUMBER### numeral unspecified unspecified unspecified unspecified unspecified  	I_DATE	null
11 Death Death Death foreign unspecified unspecified unspecified unspecified unspecified  	O	null
12 Year Year Year foreign unspecified unspecified unspecified unspecified unspecified  	O	null
13 : : : punctuation unspecified unspecified unspecified unspecified unspecified  	O	null
14 ###NUMBER### ###NUMBER### ###NUMBER### numeral unspecified unspecified unspecified unspecified unspecified  	I_DATE	null
15 Birth Birth Birth foreign unspecified unspecified unspecified unspecified unspecified  	O	null
16 Place Place Place foreign unspecified unspecified unspecified unspecified unspecified  	O	null
17 : : : punctuation unspecified unspecified unspecified unspecified unspecified  	O	null
18 גדל גדל גדל verb masculine singular unspecified 3 past  	I_LOC	null
19 ב ב בשכונת preposition unspecified unspecified unspecified unspecified unspecified 0 
19 שכונת שכונה בשכונת noun feminine singular construct unspecified unspecified  	I_LOC	null
20 תל תל תל properName unspecified unspecified unspecified unspecified unspecified  	I_LOC	null
21 Occupation Occupation Occupation foreign unspecified unspecified unspecified unspecified unspecified  	O	null
22 : : : punctuation unspecified unspecified unspecified unspecified unspecified  	O	null
23 משורר משורר משורר noun masculine singular absolute unspecified unspecified  	O	null
24 ו ו ועורך conjunction unspecified unspecified unspecified unspecified unspecified 0 
24 עורך עורך ועורך noun masculine singular construct unspecified unspecified  	O	null
25 Entry Entry Entry foreign unspecified unspecified unspecified unspecified unspecified  	O	null
26 writer writer writer foreign unspecified unspecified unspecified unspecified unspecified  	O	null
27 : : : punctuation unspecified unspecified unspecified unspecified unspecified  	O	null
28 ערן ערן ערן properName masculine singular unspecified unspecified unspecified  	I_PERS	null
29 צלגוב צלגוב צלגוב properName unspecified unspecified unspecified unspecified unspecified  	I_PERS	null
30 Entry Entry Entry foreign unspecified unspecified unspecified unspecified unspecified  	O	null
31 Value Value Value foreign unspecified unspecified unspecified unspecified unspecified  	O	null
32 : : : punctuation unspecified unspecified unspecified unspecified unspecified  	O	null
33 נולד נולד נולד verb masculine singular unspecified 3 past  	O	null
34 ו ו וגדל conjunction unspecified unspecified unspecified unspecified unspecified 0 
34 גדל גדל וגדל verb masculine singular unspecified 3 past  	I_LOC	null
35 ב ב בשכונת preposition unspecified unspecified unspecified unspecified unspecified 0 
35 שכונת שכונה בשכונת noun feminine singular construct unspecified unspecified  	I_LOC	null
36 תל תל תל properName unspecified unspecified unspecified unspecified unspecified  	I_LOC	null
37 ברוך ברוך ברוך properName unspecified unspecified unspecified unspecified unspecified  	I_LOC	null
38 ב ב בתל preposition unspecified unspecified unspecified unspecified unspecified 0 
38 תל תל בתל properName unspecified unspecified unspecified unspecified unspecified  	I_LOC	null
39 אביב אביב אביב properName unspecified unspecified unspecified unspecified unspecified  	I_LOC	null
40 . . . punctuation unspecified unspecified unspecified unspecified unspecified  	O	null

0 ב ב במהלך preposition unspecified unspecified unspecified unspecified unspecified 0 
0 מהלך מהלך במהלך noun masculine singular construct unspecified unspecified  	O	null
1 שירות שירות שירותו noun masculine singular absolute unspecified unspecified  
1 ו ו שירותו possessive masculine singular unspecified 3 unspecified 0 	O	null
2 ב ב בחיל preposition unspecified unspecified unspecified unspecified unspecified 0 
2 חיל חיל בחיל noun masculine singular construct unspecified unspecified  	I_ORG	null
3 ה ה התותחנים definiteArticle unspecified unspecified unspecified unspecified unspecified 0 
3 התותחנים תותחן התותחנים noun masculine plural absolute unspecified unspecified  	I_ORG	null
4 החל החל החל verb masculine singular unspecified 3 past  	O	null
5 לכתוב כתב לכתוב verb unspecified unspecified unspecified unspecified infinitive  	O	null
6 שירה שירה שירה noun feminine singular absolute unspecified unspecified  	O	null
7 . . . punctuation unspecified unspecified unspecified unspecified unspecified  	O	null

0 בוגר בוגר בוגר noun masculine singular construct unspecified unspecified  	O	null
1 ה ה המחזור definiteArticle unspecified unspecified unspecified unspecified unspecified 0 
1 המחזור מחזור המחזור noun masculine singular absolute unspecified unspecified  	O	null
2 ה ה הראשון definiteArticle unspecified unspecified unspecified unspecified unspecified 0 
2 הראשון ORD1 הראשון numeral masculine singular absolute unspecified unspecified  	O	null
3 של של של shel-preposition unspecified unspecified unspecified unspecified unspecified  	O	null
4 ה ה המחלקה definiteArticle unspecified unspecified unspecified unspecified unspecified 0 
4 המחלקה מחלקה המחלקה noun feminine singular absolute unspecified unspecified  	O	null
5 ל ל לפוליטיקה preposition unspecified unspecified unspecified unspecified unspecified 0 
5 ה ה לפוליטיקה definiteArticle unspecified unspecified unspecified unspecified unspecified 0 
5 הפוליטיקה פוליטיקה לפוליטיקה noun feminine singular absolute unspecified unspecified  	O	null
6 ו ו וממשל conjunction unspecified unspecified unspecified unspecified unspecified 0 
6 ממשל ממשל וממשל noun masculine singular absolute unspecified unspecified  	O	null
7 ב ב באוניברסיטת preposition unspecified unspecified unspecified unspecified unspecified 0 
7 אוניברסיטת אוניברסיטה באוניברסיטת noun feminine singular construct unspecified unspecified  	I_ORG	null
8 בן בן בן properName unspecified unspecified unspecified unspecified unspecified  	I_ORG	null
9 - - - properName unspecified unspecified unspecified unspecified unspecified  	I_ORG	null
10 גוריון גוריון גוריון properName unspecified unspecified unspecified unspecified unspecified  	I_ORG	null
11 ב ב בנגב preposition unspecified unspecified unspecified unspecified unspecified 0 
11 ה ה בנגב definiteArticle unspecified unspecified unspecified unspecified unspecified 0 
11 הנגב נגב בנגב properName unspecified unspecified unspecified unspecified unspecified  	I_LOC	null
12 . . . punctuation unspecified unspecified unspecified unspecified unspecified  	O	null

0 עם עם עם preposition unspecified unspecified unspecified unspecified unspecified  	O	null
1 סיום סיום סיום noun masculine singular construct unspecified unspecified  	O	null
2 לימודי לימוד לימודיו noun masculine plural absolute unspecified unspecified  
2 ו ו לימודיו possessive masculine singular unspecified 3 unspecified 0 	O	null
3 המשיך המשיך המשיך verb masculine singular unspecified 3 past  	O	null
4 ללמוד למד ללמוד verb unspecified unspecified unspecified unspecified infinitive  	O	null
5 עריכה עריכה עריכה noun feminine singular absolute unspecified unspecified  	O	null
6 לשונית לשוני לשונית adjective feminine singular absolute unspecified unspecified  	O	null
7 ב ב במכללת preposition unspecified unspecified unspecified unspecified unspecified 0 
7 מכללת מכללה במכללת noun feminine singular construct unspecified unspecified  	O	null
8 " " " punctuation unspecified unspecified unspecified unspecified unspecified  	O	null
9 בית בית בית properName unspecified unspecified unspecified unspecified unspecified  	I_ORG	null
10 ברל ברל ברל properName unspecified unspecified unspecified unspecified unspecified  	I_ORG	null
11 " " " punctuation unspecified unspecified unspecified unspecified unspecified  	O	null
12 ו ו ועבד conjunction unspecified unspecified unspecified unspecified unspecified 0 
12 עבד עבד ועבד verb masculine singular unspecified 3 past  	O	null
13 ל ל למחייתו preposition unspecified unspecified unspecified unspecified unspecified 0 
13 מחיית מחיה למחייתו noun feminine singular absolute unspecified unspecified  
13 ו ו למחייתו possessive masculine singular unspecified 3 unspecified 0 	O	null
14 כ כ כעורך preposition unspecified unspecified unspecified unspecified unspecified 0 
14 עורך עורך כעורך noun masculine singular construct unspecified unspecified  	O	null
15 ו ו וכנקדן conjunction unspecified unspecified unspecified unspecified unspecified 0 
15 כ כ וכנקדן preposition unspecified unspecified unspecified unspecified unspecified 0 
15 ה ה וכנקדן definiteArticle unspecified unspecified unspecified unspecified unspecified 0 
15 הנקדן נקדן וכנקדן noun masculine singular absolute unspecified unspecified  	O	null
16 עצמאי עצמאי עצמאי adjective masculine singular absolute unspecified unspecified  	O	null
17 ו ו ובהוצאות conjunction unspecified unspecified unspecified unspecified unspecified 0 
17 ב ב ובהוצאות preposition unspecified unspecified unspecified unspecified unspecified 0 
17 הוצאות הוצאה ובהוצאות noun feminine plural construct unspecified unspecified  	O	null
18 גוונים גוון גוונים noun masculine plural absolute unspecified unspecified  	O	null
19 ו ו ורימונים conjunction unspecified unspecified unspecified unspecified unspecified 0 
19 רימונים רימון ורימונים noun masculine plural absolute unspecified unspecified  	O	null
20 . . . punctuation unspecified unspecified unspecified unspecified unspecified  	O	null

0 שירי שיר שיריו noun masculine plural absolute unspecified unspecified  
0 ו ו שיריו possessive masculine singular unspecified 3 unspecified 0 	O	null
1 התפרסמו התפרסם התפרסמו verb masculine-and-feminine plural unspecified 3 past  	O	null
2 ב ב בבמות preposition unspecified unspecified unspecified unspecified unspecified 0 
2 במות במה בבמות noun feminine plural absolute unspecified unspecified  	O	null
3 שונות שונה שונות adjective feminine plural absolute unspecified unspecified  	O	null
4 , , , punctuation unspecified unspecified unspecified unspecified unspecified  	O	null
5 ב ב בהן preposition unspecified unspecified unspecified unspecified unspecified 0 
5 הן הוא בהן pronoun feminine plural unspecified 3 unspecified  	O	null
6 : : : punctuation unspecified unspecified unspecified unspecified unspecified  	O	null
7 עתון עיתון עתון noun masculine singular absolute unspecified unspecified  	O	null
8 , , , punctuation unspecified unspecified unspecified unspecified unspecified  	O	null
9 ###NUMBER### ###NUMBER### ###NUMBER### numeral unspecified unspecified unspecified unspecified unspecified  	O	null
10 ה ה הקשת definiteArticle unspecified unspecified unspecified unspecified unspecified 0 
10 הקשת קשת הקשת noun feminine singular absolute unspecified unspecified  	O	null
11 ה ה החדשה definiteArticle unspecified unspecified unspecified unspecified unspecified 0 
11 החדשה חדש החדשה adjective feminine singular absolute unspecified unspecified  	O	null
12 , , , punctuation unspecified unspecified unspecified unspecified unspecified  	O	null
13 שבוומוספי שבוומוספי שבוומוספי verb masculine-and-feminine plural unspecified 2 imperative  	O	null
14 ה ה הספרות definiteArticle unspecified unspecified unspecified unspecified unspecified 0 
14 הספרות ספרות הספרות noun feminine singular absolute unspecified unspecified  	O	null
15 של של של shel-preposition unspecified unspecified unspecified unspecified unspecified  	O	null
16 ה ה הארץוידיעות definiteArticle unspecified unspecified unspecified unspecified unspecified 0 
16 הארץוידיעות הארץוידיעות הארץוידיעות adjective feminine plural absolute unspecified unspecified  	O	null
17 אחרונות אחרון אחרונות adjective feminine plural absolute unspecified unspecified  	O	null
18 . . . punctuation unspecified unspecified unspecified unspecified unspecified  	O	null

0 כבר כבר כבר adverb unspecified unspecified unspecified unspecified unspecified  	O	null
1 ב ב בספרו preposition unspecified unspecified unspecified unspecified unspecified 0 
1 ספר ספר בספרו noun masculine singular absolute unspecified unspecified  
1 ו ו בספרו possessive masculine singular unspecified 3 unspecified 0 	O	null
2 ה ה הראשון definiteArticle unspecified unspecified unspecified unspecified unspecified 0 
2 הראשון ORD1 הראשון numeral masculine singular absolute unspecified unspecified  	O	null
3 , , , punctuation unspecified unspecified unspecified unspecified unspecified  	O	null
4 ציוּן ציוּן ציוּן verb masculine singular unspecified 2 imperative  	O	null
5 ( ( ( punctuation unspecified unspecified unspecified unspecified unspecified  	I_LOC	null
6 כרמל כרמל כרמל properName unspecified unspecified unspecified unspecified unspecified  	I_PERS	null
7 , , , punctuation unspecified unspecified unspecified unspecified unspecified  	O	null
8 ) ) ) punctuation unspecified unspecified unspecified unspecified unspecified  	O	null
9 , , , punctuation unspecified unspecified unspecified unspecified unspecified  	O	null
10 ###NUMBER### ###NUMBER### ###NUMBER### numeral unspecified unspecified unspecified unspecified unspecified  	I_DATE	null
11 אך אך אך conjunction unspecified unspecified unspecified unspecified unspecified  	O	null
12 גם גם גם conjunction unspecified unspecified unspecified unspecified unspecified  	O	null
13 ב ב בספרו preposition unspecified unspecified unspecified unspecified unspecified 0 
13 ספר ספר בספרו noun masculine singular absolute unspecified unspecified  
13 ו ו בספרו possessive masculine singular unspecified 3 unspecified 0 	O	null
14 ה ה השני definiteArticle unspecified unspecified unspecified unspecified unspecified 0 
14 השני ORD2 השני numeral masculine singular absolute unspecified unspecified  	O	null
15 , , , punctuation unspecified unspecified unspecified unspecified unspecified  	O	null
16 הוא הוא הוא pronoun masculine singular unspecified 3 unspecified  	O	null
17 ה ה המסמן definiteArticle unspecified unspecified unspecified unspecified unspecified 0 
17 המסמן סימן המסמן participle masculine singular absolute any unspecified  	O	null
18 את את את at-preposition unspecified unspecified unspecified unspecified unspecified  	O	null
19 ה ה המקום definiteArticle unspecified unspecified unspecified unspecified unspecified 0 
19 המקום מקום המקום noun masculine singular absolute unspecified unspecified  	O	null
20 ( ( ( punctuation unspecified unspecified unspecified unspecified unspecified  	O	null
21 ) ) ) punctuation unspecified unspecified unspecified unspecified unspecified  	O	null
22 , , , punctuation unspecified unspecified unspecified unspecified unspecified  	O	null
23 ###NUMBER### ###NUMBER### ###NUMBER### numeral unspecified unspecified unspecified unspecified unspecified  	I_DATE	null
24 ניתן ניתן ניתן modal masculine singular unspecified any unspecified  	O	null
25 לזהות זיהה לזהות verb unspecified unspecified unspecified unspecified infinitive  	O	null
26 כי כי כי conjunction unspecified unspecified unspecified unspecified unspecified  	O	null
27 לדידו לדידו לדידו adverb unspecified unspecified unspecified unspecified unspecified  	O	null
28 ה ה השירה definiteArticle unspecified unspecified unspecified unspecified unspecified 0 
28 השירה שירה השירה noun feminine singular absolute unspecified unspecified  	O	null
29 עצמה עצם עצמה verb feminine singular unspecified 3 past  	O	null
30 , , , punctuation unspecified unspecified unspecified unspecified unspecified  	O	null
31 ו ו והיא conjunction unspecified unspecified unspecified unspecified unspecified 0 
31 היא הוא והיא pronoun feminine singular unspecified 3 unspecified  	O	null
32 לבד לבד לבדה noun masculine singular absolute unspecified unspecified  
32 ה ה לבדה possessive feminine singular unspecified 3 unspecified 0 	O	null
33 , , , punctuation unspecified unspecified unspecified unspecified unspecified  	O	null
34 היאסימוןשל היאסימוןשל היאסימוןשל adjective masculine singular construct unspecified unspecified  	O	null
35 מקום מקום מקום noun masculine singular absolute unspecified unspecified  	O	null
36 או או או conjunction unspecified unspecified unspecified unspecified unspecified  	O	null
37 ציון ציון ציון properName unspecified unspecified unspecified unspecified unspecified  	I_PERS	null
38 דרך דרך דרך noun feminine singular absolute unspecified unspecified  	O	null
39 ב ב בחייו preposition unspecified unspecified unspecified unspecified unspecified 0 
39 חיי חיים בחייו noun masculine plural absolute unspecified unspecified  
39 ו ו בחייו possessive masculine singular unspecified 3 unspecified 0 	O	null
40 של של של shel-preposition unspecified unspecified unspecified unspecified unspecified  	O	null
41 כל כול כל quantifier unspecified unspecified construct unspecified unspecified  	O	null
42 אדם אדם אדם noun masculine singular absolute unspecified unspecified  	O	null
43 . . . punctuation unspecified unspecified unspecified unspecified unspecified  	O	null

0 ל ל למורכבות preposition unspecified unspecified unspecified unspecified unspecified 0 
0 מורכבות מורכבות למורכבות noun feminine singular construct unspecified unspecified  	O	null
1 ה ה החיים definiteArticle unspecified unspecified unspecified unspecified unspecified 0 
1 החיים חיים החיים noun masculine plural absolute unspecified unspecified  	O	null
2 יש יש יש existential unspecified unspecified unspecified unspecified unspecified  	O	null
3 פתרון פתרון פתרון noun masculine singular absolute unspecified unspecified  	O	null
4 דרך דרך דרך preposition unspecified unspecified unspecified unspecified unspecified  	O	null
5 ה ה השירה definiteArticle unspecified unspecified unspecified unspecified unspecified 0 
5 השירה שירה השירה noun feminine singular absolute unspecified unspecified  	O	null
6 , , , punctuation unspecified unspecified unspecified unspecified unspecified  	O	null
7 ה ה הנותנת definiteArticle unspecified unspecified unspecified unspecified unspecified 0 
7 הנותנת נתן הנותנת participle feminine singular absolute any unspecified  	O	null
8 ל ל להם preposition unspecified unspecified unspecified unspecified unspecified  
8 הם הם להם pronomial masculine plural unspecified 3 unspecified 0 	O	null
9 משמעות משמעות משמעות noun feminine singular absolute unspecified unspecified  	O	null
10 ו ו ומציינת conjunction unspecified unspecified unspecified unspecified unspecified 0 
10 מציינת ציין ומציינת verb feminine singular unspecified any beinoni  	O	null
11 ב ב בהם preposition unspecified unspecified unspecified unspecified unspecified  
11 הם הם בהם pronomial masculine plural unspecified 3 unspecified 0 	O	null
12 סימנים סימן סימנים noun masculine plural absolute unspecified unspecified  	O	null
13 . . . punctuation unspecified unspecified unspecified unspecified unspecified  	O	null

0 ה ה השירה definiteArticle unspecified unspecified unspecified unspecified unspecified 0 
0 השירה שירה השירה noun feminine singular absolute unspecified unspecified  	O	null
1 לפי לפי לפי preposition unspecified unspecified unspecified unspecified unspecified  	O	null
2 מזרחי מזרחי מזרחי properName unspecified unspecified unspecified unspecified unspecified  	I_PERS	null
3 נמצאת נמצא נמצאת verb feminine singular unspecified any beinoni  	O	null
4 ב ב בכול preposition unspecified unspecified unspecified unspecified unspecified 0 
4 כול כול בכול quantifier unspecified unspecified construct unspecified unspecified  	O	null
5 , , , punctuation unspecified unspecified unspecified unspecified unspecified  	O	null
6 יש יש יש existential unspecified unspecified unspecified unspecified unspecified  	O	null
7 רק רק רק conjunction unspecified unspecified unspecified unspecified unspecified  	O	null
8 למצוא מצא למצוא verb unspecified unspecified unspecified unspecified infinitive  	O	null
9 דרך דרך דרך noun feminine singular absolute unspecified unspecified  	O	null
10 לתת נתן לתת verb unspecified unspecified unspecified unspecified infinitive  	O	null
11 ל ל לה preposition unspecified unspecified unspecified unspecified unspecified  
11 ה ה לה pronomial feminine singular unspecified 3 unspecified 0 	O	null
12 ביטוי ביטוי ביטוי noun masculine singular absolute unspecified unspecified  	O	null
13 . . . punctuation unspecified unspecified unspecified unspecified unspecified  	O	null

0 כך כך כך adverb unspecified unspecified unspecified unspecified unspecified  	I_ORG	null
1 , , , punctuation unspecified unspecified unspecified unspecified unspecified  	O	null
2 למשל למשל למשל conjunction unspecified unspecified unspecified unspecified unspecified  	O	null
3 , , , punctuation unspecified unspecified unspecified unspecified unspecified  	O	null
4 עולה עלה עולה verb masculine singular unspecified any beinoni  	O	null
5 מ מ משירו preposition unspecified unspecified unspecified unspecified unspecified 0 
5 שיר שיר משירו noun masculine singular absolute unspecified unspecified  
5 ו ו משירו possessive masculine singular unspecified 3 unspecified 0 	O	null
6 " " " punctuation unspecified unspecified unspecified unspecified unspecified  	O	null
7 שפה שפה שפה noun feminine singular absolute unspecified unspecified  	O	null
8 " " " punctuation unspecified unspecified unspecified unspecified unspecified  	O	null
9 מתוך מתוך מתוך preposition unspecified unspecified unspecified unspecified unspecified  	O	null
10 הוא הוא הוא pronoun masculine singular unspecified 3 unspecified  	O	null
11 ה ה המסמן definiteArticle unspecified unspecified unspecified unspecified unspecified 0 
11 המסמן סימן המסמן participle masculine singular absolute any unspecified  	O	null
12 את את את at-preposition unspecified unspecified unspecified unspecified unspecified  	O	null
13 ה ה המקום definiteArticle unspecified unspecified unspecified unspecified unspecified 0 
13 המקום מקום המקום noun masculine singular absolute unspecified unspecified  	O	null
14 : : : punctuation unspecified unspecified unspecified unspecified unspecified  	O	null
15 " " " punctuation unspecified unspecified unspecified unspecified unspecified  	O	null
16 שְׂפַת שְׂפַת שְׂפַת properName unspecified unspecified unspecified unspecified unspecified  	I_ORG	null
17 הָאוֹטוֹבּוּס הָאוֹטוֹבּוּס הָאוֹטוֹבּוּס properName unspecified unspecified unspecified unspecified unspecified  	I_ORG	null
18 קָשָׁה קָשָׁה קָשָׁה properName unspecified unspecified unspecified unspecified unspecified  	I_ORG	null
19 . . . punctuation unspecified unspecified unspecified unspecified unspecified  	O	null

0 אֶגְזוֹזו אֶגְזוֹזו אֶגְזוֹזו properName unspecified unspecified unspecified unspecified unspecified  	I_PERS	null
1 ֹ ֹ ֹ punctuation unspecified unspecified unspecified unspecified unspecified  	O	null
2 / / / punctuation unspecified unspecified unspecified unspecified unspecified  	O	null
3 פּוֹלֵט פּוֹלֵט פּוֹלֵט noun masculine singular absolute unspecified unspecified  	O	null
4 חֲרוּזִים חֲרוּזִים חֲרוּזִים noun masculine plural absolute unspecified unspecified  	O	null
5 כְּנַעֲנִיִּם כְּנַעֲנִיִּם כְּנַעֲנִיִּם properName unspecified unspecified unspecified unspecified unspecified  	I_PERS	null
6 , , , punctuation unspecified unspecified unspecified unspecified unspecified  	O	null
7 יְצוּקִים יְצוּקִים יְצוּקִים noun masculine plural absolute unspecified unspecified  	O	null
8 / / / punctuation unspecified unspecified unspecified unspecified unspecified  	O	null
9 [ [ [ punctuation unspecified unspecified unspecified unspecified unspecified  	O	null
10 ... ... ... punctuation unspecified unspecified unspecified unspecified unspecified  	O	null
11 ] ] ] punctuation unspecified unspecified unspecified unspecified unspecified  	O	null
12 כָּל כָּל כָּל properName unspecified unspecified unspecified unspecified unspecified  	I_PERS	null
13 הַשְּׁאָר הַשְּׁאָר הַשְּׁאָר properName unspecified unspecified unspecified unspecified unspecified  	I_PERS	null
14 , , , punctuation unspecified unspecified unspecified unspecified unspecified  	O	null
15 מְכוֹנִיּוֹת מְכוֹנִיּוֹת מְכוֹנִיּוֹת properName unspecified unspecified unspecified unspecified unspecified  	I_PERS	null
16 , , , punctuation unspecified unspecified unspecified unspecified unspecified  	O	null
17 מוֹנִיּוֹת מוֹנִיּוֹת מוֹנִיּוֹת properName unspecified unspecified unspecified unspecified unspecified  	I_PERS	null
18 , , , punctuation unspecified unspecified unspecified unspecified unspecified  	O	null
19 / / / punctuation unspecified unspecified unspecified unspecified unspecified  	O	null
20 מְרַיְּרוֹת מְרַיְּרוֹת מְרַיְּרוֹת noun masculine singular absolute unspecified unspecified  	O	null
21 פְּרוֹזָה פְּרוֹזָה פְּרוֹזָה properName unspecified unspecified unspecified unspecified unspecified  	I_PERS	null
22 שְׂטָנִית שְׂטָנִית שְׂטָנִית noun feminine singular construct unspecified unspecified  	O	null
23 , , , punctuation unspecified unspecified unspecified unspecified unspecified  	O	null
24 קַטְנוֹעִים קַטְנוֹעִים קַטְנוֹעִים noun feminine singular absolute unspecified unspecified  	O	null
25 / / / punctuation unspecified unspecified unspecified unspecified unspecified  	O	null
26 כּוֹתְבִים כּוֹתְבִים כּוֹתְבִים preposition unspecified unspecified unspecified unspecified unspecified  	O	null
27 אֶת אֶת אֶת noun masculine singular absolute unspecified unspecified  	O	null
28 יְפִי יְפִי יְפִי properName unspecified unspecified unspecified unspecified unspecified  	I_PERS	null
29 הַנְּעוּרִים הַנְּעוּרִים הַנְּעוּרִים verb masculine singular unspecified 3 past  	O	null
30 ב ב בְּשִׁירָה preposition unspecified unspecified unspecified unspecified unspecified 0 
30 ְּשִׁירָה ְּשִׁירָה בְּשִׁירָה noun masculine singular absolute unspecified unspecified  	O	null
31 ב ב בְּשׁוּרוֹת preposition unspecified unspecified unspecified unspecified unspecified 0 
31 ה ה בְּשׁוּרוֹת definiteArticle unspecified unspecified unspecified unspecified unspecified 0 
31 הְּשׁוּרוֹת הְּשׁוּרוֹת בְּשׁוּרוֹת noun masculine singular absolute unspecified unspecified  	O	null
32 אֲרֻכּוֹת אֲרֻכּוֹת אֲרֻכּוֹת noun feminine singular construct unspecified unspecified  	O	null
33 " " " punctuation unspecified unspecified unspecified unspecified unspecified  	O	null
34 . . . punctuation unspecified unspecified unspecified unspecified unspecified  	O	null

0 ב ב ב preposition unspecified unspecified unspecified unspecified unspecified 0 	I_ORG	null
1 - - - punctuation unspecified unspecified unspecified unspecified unspecified  	I_ORG	null
2 ###NUMBER### ###NUMBER### ###NUMBER### numeral unspecified unspecified unspecified unspecified unspecified  	I_DATE	null
3 הקים הקים הקים verb masculine singular unspecified 3 past  	O	null
4 ו ו והחל conjunction unspecified unspecified unspecified unspecified unspecified 0 
4 החל החל והחל verb masculine singular unspecified 3 past  	O	null
5 עורך ערך עורך verb masculine singular unspecified any beinoni  	O	null
6 את את את at-preposition unspecified unspecified unspecified unspecified unspecified  	O	null
7 אתר אתר אתר noun masculine singular construct unspecified unspecified  	O	null
8 כאוסלאירוח כאוסלאירוח כאוסלאירוח properName unspecified unspecified unspecified unspecified unspecified  	O	null
9 ו ו וביקורת conjunction unspecified unspecified unspecified unspecified unspecified 0 
9 ביקורת ביקורת וביקורת noun feminine singular construct unspecified unspecified  	O	null
10 שירה שירה שירה noun feminine singular absolute unspecified unspecified  	O	null
11 . . . punctuation unspecified unspecified unspecified unspecified unspecified  	O	null

0 היה הוא היה copula masculine singular unspecified 3 past  	O	null
1 פעיל פעיל פעיל noun masculine singular absolute unspecified unspecified  	O	null
2 בולט בולט בולט adjective masculine singular absolute unspecified unspecified  	O	null
3 ב ב ב preposition unspecified unspecified unspecified unspecified unspecified 0 	O	null
4 " " " punctuation unspecified unspecified unspecified unspecified unspecified  	O	null
5 מאבק מאבק מאבק noun masculine singular construct unspecified unspecified  	O	null
6 ה ה המשוררים definiteArticle unspecified unspecified unspecified unspecified unspecified 0 
6 המשוררים משורר המשוררים noun masculine plural absolute unspecified unspecified  	O	null
7 " " " punctuation unspecified unspecified unspecified unspecified unspecified  	O	null
8 ו ו ובקבוצת conjunction unspecified unspecified unspecified unspecified unspecified 0 
8 ב ב ובקבוצת preposition unspecified unspecified unspecified unspecified unspecified 0 
8 קבוצת קבוצה ובקבוצת noun feminine singular construct unspecified unspecified  	O	null
9 ה ה המשוררים definiteArticle unspecified unspecified unspecified unspecified unspecified 0 
9 המשוררים משורר המשוררים noun masculine plural absolute unspecified unspecified  	O	null
10 " " " punctuation unspecified unspecified unspecified unspecified unspecified  	O	null
11 גרילה גרילה גרילה noun feminine singular absolute unspecified unspecified  	O	null
12 תרבות תרבות תרבות noun feminine singular absolute unspecified unspecified  	O	null
13 " " " punctuation unspecified unspecified unspecified unspecified unspecified  	O	null
14 . . . punctuation unspecified unspecified unspecified unspecified unspecified  	O	null

0 על על על preposition unspecified unspecified unspecified unspecified unspecified  	O	null
1 סיפור סיפור סיפורו noun masculine singular absolute unspecified unspecified  
1 ו ו סיפורו possessive masculine singular unspecified 3 unspecified 0 	O	null
2 ה ה הקצרצר definiteArticle unspecified unspecified unspecified unspecified unspecified 0 
2 הקצרצר הקצרצר הקצרצר adjective masculine singular absolute unspecified unspecified  	O	null
3 : : : punctuation unspecified unspecified unspecified unspecified unspecified  	O	null
4 " " " punctuation unspecified unspecified unspecified unspecified unspecified  	O	null
5 ל ל לכבוד preposition unspecified unspecified unspecified unspecified unspecified 0 
5 ה ה לכבוד definiteArticle unspecified unspecified unspecified unspecified unspecified 0 
5 הכבוד כבוד לכבוד noun masculine singular absolute unspecified unspecified  	O	null
6 . . . punctuation unspecified unspecified unspecified unspecified unspecified  	O	null

0 שלום שלום שלום noun masculine singular construct unspecified unspecified  	O	null
1 . . . punctuation unspecified unspecified unspecified unspecified unspecified  	O	null

0 אבקש ביקש אבקש verb masculine-and-feminine singular unspecified 1 future  	O	null
1 לדון דן לדון verb unspecified unspecified unspecified unspecified infinitive  	O	null
2 ב ב ב preposition unspecified unspecified unspecified unspecified unspecified  	O	null
3 . . . punctuation unspecified unspecified unspecified unspecified unspecified  	O	null

0 אציין ציין אציין verb masculine-and-feminine singular unspecified 1 future  	O	null
1 כי כי כי conjunction unspecified unspecified unspecified unspecified unspecified  	O	null
2 אני אני אני noun masculine singular absolute unspecified unspecified  	O	null
3 . . . punctuation unspecified unspecified unspecified unspecified unspecified  	O	null

0 זאת זאת זאת pronoun feminine singular unspecified 3 unspecified  	O	null
1 ו ו ולפי conjunction unspecified unspecified unspecified unspecified unspecified 0 
1 לפי לפי ולפי preposition unspecified unspecified unspecified unspecified unspecified  	O	null
2 . . . punctuation unspecified unspecified unspecified unspecified unspecified  	O	null

0 ו ו ולפי conjunction unspecified unspecified unspecified unspecified unspecified 0 
0 לפי לפי ולפי preposition unspecified unspecified unspecified unspecified unspecified  	O	null
1 . . . punctuation unspecified unspecified unspecified unspecified unspecified  	O	null

0 עבדתי עבד עבדתי verb masculine-and-feminine singular unspecified 1 past  	O	null
1 . . . punctuation unspecified unspecified unspecified unspecified unspecified  	O	null

0 הכנסותַי הכנסותַי הכנסותַי verb feminine singular unspecified 2 imperative  	O	null
1 היו הוא היו copula masculine plural unspecified 2 imperative  	O	null
2 . . . punctuation unspecified unspecified unspecified unspecified unspecified  	O	null

0 עבדתי עבד עבדתי verb masculine-and-feminine singular unspecified 1 past  	O	null
1 . . . punctuation unspecified unspecified unspecified unspecified unspecified  	O	null

0 הייתי הוא הייתי copula masculine-and-feminine singular unspecified 1 past  	O	null
1 זכאי זכאי זכאי adjective masculine singular absolute unspecified unspecified  	O	null
2 . . . punctuation unspecified unspecified unspecified unspecified unspecified  	O	null

0 בלבד בלבד בלבד adverb unspecified unspecified unspecified unspecified unspecified  	O	null
1 . . . punctuation unspecified unspecified unspecified unspecified unspecified  	O	null

0 ה ה החישוב definiteArticle unspecified unspecified unspecified unspecified unspecified 0 
0 החישוב חישוב החישוב noun masculine singular absolute unspecified unspecified  	O	null
1 נעשה נעשה נעשה verb masculine singular unspecified 3 past  	O	null
2 לפי לפי לפי preposition unspecified unspecified unspecified unspecified unspecified  	O	null
3 . . . punctuation unspecified unspecified unspecified unspecified unspecified  	O	null

0 ו ו ולפי conjunction unspecified unspecified unspecified unspecified unspecified 0 
0 לפי לפי ולפי preposition unspecified unspecified unspecified unspecified unspecified  	O	null
1 . . . punctuation unspecified unspecified unspecified unspecified unspecified  	O	null

0 כיום כיום כיום adverb unspecified unspecified unspecified unspecified unspecified  	O	null
1 אני אני אני noun masculine singular absolute unspecified unspecified  	O	null
2 . . . punctuation unspecified unspecified unspecified unspecified unspecified  	O	null

0 ב ב בתודה preposition unspecified unspecified unspecified unspecified unspecified 0 
0 תודה תודה בתודה noun feminine singular absolute unspecified unspecified  	O	null
1 " " " punctuation unspecified unspecified unspecified unspecified unspecified  	O	null
2 , , , punctuation unspecified unspecified unspecified unspecified unspecified  	O	null
3 זכה זכה זכה verb masculine singular unspecified 3 past  	O	null
4 ב ב במקום preposition unspecified unspecified unspecified unspecified unspecified 0 
4 ה ה במקום definiteArticle unspecified unspecified unspecified unspecified unspecified 0 
4 המקום מקום במקום noun masculine singular absolute unspecified unspecified  	O	null
5 ה ה הראשון definiteArticle unspecified unspecified unspecified unspecified unspecified 0 
5 הראשון ORD1 הראשון numeral masculine singular absolute unspecified unspecified  	O	null
6 ב ב בתחרות preposition unspecified unspecified unspecified unspecified unspecified 0 
6 ה ה בתחרות definiteArticle unspecified unspecified unspecified unspecified unspecified 0 
6 התחרות תחרות בתחרות noun feminine singular absolute unspecified unspecified  	O	null
7 " " " punctuation unspecified unspecified unspecified unspecified unspecified  	O	null
8 צרצר צרצר צרצר noun masculine singular construct unspecified unspecified  	O	null
9 ה ה הפיס definiteArticle unspecified unspecified unspecified unspecified unspecified 0 
9 הפיס פיס הפיס noun masculine singular absolute unspecified unspecified  	O	null
10 " " " punctuation unspecified unspecified unspecified unspecified unspecified  	O	null
11 , , , punctuation unspecified unspecified unspecified unspecified unspecified  	O	null
12 ###NUMBER### ###NUMBER### ###NUMBER### numeral unspecified unspecified unspecified unspecified unspecified  	I_DATE	null
13 תחרות תחרות תחרות noun feminine singular absolute unspecified unspecified  	O	null
14 כתיבת כתיבה כתיבת noun feminine singular construct unspecified unspecified  	O	null
15 סיפור סיפור סיפור noun masculine singular construct unspecified unspecified  	O	null
16 ב ב בן preposition unspecified unspecified unspecified unspecified unspecified  
16 הן הן בן pronomial feminine plural unspecified 3 unspecified 0 	O	null
17 ###NUMBER### ###NUMBER### ###NUMBER### numeral unspecified unspecified unspecified unspecified unspecified  	O	null
18 תווים תו תווים noun masculine plural absolute unspecified unspecified  	O	null
19 של של של shel-preposition unspecified unspecified unspecified unspecified unspecified  	O	null
20 מפעל מפעל מפעל noun masculine singular construct unspecified unspecified  	O	null
21 ה ה הפיס definiteArticle unspecified unspecified unspecified unspecified unspecified 0 
21 הפיס פיס הפיס noun masculine singular absolute unspecified unspecified  	O	null
22 . . . punctuation unspecified unspecified unspecified unspecified unspecified  	O	null

0 היה הוא היה copula masculine singular unspecified 3 past  	O	null
1 פעיל פעיל פעיל adjective masculine singular absolute unspecified unspecified  	O	null
2 שמאל שמאל שמאל noun masculine singular absolute unspecified unspecified  	O	null
3 מוחץ מחץ מוחצן participle masculine singular unspecified any unspecified  
3 ן ן מוחצן possessive feminine plural unspecified 3 unspecified 0 	I_ORG	null
4 ו ו וקולני conjunction unspecified unspecified unspecified unspecified unspecified 0 
4 קולני קולני וקולני adjective masculine singular absolute unspecified unspecified  	I_ORG	null
5 , , , punctuation unspecified unspecified unspecified unspecified unspecified  	O	null
6 דבר דבר דבר noun masculine singular absolute unspecified unspecified  	O	null
7 ש ש שהובילו relativizer/subordinatingConjunction unspecified unspecified unspecified unspecified unspecified 0 
7 הובילו הוביל שהובילו verb masculine-and-feminine plural unspecified 3 past  	O	null
8 ל ל לעימותים preposition unspecified unspecified unspecified unspecified unspecified 0 
8 עימותים עימות לעימותים noun feminine plural absolute unspecified unspecified  	O	null
9 חריפים חריף חריפים adjective masculine plural absolute unspecified unspecified  	O	null
10 עם עם עם preposition unspecified unspecified unspecified unspecified unspecified  	O	null
11 פעילי פעיל פעילי noun masculine plural construct unspecified unspecified  	O	null
12 ימין ימין ימין noun masculine singular absolute unspecified unspecified  	O	null
13 . . . punctuation unspecified unspecified unspecified unspecified unspecified  	O	null

0 ב ב ב preposition unspecified unspecified unspecified unspecified unspecified 0 	O	null
1 - - - punctuation unspecified unspecified unspecified unspecified unspecified  	O	null
2 , , , punctuation unspecified unspecified unspecified unspecified unspecified  	O	null
3 ###NUMBER### ###NUMBER### ###NUMBER### numeral unspecified unspecified unspecified unspecified unspecified  	I_DATE	null
4 ערב ערב ערב noun masculine singular construct unspecified unspecified  	O	null
5 יום יום יום noun masculine singular construct unspecified unspecified  	O	null
6 הולדת הולדה הולדתו noun feminine singular absolute unspecified unspecified  
6 ו ו הולדתו possessive masculine singular unspecified 3 unspecified 0 	O	null
7 ה ה ה numeral unspecified unspecified unspecified unspecified unspecified  	O	null
8 - - - punctuation unspecified unspecified unspecified unspecified unspecified  	O	null
9 , , , punctuation unspecified unspecified unspecified unspecified unspecified  	O	null
10 ###NUMBER### ###NUMBER### ###NUMBER### numeral unspecified unspecified unspecified unspecified unspecified  	O	null
11 שם שם שם noun masculine singular construct unspecified unspecified  	O	null
12 קץ קץ קץ noun masculine singular absolute unspecified unspecified  	O	null
13 ל ל לחייו preposition unspecified unspecified unspecified unspecified unspecified 0 
13 חיי חיים לחייו noun masculine plural absolute unspecified unspecified  
13 ו ו לחייו possessive masculine singular unspecified 3 unspecified 0 	O	null
14 . . . punctuation unspecified unspecified unspecified unspecified unspecified  	O	null

0 References References References foreign unspecified unspecified unspecified unspecified unspecified  	O	null
1 : : : punctuation unspecified unspecified unspecified unspecified unspecified  	O	null
2 גלעד גלעד גלעד properName unspecified unspecified unspecified unspecified unspecified  	I_PERS	null
3 , , , punctuation unspecified unspecified unspecified unspecified unspecified  	O	null
4 יובל יובל יובל properName unspecified unspecified unspecified unspecified unspecified  	I_PERS	null
5 . . . punctuation unspecified unspecified unspecified unspecified unspecified  	O	null

0 " " " punctuation unspecified unspecified unspecified unspecified unspecified  	O	null
1 נלחם נלחם נלחם verb masculine singular unspecified 3 past  	O	null
2 ב ב בידיעה preposition unspecified unspecified unspecified unspecified unspecified 0 
2 ה ה בידיעה definiteArticle unspecified unspecified unspecified unspecified unspecified 0 
2 הידיעה ידיעה בידיעה noun feminine singular absolute unspecified unspecified  	O	null
3 " " " punctuation unspecified unspecified unspecified unspecified unspecified  	O	null
4 . . . punctuation unspecified unspecified unspecified unspecified unspecified  	O	null

0 עתון עיתון עתון noun masculine singular construct unspecified unspecified  	O	null
1 ###NUMBER### ###NUMBER### ###NUMBER### numeral unspecified unspecified unspecified unspecified unspecified  	O	null
2 ###NUMBER### ###NUMBER### ###NUMBER### numeral unspecified unspecified unspecified unspecified unspecified  	O	null
3 . . . punctuation unspecified unspecified unspecified unspecified unspecified  	O	null

0 ###NUMBER### ###NUMBER### ###NUMBER### numeral unspecified unspecified unspecified unspecified unspecified  	I_DATE	null
1 . . . punctuation unspecified unspecified unspecified unspecified unspecified  	O	null

0 ; ; ; punctuation unspecified unspecified unspecified unspecified unspecified  	O	null
1 ###NUMBER### ###NUMBER### ###NUMBER### numeral unspecified unspecified unspecified unspecified unspecified  	O	null
2 קרפל קרפל קרפל properName unspecified unspecified unspecified unspecified unspecified  	I_PERS	null
3 , , , punctuation unspecified unspecified unspecified unspecified unspecified  	O	null
4 דליה דליה דליה properName unspecified unspecified unspecified unspecified unspecified  	I_PERS	null
5 . . . punctuation unspecified unspecified unspecified unspecified unspecified  	O	null

0 " " " punctuation unspecified unspecified unspecified unspecified unspecified  	I_ORG	null
1 שירתהברבורשלשיאריהמזרחי שירתהברבורשלשיאריהמזרחי שירתהברבורשלשיאריהמזרחי properName unspecified unspecified unspecified unspecified unspecified  	I_ORG	null
2 " " " punctuation unspecified unspecified unspecified unspecified unspecified  	O	null
3 . . . punctuation unspecified unspecified unspecified unspecified unspecified  	O	null
4 ה ה הארץ definiteArticle unspecified unspecified unspecified unspecified unspecified 0 
4 הארץ ארץ הארץ noun feminine singular absolute unspecified unspecified  	O	null
5 מוסף מוסף מוסף adjective masculine singular absolute unspecified unspecified  	O	null
6 . . . punctuation unspecified unspecified unspecified unspecified unspecified  	O	null

0 ###NUMEXP### ###NUMEXP### ###NUMEXP### numberExpression unspecified unspecified unspecified unspecified unspecified  	I_DATE	null
1 . . . punctuation unspecified unspecified unspecified unspecified unspecified  	O	null

