0 Name Name Name foreign unspecified unspecified unspecified unspecified unspecified  	O	null
1 : : : punctuation unspecified unspecified unspecified unspecified unspecified  	O	null
2 מסג מסג מסג noun masculine singular absolute unspecified unspecified  	O	null
3 , , , punctuation unspecified unspecified unspecified unspecified unspecified  	O	null
4 סבינה סבינה סבינה noun feminine singular absolute unspecified unspecified  	O	null
5 Birth Birth Birth foreign unspecified unspecified unspecified unspecified unspecified  	O	null
6 Year Year Year foreign unspecified unspecified unspecified unspecified unspecified  	O	null
7 : : : punctuation unspecified unspecified unspecified unspecified unspecified  	O	null
8 ###NUMBER### ###NUMBER### ###NUMBER### numeral unspecified unspecified unspecified unspecified unspecified  	I_DATE	null
9 Birth Birth Birth foreign unspecified unspecified unspecified unspecified unspecified  	O	null
10 Place Place Place foreign unspecified unspecified unspecified unspecified unspecified  	O	null
11 : : : punctuation unspecified unspecified unspecified unspecified unspecified  	O	null
12 סופיה סופיה סופיה properName unspecified unspecified unspecified unspecified unspecified  	I_LOC	null
13 , , , punctuation unspecified unspecified unspecified unspecified unspecified  	O	null
14 בולגריה בולגריה בולגריה properName unspecified unspecified unspecified unspecified unspecified  	I_LOC	null
15 , , , punctuation unspecified unspecified unspecified unspecified unspecified  	O	null
16 ו ו ועלתה conjunction unspecified unspecified unspecified unspecified unspecified 0 
16 עלתה עלה ועלתה verb feminine singular unspecified 3 past  	O	null
17 Occupation Occupation Occupation foreign unspecified unspecified unspecified unspecified unspecified  	O	null
18 : : : punctuation unspecified unspecified unspecified unspecified unspecified  	O	null
19 משוררת משורר משוררת noun feminine singular absolute unspecified unspecified  	O	null
20 , , , punctuation unspecified unspecified unspecified unspecified unspecified  	O	null
21 מתרגמת מתרגם מתרגמת noun feminine singular absolute unspecified unspecified  	O	null
22 ו ו וסופרת conjunction unspecified unspecified unspecified unspecified unspecified 0 
22 סופרת סופר וסופרת noun feminine singular construct unspecified unspecified  	O	null
23 ילדים ילד ילדים noun masculine plural absolute unspecified unspecified  	O	null
24 Entry Entry Entry foreign unspecified unspecified unspecified unspecified unspecified  	O	null
25 writer writer writer foreign unspecified unspecified unspecified unspecified unspecified  	O	null
26 : : : punctuation unspecified unspecified unspecified unspecified unspecified  	O	null
27 נעמי נעמי נעמי properName unspecified unspecified unspecified unspecified unspecified  	I_PERS	null
28 ברנשטיין ברנשטיין ברנשטיין properName unspecified unspecified unspecified unspecified unspecified  	I_PERS	null
29 Entry Entry Entry foreign unspecified unspecified unspecified unspecified unspecified  	O	null
30 Value Value Value foreign unspecified unspecified unspecified unspecified unspecified  	O	null
31 : : : punctuation unspecified unspecified unspecified unspecified unspecified  	O	null
32 נולדה נולד נולדה verb feminine singular unspecified 3 past  	O	null
33 ב ב בסופיה preposition unspecified unspecified unspecified unspecified unspecified 0 
33 סופיה סופיה בסופיה properName unspecified unspecified unspecified unspecified unspecified  	I_LOC	null
34 , , , punctuation unspecified unspecified unspecified unspecified unspecified  	O	null
35 בולגריה בולגריה בולגריה properName unspecified unspecified unspecified unspecified unspecified  	I_LOC	null
36 , , , punctuation unspecified unspecified unspecified unspecified unspecified  	O	null
37 ו ו ועלתה conjunction unspecified unspecified unspecified unspecified unspecified 0 
37 עלתה עלה ועלתה verb feminine singular unspecified 3 past  	O	null
38 ארצה ארצה ארצה adverb unspecified unspecified unspecified unspecified unspecified  	O	null
39 עם עם עם preposition unspecified unspecified unspecified unspecified unspecified  	O	null
40 הוריה הוריה הוריה noun feminine singular absolute unspecified unspecified  	O	null
41 ב ב ב preposition unspecified unspecified unspecified unspecified unspecified 0 	I_ORG	null
42 - - - punctuation unspecified unspecified unspecified unspecified unspecified  	I_ORG	null
43 ###NUMBER### ###NUMBER### ###NUMBER### numeral unspecified unspecified unspecified unspecified unspecified  	I_DATE	null
44 . . . punctuation unspecified unspecified unspecified unspecified unspecified  	O	null

0 גדלה גדל גדלה verb feminine singular unspecified 3 past  	O	null
1 ו ו והתחנכה conjunction unspecified unspecified unspecified unspecified unspecified 0 
1 התחנכה התחנך והתחנכה verb feminine singular unspecified 3 past  	O	null
2 ב ב ביפו preposition unspecified unspecified unspecified unspecified unspecified 0 
2 יפו יפו ביפו properName unspecified unspecified unspecified unspecified unspecified  	I_LOC	null
3 ו ו ובבתים conjunction unspecified unspecified unspecified unspecified unspecified 0 
3 ב ב ובבתים preposition unspecified unspecified unspecified unspecified unspecified 0 
3 בתים בית ובבתים noun masculine plural absolute unspecified unspecified  	O	null
4 . . . punctuation unspecified unspecified unspecified unspecified unspecified  	O	null

0 היתה הוא היתה copula feminine singular unspecified 3 past  	O	null
1 חברה חבר חברה noun feminine singular absolute unspecified unspecified  	O	null
2 ב ב בתנועת preposition unspecified unspecified unspecified unspecified unspecified 0 
2 תנועת תנועה בתנועת noun feminine singular construct unspecified unspecified  	O	null
3 " " " punctuation unspecified unspecified unspecified unspecified unspecified  	O	null
4 השומר שומר השומר properName unspecified unspecified unspecified unspecified unspecified  	I_ORG	null
5 ה ה הצעיר definiteArticle unspecified unspecified unspecified unspecified unspecified 0 
5 הצעיר צעיר הצעיר adjective masculine singular absolute unspecified unspecified  	O	null
6 " " " punctuation unspecified unspecified unspecified unspecified unspecified  	O	null
7 ו ו ואת conjunction unspecified unspecified unspecified unspecified unspecified 0 
7 את את ואת at-preposition unspecified unspecified unspecified unspecified unspecified  	O	null
8 שירות שירות שירותה noun masculine singular absolute unspecified unspecified  
8 ה ה שירותה possessive feminine singular unspecified 3 unspecified 0 	O	null
9 ה ה הצבאי definiteArticle unspecified unspecified unspecified unspecified unspecified 0 
9 הצבאי צבאי הצבאי adjective masculine singular absolute unspecified unspecified  	O	null
10 עשתה עשה עשתה verb feminine singular unspecified 3 past  	O	null
11 ב ב בחיל preposition unspecified unspecified unspecified unspecified unspecified 0 
11 חיל חיל בחיל noun masculine singular construct unspecified unspecified  	I_ORG	null
12 ה ה האוויר definiteArticle unspecified unspecified unspecified unspecified unspecified 0 
12 האוויר אוויר האוויר noun masculine singular absolute unspecified unspecified  	I_ORG	null
13 . . . punctuation unspecified unspecified unspecified unspecified unspecified  	O	null

0 למדה למד למדה verb feminine singular unspecified 3 past  	O	null
1 ספרות ספרות ספרות noun feminine singular absolute unspecified unspecified  	O	null
2 עברית עברי עברית adjective feminine singular absolute unspecified unspecified  	O	null
3 ו ו ואנגלית conjunction unspecified unspecified unspecified unspecified unspecified 0 
3 אנגלית אנגלי ואנגלית adjective feminine singular absolute unspecified unspecified  	O	null
4 ב ב באוניברסיטה preposition unspecified unspecified unspecified unspecified unspecified 0 
4 ה ה באוניברסיטה definiteArticle unspecified unspecified unspecified unspecified unspecified 0 
4 האוניברסיטה אוניברסיטה באוניברסיטה noun feminine singular absolute unspecified unspecified  	O	null
5 ה ה העברית definiteArticle unspecified unspecified unspecified unspecified unspecified 0 
5 העברית עברי העברית adjective feminine singular absolute unspecified unspecified  	O	null
6 ב ב בירושלים preposition unspecified unspecified unspecified unspecified unspecified 0 
6 ירושלים ירושלים בירושלים properName unspecified unspecified unspecified unspecified unspecified  	I_LOC	null
7 ו ו ובאוניברסיטת conjunction unspecified unspecified unspecified unspecified unspecified 0 
7 ב ב ובאוניברסיטת preposition unspecified unspecified unspecified unspecified unspecified 0 
7 אוניברסיטת אוניברסיטה ובאוניברסיטת noun feminine singular construct unspecified unspecified  	I_ORG	null
8 תלאביב תלאביב תלאביב properName unspecified unspecified unspecified unspecified unspecified  	I_ORG	null
9 . . . punctuation unspecified unspecified unspecified unspecified unspecified  	O	null

0 נשואה נשוי נשואה adjective feminine singular absolute unspecified unspecified  	O	null
1 ל ל לצייר preposition unspecified unspecified unspecified unspecified unspecified 0 
1 ה ה לצייר definiteArticle unspecified unspecified unspecified unspecified unspecified 0 
1 הצייר צייר לצייר noun masculine singular absolute unspecified unspecified  	O	null
2 אהרן אהרן אהרן properName unspecified unspecified unspecified unspecified unspecified  	I_PERS	null
3 מסג מסג מסג noun masculine singular absolute unspecified unspecified  	O	null
4 . . . punctuation unspecified unspecified unspecified unspecified unspecified  	O	null

0 פירסמה פרסם פירסמה verb feminine singular unspecified 3 past  	O	null
1 שירים שיר שירים noun masculine plural absolute unspecified unspecified  	O	null
2 ב ב בעיתוני preposition unspecified unspecified unspecified unspecified unspecified 0 
2 עיתוני עיתון בעיתוני noun masculine plural construct unspecified unspecified  	O	null
3 נוער נוער נוער noun masculine singular absolute unspecified unspecified  	O	null
4 החל החל החל verb masculine singular unspecified 3 past  	O	null
5 ב ב בגיל preposition unspecified unspecified unspecified unspecified unspecified 0 
5 גיל גיל בגיל noun masculine singular construct unspecified unspecified  	O	null
6 שתים שתים שתים noun masculine singular construct unspecified unspecified  	O	null
7 - - - punctuation unspecified unspecified unspecified unspecified unspecified  	O	null
8 עשרה CARD10 עשרה numeral masculine plural absolute unspecified unspecified  	O	null
9 , , , punctuation unspecified unspecified unspecified unspecified unspecified  	O	null
10 ו ו ובבגרותה conjunction unspecified unspecified unspecified unspecified unspecified 0 
10 ב ב ובבגרותה preposition unspecified unspecified unspecified unspecified unspecified 0 
10 בגרות בגרות ובבגרותה noun feminine singular absolute unspecified unspecified  
10 ה ה ובבגרותה possessive feminine singular unspecified 3 unspecified 0 	O	null
11 ב ב במוספי preposition unspecified unspecified unspecified unspecified unspecified 0 
11 מוספי מוסף במוספי noun masculine plural construct unspecified unspecified  	O	null
12 ה ה הספרות definiteArticle unspecified unspecified unspecified unspecified unspecified 0 
12 הספרות ספרות הספרות noun feminine singular absolute unspecified unspecified  	O	null
13 ו ו ובכתבי conjunction unspecified unspecified unspecified unspecified unspecified 0 
13 ב ב ובכתבי preposition unspecified unspecified unspecified unspecified unspecified 0 
13 כתבי כתב ובכתבי noun masculine plural construct unspecified unspecified  	O	null
14 עת עת עת noun feminine singular absolute unspecified unspecified  	O	null
15 . . . punctuation unspecified unspecified unspecified unspecified unspecified  	O	null

0 ב ב בספר preposition unspecified unspecified unspecified unspecified unspecified 0 
0 ספר ספר בספר noun masculine singular construct unspecified unspecified  	O	null
1 שירי שיר שיריה noun masculine plural absolute unspecified unspecified  
1 ה ה שיריה possessive feminine singular unspecified 3 unspecified 0 	O	null
2 ה ה הראשון definiteArticle unspecified unspecified unspecified unspecified unspecified 0 
2 הראשון ORD1 הראשון numeral masculine singular absolute unspecified unspecified  	O	null
3 , , , punctuation unspecified unspecified unspecified unspecified unspecified  	O	null
4 קולות קול קולות noun masculine plural absolute unspecified unspecified  	O	null
5 מֶשֶק מֶשֶק מֶשֶק properName unspecified unspecified unspecified unspecified unspecified  	I_PERS	null
6 ( ( ( punctuation unspecified unspecified unspecified unspecified unspecified  	O	null
7 צ'ריקובר צ'ריקובר צ'ריקובר properName unspecified unspecified unspecified unspecified unspecified  	I_PERS	null
8 , , , punctuation unspecified unspecified unspecified unspecified unspecified  	O	null
9 ) ) ) punctuation unspecified unspecified unspecified unspecified unspecified  	O	null
10 , , , punctuation unspecified unspecified unspecified unspecified unspecified  	O	null
11 ###NUMBER### ###NUMBER### ###NUMBER### numeral unspecified unspecified unspecified unspecified unspecified  	I_DATE	null
12 היא הוא היא pronoun feminine singular unspecified 3 unspecified  	O	null
13 משלחת משלחת משלחת noun feminine singular absolute unspecified unspecified  	O	null
14 את את את at-preposition unspecified unspecified unspecified unspecified unspecified  	O	null
15 נפש נפש נפשה noun feminine singular absolute unspecified unspecified  
15 ה ה נפשה possessive feminine singular unspecified 3 unspecified 0 	O	null
16 ב ב בעולם preposition unspecified unspecified unspecified unspecified unspecified 0 
16 ה ה בעולם definiteArticle unspecified unspecified unspecified unspecified unspecified 0 
16 העולם עולם בעולם noun masculine singular absolute unspecified unspecified  	O	null
17 כמו כמו כמו preposition unspecified unspecified unspecified unspecified unspecified  	O	null
18 ציפור ציפור ציפור noun masculine singular absolute unspecified unspecified  	O	null
19 , , , punctuation unspecified unspecified unspecified unspecified unspecified  	O	null
20 ו ו ורוחה conjunction unspecified unspecified unspecified unspecified unspecified 0 
20 רוח רוח ורוחה noun feminine singular absolute unspecified unspecified  
20 ה ה ורוחה possessive feminine singular unspecified 3 unspecified 0 	O	null
21 " " " punctuation unspecified unspecified unspecified unspecified unspecified  	O	null
22 דּוֹרֶכֶת דּוֹרֶכֶת דּוֹרֶכֶת verb masculine singular unspecified 2 imperative  	O	null
23 עַל עַל עַל properName unspecified unspecified unspecified unspecified unspecified  	I_PERS	null
24 הָאֲדָמָה הָאֲדָמָה הָאֲדָמָה verb masculine-and-feminine plural unspecified 2 imperative  	O	null
25 / / / punctuation unspecified unspecified unspecified unspecified unspecified  	O	null
26 כִּמְרַחֶפֶת כִּמְרַחֶפֶת כִּמְרַחֶפֶת adjective masculine singular construct unspecified unspecified  	O	null
27 עַל עַל עַל properName unspecified unspecified unspecified unspecified unspecified  	I_ORG	null
28 פְּנֵי פְּנֵי פְּנֵי verb masculine singular unspecified 2 imperative  	O	null
29 מַיִם מַיִם מַיִם adjective masculine singular construct unspecified unspecified  	O	null
30 " " " punctuation unspecified unspecified unspecified unspecified unspecified  	O	null
31 . . . punctuation unspecified unspecified unspecified unspecified unspecified  	O	null

0 ה ה הדגש definiteArticle unspecified unspecified unspecified unspecified unspecified 0 
0 הדגש דגש הדגש noun masculine singular absolute unspecified unspecified  	O	null
1 הוא הוא הוא pronoun masculine singular unspecified 3 unspecified  	O	null
2 על על על preposition unspecified unspecified unspecified unspecified unspecified  	O	null
3 יכולת יכולת יכולת noun feminine singular construct unspecified unspecified  	O	null
4 ה ה הנפש definiteArticle unspecified unspecified unspecified unspecified unspecified 0 
4 הנפש נפש הנפש noun feminine singular absolute unspecified unspecified  	O	null
5 להמריא המריא להמריא verb unspecified unspecified unspecified unspecified infinitive  	O	null
6 ב ב בכוח preposition unspecified unspecified unspecified unspecified unspecified 0 
6 כוח כוח בכוח noun masculine singular construct unspecified unspecified  	O	null
7 ה ה הדמיון definiteArticle unspecified unspecified unspecified unspecified unspecified 0 
7 הדמיון דמיון הדמיון noun masculine singular absolute unspecified unspecified  	O	null
8 ו ו ולהקשיב conjunction unspecified unspecified unspecified unspecified unspecified 0 
8 להקשיב הקשיב ולהקשיב verb unspecified unspecified unspecified unspecified infinitive  	O	null
9 ל ל לרחשי preposition unspecified unspecified unspecified unspecified unspecified 0 
9 רחשי רחש לרחשי noun masculine plural construct unspecified unspecified  	O	null
10 ה ה העולם definiteArticle unspecified unspecified unspecified unspecified unspecified 0 
10 העולם עולם העולם noun masculine singular absolute unspecified unspecified  	O	null
11 . . . punctuation unspecified unspecified unspecified unspecified unspecified  	O	null

0 ה ה הספר definiteArticle unspecified unspecified unspecified unspecified unspecified 0 
0 הספר ספר הספר noun masculine singular absolute unspecified unspecified  	O	null
1 זכה זכה זכה verb masculine singular unspecified 3 past  	O	null
2 ב ב בפרס preposition unspecified unspecified unspecified unspecified unspecified 0 
2 פרס פרס בפרס properName masculine singular unspecified unspecified unspecified  	I_LOC	null
3 ניומן ניומן ניומן properName unspecified unspecified unspecified unspecified unspecified  	I_LOC	null
4 ל ל לביכורי preposition unspecified unspecified unspecified unspecified unspecified 0 
4 ביכורי ביכור לביכורי noun masculine plural construct unspecified unspecified  	O	null
5 יצירה יצירה יצירה noun feminine singular absolute unspecified unspecified  	O	null
6 ) ) ) punctuation unspecified unspecified unspecified unspecified unspecified  	O	null
7 . . . punctuation unspecified unspecified unspecified unspecified unspecified  	O	null
8 ###NUMBER### ###NUMBER### ###NUMBER### numeral unspecified unspecified unspecified unspecified unspecified  	I_DATE	null
9 החל החל החל verb unspecified unspecified unspecified unspecified infinitive  	O	null
10 ב ב בספרה preposition unspecified unspecified unspecified unspecified unspecified 0 
10 ספר ספר בספרה noun masculine singular absolute unspecified unspecified  
10 ה ה בספרה possessive feminine singular unspecified 3 unspecified 0 	O	null
11 ה ה השני definiteArticle unspecified unspecified unspecified unspecified unspecified 0 
11 השני ORD2 השני numeral masculine singular absolute unspecified unspecified  	O	null
12 , , , punctuation unspecified unspecified unspecified unspecified unspecified  	O	null
13 ה ה הבית definiteArticle unspecified unspecified unspecified unspecified unspecified 0 
13 הבית בית הבית noun masculine singular absolute unspecified unspecified  	O	null
14 ב ב במגדל preposition unspecified unspecified unspecified unspecified unspecified 0 
14 מגדל מגדל במגדל properName unspecified unspecified unspecified unspecified unspecified  	I_LOC	null
15 ) ) ) punctuation unspecified unspecified unspecified unspecified unspecified  	O	null
16 , , , punctuation unspecified unspecified unspecified unspecified unspecified  	O	null
17 ###NUMBER### ###NUMBER### ###NUMBER### numeral unspecified unspecified unspecified unspecified unspecified  	I_DATE	null
18 הופכים הפך הופכים verb masculine plural unspecified any beinoni  	O	null
19 ה ה הטבע definiteArticle unspecified unspecified unspecified unspecified unspecified 0 
19 הטבע טבע הטבע noun masculine singular absolute unspecified unspecified  	O	null
20 ו ו והמקום conjunction unspecified unspecified unspecified unspecified unspecified 0 
20 ה ה והמקום definiteArticle unspecified unspecified unspecified unspecified unspecified 0 
20 המקום מקום והמקום noun masculine singular absolute unspecified unspecified  	O	null
21 ל ל לנושא preposition unspecified unspecified unspecified unspecified unspecified 0 
21 ה ה לנושא definiteArticle unspecified unspecified unspecified unspecified unspecified 0 
21 הנושא נושא לנושא noun masculine singular absolute unspecified unspecified  	O	null
22 ה ה המרכזי definiteArticle unspecified unspecified unspecified unspecified unspecified 0 
22 המרכזי מרכזי המרכזי adjective masculine singular absolute unspecified unspecified  	O	null
23 ב ב בשירתה preposition unspecified unspecified unspecified unspecified unspecified 0 
23 שירת שירה בשירתה noun feminine singular absolute unspecified unspecified  
23 ה ה בשירתה possessive feminine singular unspecified 3 unspecified 0 	O	null
24 . . . punctuation unspecified unspecified unspecified unspecified unspecified  	O	null

0 ה ה השירים definiteArticle unspecified unspecified unspecified unspecified unspecified 0 
0 השירים שיר השירים noun masculine plural absolute unspecified unspecified  	O	null
1 נכתבו נכתב נכתבו verb masculine-and-feminine plural unspecified 3 past  	O	null
2 ב ב ביישוב preposition unspecified unspecified unspecified unspecified unspecified 0 
2 יישוב יישוב ביישוב noun masculine singular construct unspecified unspecified  	O	null
3 מגדל מגדל מגדל properName unspecified unspecified unspecified unspecified unspecified  	I_LOC	null
4 ש ש שעל relativizer/subordinatingConjunction unspecified unspecified unspecified unspecified unspecified 0 
4 על על שעל preposition unspecified unspecified unspecified unspecified unspecified  	O	null
5 יד יד יד noun feminine singular construct unspecified unspecified  	O	null
6 ה ה הכנרת definiteArticle unspecified unspecified unspecified unspecified unspecified 0 
6 הכנרת הכנרת הכנרת properName unspecified unspecified unspecified unspecified unspecified  	I_LOC	null
7 ו ו ויש conjunction unspecified unspecified unspecified unspecified unspecified 0 
7 יש יש ויש existential unspecified unspecified unspecified unspecified unspecified  	O	null
8 ב ב בהם preposition unspecified unspecified unspecified unspecified unspecified  
8 הם הם בהם pronomial masculine plural unspecified 3 unspecified 0 	O	null
9 התייחסויות התייחסות התייחסויות noun feminine plural absolute unspecified unspecified  	O	null
10 ל ל לסיטואציות preposition unspecified unspecified unspecified unspecified unspecified 0 
10 סיטואציות סיטואציה לסיטואציות noun feminine plural absolute unspecified unspecified  	O	null
11 קונקרטיות קונקרטי קונקרטיות adjective feminine plural absolute unspecified unspecified  	O	null
12 כמו כמו כמו preposition unspecified unspecified unspecified unspecified unspecified  	O	null
13 טבילה טבילה טבילה noun feminine singular absolute unspecified unspecified  	O	null
14 ב ב במקווה preposition unspecified unspecified unspecified unspecified unspecified 0 
14 ה ה במקווה definiteArticle unspecified unspecified unspecified unspecified unspecified 0 
14 המקווה מקווה במקווה noun masculine singular absolute unspecified unspecified  	O	null
15 של של של shel-preposition unspecified unspecified unspecified unspecified unspecified  	O	null
16 האר"י האר"י האר"י properName unspecified unspecified unspecified unspecified unspecified  	I_PERS	null
17 . . . punctuation unspecified unspecified unspecified unspecified unspecified  	O	null

0 ה ה העיסוק definiteArticle unspecified unspecified unspecified unspecified unspecified 0 
0 העיסוק עיסוק העיסוק noun masculine singular absolute unspecified unspecified  	O	null
1 ב ב בחוויית preposition unspecified unspecified unspecified unspecified unspecified 0 
1 חוויית חוויה בחוויית noun feminine singular construct unspecified unspecified  	O	null
2 ה ה המקום definiteArticle unspecified unspecified unspecified unspecified unspecified 0 
2 המקום מקום המקום noun masculine singular absolute unspecified unspecified  	O	null
3 נמשך נמשך נמשך verb masculine singular unspecified 3 past  	O	null
4 ב ב בספריה preposition unspecified unspecified unspecified unspecified unspecified 0 
4 ספרי ספר בספריה noun masculine plural absolute unspecified unspecified  
4 ה ה בספריה possessive feminine singular unspecified 3 unspecified 0 	O	null
5 ה ה הבאים definiteArticle unspecified unspecified unspecified unspecified unspecified 0 
5 הבאים בא הבאים adjective masculine plural absolute unspecified unspecified  	O	null
6 , , , punctuation unspecified unspecified unspecified unspecified unspecified  	O	null
7 ה ה הנקראים definiteArticle unspecified unspecified unspecified unspecified unspecified 0 
7 הנקראים נקרא הנקראים participle masculine plural absolute any unspecified  	O	null
8 על על על preposition unspecified unspecified unspecified unspecified unspecified  	O	null
9 שם שם שם noun masculine singular construct unspecified unspecified  	O	null
10 מקומות מקום מקומות noun masculine plural construct unspecified unspecified  	O	null
11 שגרה שגרה שגרה noun feminine singular absolute unspecified unspecified  	O	null
12 ב ב בהם preposition unspecified unspecified unspecified unspecified unspecified  
12 הם הם בהם pronomial masculine plural unspecified 3 unspecified 0 	O	null
13 : : : punctuation unspecified unspecified unspecified unspecified unspecified  	O	null
14 מושב מושב מושב noun masculine singular absolute unspecified unspecified  	O	null
15 ( ( ( punctuation unspecified unspecified unspecified unspecified unspecified  	O	null
16 ) ) ) punctuation unspecified unspecified unspecified unspecified unspecified  	O	null
17 , , , punctuation unspecified unspecified unspecified unspecified unspecified  	O	null
18 ###NUMBER### ###NUMBER### ###NUMBER### numeral unspecified unspecified unspecified unspecified unspecified  	I_DATE	null
19 מושב מושב מושב noun masculine singular construct unspecified unspecified  	I_LOC	null
20 חמד חמד חמד properName unspecified unspecified unspecified unspecified unspecified  	I_LOC	null
21 ב ב במרכז preposition unspecified unspecified unspecified unspecified unspecified 0 
21 מרכז מרכז במרכז noun masculine singular construct unspecified unspecified  	O	null
22 ה ה הארץ;ימי definiteArticle unspecified unspecified unspecified unspecified unspecified 0 
22 הארץ;ימי הארץ;ימי הארץ;ימי noun feminine plural absolute unspecified unspecified  	O	null
23 מנזר מנזר מנזר noun masculine singular absolute unspecified unspecified  	O	null
24 ) ) ) punctuation unspecified unspecified unspecified unspecified unspecified  	O	null
25 , , , punctuation unspecified unspecified unspecified unspecified unspecified  	O	null
26 ###NUMBER### ###NUMBER### ###NUMBER### numeral unspecified unspecified unspecified unspecified unspecified  	I_DATE	null
27 מנזרים מנזר מנזרים noun masculine plural absolute unspecified unspecified  	O	null
28 ב ב בירושלים;והים preposition unspecified unspecified unspecified unspecified unspecified 0 
28 ירושלים;והים ירושלים;והים בירושלים;והים adjective masculine singular construct unspecified unspecified  	O	null
29 הזה הזה הזה verb masculine singular unspecified 3 past  	O	null
30 , , , punctuation unspecified unspecified unspecified unspecified unspecified  	O	null
31 ים ים ים properName unspecified unspecified unspecified unspecified unspecified  	I_PERS	null
32 כנרת כנרת כנרת properName unspecified unspecified unspecified unspecified unspecified  	I_PERS	null
33 ) ) ) punctuation unspecified unspecified unspecified unspecified unspecified  	O	null
34 , , , punctuation unspecified unspecified unspecified unspecified unspecified  	O	null
35 ###NUMBER### ###NUMBER### ###NUMBER### numeral unspecified unspecified unspecified unspecified unspecified  	I_DATE	null
36 מקומות מקום מקומות noun masculine plural absolute unspecified unspecified  	O	null
37 ל ל ליד preposition unspecified unspecified unspecified unspecified unspecified 0 
37 יד יד ליד noun feminine singular construct unspecified unspecified  	O	null
38 ה ה הכנרת definiteArticle unspecified unspecified unspecified unspecified unspecified 0 
38 הכנרת הכנרת הכנרת properName unspecified unspecified unspecified unspecified unspecified  	I_LOC	null
39 ; ; ; punctuation unspecified unspecified unspecified unspecified unspecified  	O	null
40 ו ו וכליל conjunction unspecified unspecified unspecified unspecified unspecified 0 
40 כליל כליל וכליל properName unspecified unspecified unspecified unspecified unspecified  	I_PERS	null
41 ) ) ) punctuation unspecified unspecified unspecified unspecified unspecified  	O	null
42 , , , punctuation unspecified unspecified unspecified unspecified unspecified  	O	null
43 ###NUMBER### ###NUMBER### ###NUMBER### numeral unspecified unspecified unspecified unspecified unspecified  	I_DATE	null
44 ה ה היישוב definiteArticle unspecified unspecified unspecified unspecified unspecified 0 
44 היישוב יישוב היישוב noun masculine singular absolute unspecified unspecified  	O	null
45 ש ש שליד relativizer/subordinatingConjunction unspecified unspecified unspecified unspecified unspecified 0 
45 ליד ליד שליד preposition unspecified unspecified unspecified unspecified unspecified  	O	null
46 נהריה נהריה נהריה properName unspecified unspecified unspecified unspecified unspecified  	I_LOC	null
47 . . . punctuation unspecified unspecified unspecified unspecified unspecified  	O	null

0 על על על preposition unspecified unspecified unspecified unspecified unspecified  	O	null
1 מעמד מעמד מעמדו noun masculine singular absolute unspecified unspecified  
1 ו ו מעמדו possessive masculine singular unspecified 3 unspecified 0 	O	null
2 ה ה המרכזי definiteArticle unspecified unspecified unspecified unspecified unspecified 0 
2 המרכזי מרכזי המרכזי adjective masculine singular absolute unspecified unspecified  	O	null
3 של של של shel-preposition unspecified unspecified unspecified unspecified unspecified  	O	null
4 ה ה המקום definiteArticle unspecified unspecified unspecified unspecified unspecified 0 
4 המקום מקום המקום noun masculine singular absolute unspecified unspecified  	O	null
5 ב ב בעולמה preposition unspecified unspecified unspecified unspecified unspecified 0 
5 עולם עולם בעולמה noun masculine singular absolute unspecified unspecified  
5 ה ה בעולמה possessive feminine singular unspecified 3 unspecified 0 	O	null
6 אפשר אפשר אפשר modal unspecified unspecified unspecified unspecified unspecified  	O	null
7 ללמוד למד ללמוד verb unspecified unspecified unspecified unspecified infinitive  	O	null
8 גם גם גם conjunction unspecified unspecified unspecified unspecified unspecified  	O	null
9 מ מ מדברים preposition unspecified unspecified unspecified unspecified unspecified 0 
9 דברים דבר מדברים noun masculine plural absolute unspecified unspecified  	O	null
10 ש ש שציינה relativizer/subordinatingConjunction unspecified unspecified unspecified unspecified unspecified 0 
10 ציינה ציין שציינה verb feminine singular unspecified 3 past  	O	null
11 ב ב במסה preposition unspecified unspecified unspecified unspecified unspecified 0 
11 מסה מסה במסה noun feminine singular absolute unspecified unspecified  	O	null
12 ש ש שפירסמה relativizer/subordinatingConjunction unspecified unspecified unspecified unspecified unspecified 0 
12 פירסמה פרסם שפירסמה verb feminine singular unspecified 3 past  	O	null
13 ב ב בכתב preposition unspecified unspecified unspecified unspecified unspecified 0 
13 כתב כתב בכתב noun masculine singular construct unspecified unspecified  	O	null
14 ה ה העת definiteArticle unspecified unspecified unspecified unspecified unspecified 0 
14 העת עת העת noun feminine singular absolute unspecified unspecified  	O	null
15 מאזניים מאזניים מאזניים noun masculine plural absolute unspecified unspecified  	O	null
16 ) ) ) punctuation unspecified unspecified unspecified unspecified unspecified  	O	null
17 : : : punctuation unspecified unspecified unspecified unspecified unspecified  	O	null
18 ###NUMBER### ###NUMBER### ###NUMBER### numeral unspecified unspecified unspecified unspecified unspecified  	I_DATE	null
19 " " " punctuation unspecified unspecified unspecified unspecified unspecified  	O	null
20 יש יש יש existential unspecified unspecified unspecified unspecified unspecified  	O	null
21 ל ל לי preposition unspecified unspecified unspecified unspecified unspecified  
21 י י לי pronomial masculine-and-feminine singular unspecified 1 unspecified 0 	O	null
22 צורך צורך צורך noun masculine singular absolute unspecified unspecified  	O	null
23 להיות הוא להיות copula unspecified unspecified unspecified unspecified infinitive  	O	null
24 ב ב בקשר preposition unspecified unspecified unspecified unspecified unspecified 0 
24 קשר קשר בקשר noun masculine singular absolute unspecified unspecified  	O	null
25 מתמיד מתמיד מתמיד adjective masculine singular absolute unspecified unspecified  	O	null
26 עם עם עם preposition unspecified unspecified unspecified unspecified unspecified  	O	null
27 ה ה החלק definiteArticle unspecified unspecified unspecified unspecified unspecified 0 
27 החלק חלק החלק noun masculine singular absolute unspecified unspecified  	O	null
28 ה ה הלא definiteArticle unspecified unspecified unspecified unspecified unspecified 0 
28 הלא לא הלא negation unspecified unspecified unspecified unspecified unspecified  	O	null
29 - - - punctuation unspecified unspecified unspecified unspecified unspecified  	O	null
30 אנושי אנושי אנושי adjective masculine singular absolute unspecified unspecified  	O	null
31 של של של shel-preposition unspecified unspecified unspecified unspecified unspecified  	O	null
32 עולם עולם עולם noun masculine singular construct unspecified unspecified  	O	null
33 ה ה התופעות definiteArticle unspecified unspecified unspecified unspecified unspecified 0 
33 התופעות תופעה התופעות noun feminine plural absolute unspecified unspecified  	O	null
34 . . . punctuation unspecified unspecified unspecified unspecified unspecified  	O	null

0 להיות הוא להיות copula unspecified unspecified unspecified unspecified infinitive  	O	null
1 ב ב בקשר preposition unspecified unspecified unspecified unspecified unspecified 0 
1 קשר קשר בקשר noun masculine singular absolute unspecified unspecified  	O	null
2 עם עם עם preposition unspecified unspecified unspecified unspecified unspecified  	O	null
3 ה ה המקום definiteArticle unspecified unspecified unspecified unspecified unspecified 0 
3 המקום מקום המקום noun masculine singular absolute unspecified unspecified  	O	null
4 " " " punctuation unspecified unspecified unspecified unspecified unspecified  	O	null
5 . . . punctuation unspecified unspecified unspecified unspecified unspecified  	O	null

0 ב ב בהקשר preposition unspecified unspecified unspecified unspecified unspecified 0 
0 הקשר הקשר בהקשר noun masculine singular absolute unspecified unspecified  	O	null
1 זה זה זה pronoun masculine singular unspecified 3 unspecified  	O	null
2 הושפעה הושפע הושפעה verb feminine singular unspecified 3 past  	O	null
3 , , , punctuation unspecified unspecified unspecified unspecified unspecified  	O	null
4 בין בין בין preposition unspecified unspecified unspecified unspecified unspecified  	O	null
5 ה ה השאר definiteArticle unspecified unspecified unspecified unspecified unspecified 0 
5 השאר שאר השאר noun masculine singular absolute unspecified unspecified  	O	null
6 , , , punctuation unspecified unspecified unspecified unspecified unspecified  	O	null
7 מ מ מהפילוסוף preposition unspecified unspecified unspecified unspecified unspecified 0 
7 ה ה מהפילוסוף definiteArticle unspecified unspecified unspecified unspecified unspecified 0 
7 הפילוסוף פילוסוף מהפילוסוף adjective masculine singular absolute unspecified unspecified  	O	null
8 ו ו והמסאי conjunction unspecified unspecified unspecified unspecified unspecified 0 
8 ה ה והמסאי definiteArticle unspecified unspecified unspecified unspecified unspecified 0 
8 המסאי מסאי והמסאי noun masculine singular absolute unspecified unspecified  	O	null
9 ה ה האמריקני definiteArticle unspecified unspecified unspecified unspecified unspecified 0 
9 האמריקני אמריקני האמריקני adjective masculine singular absolute unspecified unspecified  	O	null
10 הנרי הנרי הנרי properName unspecified unspecified unspecified unspecified unspecified  	I_PERS	null
11 דיוויד דיויד דיוויד properName unspecified unspecified unspecified unspecified unspecified  	I_PERS	null
12 תור תור תורו noun masculine singular absolute unspecified unspecified  
12 ו ו תורו possessive masculine singular unspecified 3 unspecified 0 	O	null
13 . . . punctuation unspecified unspecified unspecified unspecified unspecified  	O	null

0 על על על preposition unspecified unspecified unspecified unspecified unspecified  	O	null
1 פי פה פי noun masculine singular construct unspecified unspecified  	O	null
2 תפישה תפישה תפישה noun feminine singular absolute unspecified unspecified  	O	null
3 זו זו זו pronoun feminine singular unspecified 3 unspecified  	O	null
4 , , , punctuation unspecified unspecified unspecified unspecified unspecified  	O	null
5 כ כ כמשוררת preposition unspecified unspecified unspecified unspecified unspecified 0 
5 ה ה כמשוררת definiteArticle unspecified unspecified unspecified unspecified unspecified 0 
5 המשוררת משורר כמשוררת noun feminine singular absolute unspecified unspecified  	O	null
6 של של של shel-preposition unspecified unspecified unspecified unspecified unspecified  	O	null
7 מקום מקום מקום noun masculine singular absolute unspecified unspecified  	O	null
8 על על עליה preposition unspecified unspecified unspecified unspecified unspecified  
8 ה ה עליה pronomial feminine singular unspecified 3 unspecified 0 	O	null
9 לחיות חי לחיות verb unspecified unspecified unspecified unspecified infinitive  	O	null
10 ב ב בו preposition unspecified unspecified unspecified unspecified unspecified  
10 ו ו בו pronomial masculine singular unspecified 3 unspecified 0 	O	null
11 פיזית פיסי פיזית adjective feminine singular absolute unspecified unspecified  	O	null
12 ו ו ולחוות conjunction unspecified unspecified unspecified unspecified unspecified 0 
12 לחוות חווה ולחוות verb unspecified unspecified unspecified unspecified infinitive  	O	null
13 את את אותו at-preposition unspecified unspecified unspecified unspecified unspecified  
13 ו ו אותו pronomial masculine singular unspecified 3 unspecified 0 	O	null
14 ב ב בכל preposition unspecified unspecified unspecified unspecified unspecified 0 
14 כל כול בכל quantifier unspecified unspecified construct unspecified unspecified  	O	null
15 היבט היבט היבט noun masculine singular absolute unspecified unspecified  	O	null
16 אפשרי אפשרי אפשרי adjective masculine singular absolute unspecified unspecified  	O	null
17 . . . punctuation unspecified unspecified unspecified unspecified unspecified  	O	null

0 ה ה המקום definiteArticle unspecified unspecified unspecified unspecified unspecified 0 
0 המקום מקום המקום noun masculine singular absolute unspecified unspecified  	O	null
1 הוא הוא הוא pronoun masculine singular unspecified 3 unspecified  	O	null
2 לא לא לא negation unspecified unspecified unspecified unspecified unspecified  	O	null
3 כל כול כל quantifier unspecified unspecified construct unspecified unspecified  	O	null
4 מקום מקום מקום noun masculine singular absolute unspecified unspecified  	O	null
5 , , , punctuation unspecified unspecified unspecified unspecified unspecified  	O	null
6 אלא אלא אלא conjunction unspecified unspecified unspecified unspecified unspecified  	O	null
7 " " " punctuation unspecified unspecified unspecified unspecified unspecified  	O	null
8 ה ה המקום definiteArticle unspecified unspecified unspecified unspecified unspecified 0 
8 המקום מקום המקום noun masculine singular absolute unspecified unspecified  	O	null
9 ה ה הזה definiteArticle unspecified unspecified unspecified unspecified unspecified 0 
9 הזה זה הזה pronoun masculine singular unspecified 3 unspecified  	I_ORG	null
10 " " " punctuation unspecified unspecified unspecified unspecified unspecified  	O	null
11 , , , punctuation unspecified unspecified unspecified unspecified unspecified  	O	null
12 כלומר כלומר כלומר conjunction unspecified unspecified unspecified unspecified unspecified  	O	null
13 ארץ ארץ ארץ noun feminine singular construct unspecified unspecified  	I_LOC	null
14 ישראל ישראל ישראל properName unspecified unspecified unspecified unspecified unspecified  	I_LOC	null
15 ( ( ( punctuation unspecified unspecified unspecified unspecified unspecified  	O	null
16 לרוב לרוב לרוב adverb unspecified unspecified unspecified unspecified unspecified  	O	null
17 ב ב בסביבה preposition unspecified unspecified unspecified unspecified unspecified 0 
17 סביבה סביבה בסביבה noun feminine singular absolute unspecified unspecified  	O	null
18 כפרית כפרי כפרית adjective feminine singular absolute unspecified unspecified  	O	null
19 ) ) ) punctuation unspecified unspecified unspecified unspecified unspecified  	O	null
20 . . . punctuation unspecified unspecified unspecified unspecified unspecified  	O	null

0 היא הוא היא pronoun feminine singular unspecified 3 unspecified  	O	null
1 מגדירה הגדיר מגדירה verb feminine singular unspecified any beinoni  	O	null
2 את את את at-preposition unspecified unspecified unspecified unspecified unspecified  	O	null
3 שירת שירה שירתה noun feminine singular absolute unspecified unspecified  
3 ה ה שירתה possessive feminine singular unspecified 3 unspecified 0 	O	null
4 " " " punctuation unspecified unspecified unspecified unspecified unspecified  	O	null
5 שירה שירה שירה noun feminine singular absolute unspecified unspecified  	O	null
6 פוסט פוסט פוסט wPrefix unspecified unspecified unspecified unspecified unspecified  	O	null
7 - - - punctuation unspecified unspecified unspecified unspecified unspecified  	O	null
8 פסטורלית פסטורלי פסטורלית adjective feminine singular absolute unspecified unspecified  	O	null
9 " " " punctuation unspecified unspecified unspecified unspecified unspecified  	O	null
10 ו ו ומשייכת conjunction unspecified unspecified unspecified unspecified unspecified 0 
10 משייכת שייך ומשייכת verb feminine singular unspecified any beinoni  	O	null
11 את את אותה at-preposition unspecified unspecified unspecified unspecified unspecified  
11 ה ה אותה pronomial feminine singular unspecified 3 unspecified 0 	O	null
12 ל ל לתנועה preposition unspecified unspecified unspecified unspecified unspecified 0 
12 תנועה תנועה לתנועה noun feminine singular absolute unspecified unspecified  	O	null
13 ספרותית ספרותי ספרותית adjective feminine singular absolute unspecified unspecified  	O	null
14 ב ב בארצות preposition unspecified unspecified unspecified unspecified unspecified 0 
14 ארצות ארץ בארצות properName unspecified unspecified unspecified unspecified unspecified  	I_LOC	null
15 הברית ברית הברית properName unspecified unspecified unspecified unspecified unspecified  	I_LOC	null
16 , , , punctuation unspecified unspecified unspecified unspecified unspecified  	O	null
17 ב ב באנגליה preposition unspecified unspecified unspecified unspecified unspecified 0 
17 אנגליה אנגלי באנגליה properName unspecified unspecified unspecified unspecified unspecified  	I_LOC	null
18 , , , punctuation unspecified unspecified unspecified unspecified unspecified  	O	null
19 ב ב בקנדה preposition unspecified unspecified unspecified unspecified unspecified 0 
19 קנדה קנדה בקנדה properName unspecified unspecified unspecified unspecified unspecified  	I_LOC	null
20 ו ו ובאוסטרליה conjunction unspecified unspecified unspecified unspecified unspecified 0 
20 ב ב ובאוסטרליה preposition unspecified unspecified unspecified unspecified unspecified 0 
20 אוסטרליה אוסטרליה ובאוסטרליה properName unspecified unspecified unspecified unspecified unspecified  	B_LOC	null
21 , , , punctuation unspecified unspecified unspecified unspecified unspecified  	O	null
22 ה ה המאופיינת definiteArticle unspecified unspecified unspecified unspecified unspecified 0 
22 המאופיינת אופיין המאופיינת participle feminine singular absolute any unspecified  	O	null
23 ב ב בחזרה preposition unspecified unspecified unspecified unspecified unspecified 0 
23 חזרה חזרה בחזרה noun feminine singular absolute unspecified unspecified  	O	null
24 ל ל לכתיבה preposition unspecified unspecified unspecified unspecified unspecified 0 
24 כתיבה כתיבה לכתיבה noun feminine singular absolute unspecified unspecified  	O	null
25 על על על preposition unspecified unspecified unspecified unspecified unspecified  	O	null
26 ה ה הטבע definiteArticle unspecified unspecified unspecified unspecified unspecified 0 
26 הטבע טבע הטבע noun masculine singular absolute unspecified unspecified  	O	null
27 ו ו ועל conjunction unspecified unspecified unspecified unspecified unspecified 0 
27 על על ועל preposition unspecified unspecified unspecified unspecified unspecified  	O	null
28 ה ה הסביבה definiteArticle unspecified unspecified unspecified unspecified unspecified 0 
28 הסביבה סביבה הסביבה noun feminine singular absolute unspecified unspecified  	O	null
29 ה ה הפיזית definiteArticle unspecified unspecified unspecified unspecified unspecified 0 
29 הפיזית פיסי הפיזית adjective feminine singular absolute unspecified unspecified  	O	null
30 , , , punctuation unspecified unspecified unspecified unspecified unspecified  	O	null
31 ו ו וכוללת conjunction unspecified unspecified unspecified unspecified unspecified 0 
31 כוללת כלל וכוללת verb feminine singular unspecified any beinoni  	O	null
32 גם גם גם conjunction unspecified unspecified unspecified unspecified unspecified  	O	null
33 – – – punctuation unspecified unspecified unspecified unspecified unspecified  	O	null
34 אבל אבל אבל conjunction unspecified unspecified unspecified unspecified unspecified  	O	null
35 לא לא לא negation unspecified unspecified unspecified unspecified unspecified  	O	null
36 רק רק רק conjunction unspecified unspecified unspecified unspecified unspecified  	O	null
37 – – – punctuation unspecified unspecified unspecified unspecified unspecified  	O	null
38 התייחסות התייחסות התייחסות noun feminine singular absolute unspecified unspecified  	O	null
39 ל ל להיבטים preposition unspecified unspecified unspecified unspecified unspecified 0 
39 היבטים היבט להיבטים noun masculine plural absolute unspecified unspecified  	O	null
40 אקולוגיים אקולוגי אקולוגיים adjective masculine plural absolute unspecified unspecified  	O	null
41 . . . punctuation unspecified unspecified unspecified unspecified unspecified  	O	null

0 יחס יחס יחסה noun masculine singular absolute unspecified unspecified  
0 ה ה יחסה possessive feminine singular unspecified 3 unspecified 0 	O	null
1 אל אל אל preposition unspecified unspecified unspecified unspecified unspecified  	O	null
2 ה ה הטבע definiteArticle unspecified unspecified unspecified unspecified unspecified 0 
2 הטבע טבע הטבע noun masculine singular absolute unspecified unspecified  	O	null
3 הוא הוא הוא pronoun masculine singular unspecified 3 unspecified  	O	null
4 חושני חושני חושני adjective masculine singular absolute unspecified unspecified  	O	null
5 - - - punctuation unspecified unspecified unspecified unspecified unspecified  	O	null
6 תאוותני תאוותן תאוותני adjective masculine plural construct unspecified unspecified  	O	null
7 ו ו ומתפעם conjunction unspecified unspecified unspecified unspecified unspecified 0 
7 מתפעם התפעם ומתפעם verb masculine singular unspecified any beinoni  	O	null
8 , , , punctuation unspecified unspecified unspecified unspecified unspecified  	O	null
9 כמו כמו כמו conjunction unspecified unspecified unspecified unspecified unspecified  	O	null
10 גם גם גם conjunction unspecified unspecified unspecified unspecified unspecified  	O	null
11 יחס יחס יחס noun masculine singular absolute unspecified unspecified  	O	null
12 אירוני אירוני אירוני adjective masculine singular absolute unspecified unspecified  	O	null
13 ו ו ומפוכח conjunction unspecified unspecified unspecified unspecified unspecified 0 
13 מפוכח מפוכח ומפוכח adjective masculine singular absolute unspecified unspecified  	O	null
14 ל ל לבעיות preposition unspecified unspecified unspecified unspecified unspecified 0 
14 בעיות בעיה לבעיות noun feminine plural absolute unspecified unspecified  	O	null
15 אקולוגיות אקולוגי אקולוגיות adjective feminine plural absolute unspecified unspecified  	O	null
16 ו ו ולצד conjunction unspecified unspecified unspecified unspecified unspecified 0 
16 ל ל ולצד preposition unspecified unspecified unspecified unspecified unspecified 0 
16 ה ה ולצד definiteArticle unspecified unspecified unspecified unspecified unspecified 0 
16 הצד צד ולצד noun masculine singular absolute unspecified unspecified  	O	null
17 ה ה המכוער definiteArticle unspecified unspecified unspecified unspecified unspecified 0 
17 המכוער מכוער המכוער adjective masculine singular absolute unspecified unspecified  	O	null
18 של של של shel-preposition unspecified unspecified unspecified unspecified unspecified  	O	null
19 ה ה הנוף definiteArticle unspecified unspecified unspecified unspecified unspecified 0 
19 הנוף נוף הנוף noun masculine singular absolute unspecified unspecified  	O	null
20 ה ה המודרני definiteArticle unspecified unspecified unspecified unspecified unspecified 0 
20 המודרני מודרני המודרני adjective masculine singular absolute unspecified unspecified  	O	null
21 : : : punctuation unspecified unspecified unspecified unspecified unspecified  	O	null
22 מזבלת מזבלה מזבלת noun feminine singular construct unspecified unspecified  	O	null
23 חירייה חירייה חירייה properName unspecified unspecified unspecified unspecified unspecified  	I_LOC	null
24 , , , punctuation unspecified unspecified unspecified unspecified unspecified  	O	null
25 התייבשות התייבשות התייבשות noun feminine singular construct unspecified unspecified  	O	null
26 ה ה הכנרת definiteArticle unspecified unspecified unspecified unspecified unspecified 0 
26 הכנרת הכנרת הכנרת properName unspecified unspecified unspecified unspecified unspecified  	I_LOC	null
27 ו ו וזיהום conjunction unspecified unspecified unspecified unspecified unspecified 0 
27 זיהום זיהום וזיהום noun masculine singular construct unspecified unspecified  	O	null
28 ה ה הנחלים definiteArticle unspecified unspecified unspecified unspecified unspecified 0 
28 הנחלים נחל הנחלים noun masculine plural absolute unspecified unspecified  	O	null
29 . . . punctuation unspecified unspecified unspecified unspecified unspecified  	O	null

0 היא הוא היא pronoun feminine singular unspecified 3 unspecified  	O	null
1 רואה ראה רואה verb feminine singular unspecified any beinoni  	O	null
2 את את את at-preposition unspecified unspecified unspecified unspecified unspecified  	O	null
3 ה ה ה numeral unspecified unspecified unspecified unspecified unspecified  	O	null
4 " " " punctuation unspecified unspecified unspecified unspecified unspecified  	O	null
5 מקום מקום מקום noun masculine singular absolute unspecified unspecified  	O	null
6 " " " punctuation unspecified unspecified unspecified unspecified unspecified  	O	null
7 ב ב בעין preposition unspecified unspecified unspecified unspecified unspecified 0 
7 עין עין בעין properName unspecified unspecified unspecified unspecified unspecified  	O	null
8 החוצה החוצה החוצה adverb unspecified unspecified unspecified unspecified unspecified  	O	null
9 גבולות גבול גבולות noun masculine plural absolute unspecified unspecified  	O	null
10 של של של shel-preposition unspecified unspecified unspecified unspecified unspecified  	O	null
11 זמן זמן זמן noun masculine singular absolute unspecified unspecified  	O	null
12 . . . punctuation unspecified unspecified unspecified unspecified unspecified  	O	null

0 הוא הוא הוא pronoun masculine singular unspecified 3 unspecified  	O	null
1 אינו הוא אינו copula masculine singular unspecified 3 beinoni  	O	null
2 רק רק רק conjunction unspecified unspecified unspecified unspecified unspecified  	O	null
3 ה ה המקום definiteArticle unspecified unspecified unspecified unspecified unspecified 0 
3 המקום מקום המקום noun masculine singular absolute unspecified unspecified  	O	null
4 ב ב בנקודת preposition unspecified unspecified unspecified unspecified unspecified 0 
4 נקודת נקודה בנקודת noun feminine singular construct unspecified unspecified  	O	null
5 ה ה הזמן definiteArticle unspecified unspecified unspecified unspecified unspecified 0 
5 הזמן זמן הזמן noun masculine singular absolute unspecified unspecified  	O	null
6 שבה שב שבה verb feminine singular unspecified 3 past  	O	null
7 נכתב נכתב נכתב verb masculine singular unspecified 3 past  	O	null
8 ה ה השיר definiteArticle unspecified unspecified unspecified unspecified unspecified 0 
8 השיר שיר השיר noun masculine singular absolute unspecified unspecified  	O	null
9 , , , punctuation unspecified unspecified unspecified unspecified unspecified  	O	null
10 אלא אלא אלא conjunction unspecified unspecified unspecified unspecified unspecified  	O	null
11 גם גם גם conjunction unspecified unspecified unspecified unspecified unspecified  	O	null
12 ה ה ההיסטוריה definiteArticle unspecified unspecified unspecified unspecified unspecified 0 
12 ההיסטוריה היסטוריה ההיסטוריה noun feminine singular absolute unspecified unspecified  	O	null
13 ו ו והמיתולוגיה conjunction unspecified unspecified unspecified unspecified unspecified 0 
13 ה ה והמיתולוגיה definiteArticle unspecified unspecified unspecified unspecified unspecified 0 
13 המיתולוגיה מיתולוגיה והמיתולוגיה noun feminine singular absolute unspecified unspecified  	O	null
14 של של שלו shel-preposition unspecified unspecified unspecified unspecified unspecified  
14 ו ו שלו pronomial masculine singular unspecified 3 unspecified 0 	O	null
15 , , , punctuation unspecified unspecified unspecified unspecified unspecified  	O	null
16 אישים אישים אישים noun masculine plural absolute unspecified unspecified  	O	null
17 ש ש שביקרו relativizer/subordinatingConjunction unspecified unspecified unspecified unspecified unspecified 0 
17 ביקרו ביקר שביקרו verb masculine-and-feminine plural unspecified 3 past  	O	null
18 ב ב בו preposition unspecified unspecified unspecified unspecified unspecified  
18 ו ו בו pronomial masculine singular unspecified 3 unspecified 0 	O	null
19 ב ב בעבר preposition unspecified unspecified unspecified unspecified unspecified 0 
19 ה ה בעבר definiteArticle unspecified unspecified unspecified unspecified unspecified 0 
19 העבר עבר בעבר noun masculine singular absolute unspecified unspecified  	O	null
20 , , , punctuation unspecified unspecified unspecified unspecified unspecified  	O	null
21 כ כ כאלה preposition unspecified unspecified unspecified unspecified unspecified 0 
21 אלה אל כאלה noun feminine singular absolute unspecified unspecified  	O	null
22 ש ש שיבקרו relativizer/subordinatingConjunction unspecified unspecified unspecified unspecified unspecified 0 
22 יבקרו ביקר שיבקרו verb masculine-and-feminine plural unspecified 3 future  	O	null
23 ב ב בעתיד preposition unspecified unspecified unspecified unspecified unspecified 0 
23 עתיד עתיד בעתיד noun masculine singular absolute unspecified unspecified  	O	null
24 וכו וכו וכו adjective masculine singular absolute unspecified unspecified  	O	null
25 ' ' ' punctuation unspecified unspecified unspecified unspecified unspecified  	O	null
26 . . . punctuation unspecified unspecified unspecified unspecified unspecified  	O	null

0 לפעמים לפעמים לפעמים adverb unspecified unspecified unspecified unspecified unspecified  	O	null
1 היא הוא היא pronoun feminine singular unspecified 3 unspecified  	O	null
2 מזכירה הזכיר מזכירה verb feminine singular unspecified any beinoni  	O	null
3 דמויות דמות דמויות noun feminine plural absolute unspecified unspecified  	O	null
4 מיתולוגיות מיתולוגיה מיתולוגיות noun feminine plural absolute unspecified unspecified  	O	null
5 ו ו ואמיתיות conjunction unspecified unspecified unspecified unspecified unspecified 0 
5 אמיתיות אמיתי ואמיתיות adjective feminine plural absolute unspecified unspecified  	O	null
6 ה ה המרוממות definiteArticle unspecified unspecified unspecified unspecified unspecified 0 
6 המרוממות רומם המרוממות participle feminine plural absolute any unspecified  	O	null
7 את את את at-preposition unspecified unspecified unspecified unspecified unspecified  	O	null
8 ה ה הנוף definiteArticle unspecified unspecified unspecified unspecified unspecified 0 
8 הנוף נוף הנוף noun masculine singular absolute unspecified unspecified  	O	null
9 ה ה המוכר definiteArticle unspecified unspecified unspecified unspecified unspecified 0 
9 המוכר מוכר המוכר adjective masculine singular absolute unspecified unspecified  	O	null
10 . . . punctuation unspecified unspecified unspecified unspecified unspecified  	O	null

0 היבטים היבט היבטים noun masculine plural absolute unspecified unspecified  	O	null
1 אלה אלה אלה pronoun masculine-and-feminine plural unspecified 3 unspecified  	O	null
2 בולטים בולט בולטים adjective masculine plural absolute unspecified unspecified  	O	null
3 במיוחד במיוחד במיוחד adverb unspecified unspecified unspecified unspecified unspecified  	O	null
4 ב ב בספרה preposition unspecified unspecified unspecified unspecified unspecified 0 
4 ספר ספר בספרה noun masculine singular absolute unspecified unspecified  
4 ה ה בספרה possessive feminine singular unspecified 3 unspecified 0 	O	null
5 ו ו והים conjunction unspecified unspecified unspecified unspecified unspecified 0 
5 ה ה והים definiteArticle unspecified unspecified unspecified unspecified unspecified 0 
5 הים ים והים noun masculine singular absolute unspecified unspecified  	O	null
6 ה ה הזה definiteArticle unspecified unspecified unspecified unspecified unspecified 0 
6 הזה זה הזה pronoun masculine singular unspecified 3 unspecified  	O	null
7 , , , punctuation unspecified unspecified unspecified unspecified unspecified  	O	null
8 ים ים ים properName unspecified unspecified unspecified unspecified unspecified  	I_PERS	null
9 כנרת כנרת כנרת properName unspecified unspecified unspecified unspecified unspecified  	I_PERS	null
10 ) ) ) punctuation unspecified unspecified unspecified unspecified unspecified  	O	null
11 , , , punctuation unspecified unspecified unspecified unspecified unspecified  	O	null
12 ###NUMBER### ###NUMBER### ###NUMBER### numeral unspecified unspecified unspecified unspecified unspecified  	I_DATE	null
13 שבו ישב שבו verb masculine-and-feminine plural unspecified 2 imperative  	O	null
14 היא הוא היא pronoun feminine singular unspecified 3 unspecified  	O	null
15 מנהלת ניהל מנהלת verb feminine singular unspecified any beinoni  	O	null
16 דיאלוג דיאלוג דיאלוג noun masculine singular absolute unspecified unspecified  	O	null
17 אינטימי אינטימי אינטימי adjective masculine singular absolute unspecified unspecified  	O	null
18 עם עם עם preposition unspecified unspecified unspecified unspecified unspecified  	O	null
19 ה ה המשוררת definiteArticle unspecified unspecified unspecified unspecified unspecified 0 
19 המשוררת משורר המשוררת noun feminine singular absolute unspecified unspecified  	O	null
20 רחל רחל רחל properName unspecified unspecified unspecified unspecified unspecified  	I_PERS	null
21 ו ו ותרה conjunction unspecified unspecified unspecified unspecified unspecified 0 
21 תרה תר ותרה verb feminine singular unspecified 3 past  	O	null
22 ב ב בכוח preposition unspecified unspecified unspecified unspecified unspecified 0 
22 כוח כוח בכוח noun masculine singular construct unspecified unspecified  	O	null
23 ה ה הדמיון definiteArticle unspecified unspecified unspecified unspecified unspecified 0 
23 הדמיון דמיון הדמיון noun masculine singular absolute unspecified unspecified  	O	null
24 אחר אחר אחר preposition unspecified unspecified unspecified unspecified unspecified  	O	null
25 עקבות עקבה עקבות noun feminine plural construct unspecified unspecified  	O	null
26 ה ה ההיסטוריה definiteArticle unspecified unspecified unspecified unspecified unspecified 0 
26 ההיסטוריה היסטוריה ההיסטוריה noun feminine singular absolute unspecified unspecified  	O	null
27 ו ו והמיתולוגיה conjunction unspecified unspecified unspecified unspecified unspecified 0 
27 ה ה והמיתולוגיה definiteArticle unspecified unspecified unspecified unspecified unspecified 0 
27 המיתולוגיה מיתולוגיה והמיתולוגיה noun feminine singular absolute unspecified unspecified  	O	null
28 של של של shel-preposition unspecified unspecified unspecified unspecified unspecified  	O	null
29 ה ה הכנרת definiteArticle unspecified unspecified unspecified unspecified unspecified 0 
29 הכנרת הכנרת הכנרת properName unspecified unspecified unspecified unspecified unspecified  	I_PERS	null
30 . . . punctuation unspecified unspecified unspecified unspecified unspecified  	O	null

0 תירגמה תרגם תירגמה verb feminine singular unspecified 3 past  	O	null
1 כמה כמה כמה quantifier unspecified unspecified construct unspecified unspecified  	O	null
2 ספרי ספר ספרי noun masculine plural construct unspecified unspecified  	O	null
3 שירה שירה שירה noun feminine singular absolute unspecified unspecified  	O	null
4 , , , punctuation unspecified unspecified unspecified unspecified unspecified  	O	null
5 ב ב בהם preposition unspecified unspecified unspecified unspecified unspecified  
5 הם הם בהם pronomial masculine plural unspecified 3 unspecified 0 	O	null
6 : : : punctuation unspecified unspecified unspecified unspecified unspecified  	O	null
7 שועל שועל שועל noun masculine singular construct unspecified unspecified  	O	null
8 ה ה המחשבה definiteArticle unspecified unspecified unspecified unspecified unspecified 0 
8 המחשבה מחשבה המחשבה noun feminine singular absolute unspecified unspecified  	O	null
9 : : : punctuation unspecified unspecified unspecified unspecified unspecified  	O	null
10 מבחר מבחר מבחר quantifier unspecified unspecified construct unspecified unspecified  	O	null
11 שירים שיר שירים noun masculine plural absolute unspecified unspecified  	O	null
12 מאת מאת מאת preposition unspecified unspecified unspecified unspecified unspecified  	O	null
13 טד טד טד properName unspecified unspecified unspecified unspecified unspecified  	I_PERS	null
14 יוז יוז יוז properName unspecified unspecified unspecified unspecified unspecified  	I_PERS	null
15 ) ) ) punctuation unspecified unspecified unspecified unspecified unspecified  	O	null
16 ; ; ; punctuation unspecified unspecified unspecified unspecified unspecified  	O	null
17 ###NUMBER### ###NUMBER### ###NUMBER### numeral unspecified unspecified unspecified unspecified unspecified  	I_DATE	null
18 אריאל אריאל אריאל properName unspecified unspecified unspecified unspecified unspecified  	O	null
19 ו ו ושלוש conjunction unspecified unspecified unspecified unspecified unspecified 0 
19 שלוש CARD3 ושלוש numeral feminine singular absolute unspecified unspecified  	O	null
20 נשים איש נשים noun feminine plural absolute unspecified unspecified  	O	null
21 מאת מאת מאת preposition unspecified unspecified unspecified unspecified unspecified  	O	null
22 סילביה סילביה סילביה properName unspecified unspecified unspecified unspecified unspecified  	I_PERS	null
23 פלאת פלאת פלאת' noun masculine plural absolute unspecified unspecified  
23 י י פלאת' possessive masculine-and-feminine singular unspecified 1 unspecified 0 	O	null
24 ) ) ) punctuation unspecified unspecified unspecified unspecified unspecified  	O	null
25 . . . punctuation unspecified unspecified unspecified unspecified unspecified  	O	null
26 ###NUMBER### ###NUMBER### ###NUMBER### numeral unspecified unspecified unspecified unspecified unspecified  	I_DATE	null
27 כ כ כמוכן preposition unspecified unspecified unspecified unspecified unspecified 0 
27 ה ה כמוכן definiteArticle unspecified unspecified unspecified unspecified unspecified 0 
27 המוכן מוכן כמוכן adjective masculine singular absolute unspecified unspecified  	O	null
28 כתבה כתב כתבה verb feminine singular unspecified 3 past  	O	null
29 שורה שורה שורה noun feminine singular absolute unspecified unspecified  	O	null
30 ארוכה ארוך ארוכה adjective feminine singular absolute unspecified unspecified  	O	null
31 של של של shel-preposition unspecified unspecified unspecified unspecified unspecified  	O	null
32 ספרי ספר ספרי noun masculine plural construct unspecified unspecified  	O	null
33 ילדים ילד ילדים noun masculine plural absolute unspecified unspecified  	O	null
34 ב ב בשם preposition unspecified unspecified unspecified unspecified unspecified 0 
34 ה ה בשם definiteArticle unspecified unspecified unspecified unspecified unspecified 0 
34 השם שם בשם noun masculine singular absolute unspecified unspecified  	O	null
35 ה ה העט definiteArticle unspecified unspecified unspecified unspecified unspecified 0 
35 העט עט העט participle masculine singular absolute any unspecified  	I_ORG	null
36 עדולה עדולה עדולה properName unspecified unspecified unspecified unspecified unspecified  	I_ORG	null
37 . . . punctuation unspecified unspecified unspecified unspecified unspecified  	O	null

0 שירי שיר שיריה noun masculine plural absolute unspecified unspecified  
0 ה ה שיריה possessive feminine singular unspecified 3 unspecified 0 	O	null
1 תורגמו תורגם תורגמו verb masculine-and-feminine plural unspecified 3 past  	O	null
2 ל ל לכמה preposition unspecified unspecified unspecified unspecified unspecified 0 
2 כמה כמה לכמה quantifier unspecified unspecified construct unspecified unspecified  	O	null
3 שפות שפה שפות noun feminine plural absolute unspecified unspecified  	O	null
4 . . . punctuation unspecified unspecified unspecified unspecified unspecified  	O	null

0 היא הוא היא pronoun feminine singular unspecified 3 unspecified  	O	null
1 זכתה זכה זכתה verb feminine singular unspecified 3 past  	O	null
2 ב ב בפרס preposition unspecified unspecified unspecified unspecified unspecified 0 
2 פרס פרס בפרס properName masculine singular unspecified unspecified unspecified  	I_PERS	null
3 זאב זאב זאב properName unspecified unspecified unspecified unspecified unspecified  	I_PERS	null
4 ( ( ( punctuation unspecified unspecified unspecified unspecified unspecified  	O	null
5 ###NUMBER### ###NUMBER### ###NUMBER### numeral unspecified unspecified unspecified unspecified unspecified  	I_DATE	null
6 ) ) ) punctuation unspecified unspecified unspecified unspecified unspecified  	O	null
7 ו ו ובפרס conjunction unspecified unspecified unspecified unspecified unspecified 0 
7 ב ב ובפרס preposition unspecified unspecified unspecified unspecified unspecified 0 
7 פרס פרס ובפרס properName unspecified unspecified unspecified unspecified unspecified  	I_PERS	null
8 הדסה הדסה הדסה properName unspecified unspecified unspecified unspecified unspecified  	I_PERS	null
9 ( ( ( punctuation unspecified unspecified unspecified unspecified unspecified  	O	null
10 ###NUMBER### ###NUMBER### ###NUMBER### numeral unspecified unspecified unspecified unspecified unspecified  	I_DATE	null
11 ) ) ) punctuation unspecified unspecified unspecified unspecified unspecified  	O	null
12 על על על preposition unspecified unspecified unspecified unspecified unspecified  	O	null
13 כתיבת כתיבה כתיבתה noun feminine singular absolute unspecified unspecified  
13 ה ה כתיבתה possessive feminine singular unspecified 3 unspecified 0 	O	null
14 ל ל לילדים preposition unspecified unspecified unspecified unspecified unspecified 0 
14 ילדים ילד לילדים noun masculine plural absolute unspecified unspecified  	O	null
15 , , , punctuation unspecified unspecified unspecified unspecified unspecified  	O	null
16 ו ו ובפרס conjunction unspecified unspecified unspecified unspecified unspecified 0 
16 ב ב ובפרס preposition unspecified unspecified unspecified unspecified unspecified 0 
16 פרס פרס ובפרס noun masculine singular construct unspecified unspecified  	O	null
17 ה ה היצירה definiteArticle unspecified unspecified unspecified unspecified unspecified 0 
17 היצירה יצירה היצירה noun feminine singular absolute unspecified unspecified  	O	null
18 על על על preposition unspecified unspecified unspecified unspecified unspecified  	O	null
19 שם שם שם noun masculine singular construct unspecified unspecified  	O	null
20 ראש ראש ראש noun masculine singular construct unspecified unspecified  	O	null
21 ה ה הממשלה definiteArticle unspecified unspecified unspecified unspecified unspecified 0 
21 הממשלה ממשלה הממשלה noun feminine singular absolute unspecified unspecified  	O	null
22 לוי לוי לוי properName unspecified unspecified unspecified unspecified unspecified  	I_PERS	null
23 אשכול אשכול אשכול properName unspecified unspecified unspecified unspecified unspecified  	I_PERS	null
24 ) ) ) punctuation unspecified unspecified unspecified unspecified unspecified  	O	null
25 . . . punctuation unspecified unspecified unspecified unspecified unspecified  	O	null
26 ###NUMBER### ###NUMBER### ###NUMBER### numeral unspecified unspecified unspecified unspecified unspecified  	I_DATE	null
27 References References References foreign unspecified unspecified unspecified unspecified unspecified  	O	null
28 : : : punctuation unspecified unspecified unspecified unspecified unspecified  	O	null
29 נצר נצר נצר properName unspecified unspecified unspecified unspecified unspecified  	I_PERS	null
30 , , , punctuation unspecified unspecified unspecified unspecified unspecified  	O	null
31 רות רות רות properName unspecified unspecified unspecified unspecified unspecified  	I_PERS	null
32 . . . punctuation unspecified unspecified unspecified unspecified unspecified  	O	null

0 " " " punctuation unspecified unspecified unspecified unspecified unspecified  	O	null
1 שבעה CARD7 שבעה numeral masculine plural absolute unspecified unspecified  	O	null
2 ימים יום ימים noun masculine plural absolute unspecified unspecified  	O	null
3 " " " punctuation unspecified unspecified unspecified unspecified unspecified  	O	null
4 . . . punctuation unspecified unspecified unspecified unspecified unspecified  	O	null

0 מאזניים מאזניים מאזניים noun masculine plural absolute unspecified unspecified  	O	null
1 ס"ב ס"ב ס"ב properName unspecified unspecified unspecified unspecified unspecified  	I_LOC	null
2 - - - punctuation unspecified unspecified unspecified unspecified unspecified  	O	null
3 ###NUMBER### ###NUMBER### ###NUMBER### numeral unspecified unspecified unspecified unspecified unspecified  	O	null
4 ) ) ) punctuation unspecified unspecified unspecified unspecified unspecified  	O	null
5 . . . punctuation unspecified unspecified unspecified unspecified unspecified  	O	null

0 ###NUMBER### ###NUMBER### ###NUMBER### numeral unspecified unspecified unspecified unspecified unspecified  	O	null
1 ###NUMBER### ###NUMBER### ###NUMBER### numeral unspecified unspecified unspecified unspecified unspecified  	I_DATE	null
2 . . . punctuation unspecified unspecified unspecified unspecified unspecified  	O	null

0 - - - punctuation unspecified unspecified unspecified unspecified unspecified  	O	null
1 ###NUMBER### ###NUMBER### ###NUMBER### numeral unspecified unspecified unspecified unspecified unspecified  	O	null
2 ; ; ; punctuation unspecified unspecified unspecified unspecified unspecified  	O	null
3 ###NUMBER### ###NUMBER### ###NUMBER### numeral unspecified unspecified unspecified unspecified unspecified  	O	null
4 מסג מסג מסג noun masculine singular absolute unspecified unspecified  	O	null
5 , , , punctuation unspecified unspecified unspecified unspecified unspecified  	O	null
6 סבינה סבינה סבינה properName unspecified unspecified unspecified unspecified unspecified  	I_PERS	null
7 . . . punctuation unspecified unspecified unspecified unspecified unspecified  	O	null

0 " " " punctuation unspecified unspecified unspecified unspecified unspecified  	O	null
1 שירת שירה שירת noun feminine singular construct unspecified unspecified  	O	null
2 ה ה הטבע definiteArticle unspecified unspecified unspecified unspecified unspecified 0 
2 הטבע טבע הטבע noun masculine singular absolute unspecified unspecified  	O	null
3 ה ה החדשה definiteArticle unspecified unspecified unspecified unspecified unspecified 0 
3 החדשה חדש החדשה adjective feminine singular absolute unspecified unspecified  	O	null
4 " " " punctuation unspecified unspecified unspecified unspecified unspecified  	O	null
5 . . . punctuation unspecified unspecified unspecified unspecified unspecified  	O	null

0 מאזניים מאזניים מאזניים noun masculine plural absolute unspecified unspecified  	O	null
1 ע"ח ע"ח ע"ח preposition unspecified unspecified unspecified unspecified unspecified  	O	null
2 ) ) ) punctuation unspecified unspecified unspecified unspecified unspecified  	O	null
3 . . . punctuation unspecified unspecified unspecified unspecified unspecified  	O	null
4 ###NUMBER### ###NUMBER### ###NUMBER### numeral unspecified unspecified unspecified unspecified unspecified  	O	null
5 ###NUMBER### ###NUMBER### ###NUMBER### numeral unspecified unspecified unspecified unspecified unspecified  	I_DATE	null
6 . . . punctuation unspecified unspecified unspecified unspecified unspecified  	O	null

0 - - - punctuation unspecified unspecified unspecified unspecified unspecified  	O	null
1 ###NUMBER### ###NUMBER### ###NUMBER### numeral unspecified unspecified unspecified unspecified unspecified  	O	null
2 ; ; ; punctuation unspecified unspecified unspecified unspecified unspecified  	O	null
3 ###NUMBER### ###NUMBER### ###NUMBER### numeral unspecified unspecified unspecified unspecified unspecified  	O	null
4 - - - punctuation unspecified unspecified unspecified unspecified unspecified  	O	null
5 - - - punctuation unspecified unspecified unspecified unspecified unspecified  	O	null
6 - - - punctuation unspecified unspecified unspecified unspecified unspecified  	O	null
7 . . . punctuation unspecified unspecified unspecified unspecified unspecified  	O	null
8 " " " punctuation unspecified unspecified unspecified unspecified unspecified  	O	null
9 שירת שירה שירת noun feminine singular construct unspecified unspecified  	O	null
10 ה ה הטבע definiteArticle unspecified unspecified unspecified unspecified unspecified 0 
10 הטבע טבע הטבע noun masculine singular absolute unspecified unspecified  	O	null
11 ה ה החדשה definiteArticle unspecified unspecified unspecified unspecified unspecified 0 
11 החדשה חדש החדשה adjective feminine singular absolute unspecified unspecified  	O	null
12 ב ב ב preposition unspecified unspecified unspecified unspecified unspecified  	O	null
13 ' ' ' punctuation unspecified unspecified unspecified unspecified unspecified  	O	null
14 " " " punctuation unspecified unspecified unspecified unspecified unspecified  	O	null
15 . . . punctuation unspecified unspecified unspecified unspecified unspecified  	O	null

0 מאזניים מאזניים מאזניים noun masculine plural absolute unspecified unspecified  	O	null
1 ע"ט ע"ט ע"ט properName unspecified unspecified unspecified unspecified unspecified  	I_PERS	null
2 ) ) ) punctuation unspecified unspecified unspecified unspecified unspecified  	O	null
3 . . . punctuation unspecified unspecified unspecified unspecified unspecified  	O	null
4 ###NUMBER### ###NUMBER### ###NUMBER### numeral unspecified unspecified unspecified unspecified unspecified  	O	null
5 ###NUMBER### ###NUMBER### ###NUMBER### numeral unspecified unspecified unspecified unspecified unspecified  	I_DATE	null
6 . . . punctuation unspecified unspecified unspecified unspecified unspecified  	O	null

0 ###NUMBER### ###NUMBER### ###NUMBER### numeral unspecified unspecified unspecified unspecified unspecified  	O	null
1 - - - punctuation unspecified unspecified unspecified unspecified unspecified  	O	null
2 ###NUMBER### ###NUMBER### ###NUMBER### numeral unspecified unspecified unspecified unspecified unspecified  	O	null
3 . . . punctuation unspecified unspecified unspecified unspecified unspecified  	O	null

