0 Name Name Name foreign unspecified unspecified unspecified unspecified unspecified  	O	null
1 : : : punctuation unspecified unspecified unspecified unspecified unspecified  	O	null
2 מרגוליס מרגוליס מרגוליס properName unspecified unspecified unspecified unspecified unspecified  	I_ORG	null
3 , , , punctuation unspecified unspecified unspecified unspecified unspecified  	O	null
4 אסיה אסיה אסיה properName unspecified unspecified unspecified unspecified unspecified  	I_LOC	null
5 Birth Birth Birth foreign unspecified unspecified unspecified unspecified unspecified  	O	null
6 Year Year Year foreign unspecified unspecified unspecified unspecified unspecified  	O	null
7 : : : punctuation unspecified unspecified unspecified unspecified unspecified  	O	null
8 ###NUMBER### ###NUMBER### ###NUMBER### numeral unspecified unspecified unspecified unspecified unspecified  	I_DATE	null
9 Birth Birth Birth foreign unspecified unspecified unspecified unspecified unspecified  	O	null
10 Place Place Place foreign unspecified unspecified unspecified unspecified unspecified  	O	null
11 : : : punctuation unspecified unspecified unspecified unspecified unspecified  	O	null
12 אודסה אודסה אודסה properName unspecified unspecified unspecified unspecified unspecified  	I_LOC	null
13 , , , punctuation unspecified unspecified unspecified unspecified unspecified  	O	null
14 אוקראינה אוקראינה אוקראינה properName unspecified unspecified unspecified unspecified unspecified  	I_LOC	null
15 , , , punctuation unspecified unspecified unspecified unspecified unspecified  	O	null
16 ב ב בבית preposition unspecified unspecified unspecified unspecified unspecified 0 
16 בית בית בבית noun masculine singular construct unspecified unspecified  	O	null
17 Occupation Occupation Occupation foreign unspecified unspecified unspecified unspecified unspecified  	O	null
18 : : : punctuation unspecified unspecified unspecified unspecified unspecified  	O	null
19 משוררת משורר משוררת noun feminine singular absolute unspecified unspecified  	O	null
20 ו ו וסופרת conjunction unspecified unspecified unspecified unspecified unspecified 0 
20 סופרת סופר וסופרת noun feminine singular construct unspecified unspecified  	O	null
21 ילדים ילד ילדים noun masculine plural absolute unspecified unspecified  	O	null
22 Entry Entry Entry foreign unspecified unspecified unspecified unspecified unspecified  	O	null
23 writer writer writer foreign unspecified unspecified unspecified unspecified unspecified  	O	null
24 : : : punctuation unspecified unspecified unspecified unspecified unspecified  	O	null
25 אלישע אלישע אלישע properName unspecified unspecified unspecified unspecified unspecified  	I_PERS	null
26 פורת פורת פורת properName unspecified unspecified unspecified unspecified unspecified  	I_PERS	null
27 Entry Entry Entry foreign unspecified unspecified unspecified unspecified unspecified  	O	null
28 Value Value Value foreign unspecified unspecified unspecified unspecified unspecified  	O	null
29 : : : punctuation unspecified unspecified unspecified unspecified unspecified  	O	null
30 נולדה נולד נולדה verb feminine singular unspecified 3 past  	O	null
31 ב ב באודסה preposition unspecified unspecified unspecified unspecified unspecified 0 
31 אודסה אודסה באודסה properName unspecified unspecified unspecified unspecified unspecified  	I_LOC	null
32 , , , punctuation unspecified unspecified unspecified unspecified unspecified  	O	null
33 אוקראינה אוקראינה אוקראינה properName unspecified unspecified unspecified unspecified unspecified  	I_LOC	null
34 , , , punctuation unspecified unspecified unspecified unspecified unspecified  	O	null
35 ב ב בבית preposition unspecified unspecified unspecified unspecified unspecified 0 
35 בית בית בבית noun masculine singular construct unspecified unspecified  	O	null
36 יהודי יהודי יהודי noun masculine singular absolute unspecified unspecified  	O	null
37 מ מ ממתנגדי preposition unspecified unspecified unspecified unspecified unspecified 0 
37 מתנגדי מתנגד ממתנגדי noun masculine plural construct unspecified unspecified  	O	null
38 ה ה המשטר definiteArticle unspecified unspecified unspecified unspecified unspecified 0 
38 המשטר משטר המשטר noun masculine singular absolute unspecified unspecified  	O	null
39 ה ה הסובייטי definiteArticle unspecified unspecified unspecified unspecified unspecified 0 
39 הסובייטי סובייטי הסובייטי adjective masculine singular absolute unspecified unspecified  	O	null
40 . . . punctuation unspecified unspecified unspecified unspecified unspecified  	O	null

0 אביה אביה אביה properName unspecified unspecified unspecified unspecified unspecified  	I_PERS	null
1 היה הוא היה copula masculine singular unspecified 3 past  	O	null
2 פיזיקאימבריק פיזיקאימבריק פיזיקאימבריק properName unspecified unspecified unspecified unspecified unspecified  	I_PERS	null
3 , , , punctuation unspecified unspecified unspecified unspecified unspecified  	O	null
4 גיבור גיבור גיבור noun masculine singular construct unspecified unspecified  	O	null
5 מלחמת מלחמה מלחמת noun feminine singular construct unspecified unspecified  	O	null
6 ה ה העולם definiteArticle unspecified unspecified unspecified unspecified unspecified 0 
6 העולם עולם העולם noun masculine singular absolute unspecified unspecified  	O	null
7 ה ה השנייה definiteArticle unspecified unspecified unspecified unspecified unspecified 0 
7 השנייה ORD2 השנייה numeral feminine singular absolute unspecified unspecified  	O	null
8 ש ש שחלם relativizer/subordinatingConjunction unspecified unspecified unspecified unspecified unspecified 0 
8 חלם חלם שחלם verb masculine singular unspecified 3 past  	O	null
9 על על על preposition unspecified unspecified unspecified unspecified unspecified  	O	null
10 עלייה עלייה עלייה noun feminine singular absolute unspecified unspecified  	O	null
11 ל ל לישראל preposition unspecified unspecified unspecified unspecified unspecified 0 
11 ישראל ישראל לישראל properName unspecified unspecified unspecified unspecified unspecified  	I_LOC	null
12 . . . punctuation unspecified unspecified unspecified unspecified unspecified  	O	null

0 הוא הוא הוא pronoun masculine singular unspecified 3 unspecified  	O	null
1 הכשיר הכשיר הכשיר verb masculine singular unspecified 3 past  	O	null
2 את את את at-preposition unspecified unspecified unspecified unspecified unspecified  	O	null
3 ילדי ילד ילדיו noun masculine plural absolute unspecified unspecified  
3 ו ו ילדיו possessive masculine singular unspecified 3 unspecified 0 	O	null
4 ל ל לעבודה preposition unspecified unspecified unspecified unspecified unspecified 0 
4 ה ה לעבודה definiteArticle unspecified unspecified unspecified unspecified unspecified 0 
4 העבודה עבודה לעבודה noun feminine singular absolute unspecified unspecified  	O	null
5 ב ב בחקלאות preposition unspecified unspecified unspecified unspecified unspecified 0 
5 ה ה בחקלאות definiteArticle unspecified unspecified unspecified unspecified unspecified 0 
5 החקלאות חקלאות בחקלאות noun feminine singular absolute unspecified unspecified  	O	null
6 , , , punctuation unspecified unspecified unspecified unspecified unspecified  	O	null
7 לקראת לקראת לקראת preposition unspecified unspecified unspecified unspecified unspecified  	O	null
8 ה ה החיים definiteArticle unspecified unspecified unspecified unspecified unspecified 0 
8 החיים חיים החיים noun masculine plural absolute unspecified unspecified  	O	null
9 ב ב בקיבוץ preposition unspecified unspecified unspecified unspecified unspecified 0 
9 ה ה בקיבוץ definiteArticle unspecified unspecified unspecified unspecified unspecified 0 
9 הקיבוץ קיבוץ בקיבוץ noun masculine singular absolute unspecified unspecified  	O	null
10 . . . punctuation unspecified unspecified unspecified unspecified unspecified  	O	null

0 למדה למד למדה verb feminine singular unspecified 3 past  	I_LOC	null
1 ב ב באוניברסיטת preposition unspecified unspecified unspecified unspecified unspecified 0 
1 אוניברסיטת אוניברסיטה באוניברסיטת noun feminine singular construct unspecified unspecified  	I_LOC	null
2 ירוסלבל ירוסלבל ירוסלבל properName unspecified unspecified unspecified unspecified unspecified  	I_ORG	null
3 מתמטיקה מתמטיקה מתמטיקה noun feminine singular absolute unspecified unspecified  	O	null
4 ו ו והוראה conjunction unspecified unspecified unspecified unspecified unspecified 0 
4 הוראה הוראה והוראה noun feminine singular absolute unspecified unspecified  	O	null
5 - - - punctuation unspecified unspecified unspecified unspecified unspecified  	O	null
6 ###NUMBER### ###NUMBER### ###NUMBER### numeral unspecified unspecified unspecified unspecified unspecified  	I_DATE	null
7 ) ) ) punctuation unspecified unspecified unspecified unspecified unspecified  	O	null
8 . . . punctuation unspecified unspecified unspecified unspecified unspecified  	O	null

0 ###NUMBER### ###NUMBER### ###NUMBER### numeral unspecified unspecified unspecified unspecified unspecified  	I_DATE	null
1 ב ב ב preposition unspecified unspecified unspecified unspecified unspecified 0 	O	null
2 - - - punctuation unspecified unspecified unspecified unspecified unspecified  	O	null
3 ###NUMBER### ###NUMBER### ###NUMBER### numeral unspecified unspecified unspecified unspecified unspecified  	I_DATE	null
4 עלתה עלה עלתה verb feminine singular unspecified 3 past  	O	null
5 ל ל לישראל preposition unspecified unspecified unspecified unspecified unspecified 0 
5 ישראל ישראל לישראל properName unspecified unspecified unspecified unspecified unspecified  	I_LOC	null
6 עם עם עם preposition unspecified unspecified unspecified unspecified unspecified  	O	null
7 אמה אמה אמה properName unspecified unspecified unspecified unspecified unspecified  	I_PERS	null
8 ו ו ואחיה conjunction unspecified unspecified unspecified unspecified unspecified 0 
8 אחי אח ואחיה noun masculine plural absolute unspecified unspecified  
8 ה ה ואחיה possessive feminine singular unspecified 3 unspecified 0 	I_LOC	null
9 אחרי אחרי אחרי preposition unspecified unspecified unspecified unspecified unspecified  	O	null
10 ש ש ששילמו relativizer/subordinatingConjunction unspecified unspecified unspecified unspecified unspecified 0 
10 שילמו שילם ששילמו verb masculine-and-feminine plural unspecified 3 past  	O	null
11 כופר כופר כופר noun masculine singular absolute unspecified unspecified  	O	null
12 גדול גדול גדול adjective masculine singular absolute unspecified unspecified  	O	null
13 עבור עבור עבור preposition unspecified unspecified unspecified unspecified unspecified  	O	null
14 לימודי לימוד לימודיה noun masculine plural absolute unspecified unspecified  
14 ה ה לימודיה possessive feminine singular unspecified 3 unspecified 0 	O	null
15 . . . punctuation unspecified unspecified unspecified unspecified unspecified  	O	null

0 ה ה האב definiteArticle unspecified unspecified unspecified unspecified unspecified 0 
0 האב אב האב noun masculine singular absolute unspecified unspecified  	O	null
1 נפטר נפטר נפטר verb masculine singular unspecified 3 past  	O	null
2 בטרם בטרם בטרם conjunction unspecified unspecified unspecified unspecified unspecified  	O	null
3 ה ה העלייה definiteArticle unspecified unspecified unspecified unspecified unspecified 0 
3 העלייה עלייה העלייה noun feminine singular absolute unspecified unspecified  	O	null
4 . . . punctuation unspecified unspecified unspecified unspecified unspecified  	O	null

0 ה ה המשפחה definiteArticle unspecified unspecified unspecified unspecified unspecified 0 
0 המשפחה משפחה המשפחה noun feminine singular absolute unspecified unspecified  	O	null
1 נקלטה נקלט נקלטה verb feminine singular unspecified 3 past  	O	null
2 ב ב בארץ preposition unspecified unspecified unspecified unspecified unspecified 0 
2 ה ה בארץ definiteArticle unspecified unspecified unspecified unspecified unspecified 0 
2 הארץ ארץ בארץ noun feminine singular absolute unspecified unspecified  	O	null
3 ב ב באולפן preposition unspecified unspecified unspecified unspecified unspecified 0 
3 אולפן אולפן באולפן noun masculine singular absolute unspecified unspecified  	O	null
4 ל ל לעולים preposition unspecified unspecified unspecified unspecified unspecified 0 
4 עולים עולה לעולים noun masculine plural absolute unspecified unspecified  	O	null
5 ב ב בקיבוץ preposition unspecified unspecified unspecified unspecified unspecified 0 
5 קיבוץ קיבוץ בקיבוץ noun masculine singular construct unspecified unspecified  	I_LOC	null
6 חצור חצור חצור properName unspecified unspecified unspecified unspecified unspecified  	I_LOC	null
7 . . . punctuation unspecified unspecified unspecified unspecified unspecified  	O	null

0 לאחר לאחר לאחר conjunction unspecified unspecified unspecified unspecified unspecified  	O	null
1 מכן מיכן מכן verb masculine singular unspecified 2 imperative  	O	null
2 עברה עבר עברה verb feminine singular unspecified 3 past  	O	null
3 ל ל לבית preposition unspecified unspecified unspecified unspecified unspecified 0 
3 בית בית לבית properName unspecified unspecified unspecified unspecified unspecified  	I_PERS	null
4 אלפא אלפא אלפא properName unspecified unspecified unspecified unspecified unspecified  	I_PERS	null
5 ו ו ועסקה conjunction unspecified unspecified unspecified unspecified unspecified 0 
5 עסקה עסק ועסקה verb feminine singular unspecified 3 past  	O	null
6 ב ב בהוראת preposition unspecified unspecified unspecified unspecified unspecified 0 
6 הוראת הוראה בהוראת noun feminine singular construct unspecified unspecified  	O	null
7 מתמטיקה מתמטיקה מתמטיקה noun feminine singular absolute unspecified unspecified  	O	null
8 . . . punctuation unspecified unspecified unspecified unspecified unspecified  	O	null

0 שם שם שם adverb unspecified unspecified unspecified unspecified unspecified  	O	null
1 הכירה הכיר הכירה verb feminine singular unspecified 3 past  	O	null
2 את את את at-preposition unspecified unspecified unspecified unspecified unspecified  	O	null
3 ברוך ברוך ברוך properName unspecified unspecified unspecified unspecified unspecified  	I_PERS	null
4 שילקרוט שילקרוט שילקרוט properName unspecified unspecified unspecified unspecified unspecified  	I_PERS	null
5 , , , punctuation unspecified unspecified unspecified unspecified unspecified  	O	null
6 לשעבר לשעבר לשעבר adverb unspecified unspecified unspecified unspecified unspecified  	O	null
7 אסיר אסיר אסיר noun masculine singular absolute unspecified unspecified  	O	null
8 ציון ציון ציון properName unspecified unspecified unspecified unspecified unspecified  	I_PERS	null
9 בלנינגרד בלנינגרד בלנינגרד properName unspecified unspecified unspecified unspecified unspecified  	I_PERS	null
10 , , , punctuation unspecified unspecified unspecified unspecified unspecified  	O	null
11 ו ו והם conjunction unspecified unspecified unspecified unspecified unspecified 0 
11 הם הוא והם pronoun masculine plural unspecified 3 unspecified  	O	null
12 נישאו נישא נישאו verb masculine-and-feminine plural unspecified 3 past  	O	null
13 . . . punctuation unspecified unspecified unspecified unspecified unspecified  	O	null

0 היא הוא היא pronoun feminine singular unspecified 3 unspecified  	O	null
1 המשיכה המשיך המשיכה verb feminine singular unspecified 3 past  	O	null
2 את את את at-preposition unspecified unspecified unspecified unspecified unspecified  	O	null
3 לימודיהבסמינר לימודיהבסמינר לימודיהבסמינר properName unspecified unspecified unspecified unspecified unspecified  	I_PERS	null
4 ל ל למורים preposition unspecified unspecified unspecified unspecified unspecified 0 
4 ה ה למורים definiteArticle unspecified unspecified unspecified unspecified unspecified 0 
4 המורים מורה למורים noun masculine plural absolute unspecified unspecified  	O	null
5 " " " punctuation unspecified unspecified unspecified unspecified unspecified  	O	null
6 בית בית בית noun masculine singular construct unspecified unspecified  	O	null
7 ה ה הכרם definiteArticle unspecified unspecified unspecified unspecified unspecified 0 
7 הכרם כרם הכרם noun masculine singular absolute unspecified unspecified  	O	null
8 " " " punctuation unspecified unspecified unspecified unspecified unspecified  	O	null
9 . . . punctuation unspecified unspecified unspecified unspecified unspecified  	O	null

0 למדה למד למדה verb feminine singular unspecified 3 past  	O	null
1 חינוך חינוך חינוך noun masculine singular absolute unspecified unspecified  	O	null
2 מבוגרים מבוגר מבוגרים adjective masculine plural absolute unspecified unspecified  	O	null
3 , , , punctuation unspecified unspecified unspecified unspecified unspecified  	O	null
4 בוררות בוררות בוררות noun feminine singular absolute unspecified unspecified  	O	null
5 ו ו והכשרת conjunction unspecified unspecified unspecified unspecified unspecified 0 
5 הכשרת הכשרה והכשרת noun feminine singular construct unspecified unspecified  	O	null
6 דירקטורים דירקטור דירקטורים noun masculine plural absolute unspecified unspecified  	O	null
7 , , , punctuation unspecified unspecified unspecified unspecified unspecified  	O	null
8 ו ו והוסמכה conjunction unspecified unspecified unspecified unspecified unspecified 0 
8 הוסמכה הוסמך והוסמכה verb feminine singular unspecified 3 past  	O	null
9 כמורה כמורה כמורה noun feminine singular absolute unspecified unspecified  	O	null
10 בכירה.ב בכירה.ב בכירה.ב verb feminine singular unspecified 2 imperative  	O	null
11 - - - punctuation unspecified unspecified unspecified unspecified unspecified  	O	null
12 הצטרפה הצטרף הצטרפה verb feminine singular unspecified 3 past  	O	null
13 עם עם עם preposition unspecified unspecified unspecified unspecified unspecified  	O	null
14 משפחת משפחה משפחתה noun feminine singular absolute unspecified unspecified  
14 ה ה משפחתה possessive feminine singular unspecified 3 unspecified 0 	O	null
15 ל ל לקיבוץ preposition unspecified unspecified unspecified unspecified unspecified 0 
15 קיבוץ קיבוץ לקיבוץ noun masculine singular construct unspecified unspecified  	I_LOC	null
16 נגבה נגבה נגבה properName unspecified unspecified unspecified unspecified unspecified  	I_LOC	null
17 . . . punctuation unspecified unspecified unspecified unspecified unspecified  	O	null

0 ב ב בסוף preposition unspecified unspecified unspecified unspecified unspecified 0 
0 סוף סוף בסוף noun masculine singular construct unspecified unspecified  	O	null
1 שנות שנה שנות noun feminine plural construct unspecified unspecified  	O	null
2 ה ה השבעים definiteArticle unspecified unspecified unspecified unspecified unspecified 0 
2 השבעים ORD-CARD70 השבעים numeral masculine-and-feminine plural absolute unspecified unspecified  	O	null
3 החלה החל החלה verb feminine singular unspecified 3 past  	O	null
4 לפרסם פרסם לפרסם verb unspecified unspecified unspecified unspecified infinitive  	O	null
5 מ מ משיריה preposition unspecified unspecified unspecified unspecified unspecified 0 
5 שירי שיר משיריה noun masculine plural absolute unspecified unspecified  
5 ה ה משיריה possessive feminine singular unspecified 3 unspecified 0 	O	null
6 ב ב בעברית preposition unspecified unspecified unspecified unspecified unspecified 0 
6 עברית עברית בעברית properName feminine singular unspecified unspecified unspecified  	I_LOC	null
7 . . . punctuation unspecified unspecified unspecified unspecified unspecified  	O	null

0 שיר שיר שירה noun masculine singular absolute unspecified unspecified  
0 ה ה שירה possessive feminine singular unspecified 3 unspecified 0 	O	null
1 ה ה הראשון definiteArticle unspecified unspecified unspecified unspecified unspecified 0 
1 הראשון ORD1 הראשון numeral masculine singular absolute unspecified unspecified  	O	null
2 פורסם פורסם פורסם verb masculine singular unspecified 3 past  	O	null
3 ב ב בדף preposition unspecified unspecified unspecified unspecified unspecified 0 
3 דף דף בדף noun masculine singular absolute unspecified unspecified  	O	null
4 ל ל לספרות preposition unspecified unspecified unspecified unspecified unspecified 0 
4 ה ה לספרות definiteArticle unspecified unspecified unspecified unspecified unspecified 0 
4 הספרות ספרות לספרות noun feminine singular absolute unspecified unspecified  	O	null
5 ש ש שלעל relativizer/subordinatingConjunction unspecified unspecified unspecified unspecified unspecified 0 
5 ל ל שלעל preposition unspecified unspecified unspecified unspecified unspecified 0 
5 ה ה שלעל definiteArticle unspecified unspecified unspecified unspecified unspecified 0 
5 העל על שלעל noun masculine singular absolute unspecified unspecified  	O	null
6 ה ה המשמר definiteArticle unspecified unspecified unspecified unspecified unspecified 0 
6 המשמר משמר המשמר noun masculine singular absolute unspecified unspecified  	O	null
7 ) ) ) punctuation unspecified unspecified unspecified unspecified unspecified  	O	null
8 . . . punctuation unspecified unspecified unspecified unspecified unspecified  	O	null
9 ###NUMBER### ###NUMBER### ###NUMBER### numeral unspecified unspecified unspecified unspecified unspecified  	I_DATE	null
10 ה ה המשורר definiteArticle unspecified unspecified unspecified unspecified unspecified 0 
10 המשורר משורר המשורר noun masculine singular absolute unspecified unspecified  	O	null
11 נתן נתן נתן properName unspecified unspecified unspecified unspecified unspecified  	I_PERS	null
12 יונתן יונתן יונתן properName unspecified unspecified unspecified unspecified unspecified  	I_PERS	null
13 , , , punctuation unspecified unspecified unspecified unspecified unspecified  	O	null
14 ש ש שהיה relativizer/subordinatingConjunction unspecified unspecified unspecified unspecified unspecified 0 
14 היה הוא שהיה copula masculine singular unspecified 3 past  	O	null
15 עורך עורך עורך noun masculine singular construct unspecified unspecified  	O	null
16 ה ה השירה definiteArticle unspecified unspecified unspecified unspecified unspecified 0 
16 השירה שירה השירה noun feminine singular absolute unspecified unspecified  	O	null
17 ב ב בספרית preposition unspecified unspecified unspecified unspecified unspecified 0 
17 ספרית ספר בספרית noun feminine singular construct unspecified unspecified  	O	null
18 פועלים פועל פועלים noun masculine plural absolute unspecified unspecified  	O	null
19 , , , punctuation unspecified unspecified unspecified unspecified unspecified  	O	null
20 התרשם התרשם התרשם verb masculine singular unspecified 3 past  	O	null
21 מ מ מהשיר preposition unspecified unspecified unspecified unspecified unspecified 0 
21 ה ה מהשיר definiteArticle unspecified unspecified unspecified unspecified unspecified 0 
21 השיר שיר מהשיר noun masculine singular absolute unspecified unspecified  	O	null
22 ו ו והציע conjunction unspecified unspecified unspecified unspecified unspecified 0 
22 הציע הציע והציע verb masculine singular unspecified 3 past  	O	null
23 ל ל לה preposition unspecified unspecified unspecified unspecified unspecified  
23 ה ה לה pronomial feminine singular unspecified 3 unspecified 0 	O	null
24 להוציא הוציא להוציא verb unspecified unspecified unspecified unspecified infinitive  	O	null
25 ספר ספר ספר noun masculine singular absolute unspecified unspecified  	O	null
26 . . . punctuation unspecified unspecified unspecified unspecified unspecified  	O	null

0 ב ב ב preposition unspecified unspecified unspecified unspecified unspecified 0 	O	null
1 - - - punctuation unspecified unspecified unspecified unspecified unspecified  	O	null
2 ###NUMBER### ###NUMBER### ###NUMBER### numeral unspecified unspecified unspecified unspecified unspecified  	I_DATE	null
3 יצא יצא יצא verb masculine singular unspecified 3 past  	O	null
4 לאור לאור לאור preposition unspecified unspecified unspecified unspecified unspecified  	O	null
5 ספר ספר ספר noun masculine singular construct unspecified unspecified  	O	null
6 שירי שיר שיריה noun masculine plural absolute unspecified unspecified  
6 ה ה שיריה possessive feminine singular unspecified 3 unspecified 0 	O	null
7 ה ה הראשון definiteArticle unspecified unspecified unspecified unspecified unspecified 0 
7 הראשון ORD1 הראשון numeral masculine singular absolute unspecified unspecified  	O	null
8 , , , punctuation unspecified unspecified unspecified unspecified unspecified  	O	null
9 קווים קו קווים noun masculine plural absolute unspecified unspecified  	O	null
10 משם משם משם adverb unspecified unspecified unspecified unspecified unspecified  	O	null
11 ( ( ( punctuation unspecified unspecified unspecified unspecified unspecified  	O	null
12 ספרית ספר ספרית noun feminine singular construct unspecified unspecified  	O	null
13 פועלים פועל פועלים noun masculine plural absolute unspecified unspecified  	O	null
14 ) ) ) punctuation unspecified unspecified unspecified unspecified unspecified  	O	null
15 . . . punctuation unspecified unspecified unspecified unspecified unspecified  	O	null

0 ה ה הספר definiteArticle unspecified unspecified unspecified unspecified unspecified 0 
0 הספר ספר הספר noun masculine singular absolute unspecified unspecified  	O	null
1 התקבל התקבל התקבל verb masculine singular unspecified 3 past  	O	null
2 ב ב באהדה preposition unspecified unspecified unspecified unspecified unspecified 0 
2 אהדה אהדה באהדה noun feminine singular absolute unspecified unspecified  	O	null
3 רבה רב רבה adjective feminine singular absolute unspecified unspecified  	O	null
4 ו ו ושיריה conjunction unspecified unspecified unspecified unspecified unspecified 0 
4 שירי שיר ושיריה noun masculine plural absolute unspecified unspecified  
4 ה ה ושיריה possessive feminine singular unspecified 3 unspecified 0 	O	null
5 צוטטו צוטט צוטטו verb masculine-and-feminine plural unspecified 3 past  	O	null
6 ב ב בבמות preposition unspecified unspecified unspecified unspecified unspecified 0 
6 במות במה בבמות noun feminine plural absolute unspecified unspecified  	O	null
7 רבות רב רבות adjective feminine plural absolute unspecified unspecified  	O	null
8 ו ו ואף conjunction unspecified unspecified unspecified unspecified unspecified 0 
8 אף אף ואף conjunction unspecified unspecified unspecified unspecified unspecified  	O	null
9 פורסמו פורסם פורסמו verb masculine-and-feminine plural unspecified 3 past  	O	null
10 באנתולוגיות באנתולוגיות באנתולוגיות noun feminine plural absolute unspecified unspecified  	O	null
11 . . . punctuation unspecified unspecified unspecified unspecified unspecified  	O	null

0 מ מ מספריה preposition unspecified unspecified unspecified unspecified unspecified 0 
0 ספריה ספרייה מספריה noun feminine singular absolute unspecified unspecified  	O	null
1 עד עד עד preposition unspecified unspecified unspecified unspecified unspecified  	O	null
2 כה כה כה adverb unspecified unspecified unspecified unspecified unspecified  	O	null
3 : : : punctuation unspecified unspecified unspecified unspecified unspecified  	O	null
4 ל ל לנקבה preposition unspecified unspecified unspecified unspecified unspecified 0 
4 נקבה נקבה לנקבה noun feminine singular absolute unspecified unspecified  	O	null
5 יש יש יש existential unspecified unspecified unspecified unspecified unspecified  	O	null
6 כאב כאב כאב noun masculine singular absolute unspecified unspecified  	O	null
7 ( ( ( punctuation unspecified unspecified unspecified unspecified unspecified  	O	null
8 ) ) ) punctuation unspecified unspecified unspecified unspecified unspecified  	O	null
9 ‬ ‬ ‬ punctuation unspecified unspecified unspecified unspecified unspecified  	O	null
10 ; ; ; punctuation unspecified unspecified unspecified unspecified unspecified  	O	null
11 ###NUMBER### ###NUMBER### ###NUMBER### numeral unspecified unspecified unspecified unspecified unspecified  	I_DATE	null
12 מה מה מה interrogative unspecified unspecified unspecified unspecified unspecified  	O	null
13 ש ש שלי relativizer/subordinatingConjunction unspecified unspecified unspecified unspecified unspecified 0 
13 ל ל שלי preposition unspecified unspecified unspecified unspecified unspecified  
13 י י שלי pronomial masculine-and-feminine singular unspecified 1 unspecified 0 	O	null
14 ו ו ומה conjunction unspecified unspecified unspecified unspecified unspecified 0 
14 מה מה ומה interrogative unspecified unspecified unspecified unspecified unspecified  	O	null
15 לא לא לא negation unspecified unspecified unspecified unspecified unspecified  	O	null
16 של של שלי shel-preposition unspecified unspecified unspecified unspecified unspecified  
16 י י שלי pronomial masculine-and-feminine singular unspecified 1 unspecified 0 	O	null
17 ) ) ) punctuation unspecified unspecified unspecified unspecified unspecified  	O	null
18 ; ; ; punctuation unspecified unspecified unspecified unspecified unspecified  	O	null
19 ###NUMBER### ###NUMBER### ###NUMBER### numeral unspecified unspecified unspecified unspecified unspecified  	I_DATE	null
20 שלום שלום שלום noun masculine singular absolute unspecified unspecified  	O	null
21 אמא אמא אמא noun feminine singular absolute unspecified unspecified  	O	null
22 ! ! ! punctuation unspecified unspecified unspecified unspecified unspecified  	O	null

0 שלום שלום שלום noun masculine singular construct unspecified unspecified  	O	null
1 אבא אבא אבא properName unspecified unspecified unspecified unspecified unspecified  	I_PERS	null
2 ! ! ! punctuation unspecified unspecified unspecified unspecified unspecified  	O	null

0 ) ) ) punctuation unspecified unspecified unspecified unspecified unspecified  	O	null
1 ; ; ; punctuation unspecified unspecified unspecified unspecified unspecified  	O	null
2 ###NUMBER### ###NUMBER### ###NUMBER### numeral unspecified unspecified unspecified unspecified unspecified  	I_DATE	null
3 קטינקה קטינקה קטינקה properName unspecified unspecified unspecified unspecified unspecified  	I_DATE	null
4 ( ( ( punctuation unspecified unspecified unspecified unspecified unspecified  	O	null
5 ) ) ) punctuation unspecified unspecified unspecified unspecified unspecified  	O	null
6 ; ; ; punctuation unspecified unspecified unspecified unspecified unspecified  	O	null
7 הר הר הר properName unspecified unspecified unspecified unspecified unspecified  	O	null
8 ###NUMBER### ###NUMBER### ###NUMBER### numeral unspecified unspecified unspecified unspecified unspecified  	I_DATE	null
9 נבו נבו נבו properName unspecified unspecified unspecified unspecified unspecified  	I_PERS	null
10 : : : punctuation unspecified unspecified unspecified unspecified unspecified  	O	null
11 שירים שיר שירים noun masculine plural absolute unspecified unspecified  	O	null
12 ) ) ) punctuation unspecified unspecified unspecified unspecified unspecified  	O	null
13 . . . punctuation unspecified unspecified unspecified unspecified unspecified  	O	null
14 שירים שיר שירים noun masculine plural absolute unspecified unspecified  	O	null
15 ###NUMBER### ###NUMBER### ###NUMBER### numeral unspecified unspecified unspecified unspecified unspecified  	I_DATE	null
16 בודדים בודד בודדים noun masculine plural absolute unspecified unspecified  	O	null
17 של של שלה shel-preposition unspecified unspecified unspecified unspecified unspecified  
17 ה ה שלה pronomial feminine singular unspecified 3 unspecified 0 	O	null
18 תורגמו תורגם תורגמו verb masculine-and-feminine plural unspecified 3 past  	O	null
19 ל ל לכמה preposition unspecified unspecified unspecified unspecified unspecified 0 
19 כמה כמה לכמה quantifier unspecified unspecified construct unspecified unspecified  	O	null
20 שפות שפה שפות noun feminine plural absolute unspecified unspecified  	O	null
21 . . . punctuation unspecified unspecified unspecified unspecified unspecified  	O	null

0 ב ב ב preposition unspecified unspecified unspecified unspecified unspecified 0 	O	null
1 - - - punctuation unspecified unspecified unspecified unspecified unspecified  	O	null
2 ###NUMBER### ###NUMBER### ###NUMBER### numeral unspecified unspecified unspecified unspecified unspecified  	I_DATE	null
3 הועלה הועלה הועלה verb masculine singular unspecified 3 past  	O	null
4 מחזה מחזה מחזה noun masculine singular absolute unspecified unspecified  	O	null
5 של של שלה shel-preposition unspecified unspecified unspecified unspecified unspecified  
5 ה ה שלה pronomial feminine singular unspecified 3 unspecified 0 	O	null
6 ל ל לילדים preposition unspecified unspecified unspecified unspecified unspecified 0 
6 ילדים ילד לילדים noun masculine plural absolute unspecified unspecified  	O	null
7 ב ב בתיאטרון preposition unspecified unspecified unspecified unspecified unspecified 0 
7 תיאטרון תיאטרון בתיאטרון noun masculine singular construct unspecified unspecified  	O	null
8 ה ה הקיבוץ definiteArticle unspecified unspecified unspecified unspecified unspecified 0 
8 הקיבוץ קיבוץ הקיבוץ noun masculine singular absolute unspecified unspecified  	O	null
9 . . . punctuation unspecified unspecified unspecified unspecified unspecified  	O	null

0 ספר ספר ספר noun masculine singular construct unspecified unspecified  	O	null
1 ילדים ילד ילדים noun masculine plural absolute unspecified unspecified  	O	null
2 של של שלה shel-preposition unspecified unspecified unspecified unspecified unspecified  
2 ה ה שלה pronomial feminine singular unspecified 3 unspecified 0 	O	null
3 עובד עובד עובד verb masculine singular unspecified 3 past  	O	null
4 ל ל לשידור preposition unspecified unspecified unspecified unspecified unspecified 0 
4 ה ה לשידור definiteArticle unspecified unspecified unspecified unspecified unspecified 0 
4 השידור שידור לשידור noun masculine singular absolute unspecified unspecified  	O	null
5 ב ב בטלוויזיה preposition unspecified unspecified unspecified unspecified unspecified 0 
5 ה ה בטלוויזיה definiteArticle unspecified unspecified unspecified unspecified unspecified 0 
5 הטלוויזיה טלוויזיה בטלוויזיה noun feminine singular absolute unspecified unspecified  	O	null
6 ה ה החינוכית definiteArticle unspecified unspecified unspecified unspecified unspecified 0 
6 החינוכית חינוכי החינוכית adjective feminine singular absolute unspecified unspecified  	O	null
7 . . . punctuation unspecified unspecified unspecified unspecified unspecified  	O	null

0 היתה הוא היתה copula feminine singular unspecified 3 past  	O	null
1 חברה חבר חברה noun feminine singular absolute unspecified unspecified  	O	null
2 ב ב במועצת preposition unspecified unspecified unspecified unspecified unspecified 0 
2 מועצת מועצה במועצת noun feminine singular construct unspecified unspecified  	O	null
3 ה ה הפיס definiteArticle unspecified unspecified unspecified unspecified unspecified 0 
3 הפיס פיס הפיס noun masculine singular absolute unspecified unspecified  	O	null
4 ל ל לתרבות preposition unspecified unspecified unspecified unspecified unspecified 0 
4 ה ה לתרבות definiteArticle unspecified unspecified unspecified unspecified unspecified 0 
4 התרבות תרבות לתרבות noun feminine singular absolute unspecified unspecified  	O	null
5 ו ו ואמנות conjunction unspecified unspecified unspecified unspecified unspecified 0 
5 אמנות אמנות ואמנות noun feminine singular absolute unspecified unspecified  	O	null
6 ) ) ) punctuation unspecified unspecified unspecified unspecified unspecified  	O	null
7 . . . punctuation unspecified unspecified unspecified unspecified unspecified  	O	null
8 ###NUMBER### ###NUMBER### ###NUMBER### numeral unspecified unspecified unspecified unspecified unspecified  	I_DATE	null
9 מילאה מילא מילאה verb feminine singular unspecified 3 past  	O	null
10 תפקידים תפקיד תפקידים noun masculine plural absolute unspecified unspecified  	O	null
11 ציבוריים ציבורי ציבוריים adjective masculine plural absolute unspecified unspecified  	O	null
12 ב ב בקיבוצה preposition unspecified unspecified unspecified unspecified unspecified 0 
12 קיבוץ קיבוץ בקיבוצה noun masculine singular absolute unspecified unspecified  
12 ה ה בקיבוצה possessive feminine singular unspecified 3 unspecified 0 	O	null
13 ו ו ובקיבוץ conjunction unspecified unspecified unspecified unspecified unspecified 0 
13 ב ב ובקיבוץ preposition unspecified unspecified unspecified unspecified unspecified 0 
13 ה ה ובקיבוץ definiteArticle unspecified unspecified unspecified unspecified unspecified 0 
13 הקיבוץ קיבוץ ובקיבוץ noun masculine singular absolute unspecified unspecified  	O	null
14 ה ה הארצי definiteArticle unspecified unspecified unspecified unspecified unspecified 0 
14 הארצי ארצי הארצי adjective masculine singular absolute unspecified unspecified  	O	null
15 . . . punctuation unspecified unspecified unspecified unspecified unspecified  	O	null

0 מאז מאז מאז adverb unspecified unspecified unspecified unspecified unspecified  	O	null
1 ###NUMBER### ###NUMBER### ###NUMBER### numeral unspecified unspecified unspecified unspecified unspecified  	I_DATE	null
2 היא הוא היא pronoun feminine singular unspecified 3 unspecified  	O	null
3 מנהלת מנהל מנהלת noun feminine singular construct unspecified unspecified  	O	null
4 קהילה קהילה קהילה noun feminine singular absolute unspecified unspecified  	O	null
5 ב ב בקיבוצים preposition unspecified unspecified unspecified unspecified unspecified 0 
5 ה ה בקיבוצים definiteArticle unspecified unspecified unspecified unspecified unspecified 0 
5 הקיבוצים קיבוץ בקיבוצים noun masculine plural absolute unspecified unspecified  	O	null
6 נחשון נחשון נחשון properName unspecified unspecified unspecified unspecified unspecified  	I_PERS	null
7 , , , punctuation unspecified unspecified unspecified unspecified unspecified  	O	null
8 להב להב להב properName unspecified unspecified unspecified unspecified unspecified  	I_PERS	null
9 , , , punctuation unspecified unspecified unspecified unspecified unspecified  	O	null
10 כיסופים כיסופים כיסופים properName unspecified unspecified unspecified unspecified unspecified  	I_PERS	null
11 ו ו ודורות conjunction unspecified unspecified unspecified unspecified unspecified 0 
11 דורות דור ודורות properName unspecified unspecified unspecified unspecified unspecified  	I_PERS	null
12 . . . punctuation unspecified unspecified unspecified unspecified unspecified  	O	null

0 References References References foreign unspecified unspecified unspecified unspecified unspecified  	O	null
1 : : : punctuation unspecified unspecified unspecified unspecified unspecified  	O	null
2 דותן דותן דותן properName unspecified unspecified unspecified unspecified unspecified  	I_PERS	null
3 , , , punctuation unspecified unspecified unspecified unspecified unspecified  	O	null
4 איל איל איל properName unspecified unspecified unspecified unspecified unspecified  	I_PERS	null
5 . . . punctuation unspecified unspecified unspecified unspecified unspecified  	O	null

0 " " " punctuation unspecified unspecified unspecified unspecified unspecified  	O	null
1 לפרפר פרפר לפרפר verb unspecified unspecified unspecified unspecified infinitive  	O	null
2 ו ו ולקפוץ conjunction unspecified unspecified unspecified unspecified unspecified 0 
2 לקפוץ קפץ ולקפוץ verb unspecified unspecified unspecified unspecified infinitive  	O	null
3 הצידה הצידה הצידה adverb unspecified unspecified unspecified unspecified unspecified  	I_ORG	null
4 , , , punctuation unspecified unspecified unspecified unspecified unspecified  	O	null
5 ל ל לצרצר preposition unspecified unspecified unspecified unspecified unspecified 0 
5 ה ה לצרצר definiteArticle unspecified unspecified unspecified unspecified unspecified 0 
5 הצרצר צרצר לצרצר noun masculine singular absolute unspecified unspecified  	O	null
6 ו ו ולשתוק conjunction unspecified unspecified unspecified unspecified unspecified 0 
6 לשתוק שתק ולשתוק verb unspecified unspecified unspecified unspecified infinitive  	O	null
7 ב ב בזהירות preposition unspecified unspecified unspecified unspecified unspecified 0 
7 זהירות זהירות בזהירות noun feminine singular absolute unspecified unspecified  	O	null
8 " " " punctuation unspecified unspecified unspecified unspecified unspecified  	O	null
9 . . . punctuation unspecified unspecified unspecified unspecified unspecified  	O	null
10 עתון עיתון עתון noun masculine singular construct unspecified unspecified  	O	null
11 ###NUMBER### ###NUMBER### ###NUMBER### numeral unspecified unspecified unspecified unspecified unspecified  	O	null
12 - - - punctuation unspecified unspecified unspecified unspecified unspecified  	O	null
13 ###NUMBER### ###NUMBER### ###NUMBER### numeral unspecified unspecified unspecified unspecified unspecified  	O	null
14 . . . punctuation unspecified unspecified unspecified unspecified unspecified  	O	null

0 ###NUMBER### ###NUMBER### ###NUMBER### numeral unspecified unspecified unspecified unspecified unspecified  	I_DATE	null
1 . . . punctuation unspecified unspecified unspecified unspecified unspecified  	O	null

0 ; ; ; punctuation unspecified unspecified unspecified unspecified unspecified  	O	null
1 ###NUMBER### ###NUMBER### ###NUMBER### numeral unspecified unspecified unspecified unspecified unspecified  	O	null
2 כפרי כפרי כפרי adjective masculine singular absolute unspecified unspecified  	O	null
3 , , , punctuation unspecified unspecified unspecified unspecified unspecified  	O	null
4 יהודית יהודי יהודית adjective feminine singular absolute unspecified unspecified  	O	null
5 . . . punctuation unspecified unspecified unspecified unspecified unspecified  	O	null

0 " " " punctuation unspecified unspecified unspecified unspecified unspecified  	O	null
1 שירים שיר שירים noun masculine plural absolute unspecified unspecified  	O	null
2 ליריים לירי ליריים adjective masculine plural absolute unspecified unspecified  	O	null
3 הם הוא הם pronoun masculine plural unspecified 3 unspecified  	O	null
4 שירי שיר שירי noun masculine plural construct unspecified unspecified  	O	null
5 אהבה אהבה אהבה noun feminine singular absolute unspecified unspecified  	O	null
6 " " " punctuation unspecified unspecified unspecified unspecified unspecified  	O	null
7 . . . punctuation unspecified unspecified unspecified unspecified unspecified  	O	null

0 עתון עיתון עתון noun masculine singular construct unspecified unspecified  	O	null
1 ###NUMBER### ###NUMBER### ###NUMBER### numeral unspecified unspecified unspecified unspecified unspecified  	O	null
2 . . . punctuation unspecified unspecified unspecified unspecified unspecified  	O	null

0 ###NUMBER### ###NUMBER### ###NUMBER### numeral unspecified unspecified unspecified unspecified unspecified  	I_DATE	null
1 . . . punctuation unspecified unspecified unspecified unspecified unspecified  	O	null

0 ‬ ‬ ‬ punctuation unspecified unspecified unspecified unspecified unspecified  	O	null
1 ###NUMBER### ###NUMBER### ###NUMBER### numeral unspecified unspecified unspecified unspecified unspecified  	O	null
2 . . . punctuation unspecified unspecified unspecified unspecified unspecified  	O	null

0 ‬ ‬ ‬ punctuation unspecified unspecified unspecified unspecified unspecified  	O	null
1 ‬ ‬ ‬ punctuation unspecified unspecified unspecified unspecified unspecified  	O	null
2 ‬ ‬ ‬ punctuation unspecified unspecified unspecified unspecified unspecified  	O	null
3 ‬ ‬ ‬ punctuation unspecified unspecified unspecified unspecified unspecified  	O	null
4 ‬ ‬ ‬ punctuation unspecified unspecified unspecified unspecified unspecified  	O	null
5 ‬ ‬ ‬ punctuation unspecified unspecified unspecified unspecified unspecified  	O	null
6 ‬ ‬ ‬ punctuation unspecified unspecified unspecified unspecified unspecified  	O	null
7 ‬ ‬ ‬ punctuation unspecified unspecified unspecified unspecified unspecified  	O	null
8 ‬ ‬ ‬ punctuation unspecified unspecified unspecified unspecified unspecified  	O	null
9 ‬ ‬ ‬ punctuation unspecified unspecified unspecified unspecified unspecified  	O	null
10 ‬ ‬ ‬ punctuation unspecified unspecified unspecified unspecified unspecified  	O	null
11 ‬ ‬ ‬ punctuation unspecified unspecified unspecified unspecified unspecified  	O	null
12 ‬ ‬ ‬ punctuation unspecified unspecified unspecified unspecified unspecified  	O	null
13 ‬ ‬ ‬ punctuation unspecified unspecified unspecified unspecified unspecified  	O	null
14 ‬ ‬ ‬ punctuation unspecified unspecified unspecified unspecified unspecified  	O	null
15 ‬ ‬ ‬ punctuation unspecified unspecified unspecified unspecified unspecified  	O	null
16 ‬ ‬ ‬ punctuation unspecified unspecified unspecified unspecified unspecified  	O	null
17 ‬ ‬ ‬ punctuation unspecified unspecified unspecified unspecified unspecified  	O	null
18 ‬ ‬ ‬ punctuation unspecified unspecified unspecified unspecified unspecified  	O	null
19 ‬ ‬ ‬ punctuation unspecified unspecified unspecified unspecified unspecified  	O	null
20 ‬ ‬ ‬ punctuation unspecified unspecified unspecified unspecified unspecified  	O	null
21 ‬ ‬ ‬ punctuation unspecified unspecified unspecified unspecified unspecified  	O	null
22 ‬ ‬ ‬ punctuation unspecified unspecified unspecified unspecified unspecified  	O	null
23 ‬ ‬ ‬ punctuation unspecified unspecified unspecified unspecified unspecified  	O	null
24 ‬ ‬ ‬ punctuation unspecified unspecified unspecified unspecified unspecified  	O	null
25 ‬ ‬ ‬ punctuation unspecified unspecified unspecified unspecified unspecified  	O	null
26 ‬ ‬ ‬ punctuation unspecified unspecified unspecified unspecified unspecified  	O	null
27 ‬ ‬ ‬ punctuation unspecified unspecified unspecified unspecified unspecified  	O	null
28 ‬ ‬ ‬ punctuation unspecified unspecified unspecified unspecified unspecified  	O	null
29 ‬ ‬ ‬ punctuation unspecified unspecified unspecified unspecified unspecified  	O	null
30 ‬ ‬ ‬ punctuation unspecified unspecified unspecified unspecified unspecified  	O	null
31 ‬ ‬ ‬ punctuation unspecified unspecified unspecified unspecified unspecified  	O	null
32 ‬ ‬ ‬ punctuation unspecified unspecified unspecified unspecified unspecified  	O	null
33 ‬ ‬ ‬ punctuation unspecified unspecified unspecified unspecified unspecified  	O	null
34 ‬ ‬ ‬ punctuation unspecified unspecified unspecified unspecified unspecified  	O	null
35 ‬ ‬ ‬ punctuation unspecified unspecified unspecified unspecified unspecified  	O	null
36 ‬ ‬ ‬ punctuation unspecified unspecified unspecified unspecified unspecified  	O	null
37 ‬ ‬ ‬ punctuation unspecified unspecified unspecified unspecified unspecified  	O	null
38 ‬ ‬ ‬ punctuation unspecified unspecified unspecified unspecified unspecified  	O	null
39 ‬ ‬ ‬ punctuation unspecified unspecified unspecified unspecified unspecified  	O	null
40 ‬ ‬ ‬ punctuation unspecified unspecified unspecified unspecified unspecified  	O	null
41 ‬ ‬ ‬ punctuation unspecified unspecified unspecified unspecified unspecified  	O	null
42 ‬ ‬ ‬ punctuation unspecified unspecified unspecified unspecified unspecified  	O	null
43 ‬ ‬ ‬ punctuation unspecified unspecified unspecified unspecified unspecified  	O	null
44 ‬ ‬ ‬ punctuation unspecified unspecified unspecified unspecified unspecified  	O	null
45 ‬ ‬ ‬ punctuation unspecified unspecified unspecified unspecified unspecified  	O	null
46 ‬ ‬ ‬ punctuation unspecified unspecified unspecified unspecified unspecified  	O	null
47 ‬ ‬ ‬ punctuation unspecified unspecified unspecified unspecified unspecified  	O	null
48 ‬ ‬ ‬ punctuation unspecified unspecified unspecified unspecified unspecified  	O	null
49 ‬ ‬ ‬ punctuation unspecified unspecified unspecified unspecified unspecified  	O	null

