0 Name Name Name foreign unspecified unspecified unspecified unspecified unspecified  	O	null
1 : : : punctuation unspecified unspecified unspecified unspecified unspecified  	O	null
2 סימון סימון סימון properName unspecified unspecified unspecified unspecified unspecified  	I_PERS	null
3 , , , punctuation unspecified unspecified unspecified unspecified unspecified  	O	null
4 יהושע יהושע יהושע properName unspecified unspecified unspecified unspecified unspecified  	I_PERS	null
5 Birth Birth Birth foreign unspecified unspecified unspecified unspecified unspecified  	O	null
6 Year Year Year foreign unspecified unspecified unspecified unspecified unspecified  	O	null
7 : : : punctuation unspecified unspecified unspecified unspecified unspecified  	O	null
8 ###NUMBER### ###NUMBER### ###NUMBER### numeral unspecified unspecified unspecified unspecified unspecified  	I_DATE	null
9 Birth Birth Birth foreign unspecified unspecified unspecified unspecified unspecified  	O	null
10 Place Place Place foreign unspecified unspecified unspecified unspecified unspecified  	O	null
11 : : : punctuation unspecified unspecified unspecified unspecified unspecified  	O	null
12 דל דל דל adjective masculine singular absolute unspecified unspecified  	O	null
13 ו ו והתחנך conjunction unspecified unspecified unspecified unspecified unspecified 0 
13 התחנך התחנך והתחנך verb masculine singular unspecified 3 past  	O	null
14 ב ב בתלאביב preposition unspecified unspecified unspecified unspecified unspecified 0 
14 תלאביב תלאביב בתלאביב noun masculine singular absolute unspecified unspecified  	O	null
15 Occupation Occupation Occupation foreign unspecified unspecified unspecified unspecified unspecified  	O	null
16 : : : punctuation unspecified unspecified unspecified unspecified unspecified  	O	null
17 משורר משורר משורר noun masculine singular absolute unspecified unspecified  	O	null
18 ו ו ועורך conjunction unspecified unspecified unspecified unspecified unspecified 0 
18 עורך עורך ועורך noun masculine singular construct unspecified unspecified  	O	null
19 Entry Entry Entry foreign unspecified unspecified unspecified unspecified unspecified  	O	null
20 writer writer writer foreign unspecified unspecified unspecified unspecified unspecified  	O	null
21 : : : punctuation unspecified unspecified unspecified unspecified unspecified  	O	null
22 גלעד גלעד גלעד properName unspecified unspecified unspecified unspecified unspecified  	I_ORG	null
23 מאירי האיר מאירי participle masculine plural construct any unspecified  	O	null
24 Entry Entry Entry foreign unspecified unspecified unspecified unspecified unspecified  	O	null
25 Value Value Value foreign unspecified unspecified unspecified unspecified unspecified  	O	null
26 : : : punctuation unspecified unspecified unspecified unspecified unspecified  	O	null
27 נולד נולד נולד verb masculine singular unspecified 3 past  	O	null
28 , , , punctuation unspecified unspecified unspecified unspecified unspecified  	O	null
29 גדל גדל גדל verb masculine singular unspecified 3 past  	O	null
30 ו ו והתחנך conjunction unspecified unspecified unspecified unspecified unspecified 0 
30 התחנך התחנך והתחנך verb masculine singular unspecified 3 past  	O	null
31 ב ב בתלאביב preposition unspecified unspecified unspecified unspecified unspecified 0 
31 תלאביב תלאביב בתלאביב noun masculine singular absolute unspecified unspecified  	O	null
32 . . . punctuation unspecified unspecified unspecified unspecified unspecified  	O	null

0 למד למד למד verb masculine singular unspecified 3 past  	O	null
1 ב ב בתיכון preposition unspecified unspecified unspecified unspecified unspecified 0 
1 ה ה בתיכון definiteArticle unspecified unspecified unspecified unspecified unspecified 0 
1 התיכון תיכון בתיכון noun masculine singular absolute unspecified unspecified  	O	null
2 " " " punctuation unspecified unspecified unspecified unspecified unspecified  	O	null
3 עירוני עירוני עירוני properName unspecified unspecified unspecified unspecified unspecified  	I_ORG	null
4 א א א properName unspecified unspecified unspecified unspecified unspecified  	I_ORG	null
5 ' ' ' punctuation unspecified unspecified unspecified unspecified unspecified  	O	null
6 " " " punctuation unspecified unspecified unspecified unspecified unspecified  	O	null
7 . . . punctuation unspecified unspecified unspecified unspecified unspecified  	O	null

0 בוגר בוגר בוגר noun masculine singular construct unspecified unspecified  	O	null
1 ה ה החוג definiteArticle unspecified unspecified unspecified unspecified unspecified 0 
1 החוג חוג החוג noun masculine singular absolute unspecified unspecified  	O	null
2 ל ל להיסטוריה preposition unspecified unspecified unspecified unspecified unspecified 0 
2 ה ה להיסטוריה definiteArticle unspecified unspecified unspecified unspecified unspecified 0 
2 ההיסטוריה היסטוריה להיסטוריה noun feminine singular absolute unspecified unspecified  	O	null
3 ב ב באוניברסיטת preposition unspecified unspecified unspecified unspecified unspecified 0 
3 אוניברסיטת אוניברסיטה באוניברסיטת noun feminine singular construct unspecified unspecified  	O	null
4 תלאביב תלאביב תלאביב properName unspecified unspecified unspecified unspecified unspecified  	I_ORG	null
5 ( ( ( punctuation unspecified unspecified unspecified unspecified unspecified  	O	null
6 ###NUMBER### ###NUMBER### ###NUMBER### numeral unspecified unspecified unspecified unspecified unspecified  	I_DATE	null
7 - - - punctuation unspecified unspecified unspecified unspecified unspecified  	O	null
8 ###NUMBER### ###NUMBER### ###NUMBER### numeral unspecified unspecified unspecified unspecified unspecified  	I_DATE	null
9 ) ) ) punctuation unspecified unspecified unspecified unspecified unspecified  	O	null
10 ו ו ולומד conjunction unspecified unspecified unspecified unspecified unspecified 0 
10 לומד למד ולומד verb masculine singular unspecified any beinoni  	O	null
11 ב ב במסלול preposition unspecified unspecified unspecified unspecified unspecified 0 
11 מסלול מסלול במסלול noun masculine singular absolute unspecified unspecified  	O	null
12 ישיר ישיר ישיר adjective masculine singular absolute unspecified unspecified  	O	null
13 ל ל לתואר preposition unspecified unspecified unspecified unspecified unspecified 0 
13 תואר תואר לתואר noun masculine singular construct unspecified unspecified  	O	null
14 דוקטור דוקטור דוקטור noun masculine singular absolute unspecified unspecified  	O	null
15 ( ( ( punctuation unspecified unspecified unspecified unspecified unspecified  	O	null
16 ה ה הנושא definiteArticle unspecified unspecified unspecified unspecified unspecified 0 
16 הנושא נושא הנושא noun masculine singular absolute unspecified unspecified  	O	null
17 : : : punctuation unspecified unspecified unspecified unspecified unspecified  	O	null
18 ידע ידע ידע noun masculine singular absolute unspecified unspecified  	O	null
19 אוצרות אוצר אוצרותי noun masculine plural absolute unspecified unspecified  
19 י י אוצרותי possessive masculine-and-feminine singular unspecified 1 unspecified 0 	O	null
20 ) ) ) punctuation unspecified unspecified unspecified unspecified unspecified  	O	null
21 ב ב באוניברסיטת preposition unspecified unspecified unspecified unspecified unspecified 0 
21 אוניברסיטת אוניברסיטה באוניברסיטת noun feminine singular construct unspecified unspecified  	I_ORG	null
22 לונדון לונדון לונדון properName unspecified unspecified unspecified unspecified unspecified  	I_ORG	null
23 , , , punctuation unspecified unspecified unspecified unspecified unspecified  	O	null
24 ב ב בבית preposition unspecified unspecified unspecified unspecified unspecified 0 
24 בית בית בבית noun masculine singular construct unspecified unspecified  	O	null
25 ה ה הספר definiteArticle unspecified unspecified unspecified unspecified unspecified 0 
25 הספר ספר הספר noun masculine singular absolute unspecified unspecified  	O	null
26 ל ל לתרבויות preposition unspecified unspecified unspecified unspecified unspecified 0 
26 תרבויות תרבות לתרבויות noun feminine plural construct unspecified unspecified  	O	null
27 ה ה העולם definiteArticle unspecified unspecified unspecified unspecified unspecified 0 
27 העולם עולם העולם noun masculine singular absolute unspecified unspecified  	O	null
28 של של של shel-preposition unspecified unspecified unspecified unspecified unspecified  	O	null
29 קולג' קולג' קולג' properName unspecified unspecified unspecified unspecified unspecified  	I_PERS	null
30 גולדסמית גולדסמית גולדסמית properName unspecified unspecified unspecified unspecified unspecified  	I_PERS	null
31 ( ( ( punctuation unspecified unspecified unspecified unspecified unspecified  	O	null
32 מ מ מ preposition unspecified unspecified unspecified unspecified unspecified 0 	O	null
33 - - - punctuation unspecified unspecified unspecified unspecified unspecified  	O	null
34 ) ) ) punctuation unspecified unspecified unspecified unspecified unspecified  	O	null
35 . . . punctuation unspecified unspecified unspecified unspecified unspecified  	O	null
36 ###NUMBER### ###NUMBER### ###NUMBER### numeral unspecified unspecified unspecified unspecified unspecified  	I_DATE	null
37 כתב כתב כתב noun masculine singular absolute unspecified unspecified  	I_ORG	null
38 ב ב בעיתון preposition unspecified unspecified unspecified unspecified unspecified 0 
38 ה ה בעיתון definiteArticle unspecified unspecified unspecified unspecified unspecified 0 
38 העיתון עיתון בעיתון noun masculine singular absolute unspecified unspecified  	I_ORG	null
39 גלובס גלובס גלובס properName unspecified unspecified unspecified unspecified unspecified  	I_ORG	null
40 ו ו ואוצר conjunction unspecified unspecified unspecified unspecified unspecified 0 
40 אוצר אוצר ואוצר noun masculine singular construct unspecified unspecified  	O	null
41 תערוכות תערוכה תערוכות noun feminine plural absolute unspecified unspecified  	O	null
42 . . . punctuation unspecified unspecified unspecified unspecified unspecified  	O	null

0 מ מ ממייסדי preposition unspecified unspecified unspecified unspecified unspecified 0 
0 מייסדי מייסד ממייסדי noun masculine plural construct unspecified unspecified  	O	null
1 " " " punctuation unspecified unspecified unspecified unspecified unspecified  	O	null
2 ה ה האקדמיה definiteArticle unspecified unspecified unspecified unspecified unspecified 0 
2 האקדמיה אקדמיה האקדמיה noun feminine singular absolute unspecified unspecified  	O	null
3 ה ה החופשית definiteArticle unspecified unspecified unspecified unspecified unspecified 0 
3 החופשית חופשי החופשית adjective feminine singular absolute unspecified unspecified  	O	null
4 " " " punctuation unspecified unspecified unspecified unspecified unspecified  	O	null
5 ) ) ) punctuation unspecified unspecified unspecified unspecified unspecified  	O	null
6 , , , punctuation unspecified unspecified unspecified unspecified unspecified  	O	null
7 ###NUMBER### ###NUMBER### ###NUMBER### numeral unspecified unspecified unspecified unspecified unspecified  	I_DATE	null
8 גוף גוף גוף noun masculine singular absolute unspecified unspecified  	O	null
9 רב רב רב adjective masculine singular absolute unspecified unspecified  	O	null
10 - - - punctuation unspecified unspecified unspecified unspecified unspecified  	O	null
11 תחומי תחומי תחומי adjective masculine singular absolute unspecified unspecified  	O	null
12 ה ה העוסק definiteArticle unspecified unspecified unspecified unspecified unspecified 0 
12 העוסק עסק העוסק participle masculine singular absolute any unspecified  	O	null
13 ב ב בשירה preposition unspecified unspecified unspecified unspecified unspecified 0 
13 שירה שירה בשירה properName unspecified unspecified unspecified unspecified unspecified  	I_PERS	null
14 , , , punctuation unspecified unspecified unspecified unspecified unspecified  	O	null
15 ב ב באמנות preposition unspecified unspecified unspecified unspecified unspecified 0 
15 אמנות אמנות באמנות noun feminine singular absolute unspecified unspecified  	O	null
16 , , , punctuation unspecified unspecified unspecified unspecified unspecified  	O	null
17 ב ב בקולנוע preposition unspecified unspecified unspecified unspecified unspecified 0 
17 ה ה בקולנוע definiteArticle unspecified unspecified unspecified unspecified unspecified 0 
17 הקולנוע קולנוע בקולנוע noun masculine singular absolute unspecified unspecified  	O	null
18 ו ו ובפוליטיקה conjunction unspecified unspecified unspecified unspecified unspecified 0 
18 ב ב ובפוליטיקה preposition unspecified unspecified unspecified unspecified unspecified 0 
18 ה ה ובפוליטיקה definiteArticle unspecified unspecified unspecified unspecified unspecified 0 
18 הפוליטיקה פוליטיקה ובפוליטיקה noun feminine singular absolute unspecified unspecified  	O	null
19 . . . punctuation unspecified unspecified unspecified unspecified unspecified  	O	null

0 מ מ ממייסדי preposition unspecified unspecified unspecified unspecified unspecified 0 
0 מייסד ייסד ממייסדי participle masculine plural unspecified any unspecified  
0 י י ממייסדי possessive masculine-and-feminine singular unspecified 1 unspecified 0 	O	null
1 קבוצת קבוצה קבוצת noun feminine singular construct unspecified unspecified  	O	null
2 ה ה הבמאים definiteArticle unspecified unspecified unspecified unspecified unspecified 0 
2 הבמאים במאי הבמאים noun masculine plural absolute unspecified unspecified  	O	null
3 " " " punctuation unspecified unspecified unspecified unspecified unspecified  	O	null
4 ב ב בבון preposition unspecified unspecified unspecified unspecified unspecified 0 
4 בון בון בבון properName unspecified unspecified unspecified unspecified unspecified  	I_ORG	null
5 " " " punctuation unspecified unspecified unspecified unspecified unspecified  	O	null
6 ) ) ) punctuation unspecified unspecified unspecified unspecified unspecified  	O	null
7 . . . punctuation unspecified unspecified unspecified unspecified unspecified  	O	null
8 ###NUMBER### ###NUMBER### ###NUMBER### numeral unspecified unspecified unspecified unspecified unspecified  	I_DATE	null
9 ייסד ייסד ייסד verb masculine singular unspecified 3 past  	O	null
10 ו ו וערך conjunction unspecified unspecified unspecified unspecified unspecified 0 
10 ערך ערך וערך verb masculine singular unspecified 3 past  	O	null
11 ( ( ( punctuation unspecified unspecified unspecified unspecified unspecified  	O	null
12 עם עם עם preposition unspecified unspecified unspecified unspecified unspecified  	O	null
13 רועי רועי רועי properName unspecified unspecified unspecified unspecified unspecified  	I_PERS	null
14 צ'יקי צ'יקי צ'יקי properName unspecified unspecified unspecified unspecified unspecified  	I_PERS	null
15 ארד ארד ארד properName unspecified unspecified unspecified unspecified unspecified  	I_PERS	null
16 ) ) ) punctuation unspecified unspecified unspecified unspecified unspecified  	O	null
17 את את את at-preposition unspecified unspecified unspecified unspecified unspecified  	O	null
18 כתב כתב כתב verb masculine singular unspecified 3 past  	O	null
19 ה ה העת definiteArticle unspecified unspecified unspecified unspecified unspecified 0 
19 העת עת העת noun feminine singular absolute unspecified unspecified  	O	null
20 מעין מעין מעין preposition unspecified unspecified unspecified unspecified unspecified  	O	null
21 ו ו ואת conjunction unspecified unspecified unspecified unspecified unspecified 0 
21 את את ואת at-preposition unspecified unspecified unspecified unspecified unspecified  	O	null
22 כתב כתב כתב verb masculine singular unspecified 3 past  	O	null
23 ה ה העת definiteArticle unspecified unspecified unspecified unspecified unspecified 0 
23 העת עת העת noun feminine singular absolute unspecified unspecified  	O	null
24 ל ל לקולנוע preposition unspecified unspecified unspecified unspecified unspecified 0 
24 קולנוע קולנוע לקולנוע noun masculine singular construct unspecified unspecified  	O	null
25 מערבון מערבון מערבון noun masculine singular construct unspecified unspecified  	O	null
26 ( ( ( punctuation unspecified unspecified unspecified unspecified unspecified  	O	null
27 שניים שניים שניהם pronoun unspecified unspecified unspecified unspecified unspecified  
27 הם הם שניהם pronomial masculine plural unspecified 3 unspecified 0 	O	null
28 ב ב ב preposition unspecified unspecified unspecified unspecified unspecified 0 	O	null
29 - - - punctuation unspecified unspecified unspecified unspecified unspecified  	O	null
30 ) ) ) punctuation unspecified unspecified unspecified unspecified unspecified  	O	null
31 . . . punctuation unspecified unspecified unspecified unspecified unspecified  	O	null
32 ###NUMBER### ###NUMBER### ###NUMBER### numeral unspecified unspecified unspecified unspecified unspecified  	I_DATE	null
33 ערך ערך ערך noun masculine singular construct unspecified unspecified  	O	null
34 ( ( ( punctuation unspecified unspecified unspecified unspecified unspecified  	O	null
35 עם עם עם preposition unspecified unspecified unspecified unspecified unspecified  	O	null
36 אחרים אחר אחרים adjective masculine plural absolute unspecified unspecified  	O	null
37 ) ) ) punctuation unspecified unspecified unspecified unspecified unspecified  	O	null
38 את את את at-preposition unspecified unspecified unspecified unspecified unspecified  	O	null
39 אדומה אדום אדומה adjective feminine singular absolute unspecified unspecified  	O	null
40 : : : punctuation unspecified unspecified unspecified unspecified unspecified  	O	null
41 אנתולוגיית אנתולוגיית אנתולוגיית noun feminine singular construct unspecified unspecified  	O	null
42 שירה שירה שירה noun feminine singular absolute unspecified unspecified  	O	null
43 מעמדית מעמדי מעמדית adjective feminine singular absolute unspecified unspecified  	O	null
44 ) ) ) punctuation unspecified unspecified unspecified unspecified unspecified  	O	null
45 . . . punctuation unspecified unspecified unspecified unspecified unspecified  	O	null
46 ###NUMBER### ###NUMBER### ###NUMBER### numeral unspecified unspecified unspecified unspecified unspecified  	I_DATE	null
47 פירסם פרסם פירסם verb masculine singular unspecified 3 past  	O	null
48 ב ב בחוברות preposition unspecified unspecified unspecified unspecified unspecified 0 
48 חוברות חוברת בחוברות noun feminine plural construct unspecified unspecified  	O	null
49 מעין מעין מעין preposition unspecified unspecified unspecified unspecified unspecified  	O	null
50 תרגומים תרגום תרגומים noun masculine plural absolute unspecified unspecified  	O	null
51 ל ל לשירי preposition unspecified unspecified unspecified unspecified unspecified 0 
51 שירי שיר לשירי noun masculine plural construct unspecified unspecified  	O	null
52 ה ה המוזיקאים definiteArticle unspecified unspecified unspecified unspecified unspecified 0 
52 המוזיקאים מוזיקאי המוזיקאים noun masculine plural absolute unspecified unspecified  	O	null
53 דניאל דניאל דניאל properName unspecified unspecified unspecified unspecified unspecified  	I_PERS	null
54 ג'ונסטון ג'ונסטון ג'ונסטון properName unspecified unspecified unspecified unspecified unspecified  	I_PERS	null
55 , , , punctuation unspecified unspecified unspecified unspecified unspecified  	O	null
56 ו ו וודי conjunction unspecified unspecified unspecified unspecified unspecified 0 
56 ודי ודי וודי properName unspecified unspecified unspecified unspecified unspecified  	I_PERS	null
57 גאתרי גאתרי גאתרי properName unspecified unspecified unspecified unspecified unspecified  	I_PERS	null
58 ו ו ואדם conjunction unspecified unspecified unspecified unspecified unspecified 0 
58 אדם אדם ואדם noun masculine singular construct unspecified unspecified  	O	null
59 גרין גרין גרין properName unspecified unspecified unspecified unspecified unspecified  	I_PERS	null
60 ו ו ובאדומה conjunction unspecified unspecified unspecified unspecified unspecified 0 
60 ב ב ובאדומה preposition unspecified unspecified unspecified unspecified unspecified 0 
60 ה ה ובאדומה definiteArticle unspecified unspecified unspecified unspecified unspecified 0 
60 האדומה אדום ובאדומה adjective feminine singular absolute unspecified unspecified  	O	null
61 שיר שיר שיר noun masculine singular construct unspecified unspecified  	O	null
62 של של של shel-preposition unspecified unspecified unspecified unspecified unspecified  	O	null
63 פיט פייט פיט verb masculine singular unspecified 2 imperative  	O	null
64 סיגר סיגר סיגר noun masculine singular construct unspecified unspecified  	O	null
65 . . . punctuation unspecified unspecified unspecified unspecified unspecified  	O	null

0 יוצר יוצר יוצר noun masculine singular construct unspecified unspecified  	O	null
1 פוסט פוסט פוסט noun masculine singular absolute unspecified unspecified  	O	null
2 - - - punctuation unspecified unspecified unspecified unspecified unspecified  	O	null
3 מודרניסטי מודרניסטי מודרניסטי noun masculine singular absolute unspecified unspecified  	O	null
4 בין בין בין preposition unspecified unspecified unspecified unspecified unspecified  	O	null
5 - - - punctuation unspecified unspecified unspecified unspecified unspecified  	O	null
6 תחומי תחום תחומי noun masculine plural construct unspecified unspecified  	O	null
7 . . . punctuation unspecified unspecified unspecified unspecified unspecified  	O	null

0 ספר ספר ספרו noun masculine singular absolute unspecified unspecified  
0 ו ו ספרו possessive masculine singular unspecified 3 unspecified 0 	O	null
1 , , , punctuation unspecified unspecified unspecified unspecified unspecified  	O	null
2 ש ש שהוא relativizer/subordinatingConjunction unspecified unspecified unspecified unspecified unspecified 0 
2 הוא הוא שהוא pronoun masculine singular unspecified 3 unspecified  	O	null
3 למעשה למעשה למעשה adverb unspecified unspecified unspecified unspecified unspecified  	O	null
4 פרסום פרסום פרסומו noun masculine singular absolute unspecified unspecified  
4 ו ו פרסומו possessive masculine singular unspecified 3 unspecified 0 	O	null
5 ה ה הראשון definiteArticle unspecified unspecified unspecified unspecified unspecified 0 
5 הראשון ORD1 הראשון numeral masculine singular absolute unspecified unspecified  	O	null
6 , , , punctuation unspecified unspecified unspecified unspecified unspecified  	O	null
7 אזרחים אזרח אזרחים noun masculine plural absolute unspecified unspecified  	O	null
8 לאומיים לאומי לאומיים adjective masculine plural absolute unspecified unspecified  	O	null
9 , , , punctuation unspecified unspecified unspecified unspecified unspecified  	O	null
10 מאמרים מאמר מאמרים noun masculine plural absolute unspecified unspecified  	O	null
11 ( ( ( punctuation unspecified unspecified unspecified unspecified unspecified  	O	null
12 שדוריאן שדוריאן שדוריאן properName unspecified unspecified unspecified unspecified unspecified  	I_PERS	null
13 , , , punctuation unspecified unspecified unspecified unspecified unspecified  	O	null
14 ) ) ) punctuation unspecified unspecified unspecified unspecified unspecified  	O	null
15 , , , punctuation unspecified unspecified unspecified unspecified unspecified  	O	null
16 ###NUMBER### ###NUMBER### ###NUMBER### numeral unspecified unspecified unspecified unspecified unspecified  	I_DATE	null
17 יצא יצא יצא verb masculine singular unspecified 3 past  	O	null
18 ב ב בצילום preposition unspecified unspecified unspecified unspecified unspecified 0 
18 צילום צילום בצילום noun masculine singular construct unspecified unspecified  	O	null
19 זירוקס זירוקס זירוקס properName unspecified unspecified unspecified unspecified unspecified  	O	null
20 ו ו והוא conjunction unspecified unspecified unspecified unspecified unspecified 0 
20 הוא הוא והוא pronoun masculine singular unspecified 3 unspecified  	O	null
21 בן בן בן noun masculine singular construct unspecified unspecified  	O	null
22 חמישה CARD5 חמישה numeral masculine plural absolute unspecified unspecified  	O	null
23 עמודים עמוד עמודים noun masculine plural absolute unspecified unspecified  	O	null
24 . . . punctuation unspecified unspecified unspecified unspecified unspecified  	O	null

0 זו זו זו pronoun feminine singular unspecified 3 unspecified  	O	null
1 פואמה פואמה פואמה noun feminine singular absolute unspecified unspecified  	O	null
2 פרודית פרודיה פרודית noun feminine singular construct unspecified unspecified  	O	null
3 ה ה הכוללת definiteArticle unspecified unspecified unspecified unspecified unspecified 0 
3 הכוללת כלל הכוללת participle feminine singular absolute any unspecified  	O	null
4 כותרות כותרת כותרות noun feminine plural absolute unspecified unspecified  	O	null
5 מאמרים מאמר מאמרים noun masculine plural absolute unspecified unspecified  	O	null
6 בלבד בלבד בלבד adverb unspecified unspecified unspecified unspecified unspecified  	I_LOC	null
7 , , , punctuation unspecified unspecified unspecified unspecified unspecified  	O	null
8 ש ש שעוסקות relativizer/subordinatingConjunction unspecified unspecified unspecified unspecified unspecified 0 
8 עוסקות עסק שעוסקות verb feminine plural unspecified any beinoni  	O	null
9 ב ב בפואטיקה preposition unspecified unspecified unspecified unspecified unspecified 0 
9 פואטיקה פואטיקה בפואטיקה noun feminine singular absolute unspecified unspecified  	O	null
10 , , , punctuation unspecified unspecified unspecified unspecified unspecified  	O	null
11 ב ב באסתטיקה preposition unspecified unspecified unspecified unspecified unspecified 0 
11 אסתטיקה אסתטיקה באסתטיקה noun feminine singular absolute unspecified unspecified  	O	null
12 ו ו ובפוליטיקה conjunction unspecified unspecified unspecified unspecified unspecified 0 
12 ב ב ובפוליטיקה preposition unspecified unspecified unspecified unspecified unspecified 0 
12 פוליטיקה פוליטיקה ובפוליטיקה noun feminine singular absolute unspecified unspecified  	O	null
13 ב ב בהקשרים preposition unspecified unspecified unspecified unspecified unspecified 0 
13 הקשרים הקשר בהקשרים noun masculine plural absolute unspecified unspecified  	O	null
14 של של של shel-preposition unspecified unspecified unspecified unspecified unspecified  	O	null
15 תרבות תרבות תרבות noun feminine singular absolute unspecified unspecified  	O	null
16 גבוהה גבוה גבוהה adjective feminine singular absolute unspecified unspecified  	O	null
17 ו ו ופופולרית conjunction unspecified unspecified unspecified unspecified unspecified 0 
17 פופולרית פופולרי ופופולרית adjective feminine singular absolute unspecified unspecified  	O	null
18 . . . punctuation unspecified unspecified unspecified unspecified unspecified  	O	null

0 ה ה הפרודיה definiteArticle unspecified unspecified unspecified unspecified unspecified 0 
0 הפרודיה פרודיה הפרודיה noun feminine singular absolute unspecified unspecified  	O	null
1 מתייחסת התייחס מתייחסת verb feminine singular unspecified any beinoni  	O	null
2 הן הן הן conjunction unspecified unspecified unspecified unspecified unspecified  	O	null
3 ל ל לשעמום preposition unspecified unspecified unspecified unspecified unspecified 0 
3 ה ה לשעמום definiteArticle unspecified unspecified unspecified unspecified unspecified 0 
3 השעמום שעמום לשעמום noun masculine singular absolute unspecified unspecified  	O	null
4 ה ה האקדמי definiteArticle unspecified unspecified unspecified unspecified unspecified 0 
4 האקדמי אקדמי האקדמי adjective masculine singular absolute unspecified unspecified  	O	null
5 ו ו והן conjunction unspecified unspecified unspecified unspecified unspecified 0 
5 הן הן והן conjunction unspecified unspecified unspecified unspecified unspecified  	O	null
6 ל ל להרגלי preposition unspecified unspecified unspecified unspecified unspecified 0 
6 הרגלי הרגל להרגלי noun masculine plural construct unspecified unspecified  	O	null
7 קריאה קריאה קריאה noun feminine singular absolute unspecified unspecified  	O	null
8 שטחיים שטחי שטחיים adjective masculine plural absolute unspecified unspecified  	O	null
9 , , , punctuation unspecified unspecified unspecified unspecified unspecified  	O	null
10 ש ש שהם relativizer/subordinatingConjunction unspecified unspecified unspecified unspecified unspecified 0 
10 הם הוא שהם pronoun masculine plural unspecified 3 unspecified  	O	null
11 שחזור שחזור שחזור noun masculine singular absolute unspecified unspecified  	O	null
12 של של של shel-preposition unspecified unspecified unspecified unspecified unspecified  	O	null
13 קריאה קריאה קריאה noun feminine singular absolute unspecified unspecified  	O	null
14 מהירה מהיר מהירה adjective feminine singular absolute unspecified unspecified  	O	null
15 ב ב בעיתונים preposition unspecified unspecified unspecified unspecified unspecified 0 
15 ה ה בעיתונים definiteArticle unspecified unspecified unspecified unspecified unspecified 0 
15 העיתונים עיתון בעיתונים noun masculine plural absolute unspecified unspecified  	O	null
16 באמצעות באמצעות באמצעות preposition unspecified unspecified unspecified unspecified unspecified  	O	null
17 כותרות כותרת כותרות noun feminine plural absolute unspecified unspecified  	O	null
18 בלבד בלבד בלבד adverb unspecified unspecified unspecified unspecified unspecified  	I_LOC	null
19 , , , punctuation unspecified unspecified unspecified unspecified unspecified  	O	null
20 ה ה הדומה definiteArticle unspecified unspecified unspecified unspecified unspecified 0 
20 הדומה דמה הדומה participle masculine singular absolute any unspecified  	O	null
21 ל ל לקריאת preposition unspecified unspecified unspecified unspecified unspecified 0 
21 קריאת קריאה לקריאת noun feminine singular construct unspecified unspecified  	O	null
22 שלטי שלט שלטי noun masculine plural construct unspecified unspecified  	O	null
23 רחוב רחוב רחוב noun masculine singular absolute unspecified unspecified  	I_LOC	null
24 , , , punctuation unspecified unspecified unspecified unspecified unspecified  	I_LOC	null
25 מודעות מודעות מודעות noun feminine singular absolute unspecified unspecified  	I_LOC	null
26 וכדומה וכדומה וכדומה adverb unspecified unspecified unspecified unspecified unspecified  	I_LOC	null
27 . . . punctuation unspecified unspecified unspecified unspecified unspecified  	O	null

0 ספר ספר ספרו noun masculine singular absolute unspecified unspecified  
0 ו ו ספרו possessive masculine singular unspecified 3 unspecified 0 	O	null
1 ה ה השני definiteArticle unspecified unspecified unspecified unspecified unspecified 0 
1 השני ORD2 השני numeral masculine singular absolute unspecified unspecified  	O	null
2 , , , punctuation unspecified unspecified unspecified unspecified unspecified  	O	null
3 אזרחים אזרח אזרחים noun masculine plural absolute unspecified unspecified  	O	null
4 לאומיים לאומי לאומיים adjective masculine plural absolute unspecified unspecified  	O	null
5 ) ) ) punctuation unspecified unspecified unspecified unspecified unspecified  	O	null
6 , , , punctuation unspecified unspecified unspecified unspecified unspecified  	O	null
7 ###NUMBER### ###NUMBER### ###NUMBER### numeral unspecified unspecified unspecified unspecified unspecified  	I_DATE	null
8 כולל כולל כולל noun masculine singular absolute unspecified unspecified  	O	null
9 שירים שיר שירים noun masculine plural absolute unspecified unspecified  	O	null
10 פרודיים פרודיים פרודיים participle masculine plural absolute any unspecified  	O	null
11 , , , punctuation unspecified unspecified unspecified unspecified unspecified  	O	null
12 הומוריסטיים הומוריסטי הומוריסטיים adjective masculine plural absolute unspecified unspecified  	O	null
13 ו ו וקצרים conjunction unspecified unspecified unspecified unspecified unspecified 0 
13 קצרים קצר וקצרים adjective masculine plural absolute unspecified unspecified  	O	null
14 , , , punctuation unspecified unspecified unspecified unspecified unspecified  	O	null
15 למשל למשל למשל conjunction unspecified unspecified unspecified unspecified unspecified  	O	null
16 ש ש שירו relativizer/subordinatingConjunction unspecified unspecified unspecified unspecified unspecified 0 
16 ירו ירה שירו verb masculine-and-feminine plural unspecified 3 past  	O	null
17 נטול נטול נטול adjective masculine singular absolute unspecified unspecified  	O	null
18 ה ה הכותרת definiteArticle unspecified unspecified unspecified unspecified unspecified 0 
18 הכותרת כותרת הכותרת noun feminine singular absolute unspecified unspecified  	O	null
19 : : : punctuation unspecified unspecified unspecified unspecified unspecified  	O	null
20 " " " punctuation unspecified unspecified unspecified unspecified unspecified  	O	null
21 הָיִיתִי הָיִיתִי הָיִיתִי verb masculine singular unspecified 2 future  	O	null
22 בַּבִּנְיָן בַּבִּנְיָן בַּבִּנְיָן properName unspecified unspecified unspecified unspecified unspecified  	I_PERS	null
23 שֶׁל שֶׁל שֶׁל properName unspecified unspecified unspecified unspecified unspecified  	I_PERS	null
24 הַהִסְתַּדְּרוּת הַהִסְתַּדְּרוּת הַהִסְתַּדְּרוּת properName unspecified unspecified unspecified unspecified unspecified  	I_PERS	null
25 / / / punctuation unspecified unspecified unspecified unspecified unspecified  	O	null
26 ו ו וְרָאִיתִי conjunction unspecified unspecified unspecified unspecified unspecified 0 
26 ְרָאִיתִי ְרָאִיתִי וְרָאִיתִי adjective masculine plural construct unspecified unspecified  	O	null
27 ל ל לָהֶם preposition unspecified unspecified unspecified unspecified unspecified 0 
27 ָהֶם ָהֶם לָהֶם adjective masculine singular construct unspecified unspecified  	O	null
28 אֶת אֶת אֶת adverb unspecified unspecified unspecified unspecified unspecified  	O	null
29 הַמִּסְדְּרוֹן הַמִּסְדְּרוֹן הַמִּסְדְּרוֹן adjective masculine singular construct unspecified unspecified  	O	null
30 " " " punctuation unspecified unspecified unspecified unspecified unspecified  	O	null
31 . . . punctuation unspecified unspecified unspecified unspecified unspecified  	O	null

0 זו זו זו pronoun feminine singular unspecified 3 unspecified  	O	null
1 שירה שירה שירה noun feminine singular absolute unspecified unspecified  	O	null
2 חתרנית חתרן חתרנית adjective feminine singular absolute unspecified unspecified  	O	null
3 , , , punctuation unspecified unspecified unspecified unspecified unspecified  	O	null
4 ש ש שמחקה relativizer/subordinatingConjunction unspecified unspecified unspecified unspecified unspecified 0 
4 מחקה מחק שמחקה verb feminine singular unspecified 3 past  	O	null
5 אסטרטגיות אסטרטגיה אסטרטגיות noun feminine plural absolute unspecified unspecified  	O	null
6 של של של shel-preposition unspecified unspecified unspecified unspecified unspecified  	O	null
7 פרסום פרסום פרסום noun masculine singular absolute unspecified unspecified  	O	null
8 ה ה המאופיינות definiteArticle unspecified unspecified unspecified unspecified unspecified 0 
8 המאופיינות אופיין המאופיינות participle feminine plural absolute any unspecified  	O	null
9 ב ב בקומפקטיות preposition unspecified unspecified unspecified unspecified unspecified 0 
9 ה ה בקומפקטיות definiteArticle unspecified unspecified unspecified unspecified unspecified 0 
9 הקומפקטיות קומפקטיות בקומפקטיות noun feminine singular absolute unspecified unspecified  	O	null
10 , , , punctuation unspecified unspecified unspecified unspecified unspecified  	O	null
11 ב ב בעשיית preposition unspecified unspecified unspecified unspecified unspecified 0 
11 עשיית עשייה בעשיית noun feminine singular construct unspecified unspecified  	O	null
12 רושם רושם רושם noun masculine singular absolute unspecified unspecified  	O	null
13 , , , punctuation unspecified unspecified unspecified unspecified unspecified  	O	null
14 ב ב במשחקי preposition unspecified unspecified unspecified unspecified unspecified 0 
14 משחקי משחק במשחקי noun masculine plural construct unspecified unspecified  	O	null
15 לשון לשון לשון noun feminine singular absolute unspecified unspecified  	O	null
16 , , , punctuation unspecified unspecified unspecified unspecified unspecified  	O	null
17 ב ב בבהירות preposition unspecified unspecified unspecified unspecified unspecified 0 
17 בהירות בהירות בבהירות noun feminine singular absolute unspecified unspecified  	O	null
18 של של של shel-preposition unspecified unspecified unspecified unspecified unspecified  	O	null
19 ה ה המסר definiteArticle unspecified unspecified unspecified unspecified unspecified 0 
19 המסר מסר המסר noun masculine singular absolute unspecified unspecified  	O	null
20 ו ו ובערמומיות conjunction unspecified unspecified unspecified unspecified unspecified 0 
20 ב ב ובערמומיות preposition unspecified unspecified unspecified unspecified unspecified 0 
20 ערמומיות ערמומיות ובערמומיות noun feminine singular absolute unspecified unspecified  	O	null
21 – – – punctuation unspecified unspecified unspecified unspecified unspecified  	O	null
22 ה ה השיר definiteArticle unspecified unspecified unspecified unspecified unspecified 0 
22 השיר שיר השיר noun masculine singular absolute unspecified unspecified  	O	null
23 מצחיק מצחיק מצחיק adjective masculine singular absolute unspecified unspecified  	O	null
24 ו ו ורציני conjunction unspecified unspecified unspecified unspecified unspecified 0 
24 רציני רציני ורציני adjective masculine singular absolute unspecified unspecified  	O	null
25 ב ב בו preposition unspecified unspecified unspecified unspecified unspecified  
25 ו ו בו pronomial masculine singular unspecified 3 unspecified 0 	O	null
26 - - - punctuation unspecified unspecified unspecified unspecified unspecified  	O	null
27 זמנית זמני זמנית adjective feminine singular absolute unspecified unspecified  	O	null
28 . . . punctuation unspecified unspecified unspecified unspecified unspecified  	O	null

0 יצירה יצירה יצירה noun feminine singular absolute unspecified unspecified  	O	null
1 שלישית ORD3 שלישית numeral feminine singular absolute unspecified unspecified  	O	null
2 , , , punctuation unspecified unspecified unspecified unspecified unspecified  	O	null
3 ה ה הנושאת definiteArticle unspecified unspecified unspecified unspecified unspecified 0 
3 הנושאת נשא הנושאת participle feminine singular absolute any unspecified  	O	null
4 אף אף אף conjunction unspecified unspecified unspecified unspecified unspecified  	O	null
5 היא הוא היא copula feminine singular unspecified 3 beinoni  	O	null
6 את את את at-preposition unspecified unspecified unspecified unspecified unspecified  	O	null
7 ה ה השם definiteArticle unspecified unspecified unspecified unspecified unspecified 0 
7 השם שם השם noun masculine singular absolute unspecified unspecified  	O	null
8 אזרחים אזרח אזרחים noun masculine plural absolute unspecified unspecified  	O	null
9 לאומיים לאומי לאומיים adjective masculine plural absolute unspecified unspecified  	O	null
10 , , , punctuation unspecified unspecified unspecified unspecified unspecified  	O	null
11 היא הוא היא pronoun feminine singular unspecified 3 unspecified  	O	null
12 סרט סרט סרט noun masculine singular absolute unspecified unspecified  	O	null
13 ש ש שיצר relativizer/subordinatingConjunction unspecified unspecified unspecified unspecified unspecified 0 
13 יצר יצר שיצר verb masculine singular unspecified 3 past  	O	null
14 , , , punctuation unspecified unspecified unspecified unspecified unspecified  	O	null
15 ###NUMBER### ###NUMBER### ###NUMBER### numeral unspecified unspecified unspecified unspecified unspecified  	I_DATE	null
16 ###NUMBER### ###NUMBER### ###NUMBER### numeral unspecified unspecified unspecified unspecified unspecified  	O	null
17 דקות דקה דקות noun feminine plural absolute unspecified unspecified  	O	null
18 ) ) ) punctuation unspecified unspecified unspecified unspecified unspecified  	O	null
19 , , , punctuation unspecified unspecified unspecified unspecified unspecified  	O	null
20 ה ה המקיים definiteArticle unspecified unspecified unspecified unspecified unspecified 0 
20 המקיים קיים המקיים participle masculine singular absolute any unspecified  	O	null
21 זיקות זיקה זיקות noun feminine plural absolute unspecified unspecified  	O	null
22 סגנוניות סגנוניות סגנוניות adjective feminine plural absolute unspecified unspecified  	O	null
23 ו ו ותמטיות conjunction unspecified unspecified unspecified unspecified unspecified 0 
23 תמטיות תמטיות ותמטיות adjective feminine plural construct unspecified unspecified  	O	null
24 ל ל לספריו preposition unspecified unspecified unspecified unspecified unspecified 0 
24 ספרי ספר לספריו noun masculine plural absolute unspecified unspecified  
24 ו ו לספריו possessive masculine singular unspecified 3 unspecified 0 	O	null
25 . . . punctuation unspecified unspecified unspecified unspecified unspecified  	O	null

0 ב ב בסרט preposition unspecified unspecified unspecified unspecified unspecified 0 
0 ה ה בסרט definiteArticle unspecified unspecified unspecified unspecified unspecified 0 
0 הסרט סרט בסרט noun masculine singular absolute unspecified unspecified  	O	null
1 קוראים קרא קוראים verb masculine plural unspecified any beinoni  	O	null
2 מ מ משירי preposition unspecified unspecified unspecified unspecified unspecified 0 
2 שירי שיר משירי noun masculine plural construct unspecified unspecified  	O	null
3 אזרחים אזרח אזרחים noun masculine plural absolute unspecified unspecified  	O	null
4 לאומיים לאומי לאומיים adjective masculine plural absolute unspecified unspecified  	O	null
5 , , , punctuation unspecified unspecified unspecified unspecified unspecified  	O	null
6 ו ו וזו conjunction unspecified unspecified unspecified unspecified unspecified 0 
6 זו זו וזו pronoun feminine singular unspecified 3 unspecified  	O	null
7 הצהרה הצהרה הצהרה noun feminine singular absolute unspecified unspecified  	O	null
8 על על על preposition unspecified unspecified unspecified unspecified unspecified  	O	null
9 ה ה הבין definiteArticle unspecified unspecified unspecified unspecified unspecified 0 
9 הבין בין הבין wPrefix unspecified unspecified unspecified unspecified unspecified  	O	null
10 - - - punctuation unspecified unspecified unspecified unspecified unspecified  	O	null
11 תחומיות תחומי תחומיות adjective feminine plural absolute unspecified unspecified  	O	null
12 של של של shel-preposition unspecified unspecified unspecified unspecified unspecified  	O	null
13 ה ה האמנות definiteArticle unspecified unspecified unspecified unspecified unspecified 0 
13 האמנות אמנות האמנות noun feminine singular absolute unspecified unspecified  	O	null
14 ב ב בכלל preposition unspecified unspecified unspecified unspecified unspecified 0 
14 כלל כלל בכלל noun masculine singular absolute unspecified unspecified  	O	null
15 ו ו ושל conjunction unspecified unspecified unspecified unspecified unspecified 0 
15 של של ושל shel-preposition unspecified unspecified unspecified unspecified unspecified  	O	null
16 ה ה השירה definiteArticle unspecified unspecified unspecified unspecified unspecified 0 
16 השירה שירה השירה noun feminine singular absolute unspecified unspecified  	O	null
17 ב ב בפרט preposition unspecified unspecified unspecified unspecified unspecified 0 
17 ה ה בפרט definiteArticle unspecified unspecified unspecified unspecified unspecified 0 
17 הפרט פרט בפרט noun masculine singular absolute unspecified unspecified  	O	null
18 . . . punctuation unspecified unspecified unspecified unspecified unspecified  	O	null

0 ב ב במסגרת preposition unspecified unspecified unspecified unspecified unspecified 0 
0 מסגרת מסגרת במסגרת noun feminine singular construct unspecified unspecified  	O	null
1 פעילות פעילות פעילותו noun feminine singular absolute unspecified unspecified  
1 ו ו פעילותו possessive masculine singular unspecified 3 unspecified 0 	O	null
2 ב ב בקבוצת preposition unspecified unspecified unspecified unspecified unspecified 0 
2 קבוצת קבוצה בקבוצת noun feminine singular construct unspecified unspecified  	O	null
3 " " " punctuation unspecified unspecified unspecified unspecified unspecified  	O	null
4 ב ב בבון preposition unspecified unspecified unspecified unspecified unspecified 0 
4 בון בון בבון properName unspecified unspecified unspecified unspecified unspecified  	I_ORG	null
5 " " " punctuation unspecified unspecified unspecified unspecified unspecified  	O	null
6 יצר יצר יצר verb masculine singular unspecified 3 past  	O	null
7 כמה כמה כמה quantifier unspecified unspecified construct unspecified unspecified  	O	null
8 סרטים סרט סרטים noun masculine plural absolute unspecified unspecified  	O	null
9 : : : punctuation unspecified unspecified unspecified unspecified unspecified  	O	null
10 ה ה הקיצונים definiteArticle unspecified unspecified unspecified unspecified unspecified 0 
10 הקיצונים קיצוני הקיצונים noun masculine plural absolute unspecified unspecified  	O	null
11 ) ) ) punctuation unspecified unspecified unspecified unspecified unspecified  	O	null
12 , , , punctuation unspecified unspecified unspecified unspecified unspecified  	O	null
13 ה ה המילים definiteArticle unspecified unspecified unspecified unspecified unspecified 0 
13 המילים מילה המילים noun feminine plural absolute unspecified unspecified  	O	null
14 ###NUMBER### ###NUMBER### ###NUMBER### numeral unspecified unspecified unspecified unspecified unspecified  	I_DATE	null
15 ו ו והדברים conjunction unspecified unspecified unspecified unspecified unspecified 0 
15 ה ה והדברים definiteArticle unspecified unspecified unspecified unspecified unspecified 0 
15 הדברים דבר והדברים noun masculine plural absolute unspecified unspecified  	O	null
16 ( ( ( punctuation unspecified unspecified unspecified unspecified unspecified  	O	null
17 ###NUMBER### ###NUMBER### ###NUMBER### numeral unspecified unspecified unspecified unspecified unspecified  	I_DATE	null
18 ) ) ) punctuation unspecified unspecified unspecified unspecified unspecified  	O	null
19 ו ו ועוד conjunction unspecified unspecified unspecified unspecified unspecified 0 
19 עוד עוד ועוד adverb unspecified unspecified unspecified unspecified unspecified  	O	null
20 . . . punctuation unspecified unspecified unspecified unspecified unspecified  	O	null

0 References References References foreign unspecified unspecified unspecified unspecified unspecified  	O	null
1 : : : punctuation unspecified unspecified unspecified unspecified unspecified  	O	null
2 גרבוז גרבוז גרבוז properName unspecified unspecified unspecified unspecified unspecified  	I_PERS	null
3 , , , punctuation unspecified unspecified unspecified unspecified unspecified  	O	null
4 יאיר יאיר יאיר properName unspecified unspecified unspecified unspecified unspecified  	I_PERS	null
5 . . . punctuation unspecified unspecified unspecified unspecified unspecified  	O	null

0 " " " punctuation unspecified unspecified unspecified unspecified unspecified  	O	null
1 נקדו ניקד נקדו verb masculine-and-feminine plural unspecified 2 imperative  	O	null
2 את את את at-preposition unspecified unspecified unspecified unspecified unspecified  	O	null
3 ה ה העולם definiteArticle unspecified unspecified unspecified unspecified unspecified 0 
3 העולם עולם העולם noun masculine singular absolute unspecified unspecified  	O	null
4 / / / punctuation unspecified unspecified unspecified unspecified unspecified  	O	null
5 ב ב בחיריקים preposition unspecified unspecified unspecified unspecified unspecified 0 
5 חיריקים חיריקים בחיריקים adjective masculine plural absolute unspecified unspecified  	O	null
6 שמחים שמח שמחים adjective masculine plural absolute unspecified unspecified  	O	null
7 " " " punctuation unspecified unspecified unspecified unspecified unspecified  	O	null
8 . . . punctuation unspecified unspecified unspecified unspecified unspecified  	O	null
9 ה ה הארץ definiteArticle unspecified unspecified unspecified unspecified unspecified 0 
9 הארץ ארץ הארץ noun feminine singular absolute unspecified unspecified  	O	null
10 ספרים ספר ספרים noun masculine plural absolute unspecified unspecified  	O	null
11 . . . punctuation unspecified unspecified unspecified unspecified unspecified  	O	null

0 ###NUMEXP### ###NUMEXP### ###NUMEXP### numberExpression unspecified unspecified unspecified unspecified unspecified  	I_DATE	null
1 . . . punctuation unspecified unspecified unspecified unspecified unspecified  	O	null

0 ; ; ; punctuation unspecified unspecified unspecified unspecified unspecified  	O	null
1 ###NUMBER### ###NUMBER### ###NUMBER### numeral unspecified unspecified unspecified unspecified unspecified  	O	null
2 שבתאי שבתאי שבתאי properName unspecified unspecified unspecified unspecified unspecified  	I_PERS	null
3 , , , punctuation unspecified unspecified unspecified unspecified unspecified  	O	null
4 אהרן אהרן אהרן properName unspecified unspecified unspecified unspecified unspecified  	I_PERS	null
5 . . . punctuation unspecified unspecified unspecified unspecified unspecified  	O	null

0 " " " punctuation unspecified unspecified unspecified unspecified unspecified  	O	null
1 איך איך איך adverb unspecified unspecified unspecified unspecified unspecified  	O	null
2 אפשר אפשר אפשר modal unspecified unspecified unspecified unspecified unspecified  	O	null
3 להישאר נשאר להישאר verb unspecified unspecified unspecified unspecified infinitive  	O	null
4 ' ' ' punctuation unspecified unspecified unspecified unspecified unspecified  	O	null
5 נסיך נסיך נסיך noun masculine singular absolute unspecified unspecified  	O	null
6 ' ' ' punctuation unspecified unspecified unspecified unspecified unspecified  	O	null
7 בלי בלי בלי conjunction unspecified unspecified unspecified unspecified unspecified  	O	null
8 להתגלגל התגלגל להתגלגל verb unspecified unspecified unspecified unspecified infinitive  	O	null
9 ל ל לאולמרט preposition unspecified unspecified unspecified unspecified unspecified 0 
9 אולמרט אולמרט לאולמרט properName unspecified unspecified unspecified unspecified unspecified  	I_PERS	null
10 ? ? ? punctuation unspecified unspecified unspecified unspecified unspecified  	O	null

0 " " " punctuation unspecified unspecified unspecified unspecified unspecified  	O	null
1 . . . punctuation unspecified unspecified unspecified unspecified unspecified  	O	null
2 ה ה הארץ definiteArticle unspecified unspecified unspecified unspecified unspecified 0 
2 הארץ ארץ הארץ noun feminine singular absolute unspecified unspecified  	O	null
3 תרבות תרבות תרבות noun feminine singular absolute unspecified unspecified  	O	null
4 ו ו וספרות conjunction unspecified unspecified unspecified unspecified unspecified 0 
4 ספרות ספרות וספרות noun feminine singular absolute unspecified unspecified  	O	null
5 . . . punctuation unspecified unspecified unspecified unspecified unspecified  	O	null

0 ###NUMEXP### ###NUMEXP### ###NUMEXP### numberExpression unspecified unspecified unspecified unspecified unspecified  	I_DATE	null
1 . . . punctuation unspecified unspecified unspecified unspecified unspecified  	O	null

