0 Name Name Name foreign unspecified unspecified unspecified unspecified unspecified  	O	null
1 : : : punctuation unspecified unspecified unspecified unspecified unspecified  	O	null
2 פיאד פיאד פיאד' noun masculine singular absolute unspecified unspecified  
2 י י פיאד' possessive masculine-and-feminine singular unspecified 1 unspecified 0 	O	null
3 , , , punctuation unspecified unspecified unspecified unspecified unspecified  	O	null
4 תופיק תופיק תופיק noun masculine singular construct unspecified unspecified  	O	null
5 Birth Birth Birth foreign unspecified unspecified unspecified unspecified unspecified  	O	null
6 Year Year Year foreign unspecified unspecified unspecified unspecified unspecified  	O	null
7 : : : punctuation unspecified unspecified unspecified unspecified unspecified  	O	null
8 ###NUMBER### ###NUMBER### ###NUMBER### numeral unspecified unspecified unspecified unspecified unspecified  	I_DATE	null
9 Birth Birth Birth foreign unspecified unspecified unspecified unspecified unspecified  	I_ORG	null
10 Place Place Place foreign unspecified unspecified unspecified unspecified unspecified  	I_ORG	null
11 : : : punctuation unspecified unspecified unspecified unspecified unspecified  	I_LOC	null
12 כפר כפר כפר noun masculine singular absolute unspecified unspecified  	I_LOC	null
13 מקיבלה מקיבלה מקיבלה properName unspecified unspecified unspecified unspecified unspecified  	I_LOC	null
14 Occupation Occupation Occupation foreign unspecified unspecified unspecified unspecified unspecified  	O	null
15 : : : punctuation unspecified unspecified unspecified unspecified unspecified  	O	null
16 סופר סופר סופר noun masculine singular absolute unspecified unspecified  	O	null
17 , , , punctuation unspecified unspecified unspecified unspecified unspecified  	O	null
18 מתרגם מתרגם מתרגם noun masculine singular absolute unspecified unspecified  	O	null
19 ו ו ומחזאי conjunction unspecified unspecified unspecified unspecified unspecified 0 
19 מחזאי מחזאי ומחזאי noun masculine singular absolute unspecified unspecified  	O	null
20 ב ב בשפה preposition unspecified unspecified unspecified unspecified unspecified 0 
20 ה ה בשפה definiteArticle unspecified unspecified unspecified unspecified unspecified 0 
20 השפה שפה בשפה noun feminine singular absolute unspecified unspecified  	O	null
21 ה ה הערבית definiteArticle unspecified unspecified unspecified unspecified unspecified 0 
21 הערבית ערבי הערבית adjective feminine singular absolute unspecified unspecified  	O	null
22 Entry Entry Entry foreign unspecified unspecified unspecified unspecified unspecified  	O	null
23 writer writer writer foreign unspecified unspecified unspecified unspecified unspecified  	O	null
24 : : : punctuation unspecified unspecified unspecified unspecified unspecified  	O	null
25 אריאל אריאל אריאל properName unspecified unspecified unspecified unspecified unspecified  	I_ORG	null
26 שיטרית שיטרית שיטרית properName unspecified unspecified unspecified unspecified unspecified  	I_ORG	null
27 Entry Entry Entry foreign unspecified unspecified unspecified unspecified unspecified  	O	null
28 Value Value Value foreign unspecified unspecified unspecified unspecified unspecified  	O	null
29 : : : punctuation unspecified unspecified unspecified unspecified unspecified  	O	null
30 נולד נולד נולד verb masculine singular unspecified 3 past  	I_LOC	null
31 ב ב בכפר preposition unspecified unspecified unspecified unspecified unspecified 0 
31 כפר כפר בכפר noun masculine singular construct unspecified unspecified  	I_LOC	null
32 מקיבלה מקיבלה מקיבלה properName unspecified unspecified unspecified unspecified unspecified  	I_LOC	null
33 . . . punctuation unspecified unspecified unspecified unspecified unspecified  	O	null

0 סיים סיים סיים verb masculine singular unspecified 3 past  	O	null
1 את את את at-preposition unspecified unspecified unspecified unspecified unspecified  	O	null
2 לימודי לימוד לימודיו noun masculine plural absolute unspecified unspecified  
2 ו ו לימודיו possessive masculine singular unspecified 3 unspecified 0 	O	null
3 ה ה התיכוניים definiteArticle unspecified unspecified unspecified unspecified unspecified 0 
3 התיכוניים תיכוני התיכוניים adjective masculine plural absolute unspecified unspecified  	O	null
4 ב ב בנצרת preposition unspecified unspecified unspecified unspecified unspecified 0 
4 נצרת נצרת בנצרת properName unspecified unspecified unspecified unspecified unspecified  	I_LOC	null
5 . . . punctuation unspecified unspecified unspecified unspecified unspecified  	O	null

0 בעל בעל בעל noun masculine singular construct unspecified unspecified  	O	null
1 תואר תואר תואר noun masculine singular absolute unspecified unspecified  	O	null
2 ראשון ORD1 ראשון numeral masculine singular absolute unspecified unspecified  	O	null
3 ב ב בתקשורת preposition unspecified unspecified unspecified unspecified unspecified 0 
3 ה ה בתקשורת definiteArticle unspecified unspecified unspecified unspecified unspecified 0 
3 התקשורת תקשורת בתקשורת noun feminine singular absolute unspecified unspecified  	O	null
4 מ מ מהאוניברסיטה preposition unspecified unspecified unspecified unspecified unspecified 0 
4 ה ה מהאוניברסיטה definiteArticle unspecified unspecified unspecified unspecified unspecified 0 
4 האוניברסיטה אוניברסיטה מהאוניברסיטה noun feminine singular absolute unspecified unspecified  	I_ORG	null
5 ה ה העברית definiteArticle unspecified unspecified unspecified unspecified unspecified 0 
5 העברית עברי העברית adjective feminine singular absolute unspecified unspecified  	I_ORG	null
6 ב ב בירושלים preposition unspecified unspecified unspecified unspecified unspecified 0 
6 ירושלים ירושלים בירושלים properName unspecified unspecified unspecified unspecified unspecified  	I_LOC	null
7 . . . punctuation unspecified unspecified unspecified unspecified unspecified  	O	null

0 עבד עיבד עבד properName unspecified unspecified unspecified unspecified unspecified  	I_PERS	null
1 כעמיל כעמיל כעמיל verb masculine singular unspecified 2 future  	O	null
2 מ מ מכס preposition unspecified unspecified unspecified unspecified unspecified 0 
2 כס כס מכס noun masculine singular construct unspecified unspecified  	O	null
3 ב ב בנמל preposition unspecified unspecified unspecified unspecified unspecified 0 
3 נמל נמל בנמל noun masculine singular construct unspecified unspecified  	O	null
4 חיפה חיפה חיפה properName unspecified unspecified unspecified unspecified unspecified  	I_LOC	null
5 . . . punctuation unspecified unspecified unspecified unspecified unspecified  	O	null

0 נכלא נכלא נכלא verb masculine singular unspecified 3 past  	O	null
1 בגין בגין בגין preposition unspecified unspecified unspecified unspecified unspecified  	O	null
2 עברות עברה עברות noun feminine plural absolute unspecified unspecified  	O	null
3 ביטחוניות בטחוני ביטחוניות adjective feminine plural absolute unspecified unspecified  	O	null
4 ( ( ( punctuation unspecified unspecified unspecified unspecified unspecified  	O	null
5 ###NUMBER### ###NUMBER### ###NUMBER### numeral unspecified unspecified unspecified unspecified unspecified  	I_DATE	null
6 - - - punctuation unspecified unspecified unspecified unspecified unspecified  	O	null
7 ###NUMBER### ###NUMBER### ###NUMBER### numeral unspecified unspecified unspecified unspecified unspecified  	I_DATE	null
8 ) ) ) punctuation unspecified unspecified unspecified unspecified unspecified  	O	null
9 ו ו ועזב conjunction unspecified unspecified unspecified unspecified unspecified 0 
9 עזב עזב ועזב verb masculine singular unspecified 3 past  	O	null
10 את את את at-preposition unspecified unspecified unspecified unspecified unspecified  	O	null
11 ישראל ישראל ישראל properName unspecified unspecified unspecified unspecified unspecified  	I_PERS	null
12 ב ב ב preposition unspecified unspecified unspecified unspecified unspecified 0 	O	null
13 - - - punctuation unspecified unspecified unspecified unspecified unspecified  	O	null
14 , , , punctuation unspecified unspecified unspecified unspecified unspecified  	O	null
15 ###NUMBER### ###NUMBER### ###NUMBER### numeral unspecified unspecified unspecified unspecified unspecified  	I_DATE	null
16 ב ב במסגרת preposition unspecified unspecified unspecified unspecified unspecified 0 
16 מסגרת מסגרת במסגרת noun feminine singular construct unspecified unspecified  	O	null
17 הסכם הסכם הסכם noun masculine singular construct unspecified unspecified  	O	null
18 חילופי חילוף חילופי noun masculine plural construct unspecified unspecified  	O	null
19 אסירים אסיר אסירים noun masculine plural absolute unspecified unspecified  	O	null
20 עם עם עם preposition unspecified unspecified unspecified unspecified unspecified  	I_LOC	null
21 מצרים מצר מצרים properName unspecified unspecified unspecified unspecified unspecified  	I_LOC	null
22 . . . punctuation unspecified unspecified unspecified unspecified unspecified  	O	null

0 עבד עבד עבד properName masculine singular unspecified unspecified unspecified  	I_PERS	null
1 ב ב במרכז preposition unspecified unspecified unspecified unspecified unspecified 0 
1 ה ה במרכז definiteArticle unspecified unspecified unspecified unspecified unspecified 0 
1 המרכז מרכז במרכז noun masculine singular absolute unspecified unspecified  	O	null
2 ל ל ללימודים preposition unspecified unspecified unspecified unspecified unspecified 0 
2 לימודים לימוד ללימודים noun masculine plural absolute unspecified unspecified  	O	null
3 פלסטיניים פלסטיני פלסטיניים adjective masculine plural absolute unspecified unspecified  	O	null
4 ב ב בעיר preposition unspecified unspecified unspecified unspecified unspecified 0 
4 עיר עיר בעיר noun feminine singular construct unspecified unspecified  	O	null
5 ביירות בירות ביירות properName feminine singular unspecified unspecified unspecified  	I_LOC	null
6 עד עד עד noun masculine singular absolute unspecified unspecified  	O	null
7 , , , punctuation unspecified unspecified unspecified unspecified unspecified  	O	null
8 ###NUMBER### ###NUMBER### ###NUMBER### numeral unspecified unspecified unspecified unspecified unspecified  	I_DATE	null
9 אז אז אז conjunction unspecified unspecified unspecified unspecified unspecified  	O	null
10 עבר עבר עבר verb masculine singular unspecified 3 past  	O	null
11 ל ל לתוניסיה preposition unspecified unspecified unspecified unspecified unspecified 0 
11 תוניסיה תוניס לתוניסיה properName unspecified unspecified unspecified unspecified unspecified  	I_LOC	null
12 , , , punctuation unspecified unspecified unspecified unspecified unspecified  	O	null
13 שבה שב שבה verb feminine singular unspecified 3 past  	O	null
14 הוא הוא הוא pronoun masculine singular unspecified 3 unspecified  	O	null
15 מתגורר התגורר מתגורר verb masculine singular unspecified any beinoni  	O	null
16 עד עד עד preposition unspecified unspecified unspecified unspecified unspecified  	O	null
17 ה ה היום definiteArticle unspecified unspecified unspecified unspecified unspecified 0 
17 היום יום היום noun masculine singular absolute unspecified unspecified  	O	null
18 . . . punctuation unspecified unspecified unspecified unspecified unspecified  	O	null

0 קיבל קיבל קיבל verb masculine singular unspecified 3 past  	O	null
1 תעודה תעודה תעודה noun feminine singular absolute unspecified unspecified  	O	null
2 ל ל לעבודה preposition unspecified unspecified unspecified unspecified unspecified 0 
2 ה ה לעבודה definiteArticle unspecified unspecified unspecified unspecified unspecified 0 
2 העבודה עבודה לעבודה noun feminine singular absolute unspecified unspecified  	O	null
3 ב ב בעיתונות preposition unspecified unspecified unspecified unspecified unspecified 0 
3 ה ה בעיתונות definiteArticle unspecified unspecified unspecified unspecified unspecified 0 
3 העיתונות עיתונות בעיתונות noun feminine singular absolute unspecified unspecified  	O	null
4 ו ו ועבד conjunction unspecified unspecified unspecified unspecified unspecified 0 
4 עבד עבד ועבד verb masculine singular unspecified 3 past  	O	null
5 ב ב בארגון preposition unspecified unspecified unspecified unspecified unspecified 0 
5 ה ה בארגון definiteArticle unspecified unspecified unspecified unspecified unspecified 0 
5 הארגון ארגון בארגון noun masculine singular absolute unspecified unspecified  	O	null
6 ה ה הערבי definiteArticle unspecified unspecified unspecified unspecified unspecified 0 
6 הערבי ערבי הערבי adjective masculine singular absolute unspecified unspecified  	O	null
7 ל ל לחינוך preposition unspecified unspecified unspecified unspecified unspecified 0 
7 ה ה לחינוך definiteArticle unspecified unspecified unspecified unspecified unspecified 0 
7 החינוך חינוך לחינוך noun masculine singular absolute unspecified unspecified  	O	null
8 , , , punctuation unspecified unspecified unspecified unspecified unspecified  	O	null
9 תרבות תרבות תרבות noun feminine singular absolute unspecified unspecified  	O	null
10 ו ו ומדעים conjunction unspecified unspecified unspecified unspecified unspecified 0 
10 מדעים מדע ומדעים noun masculine plural absolute unspecified unspecified  	O	null
11 . . . punctuation unspecified unspecified unspecified unspecified unspecified  	O	null

0 החל החל החל verb masculine singular unspecified 3 past  	O	null
1 לפרסם פרסם לפרסם verb unspecified unspecified unspecified unspecified infinitive  	O	null
2 סיפורים סיפור סיפורים noun masculine plural absolute unspecified unspecified  	O	null
3 ב ב בעיתונים preposition unspecified unspecified unspecified unspecified unspecified 0 
3 עיתונים עיתון בעיתונים noun masculine plural absolute unspecified unspecified  	O	null
4 אל אל אל preposition unspecified unspecified unspecified unspecified unspecified  	O	null
5 - - - properName unspecified unspecified unspecified unspecified unspecified  	O	null
6 יום יום יום noun masculine singular absolute unspecified unspecified  	O	null
7 ו ו ואל conjunction unspecified unspecified unspecified unspecified unspecified 0 
7 אל אל ואל preposition unspecified unspecified unspecified unspecified unspecified  	I_ORG	null
8 - - - punctuation unspecified unspecified unspecified unspecified unspecified  	I_ORG	null
9 אתתחאד אתתחאד אתתחאד properName unspecified unspecified unspecified unspecified unspecified  	I_ORG	null
10 ו ו ובמוסף conjunction unspecified unspecified unspecified unspecified unspecified 0 
10 ב ב ובמוסף preposition unspecified unspecified unspecified unspecified unspecified 0 
10 ה ה ובמוסף definiteArticle unspecified unspecified unspecified unspecified unspecified 0 
10 המוסף מוסף ובמוסף noun masculine singular absolute unspecified unspecified  	O	null
11 ה ה הספרותי definiteArticle unspecified unspecified unspecified unspecified unspecified 0 
11 הספרותי ספרותי הספרותי adjective masculine singular absolute unspecified unspecified  	O	null
12 אל אל אל preposition unspecified unspecified unspecified unspecified unspecified  	O	null
13 - - - punctuation unspecified unspecified unspecified unspecified unspecified  	O	null
14 ג'דיד ג'דיד ג'דיד properName unspecified unspecified unspecified unspecified unspecified  	I_ORG	null
15 . . . punctuation unspecified unspecified unspecified unspecified unspecified  	O	null

0 חיבר חיבר חיבר verb masculine singular unspecified 3 past  	O	null
1 שלושה CARD3 שלושה numeral masculine plural absolute unspecified unspecified  	O	null
2 רומנים רומן רומנים noun masculine plural absolute unspecified unspecified  	O	null
3 , , , punctuation unspecified unspecified unspecified unspecified unspecified  	O	null
4 ה ה הראשון definiteArticle unspecified unspecified unspecified unspecified unspecified 0 
4 הראשון ORD1 הראשון numeral masculine singular absolute unspecified unspecified  	O	null
5 בשם בישם בשם verb masculine singular unspecified 3 past  	O	null
6 ה ה המעוותים definiteArticle unspecified unspecified unspecified unspecified unspecified 0 
6 המעוותים עוות המעוותים participle masculine plural absolute any unspecified  	I_ORG	null
7 ( ( ( punctuation unspecified unspecified unspecified unspecified unspecified  	O	null
8 מטבעת טיבע מטבעת participle feminine singular construct any unspecified  	I_ORG	null
9 אל אל אל properName unspecified unspecified unspecified unspecified unspecified  	I_PERS	null
10 - - - properName unspecified unspecified unspecified unspecified unspecified  	I_PERS	null
11 אתתחאד אתתחאד אתתחאד properName unspecified unspecified unspecified unspecified unspecified  	I_PERS	null
12 , , , punctuation unspecified unspecified unspecified unspecified unspecified  	O	null
13 ) ) ) punctuation unspecified unspecified unspecified unspecified unspecified  	O	null
14 , , , punctuation unspecified unspecified unspecified unspecified unspecified  	O	null
15 ###NUMBER### ###NUMBER### ###NUMBER### numeral unspecified unspecified unspecified unspecified unspecified  	I_DATE	null
16 ה ה השני definiteArticle unspecified unspecified unspecified unspecified unspecified 0 
16 השני שני השני noun masculine singular absolute unspecified unspecified  	O	null
17 בשם בישם בשם verb masculine singular unspecified 3 past  	O	null
18 פלוגה פלוגה פלוגה noun feminine singular absolute unspecified unspecified  	O	null
19 ###NUMBER### ###NUMBER### ###NUMBER### numeral unspecified unspecified unspecified unspecified unspecified  	O	null
20 ( ( ( punctuation unspecified unspecified unspecified unspecified unspecified  	O	null
21 ###NUMBER### ###NUMBER### ###NUMBER### numeral unspecified unspecified unspecified unspecified unspecified  	I_DATE	null
22 ) ) ) punctuation unspecified unspecified unspecified unspecified unspecified  	O	null
23 ו ו והשלישי conjunction unspecified unspecified unspecified unspecified unspecified 0 
23 ה ה והשלישי definiteArticle unspecified unspecified unspecified unspecified unspecified 0 
23 השלישי ORD3 והשלישי numeral masculine singular absolute unspecified unspecified  	O	null
24 בשם בישם בשם verb masculine singular unspecified 3 past  	O	null
25 מיליציה מיליציה מיליציה noun feminine singular absolute unspecified unspecified  	O	null
26 אהובתי אהובתי אהובתי adjective masculine singular absolute unspecified unspecified  	O	null
27 ) ) ) punctuation unspecified unspecified unspecified unspecified unspecified  	O	null
28 . . . punctuation unspecified unspecified unspecified unspecified unspecified  	O	null
29 ###NUMBER### ###NUMBER### ###NUMBER### numeral unspecified unspecified unspecified unspecified unspecified  	I_DATE	null
30 כתב כתב כתב verb masculine singular unspecified 3 past  	O	null
31 גם גם גם conjunction unspecified unspecified unspecified unspecified unspecified  	O	null
32 מ מ מחזה preposition unspecified unspecified unspecified unspecified unspecified 0 
32 חזה חזה מחזה properName unspecified unspecified unspecified unspecified unspecified  	I_PERS	null
33 בשם בישם בשם verb masculine singular unspecified 3 past  	I_LOC	null
34 בית בית בית properName feminine singular unspecified unspecified unspecified  	I_PERS	null
35 ה ה השיגעון definiteArticle unspecified unspecified unspecified unspecified unspecified 0 
35 השיגעון שיגעון השיגעון noun masculine singular absolute unspecified unspecified  	O	null
36 ( ( ( punctuation unspecified unspecified unspecified unspecified unspecified  	O	null
37 ###NUMBER### ###NUMBER### ###NUMBER### numeral unspecified unspecified unspecified unspecified unspecified  	I_DATE	null
38 ) ) ) punctuation unspecified unspecified unspecified unspecified unspecified  	O	null
39 ו ו וקובץ conjunction unspecified unspecified unspecified unspecified unspecified 0 
39 קובץ קובץ וקובץ noun masculine singular construct unspecified unspecified  	O	null
40 סיפורים סיפור סיפורים noun masculine plural absolute unspecified unspecified  	O	null
41 קצרים קצר קצרים adjective masculine plural absolute unspecified unspecified  	O	null
42 בשם בישם בשם verb masculine singular unspecified 3 past  	O	null
43 ה ה הרחוב definiteArticle unspecified unspecified unspecified unspecified unspecified 0 
43 הרחוב רחוב הרחוב noun masculine singular absolute unspecified unspecified  	O	null
44 ה ה הצהוב definiteArticle unspecified unspecified unspecified unspecified unspecified 0 
44 הצהוב צהוב הצהוב adjective masculine singular absolute unspecified unspecified  	O	null
45 ) ) ) punctuation unspecified unspecified unspecified unspecified unspecified  	O	null
46 . . . punctuation unspecified unspecified unspecified unspecified unspecified  	O	null
47 ###NUMBER### ###NUMBER### ###NUMBER### numeral unspecified unspecified unspecified unspecified unspecified  	I_DATE	null
48 תירגם תרגם תירגם verb masculine singular unspecified 3 past  	O	null
49 , , , punctuation unspecified unspecified unspecified unspecified unspecified  	O	null
50 בין בין בין conjunction unspecified unspecified unspecified unspecified unspecified  	O	null
51 ה ה השאר definiteArticle unspecified unspecified unspecified unspecified unspecified 0 
51 השאר שאר השאר quantifier unspecified unspecified unspecified unspecified unspecified  	O	null
52 , , , punctuation unspecified unspecified unspecified unspecified unspecified  	O	null
53 את את את at-preposition unspecified unspecified unspecified unspecified unspecified  	O	null
54 ה ה הסיפור definiteArticle unspecified unspecified unspecified unspecified unspecified 0 
54 הסיפור סיפור הסיפור noun masculine singular absolute unspecified unspecified  	O	null
55 " " " punctuation unspecified unspecified unspecified unspecified unspecified  	O	null
56 חרבת חרב חרבת adjective feminine singular construct unspecified unspecified  	I_ORG	null
57 חזעה חזעה חזעה properName unspecified unspecified unspecified unspecified unspecified  	I_ORG	null
58 " " " punctuation unspecified unspecified unspecified unspecified unspecified  	O	null
59 מאת מאת מאת preposition unspecified unspecified unspecified unspecified unspecified  	O	null
60 ס' ס' ס' properName unspecified unspecified unspecified unspecified unspecified  	I_PERS	null
61 יזהר יזהר יזהר properName unspecified unspecified unspecified unspecified unspecified  	I_PERS	null
62 ל ל לערבית preposition unspecified unspecified unspecified unspecified unspecified 0 
62 ערבית ערבית לערבית properName feminine singular unspecified unspecified unspecified  	B_PERS	null
63 ) ) ) punctuation unspecified unspecified unspecified unspecified unspecified  	O	null
64 . . . punctuation unspecified unspecified unspecified unspecified unspecified  	O	null
65 ###NUMBER### ###NUMBER### ###NUMBER### numeral unspecified unspecified unspecified unspecified unspecified  	I_DATE	null
66 ה ה הרומן definiteArticle unspecified unspecified unspecified unspecified unspecified 0 
66 הרומן רומן הרומן noun masculine singular absolute unspecified unspecified  	O	null
67 ה ה המעוותים definiteArticle unspecified unspecified unspecified unspecified unspecified 0 
67 המעוותים עוות המעוותים participle masculine plural absolute any unspecified  	O	null
68 נחשב חישב נחשב verb masculine-and-feminine plural unspecified 1 future  	O	null
69 ל ל לרומן preposition unspecified unspecified unspecified unspecified unspecified 0 
69 רום רום לרומן noun masculine singular absolute unspecified unspecified  
69 ן ן לרומן possessive feminine plural unspecified 3 unspecified 0 	O	null
70 ה ה הפלסטיני definiteArticle unspecified unspecified unspecified unspecified unspecified 0 
70 הפלסטיני פלסטיני הפלסטיני adjective masculine singular absolute unspecified unspecified  	O	null
71 האמנות האמנה האמנותי noun feminine plural absolute unspecified unspecified  
71 י י האמנותי possessive masculine-and-feminine singular unspecified 1 unspecified 0 	O	null
72 ה ה הראשון definiteArticle unspecified unspecified unspecified unspecified unspecified 0 
72 הראשון ORD1 הראשון numeral masculine singular absolute unspecified unspecified  	O	null
73 ש ש שלא relativizer/subordinatingConjunction unspecified unspecified unspecified unspecified unspecified 0 
73 לא לא שלא negation unspecified unspecified unspecified unspecified unspecified  	O	null
74 מתמקד התמקד מתמקד verb masculine singular unspecified any beinoni  	O	null
75 ב ב באמירות preposition unspecified unspecified unspecified unspecified unspecified 0 
75 אמירות אמירה באמירות noun feminine plural construct unspecified unspecified  	O	null
76 פוליטיות פוליטי פוליטיות adjective feminine plural absolute unspecified unspecified  	O	null
77 מובהקות הובהק מובהקות verb feminine plural unspecified any beinoni  	O	null
78 נגד נגד נגד preposition unspecified unspecified unspecified unspecified unspecified  	O	null
79 ישראל ישראל ישראל properName unspecified unspecified unspecified unspecified unspecified  	I_PERS	null
80 , , , punctuation unspecified unspecified unspecified unspecified unspecified  	O	null
81 אלא אלא אלא conjunction unspecified unspecified unspecified unspecified unspecified  	O	null
82 ב ב בביקורת preposition unspecified unspecified unspecified unspecified unspecified 0 
82 ביקורת ביקורת בביקורת noun feminine singular construct unspecified unspecified  	O	null
83 ה ה המכוונת definiteArticle unspecified unspecified unspecified unspecified unspecified 0 
83 המכוונת כוון המכוונת participle feminine singular absolute any unspecified  	O	null
84 ל ל לקלקלותיה preposition unspecified unspecified unspecified unspecified unspecified 0 
84 קלקלות קלקלה לקלקלותיה noun feminine plural absolute unspecified unspecified  
84 ה ה לקלקלותיה possessive feminine singular unspecified 3 unspecified 0 	O	null
85 של של של shel-preposition unspecified unspecified unspecified unspecified unspecified  	O	null
86 ה ה החברה definiteArticle unspecified unspecified unspecified unspecified unspecified 0 
86 החברה חבר החברה noun feminine singular absolute unspecified unspecified  	O	null
87 ה ה הערבית definiteArticle unspecified unspecified unspecified unspecified unspecified 0 
87 הערבית ערבי הערבית adjective feminine singular absolute unspecified unspecified  	O	null
88 ב ב בארץ preposition unspecified unspecified unspecified unspecified unspecified 0 
88 ה ה בארץ definiteArticle unspecified unspecified unspecified unspecified unspecified 0 
88 הארץ ארץ בארץ properName unspecified unspecified unspecified unspecified unspecified  	I_LOC	null
89 . . . punctuation unspecified unspecified unspecified unspecified unspecified  	O	null

0 ה ה הרומן definiteArticle unspecified unspecified unspecified unspecified unspecified 0 
0 הרומן רומן הרומן noun masculine singular absolute unspecified unspecified  	O	null
1 מספר מספר מספר verb masculine singular unspecified 3 past  	O	null
2 את את את at-preposition unspecified unspecified unspecified unspecified unspecified  	O	null
3 קורות קורה קורותיו noun feminine plural absolute unspecified unspecified  
3 ו ו קורותיו possessive masculine singular unspecified 3 unspecified 0 	O	null
4 של של של shel-preposition unspecified unspecified unspecified unspecified unspecified  	O	null
5 סעיד סעיד סעיד properName unspecified unspecified unspecified unspecified unspecified  	I_PERS	null
6 , , , punctuation unspecified unspecified unspecified unspecified unspecified  	O	null
7 נער נער נער noun masculine singular absolute unspecified unspecified  	O	null
8 ה ה הלומד definiteArticle unspecified unspecified unspecified unspecified unspecified 0 
8 הלומד למד הלומד participle masculine singular absolute any unspecified  	O	null
9 ב ב בתיכון preposition unspecified unspecified unspecified unspecified unspecified 0 
9 תיכון תיכון בתיכון noun masculine singular absolute unspecified unspecified  	O	null
10 ב ב בכפר preposition unspecified unspecified unspecified unspecified unspecified 0 
10 ה ה בכפר definiteArticle unspecified unspecified unspecified unspecified unspecified 0 
10 הכפר כפר בכפר noun masculine singular absolute unspecified unspecified  	O	null
11 ב ב בתנאי preposition unspecified unspecified unspecified unspecified unspecified 0 
11 תנאי תנאי בתנאי noun masculine singular construct unspecified unspecified  	O	null
12 עוני עוני עוני noun masculine singular absolute unspecified unspecified  	O	null
13 מחפירים מחפיר מחפירים adjective masculine plural absolute unspecified unspecified  	O	null
14 ו ו ובאווירה conjunction unspecified unspecified unspecified unspecified unspecified 0 
14 ב ב ובאווירה preposition unspecified unspecified unspecified unspecified unspecified 0 
14 אווירה אווירה ובאווירה noun feminine singular absolute unspecified unspecified  	O	null
15 שמרנית שמרן שמרנית adjective feminine singular absolute unspecified unspecified  	O	null
16 , , , punctuation unspecified unspecified unspecified unspecified unspecified  	O	null
17 ש ש שמהם relativizer/subordinatingConjunction unspecified unspecified unspecified unspecified unspecified 0 
17 מן מן שמהם preposition unspecified unspecified unspecified unspecified unspecified  
17 הם הם שמהם pronomial masculine plural unspecified 3 unspecified 0 	O	null
18 הוא הוא הוא pronoun masculine singular unspecified 3 unspecified  	O	null
19 נמלט נמלט נמלט verb masculine singular unspecified 3 past  	O	null
20 ל ל לעיר preposition unspecified unspecified unspecified unspecified unspecified 0 
20 עיר עיר לעיר noun feminine singular construct unspecified unspecified  	O	null
21 נצרת נצרת נצרת properName unspecified unspecified unspecified unspecified unspecified  	I_LOC	null
22 . . . punctuation unspecified unspecified unspecified unspecified unspecified  	O	null

0 ה ה העלילה definiteArticle unspecified unspecified unspecified unspecified unspecified 0 
0 העלילה עלילה העלילה noun feminine singular absolute unspecified unspecified  	O	null
1 מתעכבת התעכב מתעכבת verb feminine singular unspecified any beinoni  	O	null
2 על על על preposition unspecified unspecified unspecified unspecified unspecified  	O	null
3 ה ה הקושי definiteArticle unspecified unspecified unspecified unspecified unspecified 0 
3 הקושי קושי הקושי noun masculine singular absolute unspecified unspecified  	O	null
4 של של שלו shel-preposition unspecified unspecified unspecified unspecified unspecified  
4 ו ו שלו pronomial masculine singular unspecified 3 unspecified 0 	O	null
5 למצוא מצא למצוא verb unspecified unspecified unspecified unspecified infinitive  	O	null
6 את את את at-preposition unspecified unspecified unspecified unspecified unspecified  	O	null
7 דרך דרך דרכו noun feminine singular absolute unspecified unspecified  
7 ו ו דרכו possessive masculine singular unspecified 3 unspecified 0 	O	null
8 ב ב בעיר preposition unspecified unspecified unspecified unspecified unspecified 0 
8 ה ה בעיר definiteArticle unspecified unspecified unspecified unspecified unspecified 0 
8 העיר עיר בעיר noun feminine singular absolute unspecified unspecified  	O	null
9 ה ה הגדולה definiteArticle unspecified unspecified unspecified unspecified unspecified 0 
9 הגדולה גדול הגדולה adjective feminine singular absolute unspecified unspecified  	O	null
10 , , , punctuation unspecified unspecified unspecified unspecified unspecified  	O	null
11 ו ו ומדגישה conjunction unspecified unspecified unspecified unspecified unspecified 0 
11 מדגישה הדגיש ומדגישה verb feminine singular unspecified any beinoni  	O	null
12 את את את at-preposition unspecified unspecified unspecified unspecified unspecified  	O	null
13 ה ה הזרות definiteArticle unspecified unspecified unspecified unspecified unspecified 0 
13 הזרות זרות הזרות noun feminine singular absolute unspecified unspecified  	O	null
14 ה ה הכפולה definiteArticle unspecified unspecified unspecified unspecified unspecified 0 
14 הכפולה כפול הכפולה adjective feminine singular absolute unspecified unspecified  	O	null
15 של של של shel-preposition unspecified unspecified unspecified unspecified unspecified  	O	null
16 בן בן בן noun masculine singular construct unspecified unspecified  	O	null
17 ה ה הכפר definiteArticle unspecified unspecified unspecified unspecified unspecified 0 
17 הכפר כפר הכפר noun masculine singular absolute unspecified unspecified  	O	null
18 ש ש שחש relativizer/subordinatingConjunction unspecified unspecified unspecified unspecified unspecified 0 
18 חש חש שחש verb masculine singular unspecified 3 past  	O	null
19 זר זר זר noun masculine singular absolute unspecified unspecified  	O	null
20 ב ב בכפרו preposition unspecified unspecified unspecified unspecified unspecified 0 
20 כפר כפר בכפרו noun masculine singular absolute unspecified unspecified  
20 ו ו בכפרו possessive masculine singular unspecified 3 unspecified 0 	O	null
21 אך אך אך conjunction unspecified unspecified unspecified unspecified unspecified  	O	null
22 גם גם גם conjunction unspecified unspecified unspecified unspecified unspecified  	O	null
23 ב ב בעיר preposition unspecified unspecified unspecified unspecified unspecified 0 
23 ה ה בעיר definiteArticle unspecified unspecified unspecified unspecified unspecified 0 
23 העיר עיר בעיר noun feminine singular absolute unspecified unspecified  	O	null
24 ש ש שאליה relativizer/subordinatingConjunction unspecified unspecified unspecified unspecified unspecified 0 
24 אל אל שאליה preposition unspecified unspecified unspecified unspecified unspecified  
24 ה ה שאליה pronomial feminine singular unspecified 3 unspecified 0 	O	null
25 הוא הוא הוא pronoun masculine singular unspecified 3 unspecified  	O	null
26 עובר עבר עובר verb masculine singular unspecified any beinoni  	O	null
27 . . . punctuation unspecified unspecified unspecified unspecified unspecified  	O	null

0 ב ב ברומן preposition unspecified unspecified unspecified unspecified unspecified 0 
0 רומן רומן ברומן noun masculine singular construct unspecified unspecified  	O	null
1 עולים עולה עולים noun masculine plural absolute unspecified unspecified  	O	null
2 גם גם גם conjunction unspecified unspecified unspecified unspecified unspecified  	O	null
3 נושאים נושא נושאים noun masculine plural absolute unspecified unspecified  	O	null
4 מיניים מיני מיניים adjective masculine plural absolute unspecified unspecified  	O	null
5 , , , punctuation unspecified unspecified unspecified unspecified unspecified  	O	null
6 ש ש שנחשבו relativizer/subordinatingConjunction unspecified unspecified unspecified unspecified unspecified 0 
6 נחשבו נחשב שנחשבו verb masculine-and-feminine plural unspecified 3 past  	O	null
7 עד עד עד preposition unspecified unspecified unspecified unspecified unspecified  	O	null
8 אז אז אז adverb unspecified unspecified unspecified unspecified unspecified  	O	null
9 ל ל לטאבו preposition unspecified unspecified unspecified unspecified unspecified 0 
9 טאבו טאבו לטאבו noun masculine singular absolute unspecified unspecified  	O	null
10 ב ב בספרות preposition unspecified unspecified unspecified unspecified unspecified 0 
10 ה ה בספרות definiteArticle unspecified unspecified unspecified unspecified unspecified 0 
10 הספרות ספרות בספרות noun feminine singular absolute unspecified unspecified  	O	null
11 ה ה הפלסטינית definiteArticle unspecified unspecified unspecified unspecified unspecified 0 
11 הפלסטינית פלסטיני הפלסטינית adjective feminine singular absolute unspecified unspecified  	O	null
12 . . . punctuation unspecified unspecified unspecified unspecified unspecified  	O	null

0 לאחר לאחר לאחר conjunction unspecified unspecified unspecified unspecified unspecified  	O	null
1 צאת צאת צאתו noun feminine singular absolute unspecified unspecified  
1 ו ו צאתו possessive masculine singular unspecified 3 unspecified 0 	O	null
2 ל ל לאור preposition unspecified unspecified unspecified unspecified unspecified 0 
2 ה ה לאור definiteArticle unspecified unspecified unspecified unspecified unspecified 0 
2 האור אור לאור noun masculine singular absolute unspecified unspecified  	O	null
3 הותקפו הותקף הותקפו verb masculine-and-feminine plural unspecified 3 past  	O	null
4 ה ה הרומן definiteArticle unspecified unspecified unspecified unspecified unspecified 0 
4 הרומן רומן הרומן noun masculine singular absolute unspecified unspecified  	O	null
5 ו ו ומחברו conjunction unspecified unspecified unspecified unspecified unspecified 0 
5 מ מ ומחברו preposition unspecified unspecified unspecified unspecified unspecified 0 
5 חבר חבר ומחברו noun masculine singular absolute unspecified unspecified  
5 ו ו ומחברו possessive masculine singular unspecified 3 unspecified 0 	O	null
6 ב ב באופן preposition unspecified unspecified unspecified unspecified unspecified 0 
6 אופן אופן באופן noun masculine singular absolute unspecified unspecified  	O	null
7 חסר חסר חסר adjective masculine singular absolute unspecified unspecified  	O	null
8 תקדים תקדים תקדים noun masculine singular absolute unspecified unspecified  	O	null
9 על על על preposition unspecified unspecified unspecified unspecified unspecified  	O	null
10 ידי יד ידי noun feminine plural construct unspecified unspecified  	O	null
11 ה ה המבקרים definiteArticle unspecified unspecified unspecified unspecified unspecified 0 
11 המבקרים מבקר המבקרים noun masculine plural absolute unspecified unspecified  	O	null
12 ה ה הערבים definiteArticle unspecified unspecified unspecified unspecified unspecified 0 
12 הערבים ערב הערבים adjective masculine plural absolute unspecified unspecified  	O	null
13 ה ה הישראליים definiteArticle unspecified unspecified unspecified unspecified unspecified 0 
13 הישראליים ישראלי הישראליים adjective masculine plural absolute unspecified unspecified  	O	null
14 , , , punctuation unspecified unspecified unspecified unspecified unspecified  	O	null
15 ו ו והדעה conjunction unspecified unspecified unspecified unspecified unspecified 0 
15 ה ה והדעה definiteArticle unspecified unspecified unspecified unspecified unspecified 0 
15 הדעה דעה והדעה noun feminine singular absolute unspecified unspecified  	O	null
16 ה ה הרווחת definiteArticle unspecified unspecified unspecified unspecified unspecified 0 
16 הרווחת רווח הרווחת adjective feminine singular absolute unspecified unspecified  	O	null
17 היתה הוא היתה copula feminine singular unspecified 3 past  	O	null
18 ש ש שמדובר relativizer/subordinatingConjunction unspecified unspecified unspecified unspecified unspecified 0 
18 מדובר דובר שמדובר verb masculine singular unspecified any beinoni  	O	null
19 ב ב בספר preposition unspecified unspecified unspecified unspecified unspecified 0 
19 ה ה בספר definiteArticle unspecified unspecified unspecified unspecified unspecified 0 
19 הספר ספר בספר noun masculine singular absolute unspecified unspecified  	O	null
20 ש ש שראוי relativizer/subordinatingConjunction unspecified unspecified unspecified unspecified unspecified 0 
20 ראוי ראוי שראוי modal masculine singular unspecified any unspecified  	O	null
21 להוקיע הוקיע להוקיע verb unspecified unspecified unspecified unspecified infinitive  	O	null
22 ו ו ולשכוח conjunction unspecified unspecified unspecified unspecified unspecified 0 
22 לשכוח שכח ולשכוח verb unspecified unspecified unspecified unspecified infinitive  	O	null
23 , , , punctuation unspecified unspecified unspecified unspecified unspecified  	O	null
24 ו ו ולו conjunction unspecified unspecified unspecified unspecified unspecified 0 
24 לו לו ולו conjunction unspecified unspecified unspecified unspecified unspecified  	O	null
25 בשל בשל בשל preposition unspecified unspecified unspecified unspecified unspecified  	O	null
26 ה ה התיאורים definiteArticle unspecified unspecified unspecified unspecified unspecified 0 
26 התיאורים תיאור התיאורים noun masculine plural absolute unspecified unspecified  	O	null
27 ה ה המיניים definiteArticle unspecified unspecified unspecified unspecified unspecified 0 
27 המיניים מיני המיניים adjective masculine plural absolute unspecified unspecified  	O	null
28 ש ש שהוא relativizer/subordinatingConjunction unspecified unspecified unspecified unspecified unspecified 0 
28 הוא הוא שהוא pronoun masculine singular unspecified 3 unspecified  	O	null
29 מכיל הכיל מכיל verb masculine singular unspecified any beinoni  	O	null
30 . . . punctuation unspecified unspecified unspecified unspecified unspecified  	O	null

0 אולם אולם אולם conjunction unspecified unspecified unspecified unspecified unspecified  	O	null
1 , , , punctuation unspecified unspecified unspecified unspecified unspecified  	O	null
2 כפי כפי כפי conjunction unspecified unspecified unspecified unspecified unspecified  	O	null
3 ש ש שטוען relativizer/subordinatingConjunction unspecified unspecified unspecified unspecified unspecified 0 
3 טוען טען שטוען verb masculine singular unspecified any beinoni  	O	null
4 מחמוד מחמוד מחמוד properName unspecified unspecified unspecified unspecified unspecified  	I_PERS	null
5 גנאים גנאי גנאים noun masculine plural absolute unspecified unspecified  	O	null
6 ) ) ) punctuation unspecified unspecified unspecified unspecified unspecified  	O	null
7 , , , punctuation unspecified unspecified unspecified unspecified unspecified  	O	null
8 ###NUMBER### ###NUMBER### ###NUMBER### numeral unspecified unspecified unspecified unspecified unspecified  	I_DATE	null
9 ספר ספר ספר noun masculine singular absolute unspecified unspecified  	O	null
10 זה זה זה pronoun masculine singular unspecified 3 unspecified  	O	null
11 ראוי ראוי ראוי adjective masculine singular absolute unspecified unspecified  	O	null
12 ל ל להוקרה preposition unspecified unspecified unspecified unspecified unspecified 0 
12 הוקרה הוקרה להוקרה noun feminine singular absolute unspecified unspecified  	O	null
13 גם גם גם conjunction unspecified unspecified unspecified unspecified unspecified  	O	null
14 בשל בשל בשל preposition unspecified unspecified unspecified unspecified unspecified  	O	null
15 נועזות נועזות נועזותו noun feminine singular absolute unspecified unspecified  
15 ו ו נועזותו possessive masculine singular unspecified 3 unspecified 0 	O	null
16 ו ו וגם conjunction unspecified unspecified unspecified unspecified unspecified 0 
16 גם גם וגם conjunction unspecified unspecified unspecified unspecified unspecified  	O	null
17 בשל בשל בשל preposition unspecified unspecified unspecified unspecified unspecified  	O	null
18 ה ה החידושים definiteArticle unspecified unspecified unspecified unspecified unspecified 0 
18 החידושים חידוש החידושים noun masculine plural absolute unspecified unspecified  	O	null
19 ש ש שהביא relativizer/subordinatingConjunction unspecified unspecified unspecified unspecified unspecified 0 
19 הביא הביא שהביא verb masculine singular unspecified 3 past  	O	null
20 ל ל לספרות preposition unspecified unspecified unspecified unspecified unspecified 0 
20 ה ה לספרות definiteArticle unspecified unspecified unspecified unspecified unspecified 0 
20 הספרות ספרות לספרות noun feminine singular absolute unspecified unspecified  	O	null
21 ה ה הערבית definiteArticle unspecified unspecified unspecified unspecified unspecified 0 
21 הערבית ערבי הערבית adjective feminine singular absolute unspecified unspecified  	O	null
22 ה ה המקומית definiteArticle unspecified unspecified unspecified unspecified unspecified 0 
22 המקומית מקומי המקומית adjective feminine singular absolute unspecified unspecified  	O	null
23 , , , punctuation unspecified unspecified unspecified unspecified unspecified  	O	null
24 הן הן הן conjunction unspecified unspecified unspecified unspecified unspecified  	O	null
25 ב ב בסגנון preposition unspecified unspecified unspecified unspecified unspecified 0 
25 ה ה בסגנון definiteArticle unspecified unspecified unspecified unspecified unspecified 0 
25 הסגנון סגנון בסגנון noun masculine singular absolute unspecified unspecified  	O	null
26 ו ו והן conjunction unspecified unspecified unspecified unspecified unspecified 0 
26 הן הן והן conjunction unspecified unspecified unspecified unspecified unspecified  	O	null
27 ב ב בתוכן preposition unspecified unspecified unspecified unspecified unspecified 0 
27 ה ה בתוכן definiteArticle unspecified unspecified unspecified unspecified unspecified 0 
27 התוכן תוכן בתוכן noun masculine singular absolute unspecified unspecified  	O	null
28 . . . punctuation unspecified unspecified unspecified unspecified unspecified  	O	null

0 את את את at-preposition unspecified unspecified unspecified unspecified unspecified  	O	null
1 יצירות יצירה יצירותיו noun feminine plural absolute unspecified unspecified  
1 ו ו יצירותיו possessive masculine singular unspecified 3 unspecified 0 	O	null
2 ש ש שנכתבו relativizer/subordinatingConjunction unspecified unspecified unspecified unspecified unspecified 0 
2 נכתבו נכתב שנכתבו verb masculine-and-feminine plural unspecified 3 past  	O	null
3 לאחר לאחר לאחר preposition unspecified unspecified unspecified unspecified unspecified  	O	null
4 ה ה הרומן definiteArticle unspecified unspecified unspecified unspecified unspecified 0 
4 הרומן רומן הרומן noun masculine singular absolute unspecified unspecified  	O	null
5 ה ה הזה definiteArticle unspecified unspecified unspecified unspecified unspecified 0 
5 הזה זה הזה pronoun masculine singular unspecified 3 unspecified  	O	null
6 חיבר חיבר חיבר verb masculine singular unspecified 3 past  	O	null
7 ב ב בסגנון preposition unspecified unspecified unspecified unspecified unspecified 0 
7 סגנון סגנון בסגנון noun masculine singular absolute unspecified unspecified  	O	null
8 מסורתי מסורתי מסורתי adjective masculine singular absolute unspecified unspecified  	O	null
9 ו ו ומקובל conjunction unspecified unspecified unspecified unspecified unspecified 0 
9 מקובל מקובל ומקובל adjective masculine singular absolute unspecified unspecified  	O	null
10 יותר יותר יותר adverb unspecified unspecified unspecified unspecified unspecified  	O	null
11 , , , punctuation unspecified unspecified unspecified unspecified unspecified  	O	null
12 ו ו ולראיה conjunction unspecified unspecified unspecified unspecified unspecified 0 
12 ל ל ולראיה preposition unspecified unspecified unspecified unspecified unspecified 0 
12 ראיה ראיה ולראיה noun feminine singular absolute unspecified unspecified  	O	null
13 – – – punctuation unspecified unspecified unspecified unspecified unspecified  	O	null
14 ה ה המחזה definiteArticle unspecified unspecified unspecified unspecified unspecified 0 
14 המחזה מחזה המחזה noun masculine singular absolute unspecified unspecified  	O	null
15 בית בית בית noun masculine singular construct unspecified unspecified  	O	null
16 ה ה השיגעון definiteArticle unspecified unspecified unspecified unspecified unspecified 0 
16 השיגעון שיגעון השיגעון noun masculine singular absolute unspecified unspecified  	O	null
17 ( ( ( punctuation unspecified unspecified unspecified unspecified unspecified  	O	null
18 ###NUMBER### ###NUMBER### ###NUMBER### numeral unspecified unspecified unspecified unspecified unspecified  	I_DATE	null
19 ) ) ) punctuation unspecified unspecified unspecified unspecified unspecified  	O	null
20 ו ו וקובץ conjunction unspecified unspecified unspecified unspecified unspecified 0 
20 קובץ קובץ וקובץ noun masculine singular construct unspecified unspecified  	O	null
21 ה ה הסיפורים definiteArticle unspecified unspecified unspecified unspecified unspecified 0 
21 הסיפורים סיפור הסיפורים noun masculine plural absolute unspecified unspecified  	O	null
22 ה ה הרחוב definiteArticle unspecified unspecified unspecified unspecified unspecified 0 
22 הרחוב רחוב הרחוב noun masculine singular absolute unspecified unspecified  	O	null
23 ה ה הצהוב definiteArticle unspecified unspecified unspecified unspecified unspecified 0 
23 הצהוב צהוב הצהוב adjective masculine singular absolute unspecified unspecified  	O	null
24 ( ( ( punctuation unspecified unspecified unspecified unspecified unspecified  	O	null
25 ###NUMBER### ###NUMBER### ###NUMBER### numeral unspecified unspecified unspecified unspecified unspecified  	I_DATE	null
26 ) ) ) punctuation unspecified unspecified unspecified unspecified unspecified  	O	null
27 התקבלו התקבל התקבלו verb masculine-and-feminine plural unspecified 3 past  	O	null
28 ב ב באהדה preposition unspecified unspecified unspecified unspecified unspecified 0 
28 אהדה אהדה באהדה noun feminine singular absolute unspecified unspecified  	O	null
29 בקרב בקרב בקרב preposition unspecified unspecified unspecified unspecified unspecified  	O	null
30 ה ה המבקרים definiteArticle unspecified unspecified unspecified unspecified unspecified 0 
30 המבקרים מבקר המבקרים noun masculine plural absolute unspecified unspecified  	O	null
31 . . . punctuation unspecified unspecified unspecified unspecified unspecified  	O	null

0 ראוי ראוי ראוי adjective masculine singular absolute unspecified unspecified  	O	null
1 ל ל לציון preposition unspecified unspecified unspecified unspecified unspecified 0 
1 ציון ציון לציון noun masculine singular absolute unspecified unspecified  	O	null
2 גם גם גם conjunction unspecified unspecified unspecified unspecified unspecified  	O	null
3 ה ה הסיפור definiteArticle unspecified unspecified unspecified unspecified unspecified 0 
3 הסיפור סיפור הסיפור noun masculine singular absolute unspecified unspecified  	O	null
4 " " " punctuation unspecified unspecified unspecified unspecified unspecified  	O	null
5 ה ה הכלב definiteArticle unspecified unspecified unspecified unspecified unspecified 0 
5 הכלב כלב הכלב noun masculine singular absolute unspecified unspecified  	O	null
6 סמור סמור סמור noun masculine singular absolute unspecified unspecified  	O	null
7 " " " punctuation unspecified unspecified unspecified unspecified unspecified  	O	null
8 ( ( ( punctuation unspecified unspecified unspecified unspecified unspecified  	O	null
9 מערבית מערבי מערבית noun feminine singular absolute unspecified unspecified  	O	null
10 : : : punctuation unspecified unspecified unspecified unspecified unspecified  	O	null
11 שמעון שמעון שמעון properName unspecified unspecified unspecified unspecified unspecified  	I_PERS	null
12 בלס בלס בלס properName unspecified unspecified unspecified unspecified unspecified  	I_PERS	null
13 , , , punctuation unspecified unspecified unspecified unspecified unspecified  	O	null
14 בתוך בתוך בתוך preposition unspecified unspecified unspecified unspecified unspecified  	O	null
15 סיפורים סיפור סיפורים noun masculine plural absolute unspecified unspecified  	O	null
16 פלסטיניים פלסטיני פלסטיניים adjective masculine plural absolute unspecified unspecified  	O	null
17 , , , punctuation unspecified unspecified unspecified unspecified unspecified  	O	null
18 , , , punctuation unspecified unspecified unspecified unspecified unspecified  	O	null
19 ###NUMBER### ###NUMBER### ###NUMBER### numeral unspecified unspecified unspecified unspecified unspecified  	I_DATE	null
20 - - - punctuation unspecified unspecified unspecified unspecified unspecified  	O	null
21 ###NUMBER### ###NUMBER### ###NUMBER### numeral unspecified unspecified unspecified unspecified unspecified  	O	null
22 ) ) ) punctuation unspecified unspecified unspecified unspecified unspecified  	O	null
23 , , , punctuation unspecified unspecified unspecified unspecified unspecified  	O	null
24 ###NUMBER### ###NUMBER### ###NUMBER### numeral unspecified unspecified unspecified unspecified unspecified  	O	null
25 ש ש שמציג relativizer/subordinatingConjunction unspecified unspecified unspecified unspecified unspecified 0 
25 מציג הציג שמציג verb masculine singular unspecified any beinoni  	O	null
26 את את את at-preposition unspecified unspecified unspecified unspecified unspecified  	O	null
27 כפר כפר כפר noun masculine singular construct unspecified unspecified  	O	null
28 הולדת הולדה הולדתו noun feminine singular absolute unspecified unspecified  
28 ו ו הולדתו possessive masculine singular unspecified 3 unspecified 0 	O	null
29 של של של shel-preposition unspecified unspecified unspecified unspecified unspecified  	O	null
30 פיאד פיאד פיאד' noun masculine singular absolute unspecified unspecified  
30 י י פיאד' possessive masculine-and-feminine singular unspecified 1 unspecified 0 	O	null
31 ב ב בסוף preposition unspecified unspecified unspecified unspecified unspecified 0 
31 סוף סוף בסוף noun masculine singular construct unspecified unspecified  	O	null
32 תקופת תקופה תקופת noun feminine singular construct unspecified unspecified  	O	null
33 ה ה המנדט definiteArticle unspecified unspecified unspecified unspecified unspecified 0 
33 המנדט מנדט המנדט noun masculine singular absolute unspecified unspecified  	O	null
34 ו ו ובשעת conjunction unspecified unspecified unspecified unspecified unspecified 0 
34 ב ב ובשעת preposition unspecified unspecified unspecified unspecified unspecified 0 
34 שעת שעה ובשעת noun feminine singular construct unspecified unspecified  	O	null
35 כיבוש כיבוש כיבושו noun masculine singular absolute unspecified unspecified  
35 ו ו כיבושו possessive masculine singular unspecified 3 unspecified 0 	O	null
36 על על על preposition unspecified unspecified unspecified unspecified unspecified  	O	null
37 ידי יד ידי noun feminine plural construct unspecified unspecified  	O	null
38 ה ה היהודים definiteArticle unspecified unspecified unspecified unspecified unspecified 0 
38 היהודים יהודי היהודים noun masculine plural absolute unspecified unspecified  	O	null
39 מ מ מנקודת preposition unspecified unspecified unspecified unspecified unspecified 0 
39 נקודת נקודה מנקודת noun feminine singular construct unspecified unspecified  	O	null
40 ראות ראות ראות noun feminine singular absolute unspecified unspecified  	O	null
41 מיוחדת מיוחד מיוחדת adjective feminine singular absolute unspecified unspecified  	O	null
42 : : : punctuation unspecified unspecified unspecified unspecified unspecified  	O	null
43 זו זו זו pronoun feminine singular unspecified 3 unspecified  	O	null
44 של של של shel-preposition unspecified unspecified unspecified unspecified unspecified  	O	null
45 ה ה הכלב definiteArticle unspecified unspecified unspecified unspecified unspecified 0 
45 הכלב כלב הכלב noun masculine singular absolute unspecified unspecified  	O	null
46 סמור סמור סמור noun masculine singular absolute unspecified unspecified  	O	null
47 . . . punctuation unspecified unspecified unspecified unspecified unspecified  	O	null

0 סמור סמור סמור noun masculine singular absolute unspecified unspecified  	O	null
1 , , , punctuation unspecified unspecified unspecified unspecified unspecified  	O	null
2 שונא שנא שונא verb masculine singular unspecified any beinoni  	O	null
3 מדים מד מדים noun masculine plural absolute unspecified unspecified  	O	null
4 של של של shel-preposition unspecified unspecified unspecified unspecified unspecified  	O	null
5 בריטים בריטי בריטים noun masculine plural absolute unspecified unspecified  	O	null
6 ו ו וגם conjunction unspecified unspecified unspecified unspecified unspecified 0 
6 גם גם וגם conjunction unspecified unspecified unspecified unspecified unspecified  	O	null
7 של של של shel-preposition unspecified unspecified unspecified unspecified unspecified  	O	null
8 יהודים יהודי יהודים noun masculine plural absolute unspecified unspecified  	O	null
9 , , , punctuation unspecified unspecified unspecified unspecified unspecified  	O	null
10 מציל הציל מציל verb masculine singular unspecified any beinoni  	O	null
11 את את את at-preposition unspecified unspecified unspecified unspecified unspecified  	O	null
12 ה ה הילד definiteArticle unspecified unspecified unspecified unspecified unspecified 0 
12 הילד ילד הילד noun masculine singular absolute unspecified unspecified  	O	null
13 ה ה המגדל definiteArticle unspecified unspecified unspecified unspecified unspecified 0 
13 המגדל מגדל המגדל noun masculine singular absolute unspecified unspecified  	O	null
14 את את אותו at-preposition unspecified unspecified unspecified unspecified unspecified  
14 ו ו אותו pronomial masculine singular unspecified 3 unspecified 0 	O	null
15 מ מ מידי preposition unspecified unspecified unspecified unspecified unspecified 0 
15 ידי יד מידי noun feminine plural construct unspecified unspecified  	O	null
16 ה ה החיילים definiteArticle unspecified unspecified unspecified unspecified unspecified 0 
16 החיילים חייל החיילים noun masculine plural absolute unspecified unspecified  	O	null
17 ה ה היהודים definiteArticle unspecified unspecified unspecified unspecified unspecified 0 
17 היהודים יהודי היהודים adjective masculine plural absolute unspecified unspecified  	O	null
18 , , , punctuation unspecified unspecified unspecified unspecified unspecified  	O	null
19 ו ו וכשמגיעה conjunction unspecified unspecified unspecified unspecified unspecified 0 
19 כש כש וכשמגיעה temporalSubConj unspecified unspecified unspecified unspecified unspecified 0 
19 מגיעה הגיע וכשמגיעה verb feminine singular unspecified any beinoni  	O	null
20 ה ה השעה definiteArticle unspecified unspecified unspecified unspecified unspecified 0 
20 השעה שעה השעה noun feminine singular absolute unspecified unspecified  	O	null
21 לעזוב עזב לעזוב verb unspecified unspecified unspecified unspecified infinitive  	O	null
22 את את את at-preposition unspecified unspecified unspecified unspecified unspecified  	O	null
23 ה ה הכפר definiteArticle unspecified unspecified unspecified unspecified unspecified 0 
23 הכפר כפר הכפר noun masculine singular absolute unspecified unspecified  	O	null
24 הוא הוא הוא pronoun masculine singular unspecified 3 unspecified  	O	null
25 מסרב סירב מסרב verb masculine singular unspecified any beinoni  	O	null
26 להימלט נמלט להימלט verb unspecified unspecified unspecified unspecified infinitive  	O	null
27 . . . punctuation unspecified unspecified unspecified unspecified unspecified  	O	null

0 ה ה הילד definiteArticle unspecified unspecified unspecified unspecified unspecified 0 
0 הילד ילד הילד noun masculine singular absolute unspecified unspecified  	O	null
1 נשאר נשאר נשאר verb masculine singular unspecified 3 past  	O	null
2 עם עם עמו preposition unspecified unspecified unspecified unspecified unspecified  
2 ו ו עמו pronomial masculine singular unspecified 3 unspecified 0 	O	null
3 ב ב בכפר preposition unspecified unspecified unspecified unspecified unspecified 0 
3 ה ה בכפר definiteArticle unspecified unspecified unspecified unspecified unspecified 0 
3 הכפר כפר בכפר noun masculine singular absolute unspecified unspecified  	O	null
4 ו ו ומבין conjunction unspecified unspecified unspecified unspecified unspecified 0 
4 מבין הבין ומבין verb masculine singular unspecified any beinoni  	O	null
5 באמצעות באמצעות באמצעותו preposition unspecified unspecified unspecified unspecified unspecified  
5 ו ו באמצעותו pronomial masculine singular unspecified 3 unspecified 0 	O	null
6 את את את at-preposition unspecified unspecified unspecified unspecified unspecified  	O	null
7 פשר פשר פשר noun masculine singular construct unspecified unspecified  	O	null
8 ה ה הנאמנות definiteArticle unspecified unspecified unspecified unspecified unspecified 0 
8 הנאמנות נאמנות הנאמנות noun feminine singular absolute unspecified unspecified  	O	null
9 ל ל לבית preposition unspecified unspecified unspecified unspecified unspecified 0 
9 ה ה לבית definiteArticle unspecified unspecified unspecified unspecified unspecified 0 
9 הבית בית לבית noun masculine singular absolute unspecified unspecified  	O	null
10 . . . punctuation unspecified unspecified unspecified unspecified unspecified  	O	null

0 פיין פיין פיין properName unspecified unspecified unspecified unspecified unspecified  	I_PERS	null
1 , , , punctuation unspecified unspecified unspecified unspecified unspecified  	O	null
2 יונתן יונתן יונתן properName unspecified unspecified unspecified unspecified unspecified  	I_PERS	null
3 ( ( ( punctuation unspecified unspecified unspecified unspecified unspecified  	O	null
4 ###NUMBER### ###NUMBER### ###NUMBER### numeral unspecified unspecified unspecified unspecified unspecified  	I_DATE	null
5 ) ) ) punctuation unspecified unspecified unspecified unspecified unspecified  	O	null
6 References References References foreign unspecified unspecified unspecified unspecified unspecified  	O	null
7 : : : punctuation unspecified unspecified unspecified unspecified unspecified  	O	null
8 خليل خليل خليل properName unspecified unspecified unspecified unspecified unspecified  	I_ORG	null
9 , , , punctuation unspecified unspecified unspecified unspecified unspecified  	O	null
10 محمد محمد محمد properName unspecified unspecified unspecified unspecified unspecified  	I_PERS	null
11 . . . punctuation unspecified unspecified unspecified unspecified unspecified  	O	null

0 " " " punctuation unspecified unspecified unspecified unspecified unspecified  	I_ORG	null
1 الالتزام الالتزام الالتزام properName unspecified unspecified unspecified unspecified unspecified  	I_ORG	null
2 في في في adjective masculine singular construct unspecified unspecified  	O	null
3 أدب أدب أدب adjective masculine singular construct unspecified unspecified  	O	null
4 توفيق توفيق توفيق adjective masculine singular construct unspecified unspecified  	O	null
5 فياض فياض فياض adjective masculine singular construct unspecified unspecified  	O	null
6 " " " punctuation unspecified unspecified unspecified unspecified unspecified  	O	null
7 . . . punctuation unspecified unspecified unspecified unspecified unspecified  	O	null

0 موسوعة موسوعة موسوعة adjective masculine singular construct unspecified unspecified  	O	null
1 أبحاث أبحاث أبحاث adjective masculine singular construct unspecified unspecified  	O	null
2 ودراسات ودراسات ودراسات adjective masculine singular construct unspecified unspecified  	O	null
3 في في في adjective masculine singular construct unspecified unspecified  	O	null
4 الأدب الأدب الأدب properName unspecified unspecified unspecified unspecified unspecified  	I_ORG	null
5 الفلسطيني الفلسطيني الفلسطيني verb masculine singular unspecified 2 imperative  	O	null
6 الحديث الحديث الحديث properName unspecified unspecified unspecified unspecified unspecified  	I_PERS	null
7 . . . punctuation unspecified unspecified unspecified unspecified unspecified  	O	null

0 باقة باقة باقة adjective masculine singular construct unspecified unspecified  	O	null
1 الغربية الغربية الغربية adjective masculine singular construct unspecified unspecified  	O	null
2 : : : punctuation unspecified unspecified unspecified unspecified unspecified  	O	null
3 مجمع مجمع مجمع adjective masculine singular construct unspecified unspecified  	O	null
4 القاسمي القاسمي القاسمي adjective masculine singular construct unspecified unspecified  	O	null
5 للغة للغة للغة adjective masculine singular construct unspecified unspecified  	O	null
6 العربية العربية العربية properName unspecified unspecified unspecified unspecified unspecified  	I_LOC	null
7 . . . punctuation unspecified unspecified unspecified unspecified unspecified  	O	null

0 ###NUMBER### ###NUMBER### ###NUMBER### numeral unspecified unspecified unspecified unspecified unspecified  	I_DATE	null
1 . . . punctuation unspecified unspecified unspecified unspecified unspecified  	O	null

0 - - - punctuation unspecified unspecified unspecified unspecified unspecified  	O	null
1 ###NUMBER### ###NUMBER### ###NUMBER### numeral unspecified unspecified unspecified unspecified unspecified  	O	null
2 ; ; ; punctuation unspecified unspecified unspecified unspecified unspecified  	O	null
3 ###NUMBER### ###NUMBER### ###NUMBER### numeral unspecified unspecified unspecified unspecified unspecified  	O	null
4 ינון יינון ינון properName unspecified unspecified unspecified unspecified unspecified  	I_PERS	null
5 , , , punctuation unspecified unspecified unspecified unspecified unspecified  	O	null
6 אברהם אברהם אברהם properName unspecified unspecified unspecified unspecified unspecified  	I_PERS	null
7 . . . punctuation unspecified unspecified unspecified unspecified unspecified  	O	null

0 " " " punctuation unspecified unspecified unspecified unspecified unspecified  	O	null
1 נושאים נושא נושאים noun masculine plural absolute unspecified unspecified  	O	null
2 חברתיים חברתי חברתיים adjective masculine plural absolute unspecified unspecified  	O	null
3 " " " punctuation unspecified unspecified unspecified unspecified unspecified  	O	null
4 . . . punctuation unspecified unspecified unspecified unspecified unspecified  	O	null

0 ה ה המזרח definiteArticle unspecified unspecified unspecified unspecified unspecified 0 
0 המזרח מזרח המזרח noun masculine singular absolute unspecified unspecified  	O	null
1 ה ה החדש definiteArticle unspecified unspecified unspecified unspecified unspecified 0 
1 החדש חדש החדש adjective masculine singular absolute unspecified unspecified  	O	null
2 ט"ז ט"ז ט"ז properName unspecified unspecified unspecified unspecified unspecified  	I_ORG	null
3 ###NUMBER### ###NUMBER### ###NUMBER### numeral unspecified unspecified unspecified unspecified unspecified  	I_ORG	null
4 - - - punctuation unspecified unspecified unspecified unspecified unspecified  	O	null
5 ###NUMBER### ###NUMBER### ###NUMBER### numeral unspecified unspecified unspecified unspecified unspecified  	O	null
6 . . . punctuation unspecified unspecified unspecified unspecified unspecified  	O	null

0 ###NUMBER### ###NUMBER### ###NUMBER### numeral unspecified unspecified unspecified unspecified unspecified  	I_DATE	null
1 . . . punctuation unspecified unspecified unspecified unspecified unspecified  	O	null

0 - - - punctuation unspecified unspecified unspecified unspecified unspecified  	O	null
1 ###NUMBER### ###NUMBER### ###NUMBER### numeral unspecified unspecified unspecified unspecified unspecified  	O	null
2 ; ; ; punctuation unspecified unspecified unspecified unspecified unspecified  	O	null
3 ###NUMBER### ###NUMBER### ###NUMBER### numeral unspecified unspecified unspecified unspecified unspecified  	O	null
4 Ghanayim Ghanayim Ghanayim foreign unspecified unspecified unspecified unspecified unspecified  	O	null
5 , , , punctuation unspecified unspecified unspecified unspecified unspecified  	O	null
6 Mahmud Mahmud Mahmud foreign unspecified unspecified unspecified unspecified unspecified  	O	null
7 . . . punctuation unspecified unspecified unspecified unspecified unspecified  	O	null

0 " " " punctuation unspecified unspecified unspecified unspecified unspecified  	O	null
1 Lone Lone Lone foreign unspecified unspecified unspecified unspecified unspecified  	O	null
2 Rebel Rebel Rebel foreign unspecified unspecified unspecified unspecified unspecified  	O	null
3 " " " punctuation unspecified unspecified unspecified unspecified unspecified  	O	null
4 . . . punctuation unspecified unspecified unspecified unspecified unspecified  	O	null

0 The The The foreign unspecified unspecified unspecified unspecified unspecified  	I_ORG	null
1 Quest Quest Quest foreign unspecified unspecified unspecified unspecified unspecified  	I_ORG	null
2 for for for foreign unspecified unspecified unspecified unspecified unspecified  	I_ORG	null
3 a a a foreign unspecified unspecified unspecified unspecified unspecified  	I_ORG	null
4 Lost Lost Lost foreign unspecified unspecified unspecified unspecified unspecified  	I_ORG	null
5 Identity Identity Identity foreign unspecified unspecified unspecified unspecified unspecified  	I_ORG	null
6 : : : punctuation unspecified unspecified unspecified unspecified unspecified  	O	null
7 Palestinian Palestinian Palestinian foreign unspecified unspecified unspecified unspecified unspecified  	O	null
8 Fiction Fiction Fiction foreign unspecified unspecified unspecified unspecified unspecified  	O	null
9 in in in foreign unspecified unspecified unspecified unspecified unspecified  	O	null
10 Israel Israel Israel foreign unspecified unspecified unspecified unspecified unspecified  	O	null
11 . . . punctuation unspecified unspecified unspecified unspecified unspecified  	O	null

0 Wiesbaden Wiesbaden Wiesbaden foreign unspecified unspecified unspecified unspecified unspecified  	O	null
1 : : : punctuation unspecified unspecified unspecified unspecified unspecified  	O	null
2 Harrassowitz Harrassowitz Harrassowitz foreign unspecified unspecified unspecified unspecified unspecified  	O	null
3 . . . punctuation unspecified unspecified unspecified unspecified unspecified  	O	null

0 ###NUMBER### ###NUMBER### ###NUMBER### numeral unspecified unspecified unspecified unspecified unspecified  	I_DATE	null
1 . . . punctuation unspecified unspecified unspecified unspecified unspecified  	O	null

0 ###NUMBER### ###NUMBER### ###NUMBER### numeral unspecified unspecified unspecified unspecified unspecified  	O	null
1 - - - punctuation unspecified unspecified unspecified unspecified unspecified  	O	null
2 ###NUMBER### ###NUMBER### ###NUMBER### numeral unspecified unspecified unspecified unspecified unspecified  	O	null
3 . . . punctuation unspecified unspecified unspecified unspecified unspecified  	O	null

